1100,서울특별시,1101,종로구,합계,,129968,100629,46130,49172,3115,53,558,42,9,50,82,105,20,30,99366,1263,29339
1100,서울특별시,1101,종로구,거소·선상투표,,217,200,82,85,4,1,3,0,0,0,0,2,0,0,177,23,17
1100,서울특별시,1101,종로구,관외사전투표,,13132,13092,6416,5972,434,8,99,4,1,5,3,22,2,4,12970,122,40
1100,서울특별시,1101,종로구,재외투표,,2077,1480,739,541,56,2,9,0,0,0,0,1,0,0,1348,132,597
1100,서울특별시,1101,종로구,재외투표(공관),,0,188,83,79,6,0,0,0,0,0,0,0,0,0,168,20,-188
1100,서울특별시,1101,종로구,청운효자동,소계,8706,6640,3150,3137,237,3,26,2,0,3,7,4,1,2,6572,68,2066
1100,서울특별시,1101,종로구,,관내사전투표,3102,3098,1758,1221,81,2,8,1,0,0,4,1,1,1,3078,20,4
1100,서울특별시,1101,종로구,,청운효자동제1투,1925,1170,402,700,43,1,7,0,0,2,1,1,0,0,1157,13,755
1100,서울특별시,1101,종로구,,청운효자동제2투,1792,1155,436,637,61,0,3,0,0,1,0,1,0,1,1140,15,637
1100,서울특별시,1101,종로구,,청운효자동제3투,1887,1217,554,579,52,0,8,1,0,0,2,1,0,0,1197,20,670
1100,서울특별시,1101,종로구,사직동,소계,7651,5850,2260,3282,212,3,22,0,1,2,4,4,0,0,5790,60,1801
1100,서울특별시,1101,종로구,,관내사전투표,2737,2732,1360,1259,83,1,4,0,0,1,0,1,0,0,2709,23,5
1100,서울특별시,1101,종로구,,사직동제1투,1555,823,317,451,32,0,9,0,0,0,2,1,0,0,812,11,732
1100,서울특별시,1101,종로구,,사직동제2투,3359,2295,583,1572,97,2,9,0,1,1,2,2,0,0,2269,26,1064
1100,서울특별시,1101,종로구,삼청동,소계,1935,1443,591,767,51,0,10,0,0,3,3,0,0,0,1425,18,492
1100,서울특별시,1101,종로구,,관내사전투표,717,716,376,299,25,0,5,0,0,0,1,0,0,0,706,10,1
1100,서울특별시,1101,종로구,,삼청동투표소,1218,727,215,468,26,0,5,0,0,3,2,0,0,0,719,8,491
1100,서울특별시,1101,종로구,부암동,소계,7205,5485,2496,2731,154,0,26,4,0,4,0,4,1,2,5422,63,1720
1100,서울특별시,1101,종로구,,관내사전투표,2360,2360,1283,1002,57,0,5,3,0,0,0,0,0,1,2351,9,0
1100,서울특별시,1101,종로구,,부암동제1투,1761,1028,406,556,32,0,7,1,0,0,0,2,1,0,1005,23,733
1100,서울특별시,1101,종로구,,부암동제2투,1704,1165,477,619,41,0,8,0,0,1,0,1,0,0,1147,18,539
1100,서울특별시,1101,종로구,,부암동제3투,1380,932,330,554,24,0,6,0,0,3,0,1,0,1,919,13,448
1100,서울특별시,1101,종로구,평창동,소계,13796,10534,3866,6248,266,5,35,7,1,6,8,11,0,2,10455,79,3262
1100,서울특별시,1101,종로구,,관내사전투표,4411,4411,2011,2253,104,2,5,3,1,2,2,4,0,1,4388,23,0
1100,서울특별시,1101,종로구,,평창동제1투,1936,1181,360,775,31,1,5,1,0,0,0,0,0,0,1173,8,755
1100,서울특별시,1101,종로구,,평창동제2투,2720,1718,429,1233,30,0,9,0,0,1,0,1,0,0,1703,15,1002
1100,서울특별시,1101,종로구,,평창동제3투,1653,1180,348,771,37,1,6,3,0,2,0,1,0,0,1169,11,473
1100,서울특별시,1101,종로구,,평창동제4투,1563,1071,395,611,36,0,8,0,0,1,5,3,0,1,1060,11,492
1100,서울특별시,1101,종로구,,평창동제5투,1513,973,323,605,28,1,2,0,0,0,1,2,0,0,962,11,540
1100,서울특별시,1101,종로구,무악동,소계,6143,4978,2162,2586,155,3,17,0,1,0,2,3,2,2,4933,45,1165
1100,서울특별시,1101,종로구,,관내사전투표,2572,2570,1306,1178,63,2,4,0,0,0,0,1,0,1,2555,15,2
1100,서울특별시,1101,종로구,,무악동제1투,1480,1063,365,636,44,1,2,0,0,0,0,0,2,0,1050,13,417
1100,서울특별시,1101,종로구,,무악동제2투,2091,1345,491,772,48,0,11,0,1,0,2,2,0,1,1328,17,746
1100,서울특별시,1101,종로구,교남동,소계,7795,6215,2621,3276,193,3,28,1,0,2,9,11,2,1,6147,68,1580
1100,서울특별시,1101,종로구,,관내사전투표,2876,2875,1415,1335,85,2,5,1,0,0,2,7,1,0,2853,22,1
1100,서울특별시,1101,종로구,,교남동제1투,1414,837,395,387,25,0,10,0,0,0,4,2,0,0,823,14,577
1100,서울특별시,1101,종로구,,교남동제2투,1229,748,293,396,30,1,8,0,0,1,3,1,0,1,734,14,481
1100,서울특별시,1101,종로구,,교남동제3투,2276,1755,518,1158,53,0,5,0,0,1,0,1,1,0,1737,18,521
1100,서울특별시,1101,종로구,가회동,소계,3454,2650,1252,1243,104,2,10,1,0,2,2,4,1,2,2623,27,804
1100,서울특별시,1101,종로구,,관내사전투표,1456,1454,793,586,55,0,3,0,0,0,0,4,0,1,1442,12,2
1100,서울특별시,1101,종로구,,가회동투표소,1998,1196,459,657,49,2,7,1,0,2,2,0,1,1,1181,15,802
1100,서울특별시,1101,종로구,종로1·2·3·4가동,소계,5741,3527,1468,1911,81,2,17,0,1,1,2,4,3,0,3490,37,2214
1100,서울특별시,1101,종로구,,관내사전투표,1540,1540,753,743,28,0,3,0,0,0,0,1,0,0,1528,12,0
1100,서울특별시,1101,종로구,,종로1·2·3·4가동제1투,2022,836,270,522,25,0,10,0,0,0,2,0,1,0,830,6,1186
1100,서울특별시,1101,종로구,,종로1·2·3·4가동제2투,2179,1151,445,646,28,2,4,0,1,1,0,3,2,0,1132,19,1028
1100,서울특별시,1101,종로구,종로5·6가동,소계,4130,2906,1305,1460,76,0,23,0,0,1,2,0,0,2,2869,37,1224
1100,서울특별시,1101,종로구,,관내사전투표,1327,1325,668,608,30,0,6,0,0,1,1,0,0,0,1314,11,2
1100,서울특별시,1101,종로구,,종로5·6가동제1투,1520,850,310,485,32,0,5,0,0,0,1,0,0,0,833,17,670
1100,서울특별시,1101,종로구,,종로5·6가동제2투,1283,731,327,367,14,0,12,0,0,0,0,0,0,2,722,9,552
1100,서울특별시,1101,종로구,이화동,소계,6154,4703,2279,2141,174,2,23,1,1,4,5,8,1,1,4640,63,1451
1100,서울특별시,1101,종로구,,관내사전투표,2430,2430,1347,975,74,1,5,0,0,0,2,5,0,1,2410,20,0
1100,서울특별시,1101,종로구,,이화동제1투,1960,1248,535,600,64,1,10,0,1,3,1,2,1,0,1218,30,712
1100,서울특별시,1101,종로구,,이화동제2투,1764,1025,397,566,36,0,8,1,0,1,2,1,0,0,1012,13,739
1100,서울특별시,1101,종로구,혜화동,소계,12828,9743,4400,4752,364,15,47,12,0,5,9,6,1,5,9616,127,3085
1100,서울특별시,1101,종로구,,관내사전투표,4538,4532,2357,1962,152,6,11,7,0,0,1,3,0,3,4502,30,6
1100,서울특별시,1101,종로구,,혜화동제1투,2127,1351,576,669,59,1,8,1,0,4,2,1,0,0,1321,30,776
1100,서울특별시,1101,종로구,,혜화동제2투,1921,1208,457,659,55,2,10,1,0,0,0,1,0,0,1185,23,713
1100,서울특별시,1101,종로구,,혜화동제3투,1774,1094,366,665,40,1,6,0,0,1,5,0,0,0,1084,10,680
1100,서울특별시,1101,종로구,,혜화동제4투,1263,820,320,436,33,3,7,2,0,0,1,0,1,1,804,16,443
1100,서울특별시,1101,종로구,,혜화동제5투,1205,738,324,361,25,2,5,1,0,0,0,1,0,1,720,18,467
1100,서울특별시,1101,종로구,창신제1동,소계,5152,3907,2134,1580,90,0,37,2,1,1,6,4,2,2,3859,48,1245
1100,서울특별시,1101,종로구,,관내사전투표,2369,2368,1421,844,50,0,19,2,1,0,0,3,1,1,2342,26,1
1100,서울특별시,1101,종로구,,창신제1동제1투,833,360,167,170,9,0,4,0,0,0,2,0,0,0,352,8,473
1100,서울특별시,1101,종로구,,창신제1동제2투,1950,1179,546,566,31,0,14,0,0,1,4,1,1,1,1165,14,771
1100,서울특별시,1101,종로구,창신제2동,소계,6071,4089,2262,1633,78,2,35,3,0,4,7,3,1,3,4031,58,1982
1100,서울특별시,1101,종로구,,관내사전투표,1320,1313,839,426,24,2,7,1,0,1,1,0,0,0,1301,12,7
1100,서울특별시,1101,종로구,,창신제2동제1투,1260,707,346,323,11,0,9,0,0,1,1,1,0,2,694,13,553
1100,서울특별시,1101,종로구,,창신제2동제2투,1910,1193,602,532,26,0,8,1,0,0,2,2,1,1,1175,18,717
1100,서울특별시,1101,종로구,,창신제2동제3투,1581,876,475,352,17,0,11,1,0,2,3,0,0,0,861,15,705
1100,서울특별시,1101,종로구,창신제3동,소계,5236,4067,2036,1848,109,1,16,1,0,4,3,3,0,0,4021,46,1169
1100,서울특별시,1101,종로구,,관내사전투표,1983,1982,1131,786,46,0,3,1,0,1,0,0,0,0,1968,14,1
1100,서울특별시,1101,종로구,,창신제3동제1투,1204,707,335,334,19,1,7,0,0,1,1,1,0,0,699,8,497
1100,서울특별시,1101,종로구,,창신제3동제2투,2049,1378,570,728,44,0,6,0,0,2,2,2,0,0,1354,24,671
1100,서울특별시,1101,종로구,숭인제1동,소계,4575,3286,1641,1489,84,1,26,1,1,2,1,1,1,0,3248,38,1289
1100,서울특별시,1101,종로구,,관내사전투표,1523,1522,867,600,31,1,7,1,0,1,0,0,1,0,1509,13,1
1100,서울특별시,1101,종로구,,숭인제1동제1투,1729,948,417,475,24,0,12,0,0,0,1,0,0,0,929,19,781
1100,서울특별시,1101,종로구,,숭인제1동제2투,1323,816,357,414,29,0,7,0,1,1,0,1,0,0,810,6,507
1100,서울특별시,1101,종로구,숭인제2동,소계,7970,5605,2866,2394,185,0,49,3,1,1,9,10,2,2,5522,83,2365
1100,서울특별시,1101,종로구,,관내사전투표,2433,2431,1397,921,63,0,15,2,0,1,1,3,0,0,2403,28,2
1100,서울특별시,1101,종로구,,숭인제2동제1투,2200,1291,555,621,64,0,12,0,0,0,4,2,1,0,1259,32,909
1100,서울특별시,1101,종로구,,숭인제2동제2투,1687,925,419,451,27,0,10,1,1,0,2,3,1,0,915,10,762
1100,서울특별시,1101,종로구,,숭인제2동제3투,1650,958,495,401,31,0,12,0,0,0,2,2,0,2,945,13,692
1100,서울특별시,1101,종로구,잘못 투입·구분된 투표지,,0,41,21,17,2,0,0,0,0,0,0,0,0,0,40,1,-41
1100,서울특별시,1102,중구,합계,,111448,84998,38244,42906,2310,46,463,19,10,17,67,57,17,28,84184,814,26450
1100,서울특별시,1102,중구,거소·선상투표,,196,185,59,105,5,0,1,0,0,0,0,0,1,1,172,13,11
1100,서울특별시,1102,중구,관외사전투표,,11572,11562,5524,5488,351,6,78,3,1,2,6,16,0,7,11482,80,10
1100,서울특별시,1102,중구,재외투표,,1359,915,467,346,20,0,5,1,0,0,1,1,0,0,841,74,444
1100,서울특별시,1102,중구,소공동,소계,1747,1296,489,734,50,1,6,2,0,0,0,3,1,0,1286,10,451
1100,서울특별시,1102,중구,,관내사전투표,469,469,228,223,10,0,3,1,0,0,0,1,0,0,466,3,0
1100,서울특별시,1102,중구,,소공동제1투,341,179,56,113,6,1,0,0,0,0,0,2,0,0,178,1,162
1100,서울특별시,1102,중구,,소공동제2투,937,648,205,398,34,0,3,1,0,0,0,0,1,0,642,6,289
1100,서울특별시,1102,중구,회현동,소계,3883,2519,965,1460,50,0,15,2,0,2,3,0,0,0,2497,22,1364
1100,서울특별시,1102,중구,,관내사전투표,1135,1135,506,603,12,0,6,1,0,1,1,0,0,0,1130,5,0
1100,서울특별시,1102,중구,,회현동제1투,2132,1083,342,689,31,0,6,0,0,1,1,0,0,0,1070,13,1049
1100,서울특별시,1102,중구,,회현동제2투,616,301,117,168,7,0,3,1,0,0,1,0,0,0,297,4,315
1100,서울특별시,1102,중구,명동,소계,2150,1515,593,860,37,1,12,0,0,1,2,0,1,0,1507,8,635
1100,서울특별시,1102,중구,,관내사전투표,780,780,362,390,19,1,3,0,0,1,0,0,1,0,777,3,0
1100,서울특별시,1102,중구,,명동제1투,1262,697,223,441,18,0,8,0,0,0,2,0,0,0,692,5,565
1100,서울특별시,1102,중구,,명동제2투,108,38,8,29,0,0,1,0,0,0,0,0,0,0,38,0,70
1100,서울특별시,1102,중구,필동,소계,3998,3081,1396,1550,73,1,17,0,0,2,4,2,0,0,3045,36,917
1100,서울특별시,1102,중구,,관내사전투표,1889,1889,960,865,41,1,6,0,0,0,1,2,0,0,1876,13,0
1100,서울특별시,1102,중구,,필동제1투,1068,583,217,334,15,0,4,0,0,2,2,0,0,0,574,9,485
1100,서울특별시,1102,중구,,필동제2투,1041,609,219,351,17,0,7,0,0,0,1,0,0,0,595,14,432
1100,서울특별시,1102,중구,장충동,소계,3940,2902,1316,1437,81,2,26,0,0,1,2,2,0,1,2868,34,1038
1100,서울특별시,1102,중구,,관내사전투표,1418,1417,737,617,37,2,10,0,0,0,0,2,0,1,1406,11,1
1100,서울특별시,1102,중구,,장충동제1투,1268,747,282,428,19,0,8,0,0,0,2,0,0,0,739,8,521
1100,서울특별시,1102,중구,,장충동제2투,1254,738,297,392,25,0,8,0,0,1,0,0,0,0,723,15,516
1100,서울특별시,1102,중구,광희동,소계,3757,2435,928,1389,65,0,13,0,0,0,1,2,1,0,2399,36,1322
1100,서울특별시,1102,중구,,관내사전투표,583,583,292,274,8,0,1,0,0,0,0,1,0,0,576,7,0
1100,서울특별시,1102,중구,,광희동제1투,1391,708,270,405,20,0,2,0,0,0,0,1,1,0,699,9,683
1100,서울특별시,1102,중구,,광희동제2투,1783,1144,366,710,37,0,10,0,0,0,1,0,0,0,1124,20,639
1100,서울특별시,1102,중구,을지로동,소계,1478,987,390,559,25,1,4,0,0,0,1,0,0,0,980,7,491
1100,서울특별시,1102,중구,,관내사전투표,446,446,208,223,11,0,2,0,0,0,0,0,0,0,444,2,0
1100,서울특별시,1102,중구,,을지로동제1투,544,237,70,155,6,1,1,0,0,0,1,0,0,0,234,3,307
1100,서울특별시,1102,중구,,을지로동제2투,488,304,112,181,8,0,1,0,0,0,0,0,0,0,302,2,184
1100,서울특별시,1102,중구,신당동,소계,7063,5048,2400,2422,124,5,37,1,1,1,2,3,2,1,4999,49,2015
1100,서울특별시,1102,중구,,관내사전투표,2546,2546,1361,1092,61,2,12,0,0,0,1,2,1,0,2532,14,0
1100,서울특별시,1102,중구,,신당동제1투,1558,755,334,376,17,2,6,1,1,1,0,1,0,1,740,15,803
1100,서울특별시,1102,중구,,신당동제2투,1518,910,332,536,26,1,6,0,0,0,0,0,1,0,902,8,608
1100,서울특별시,1102,중구,,신당동제3투,1441,837,373,418,20,0,13,0,0,0,1,0,0,0,825,12,604
1100,서울특별시,1102,중구,다산동,소계,10155,7101,3350,3391,211,10,45,1,0,0,7,6,2,6,7029,72,3054
1100,서울특별시,1102,중구,,관내사전투표,2677,2677,1459,1114,60,5,11,1,0,0,2,2,0,0,2654,23,0
1100,서울특별시,1102,중구,,다산동제1투,1909,1042,443,540,38,2,8,0,0,0,0,1,1,4,1037,5,867
1100,서울특별시,1102,중구,,다산동제2투,2095,1292,555,653,47,2,11,0,0,0,2,0,0,1,1271,21,803
1100,서울특별시,1102,중구,,다산동제3투,1640,959,414,491,32,1,6,0,0,0,3,1,1,0,949,10,681
1100,서울특별시,1102,중구,,다산동제4투,1834,1131,479,593,34,0,9,0,0,0,0,2,0,1,1118,13,703
1100,서울특별시,1102,중구,약수동,소계,13658,10613,4561,5623,279,4,40,4,1,3,12,5,4,4,10540,73,3045
1100,서울특별시,1102,중구,,관내사전투표,4329,4328,2163,2018,102,2,13,4,0,0,2,1,2,2,4309,19,1
1100,서울특별시,1102,중구,,약수동제1투,1256,647,253,357,22,1,3,0,0,0,0,0,0,0,636,11,609
1100,서울특별시,1102,중구,,약수동제2투,1448,1006,475,490,29,0,2,0,0,0,1,0,0,0,997,9,442
1100,서울특별시,1102,중구,,약수동제3투,2380,1749,519,1154,52,0,4,0,0,1,4,2,1,0,1737,12,631
1100,서울특별시,1102,중구,,약수동제4투,2252,1655,544,1037,51,1,5,0,1,2,1,2,0,0,1644,11,597
1100,서울특별시,1102,중구,,약수동제5투,1993,1228,607,567,23,0,13,0,0,0,4,0,1,2,1217,11,765
1100,서울특별시,1102,중구,청구동,소계,10615,8150,3605,4209,202,7,34,2,2,0,6,1,1,3,8072,78,2465
1100,서울특별시,1102,중구,,관내사전투표,2784,2784,1486,1199,70,1,5,1,0,0,1,0,0,1,2764,20,0
1100,서울특별시,1102,중구,,청구동제1투,1025,623,300,290,17,0,7,0,0,0,2,0,0,0,616,7,402
1100,서울특별시,1102,중구,,청구동제2투,1413,752,305,407,28,0,1,0,0,0,2,0,0,0,743,9,661
1100,서울특별시,1102,중구,,청구동제3투,1835,1421,470,899,28,2,5,0,1,0,0,1,1,1,1408,13,414
1100,서울특별시,1102,중구,,청구동제4투,1431,1023,429,540,30,2,8,1,0,0,0,0,0,0,1010,13,408
1100,서울특별시,1102,중구,,청구동제5투,2127,1547,615,874,29,2,8,0,1,0,1,0,0,1,1531,16,580
1100,서울특별시,1102,중구,신당제5동,소계,8626,6268,3043,2946,173,0,34,1,1,0,6,8,2,1,6215,53,2358
1100,서울특별시,1102,중구,,관내사전투표,3162,3162,1718,1335,74,0,10,1,0,0,3,5,0,0,3146,16,0
1100,서울특별시,1102,중구,,신당제5동제1투,1634,864,376,434,28,0,7,0,0,0,2,1,0,1,849,15,770
1100,서울특별시,1102,중구,,신당제5동제2투,2367,1340,573,705,31,0,14,0,0,0,1,2,0,0,1326,14,1027
1100,서울특별시,1102,중구,,신당제5동제3투,1463,902,376,472,40,0,3,0,1,0,0,0,2,0,894,8,561
1100,서울특별시,1102,중구,동화동,소계,8177,6359,2818,3280,179,4,23,0,0,0,4,0,1,4,6313,46,1818
1100,서울특별시,1102,중구,,관내사전투표,3068,3063,1563,1408,77,0,3,0,0,0,0,0,0,1,3052,11,5
1100,서울특별시,1102,중구,,동화동제1투,898,530,202,303,14,1,3,0,0,0,0,0,1,1,525,5,368
1100,서울특별시,1102,중구,,동화동제2투,1388,967,351,555,37,1,6,0,0,0,1,0,0,0,951,16,421
1100,서울특별시,1102,중구,,동화동제3투,1577,1054,377,631,31,2,5,0,0,0,1,0,0,0,1047,7,523
1100,서울특별시,1102,중구,,동화동제4투,1246,745,325,383,20,0,6,0,0,0,2,0,0,2,738,7,501
1100,서울특별시,1102,중구,황학동,소계,10175,7288,3380,3581,194,2,41,1,3,5,5,4,0,0,7216,72,2887
1100,서울특별시,1102,중구,,관내사전투표,2795,2795,1484,1206,71,0,13,0,1,1,1,2,0,0,2779,16,0
1100,서울특별시,1102,중구,,황학동제1투,2908,1612,679,851,49,1,9,1,0,0,3,1,0,0,1594,18,1296
1100,서울특별시,1102,중구,,황학동제2투,1834,1042,464,513,36,1,7,0,1,2,0,1,0,0,1025,17,792
1100,서울특별시,1102,중구,,황학동제3투,2638,1839,753,1011,38,0,12,0,1,2,1,0,0,0,1818,21,799
1100,서울특별시,1102,중구,중림동,소계,8899,6768,2957,3523,191,2,32,1,1,0,5,4,1,0,6717,51,2131
1100,서울특별시,1102,중구,,관내사전투표,2680,2680,1375,1209,70,0,8,0,0,0,1,1,0,0,2664,16,0
1100,서울특별시,1102,중구,,중림동제1투,2013,1332,488,792,31,0,3,0,0,0,1,2,1,0,1318,14,681
1100,서울특별시,1102,중구,,중림동제2투,2075,1213,496,663,36,1,7,0,0,0,1,1,0,0,1205,8,862
1100,서울특별시,1102,중구,,중림동제3투,2131,1543,598,859,54,1,14,1,1,0,2,0,0,0,1530,13,588
1100,서울특별시,1102,중구,잘못 투입·구분된 투표지,,0,6,3,3,0,0,0,0,0,0,0,0,0,0,6,0,-6
1100,서울특별시,1103,용산구,합계,,199077,152068,60063,85047,4374,67,755,37,24,56,86,100,27,46,150682,1386,47009
1100,서울특별시,1103,용산구,거소·선상투표,,273,257,83,129,9,1,2,0,0,1,0,1,1,0,227,30,16
1100,서울특별시,1103,용산구,관외사전투표,,20976,20972,9076,10983,588,9,112,5,2,4,6,22,3,11,20821,151,4
1100,서울특별시,1103,용산구,재외투표,,2982,2082,857,978,62,1,7,0,3,2,1,0,0,0,1911,171,900
1100,서울특별시,1103,용산구,후암동,소계,13481,9953,4853,4642,290,3,50,5,0,2,6,8,6,0,9865,88,3528
1100,서울특별시,1103,용산구,,관내사전투표,4762,4762,2613,1995,125,2,6,1,0,0,0,2,2,0,4746,16,0
1100,서울특별시,1103,용산구,,후암동제1투,2547,1469,643,743,48,0,13,1,0,0,0,1,0,0,1449,20,1078
1100,서울특별시,1103,용산구,,후암동제2투,1970,1140,513,540,49,0,8,1,0,0,2,3,1,0,1117,23,830
1100,서울특별시,1103,용산구,,후암동제3투,2058,1251,515,669,35,0,9,2,0,2,3,1,1,0,1237,14,807
1100,서울특별시,1103,용산구,,후암동제4투,2144,1331,569,695,33,1,14,0,0,0,1,1,2,0,1316,15,813
1100,서울특별시,1103,용산구,용산2가동,소계,7867,5534,2623,2577,211,5,42,1,1,5,7,4,0,3,5479,55,2333
1100,서울특별시,1103,용산구,,관내사전투표,2594,2594,1405,1059,93,3,12,1,0,1,0,2,0,1,2577,17,0
1100,서울특별시,1103,용산구,,용산2가동제1투,1726,893,363,469,35,1,8,0,1,0,1,1,0,2,881,12,833
1100,서울특별시,1103,용산구,,용산2가동제2투,1264,744,285,409,35,0,5,0,0,0,3,0,0,0,737,7,520
1100,서울특별시,1103,용산구,,용산2가동제3투,1073,648,290,313,26,1,10,0,0,0,0,0,0,0,640,8,425
1100,서울특별시,1103,용산구,,용산2가동제4투,1210,655,280,327,22,0,7,0,0,4,3,1,0,0,644,11,555
1100,서울특별시,1103,용산구,남영동,소계,6698,4404,2095,2040,142,5,44,2,1,3,4,11,1,1,4349,55,2294
1100,서울특별시,1103,용산구,,관내사전투표,2034,2034,1075,850,68,1,18,2,0,1,0,5,0,0,2020,14,0
1100,서울특별시,1103,용산구,,남영동제1투,2342,1180,536,565,42,2,11,0,0,1,2,1,0,0,1160,20,1162
1100,서울특별시,1103,용산구,,남영동제2투,2322,1190,484,625,32,2,15,0,1,1,2,5,1,1,1169,21,1132
1100,서울특별시,1103,용산구,청파동,소계,14261,9913,4920,4385,394,6,65,5,0,3,8,9,5,7,9807,106,4348
1100,서울특별시,1103,용산구,,관내사전투표,3688,3688,2098,1388,155,3,17,3,0,1,2,2,0,3,3672,16,0
1100,서울특별시,1103,용산구,,청파동제1투,1295,774,317,415,22,0,6,0,0,0,2,2,1,0,765,9,521
1100,서울특별시,1103,용산구,,청파동제2투,1603,964,490,422,23,0,9,0,0,0,1,0,1,1,947,17,639
1100,서울특별시,1103,용산구,,청파동제3투,1918,1162,613,485,41,1,8,1,0,0,1,0,0,2,1152,10,756
1100,서울특별시,1103,용산구,,청파동제4투,2218,1342,554,695,64,0,9,1,0,0,0,2,0,0,1325,17,876
1100,서울특별시,1103,용산구,,청파동제5투,1799,1075,457,537,51,1,6,0,0,0,0,2,3,0,1057,18,724
1100,서울특별시,1103,용산구,,청파동제6투,1740,908,391,443,38,1,10,0,0,2,2,1,0,1,889,19,832
1100,서울특별시,1103,용산구,원효로제1동,소계,12787,10037,4104,5443,348,4,33,3,0,3,6,5,1,4,9954,83,2750
1100,서울특별시,1103,용산구,,관내사전투표,4737,4737,2261,2291,157,2,5,1,0,0,1,3,0,1,4722,15,0
1100,서울특별시,1103,용산구,,원효로제1동제1투,2339,1527,658,758,72,1,12,1,0,1,1,2,1,0,1507,20,812
1100,서울특별시,1103,용산구,,원효로제1동제2투,2049,1346,462,809,49,1,8,0,0,1,0,0,0,2,1332,14,703
1100,서울특별시,1103,용산구,,원효로제1동제3투,2019,1293,361,863,40,0,3,1,0,0,4,0,0,1,1273,20,726
1100,서울특별시,1103,용산구,,원효로제1동제4투,1643,1134,362,722,30,0,5,0,0,1,0,0,0,0,1120,14,509
1100,서울특별시,1103,용산구,원효로제2동,소계,10135,7789,3334,4108,230,3,40,1,4,3,2,3,1,2,7731,58,2346
1100,서울특별시,1103,용산구,,관내사전투표,3275,3275,1665,1499,84,2,10,0,0,1,0,0,1,1,3263,12,0
1100,서울특별시,1103,용산구,,원효로제2동제1투,2804,1899,637,1170,58,1,13,0,1,1,0,1,0,0,1882,17,905
1100,서울특별시,1103,용산구,,원효로제2동제2투,1979,1282,462,753,45,0,8,0,1,0,1,0,0,0,1270,12,697
1100,서울특별시,1103,용산구,,원효로제2동제3투,2077,1333,570,686,43,0,9,1,2,1,1,2,0,1,1316,17,744
1100,서울특별시,1103,용산구,효창동,소계,8076,6423,2856,3276,193,1,28,1,0,1,2,4,0,1,6363,60,1653
1100,서울특별시,1103,용산구,,관내사전투표,3303,3303,1700,1464,100,1,9,1,0,1,0,1,0,0,3277,26,0
1100,서울특별시,1103,용산구,,효창동제1투,2248,1475,578,826,44,0,7,0,0,0,1,3,0,1,1460,15,773
1100,서울특별시,1103,용산구,,효창동제2투,1570,1044,344,644,35,0,7,0,0,0,0,0,0,0,1030,14,526
1100,서울특별시,1103,용산구,,효창동제3투,955,601,234,342,14,0,5,0,0,0,1,0,0,0,596,5,354
1100,서울특별시,1103,용산구,용문동,소계,9790,7570,3464,3723,255,5,42,0,1,2,7,10,1,2,7512,58,2220
1100,서울특별시,1103,용산구,,관내사전투표,3808,3808,2011,1642,108,4,20,0,0,0,0,3,1,0,3789,19,0
1100,서울특별시,1103,용산구,,용문동제1투,2232,1249,587,582,56,0,4,0,0,0,4,3,0,1,1237,12,983
1100,서울특별시,1103,용산구,,용문동제2투,1780,1091,408,616,42,0,10,0,0,1,2,1,0,0,1080,11,689
1100,서울특별시,1103,용산구,,용문동제3투,1970,1422,458,883,49,1,8,0,1,1,1,3,0,1,1406,16,548
1100,서울특별시,1103,용산구,한강로동,소계,16116,12170,3795,7863,355,2,39,1,1,4,4,3,2,0,12069,101,3946
1100,서울특별시,1103,용산구,,관내사전투표,3804,3804,1556,2121,92,0,8,1,1,1,0,2,1,0,3783,21,0
1100,서울특별시,1103,용산구,,한강로동제1투,2152,1559,457,1021,56,2,5,0,0,1,1,0,1,0,1544,15,593
1100,서울특별시,1103,용산구,,한강로동제2투,2976,1818,352,1386,59,0,5,0,0,1,0,0,0,0,1803,15,1158
1100,서울특별시,1103,용산구,,한강로동제3투,2402,1747,663,966,87,0,7,0,0,1,0,0,0,0,1724,23,655
1100,서울특별시,1103,용산구,,한강로동제4투,2635,1874,350,1474,28,0,5,0,0,0,0,1,0,0,1858,16,761
1100,서울특별시,1103,용산구,,한강로동제5투,2147,1368,417,895,33,0,9,0,0,0,3,0,0,0,1357,11,779
1100,서울특별시,1103,용산구,이촌제1동,소계,19821,15471,3666,11389,299,3,29,2,5,6,5,4,2,1,15411,60,4350
1100,서울특별시,1103,용산구,,관내사전투표,6824,6824,1990,4700,102,1,7,2,0,0,1,2,1,0,6806,18,0
1100,서울특별시,1103,용산구,,이촌제1동제1투,2915,1960,295,1607,41,0,5,0,1,0,3,0,0,0,1952,8,955
1100,서울특별시,1103,용산구,,이촌제1동제2투,3788,2256,512,1663,60,0,9,0,0,2,0,0,0,1,2247,9,1532
1100,서울특별시,1103,용산구,,이촌제1동제3투,2440,1746,323,1376,30,2,4,0,3,0,0,0,0,0,1738,8,694
1100,서울특별시,1103,용산구,,이촌제1동제4투,2786,1973,477,1412,58,0,3,0,1,4,0,2,1,0,1958,15,813
1100,서울특별시,1103,용산구,,이촌제1동제5투,1068,712,69,631,8,0,1,0,0,0,1,0,0,0,710,2,356
1100,서울특별시,1103,용산구,이촌제2동,소계,6556,5164,1955,3024,110,2,23,0,5,1,6,4,0,1,5131,33,1392
1100,서울특별시,1103,용산구,,관내사전투표,2067,2065,943,1063,40,0,9,0,0,0,3,2,0,1,2061,4,2
1100,서울특별시,1103,용산구,,이촌제2동제1투,1366,834,261,531,25,0,8,0,0,1,1,1,0,0,828,6,532
1100,서울특별시,1103,용산구,,이촌제2동제2투,1264,845,239,574,13,0,2,0,4,0,2,0,0,0,834,11,419
1100,서울특별시,1103,용산구,,이촌제2동제3투,1859,1420,512,856,32,2,4,0,1,0,0,1,0,0,1408,12,439
1100,서울특별시,1103,용산구,이태원제1동,소계,5787,4139,1517,2441,120,3,25,2,0,1,0,2,0,0,4111,28,1648
1100,서울특별시,1103,용산구,,관내사전투표,1822,1822,810,936,57,1,8,1,0,0,0,0,0,0,1813,9,0
1100,서울특별시,1103,용산구,,이태원제1동제1투,2434,1439,419,963,33,0,10,0,0,1,0,1,0,0,1427,12,995
1100,서울특별시,1103,용산구,,이태원제1동제2투,1531,878,288,542,30,2,7,1,0,0,0,1,0,0,871,7,653
1100,서울특별시,1103,용산구,이태원제2동,소계,7333,5048,1984,2790,154,5,30,2,1,2,8,3,3,2,4984,64,2285
1100,서울특별시,1103,용산구,,관내사전투표,2133,2133,972,1076,51,2,8,1,0,1,0,0,0,0,2111,22,0
1100,서울특별시,1103,용산구,,이태원제2동제1투,2063,1071,360,641,36,2,8,0,1,1,7,1,1,0,1058,13,992
1100,서울특별시,1103,용산구,,이태원제2동제2투,1748,1021,379,572,37,0,9,0,0,0,1,2,1,2,1003,18,727
1100,서울특별시,1103,용산구,,이태원제2동제3투,1389,823,273,501,30,1,5,1,0,0,0,0,1,0,812,11,566
1100,서울특별시,1103,용산구,한남동,소계,15402,10290,3403,6486,252,4,44,1,0,6,6,4,0,3,10209,81,5112
1100,서울특별시,1103,용산구,,관내사전투표,3756,3755,1588,2046,88,4,4,0,0,2,2,1,0,1,3736,19,1
1100,서울특별시,1103,용산구,,한남동제1투,2215,1443,434,946,36,0,12,0,0,0,0,0,0,0,1428,15,772
1100,서울특별시,1103,용산구,,한남동제2투,1704,897,359,482,32,0,6,1,0,0,0,2,0,1,883,14,807
1100,서울특별시,1103,용산구,,한남동제3투,3067,1832,325,1462,25,0,5,0,0,2,1,0,0,0,1820,12,1235
1100,서울특별시,1103,용산구,,한남동제4투,2225,1407,363,993,34,0,5,0,0,1,1,0,0,1,1398,9,818
1100,서울특별시,1103,용산구,,한남동제5투,2435,956,334,557,37,0,12,0,0,1,2,1,0,0,944,12,1479
1100,서울특별시,1103,용산구,서빙고동,소계,9048,6715,1922,4562,131,2,41,2,0,5,2,0,0,3,6670,45,2333
1100,서울특별시,1103,용산구,,관내사전투표,2169,2169,889,1217,42,0,9,1,0,0,0,0,0,0,2158,11,0
1100,서울특별시,1103,용산구,,서빙고동제1투,1968,1362,383,902,41,0,15,1,0,0,1,0,0,1,1344,18,606
1100,서울특별시,1103,용산구,,서빙고동제2투,1382,802,278,481,23,1,10,0,0,0,1,0,0,1,795,7,580
1100,서울특별시,1103,용산구,,서빙고동제3투,2382,1739,186,1520,17,1,5,0,0,4,0,0,0,1,1734,5,643
1100,서울특별시,1103,용산구,,서빙고동제4투,1147,643,186,442,8,0,2,0,0,1,0,0,0,0,639,4,504
1100,서울특별시,1103,용산구,보광동,소계,11688,8133,3554,4206,231,3,59,4,0,2,6,3,1,5,8074,59,3555
1100,서울특별시,1103,용산구,,관내사전투표,3891,3891,1827,1931,91,1,19,1,0,0,1,2,0,3,3876,15,0
1100,서울특별시,1103,용산구,,보광동제1투,2140,1061,426,577,33,0,10,0,0,2,0,0,0,1,1049,12,1079
1100,서울특별시,1103,용산구,,보광동제2투,1804,993,438,496,42,1,8,2,0,0,0,0,0,0,987,6,811
1100,서울특별시,1103,용산구,,보광동제3투,2160,1222,480,663,42,1,15,1,0,0,1,0,1,1,1205,17,938
1100,서울특별시,1103,용산구,,보광동제4투,1693,966,383,539,23,0,7,0,0,0,4,1,0,0,957,9,727
1100,서울특별시,1103,용산구,잘못 투입·구분된 투표지,,0,4,2,2,0,0,0,0,0,0,0,0,0,0,4,0,-4
1100,서울특별시,1104,성동구,합계,,252087,197240,84411,103880,5365,123,969,50,20,47,122,152,34,65,195238,2002,54847
1100,서울특별시,1104,성동구,거소·선상투표,,339,301,106,151,2,0,9,0,0,0,1,0,1,0,270,31,38
1100,서울특별시,1104,성동구,관외사전투표,,24803,24797,11151,12473,705,22,151,7,2,5,8,37,2,10,24573,224,6
1100,서울특별시,1104,성동구,재외투표,,2410,1783,858,714,49,0,4,1,0,0,0,0,1,0,1627,156,627
1100,서울특별시,1104,성동구,금호1가동,소계,11395,8615,3669,4609,202,3,36,2,0,1,8,4,3,1,8538,77,2780
1100,서울특별시,1104,성동구,,관내사전투표,3173,3173,1614,1464,60,0,10,0,0,0,3,3,0,0,3154,19,0
1100,서울특별시,1104,성동구,,금호1가동제1투,1504,861,358,461,24,0,6,0,0,0,1,0,1,0,851,10,643
1100,서울특별시,1104,성동구,,금호1가동제2투,2482,1643,696,871,38,1,11,2,0,0,2,0,1,1,1623,20,839
1100,서울특별시,1104,성동구,,금호1가동제3투,2590,1839,657,1101,50,2,7,0,0,1,2,1,0,0,1821,18,751
1100,서울특별시,1104,성동구,,금호1가동제4투,1646,1099,344,712,30,0,2,0,0,0,0,0,1,0,1089,10,547
1100,서울특별시,1104,성동구,금호2·3가동,소계,17159,12722,5545,6659,320,9,54,3,2,0,9,8,3,6,12618,104,4437
1100,서울특별시,1104,성동구,,관내사전투표,4693,4693,2444,2108,96,6,11,1,1,0,0,1,0,3,4671,22,0
1100,서울특별시,1104,성동구,,금호2·3가동제1투,2862,1816,702,1024,53,0,9,0,1,0,4,5,1,1,1800,16,1046
1100,서울특별시,1104,성동구,,금호2·3가동제2투,2633,1599,696,827,44,0,9,2,0,0,1,1,0,0,1580,19,1034
1100,서울특별시,1104,성동구,,금호2·3가동제3투,2649,1621,680,855,51,2,12,0,0,0,2,0,2,2,1606,15,1028
1100,서울특별시,1104,성동구,,금호2·3가동제4투,2046,1541,523,952,41,1,4,0,0,0,0,1,0,0,1522,19,505
1100,서울특별시,1104,성동구,,금호2·3가동제5투,2276,1452,500,893,35,0,9,0,0,0,2,0,0,0,1439,13,824
1100,서울특별시,1104,성동구,금호4가동,소계,11719,9107,3727,5049,193,4,50,2,1,5,3,8,1,5,9048,59,2612
1100,서울특별시,1104,성동구,,관내사전투표,4179,4179,2093,1962,87,0,16,1,0,0,0,4,0,3,4166,13,0
1100,서울특별시,1104,성동구,,금호4가동제1투,1434,809,259,510,19,1,9,0,0,0,0,1,0,0,799,10,625
1100,서울특별시,1104,성동구,,금호4가동제2투,2098,1460,474,919,39,2,7,1,0,0,1,1,0,0,1444,16,638
1100,서울특별시,1104,성동구,,금호4가동제3투,1985,1193,462,678,26,1,10,0,0,2,1,1,1,2,1184,9,792
1100,서울특별시,1104,성동구,,금호4가동제4투,2023,1466,439,980,22,0,8,0,1,3,1,1,0,0,1455,11,557
1100,서울특별시,1104,성동구,옥수동,소계,19705,15269,5114,9615,354,11,49,3,4,3,13,6,3,3,15178,91,4436
1100,서울특별시,1104,성동구,,관내사전투표,5188,5188,2060,2982,114,3,4,3,0,1,0,2,0,0,5169,19,0
1100,서울특별시,1104,성동구,,옥수동제1투,2502,1859,575,1219,40,2,7,0,0,0,0,0,0,0,1843,16,643
1100,서울특별시,1104,성동구,,옥수동제2투,2069,1365,384,914,42,2,6,0,0,0,4,0,1,0,1353,12,704
1100,서울특별시,1104,성동구,,옥수동제3투,2482,1712,568,1080,45,0,6,0,0,0,6,2,0,0,1707,5,770
1100,서울특별시,1104,성동구,,옥수동제4투,2609,1537,401,1083,28,1,8,0,2,0,1,1,0,0,1525,12,1072
1100,서울특별시,1104,성동구,,옥수동제5투,2002,1477,470,938,40,1,9,0,2,1,1,0,2,2,1466,11,525
1100,서울특별시,1104,성동구,,옥수동제6투,2853,2131,656,1399,45,2,9,0,0,1,1,1,0,1,2115,16,722
1100,서울특별시,1104,성동구,응봉동,소계,12309,9673,4203,5082,250,5,39,0,0,4,6,3,3,1,9596,77,2636
1100,서울특별시,1104,성동구,,관내사전투표,4701,4701,2363,2210,90,2,15,0,0,0,2,3,0,0,4685,16,0
1100,서울특별시,1104,성동구,,응봉동제1투,2440,1413,597,728,51,2,10,0,0,1,2,0,1,0,1392,21,1027
1100,서울특별시,1104,성동구,,응봉동제2투,2731,1801,627,1077,60,1,3,0,0,2,1,0,2,1,1774,27,930
1100,서울특별시,1104,성동구,,응봉동제3투,2437,1758,616,1067,49,0,11,0,0,1,1,0,0,0,1745,13,679
1100,서울특별시,1104,성동구,성수1가제1동,소계,12061,8894,3419,5080,253,4,42,0,2,3,4,5,1,1,8814,80,3167
1100,서울특별시,1104,성동구,,관내사전투표,3209,3209,1494,1607,77,1,13,0,0,1,0,3,0,0,3196,13,0
1100,서울특별시,1104,성동구,,성수1가제1동제1투,2031,1128,474,579,42,0,12,0,1,0,3,1,0,1,1113,15,903
1100,서울특별시,1104,성동구,,성수1가제1동제2투,3088,2134,661,1394,45,1,8,0,0,2,0,0,0,0,2111,23,954
1100,서울특별시,1104,성동구,,성수1가제1동제3투,2168,1481,432,973,44,1,5,0,1,0,0,1,1,0,1458,23,687
1100,서울특별시,1104,성동구,,성수1가제1동제4투,1565,942,358,527,45,1,4,0,0,0,1,0,0,0,936,6,623
1100,서울특별시,1104,성동구,성수1가제2동,소계,11161,8997,3735,4811,302,4,38,4,0,2,2,9,2,3,8912,85,2164
1100,서울특별시,1104,성동구,,관내사전투표,4208,4208,1895,2133,131,2,14,3,0,0,0,4,1,1,4184,24,0
1100,서울특별시,1104,성동구,,성수1가제2동제1투,1193,703,249,410,30,0,2,0,0,0,0,2,0,0,693,10,490
1100,서울특별시,1104,성동구,,성수1가제2동제2투,732,512,189,289,18,1,3,0,0,0,1,1,0,0,502,10,220
1100,서울특별시,1104,성동구,,성수1가제2동제3투,2467,1680,689,897,57,0,12,0,0,0,0,1,0,1,1657,23,787
1100,서울특별시,1104,성동구,,성수1가제2동제4투,2561,1894,713,1082,66,1,7,1,0,2,1,1,1,1,1876,18,667
1100,서울특별시,1104,성동구,성수2가제1동,소계,13255,9814,4280,5106,254,6,52,3,2,4,7,9,1,4,9728,86,3441
1100,서울특별시,1104,성동구,,관내사전투표,4668,4668,2352,2145,114,2,17,0,0,2,0,8,0,1,4641,27,0
1100,서울특별시,1104,성동구,,성수2가제1동제1투,1938,1171,437,678,34,1,7,1,1,0,3,0,0,1,1163,8,767
1100,서울특별시,1104,성동구,,성수2가제1동제2투,2403,1569,593,906,35,0,12,1,1,1,2,1,1,2,1555,14,834
1100,서울특별시,1104,성동구,,성수2가제1동제3투,2157,1134,399,668,32,2,11,0,0,1,1,0,0,0,1114,20,1023
1100,서울특별시,1104,성동구,,성수2가제1동제4투,2089,1272,499,709,39,1,5,1,0,0,1,0,0,0,1255,17,817
1100,서울특별시,1104,성동구,성수2가제3동,소계,8984,6829,2790,3742,174,5,43,1,1,1,2,5,0,3,6767,62,2155
1100,서울특별시,1104,성동구,,관내사전투표,3058,3058,1460,1487,76,1,12,1,1,0,0,3,0,2,3043,15,0
1100,서울특별시,1104,성동구,,성수2가제3동제1투,2303,1319,530,704,46,1,11,0,0,1,1,1,0,1,1296,23,984
1100,서울특별시,1104,성동구,,성수2가제3동제2투,2414,1720,513,1142,33,1,10,0,0,0,1,0,0,0,1700,20,694
1100,서울특별시,1104,성동구,,성수2가제3동제3투,1209,732,287,409,19,2,10,0,0,0,0,1,0,0,728,4,477
1100,서울특별시,1104,성동구,왕십리도선동,소계,20176,15381,6374,8326,436,4,66,5,2,0,7,9,3,4,15236,145,4795
1100,서울특별시,1104,성동구,,관내사전투표,5799,5799,2763,2828,150,1,9,3,1,0,2,1,1,0,5759,40,0
1100,서울특별시,1104,성동구,,왕십리도선동제1투,2333,1499,660,751,50,0,13,0,0,0,0,2,0,2,1478,21,834
1100,서울특별시,1104,성동구,,왕십리도선동제2투,2577,1609,726,801,45,1,12,0,0,0,1,2,0,0,1588,21,968
1100,서울특별시,1104,성동구,,왕십리도선동제3투,2069,1522,544,890,48,0,10,0,0,0,2,2,1,2,1499,23,547
1100,서울특별시,1104,성동구,,왕십리도선동제4투,2876,1849,625,1152,47,1,6,1,1,0,0,1,0,0,1834,15,1027
1100,서울특별시,1104,성동구,,왕십리도선동제5투,2415,1656,559,1025,48,1,9,1,0,0,0,0,1,0,1644,12,759
1100,서울특별시,1104,성동구,,왕십리도선동제6투,2107,1447,497,879,48,0,7,0,0,0,2,1,0,0,1434,13,660
1100,서울특별시,1104,성동구,왕십리제2동,소계,13477,10436,4998,4916,337,10,46,4,1,3,8,11,3,2,10339,97,3041
1100,서울특별시,1104,성동구,,관내사전투표,4453,4453,2432,1824,136,4,21,2,0,1,2,4,0,1,4427,26,0
1100,서울특별시,1104,성동구,,왕십리제2동제1투,2468,1426,637,701,57,3,7,0,0,0,1,2,0,1,1409,17,1042
1100,서울특별시,1104,성동구,,왕십리제2동제2투,2195,1379,613,691,44,1,8,0,0,1,2,2,1,0,1363,16,816
1100,서울특별시,1104,성동구,,왕십리제2동제3투,2071,1481,617,793,45,2,4,1,1,0,0,2,1,0,1466,15,590
1100,서울특별시,1104,성동구,,왕십리제2동제4투,2290,1697,699,907,55,0,6,1,0,1,3,1,1,0,1674,23,593
1100,서울특별시,1104,성동구,행당제1동,소계,11647,9172,3732,5021,264,2,36,2,1,2,7,5,1,4,9077,95,2475
1100,서울특별시,1104,성동구,,관내사전투표,4263,4263,1958,2139,120,1,12,0,0,1,2,4,0,1,4238,25,0
1100,서울특별시,1104,성동구,,행당제1동제1투,1932,1169,418,701,30,0,3,0,0,0,1,0,0,1,1154,15,763
1100,서울특별시,1104,성동구,,행당제1동제2투,2284,1573,539,946,53,0,9,2,1,1,1,1,0,0,1553,20,711
1100,서울특별시,1104,성동구,,행당제1동제3투,1586,966,405,495,29,0,7,0,0,0,1,0,1,2,940,26,620
1100,서울특별시,1104,성동구,,행당제1동제4투,1582,1201,412,740,32,1,5,0,0,0,2,0,0,0,1192,9,381
1100,서울특별시,1104,성동구,행당제2동,소계,17334,13587,5828,7167,375,8,63,3,1,5,10,10,1,7,13478,109,3747
1100,서울특별시,1104,성동구,,관내사전투표,5202,5202,2618,2437,99,0,21,0,1,1,0,4,0,4,5185,17,0
1100,서울특별시,1104,성동구,,행당제2동제1투,2617,1782,611,1068,67,2,7,1,0,1,1,0,0,1,1759,23,835
1100,서울특별시,1104,성동구,,행당제2동제2투,2269,1435,582,765,49,2,9,0,0,1,0,3,0,0,1411,24,834
1100,서울특별시,1104,성동구,,행당제2동제3투,2532,1717,740,887,56,4,10,0,0,1,0,2,0,0,1700,17,815
1100,서울특별시,1104,성동구,,행당제2동제4투,2311,1715,585,1048,59,0,3,0,0,0,6,0,1,1,1703,12,596
1100,서울특별시,1104,성동구,,행당제2동제5투,2403,1736,692,962,45,0,13,2,0,1,3,1,0,1,1720,16,667
1100,서울특별시,1104,성동구,마장동,소계,17471,13080,6010,6415,362,5,90,5,1,4,16,11,0,4,12923,157,4391
1100,서울특별시,1104,성동구,,관내사전투표,4736,4736,2493,2075,109,3,18,2,0,0,0,1,0,0,4701,35,0
1100,서울특별시,1104,성동구,,마장동제1투,1964,1145,443,628,36,0,14,2,1,0,0,2,0,0,1126,19,819
1100,서울특별시,1104,성동구,,마장동제2투,2233,1557,647,817,57,1,11,1,0,1,1,2,0,2,1540,17,676
1100,서울특별시,1104,성동구,,마장동제3투,2420,1697,668,930,53,1,15,0,0,2,7,4,0,1,1681,16,723
1100,서울특별시,1104,성동구,,마장동제4투,1932,1252,552,637,27,0,9,0,0,1,4,0,0,0,1230,22,680
1100,서울특별시,1104,성동구,,마장동제5투,2203,1360,682,608,33,0,15,0,0,0,4,1,0,0,1343,17,843
1100,서울특별시,1104,성동구,,마장동제6투,1983,1333,525,720,47,0,8,0,0,0,0,1,0,1,1302,31,650
1100,서울특별시,1104,성동구,사근동,소계,8737,6159,2597,3160,212,9,38,1,0,4,1,4,1,3,6030,129,2578
1100,서울특별시,1104,성동구,,관내사전투표,2483,2483,1183,1158,90,2,10,1,0,1,0,3,1,2,2451,32,0
1100,서울특별시,1104,성동구,,사근동제1투,1344,796,321,409,32,0,5,0,0,1,1,0,0,1,770,26,548
1100,서울특별시,1104,성동구,,사근동제2투,1992,1145,505,570,36,3,9,0,0,0,0,0,0,0,1123,22,847
1100,서울특별시,1104,성동구,,사근동제3투,2918,1735,588,1023,54,4,14,0,0,2,0,1,0,0,1686,49,1183
1100,서울특별시,1104,성동구,송정동,소계,8401,5932,2881,2776,159,8,31,1,0,0,6,3,2,1,5868,64,2469
1100,서울특별시,1104,성동구,,관내사전투표,2484,2484,1369,1041,57,2,4,0,0,0,1,2,0,1,2477,7,0
1100,서울특별시,1104,성동구,,송정동제1투,2061,1193,544,583,31,3,9,0,0,0,2,0,0,0,1172,21,868
1100,서울특별시,1104,성동구,,송정동제2투,1866,1104,478,559,37,1,8,0,0,0,2,1,1,0,1087,17,762
1100,서울특별시,1104,성동구,,송정동제3투,1990,1151,490,593,34,2,10,1,0,0,1,0,1,0,1132,19,839
1100,서울특별시,1104,성동구,용답동,소계,9544,6689,3393,3006,162,4,32,3,0,1,4,5,2,3,6615,74,2855
1100,서울특별시,1104,성동구,,관내사전투표,3040,3040,1799,1143,57,2,11,2,0,0,0,0,1,2,3017,23,0
1100,서울특별시,1104,성동구,,용답동제1투,2714,1419,635,712,44,1,8,0,0,0,0,0,0,0,1400,19,1295
1100,서울특별시,1104,성동구,,용답동제2투,2058,1184,528,602,29,0,7,0,0,0,3,3,0,1,1173,11,874
1100,서울특별시,1104,성동구,,용답동제3투,1732,1046,431,549,32,1,6,1,0,1,1,2,1,0,1025,21,686
1100,서울특별시,1104,성동구,잘못 투입·구분된 투표지,,0,3,1,2,0,0,0,0,0,0,0,0,0,0,3,0,-3
1100,서울특별시,1105,광진구,합계,,303582,235471,109922,113733,7072,155,1416,52,36,62,180,172,38,80,232918,2553,68111
1100,서울특별시,1105,광진구,거소·선상투표,,378,349,125,154,6,2,9,1,0,0,0,0,0,0,297,52,29
1100,서울특별시,1105,광진구,관외사전투표,,28877,28872,14245,13029,980,21,232,7,5,8,8,37,4,7,28583,289,5
1100,서울특별시,1105,광진구,재외투표,,2434,1801,996,603,48,1,5,0,2,0,0,1,0,0,1656,145,633
1100,서울특별시,1105,광진구,중곡제1동,소계,12535,9135,4617,4063,276,4,69,3,4,0,3,3,1,2,9045,90,3400
1100,서울특별시,1105,광진구,,관내사전투표,4096,4096,2350,1580,108,1,21,2,2,0,0,1,0,2,4067,29,0
1100,서울특별시,1105,광진구,,중곡제1동제1투,2014,1153,500,580,51,3,9,0,0,0,0,0,0,0,1143,10,861
1100,서울특별시,1105,광진구,,중곡제1동제2투,2251,1311,589,644,47,0,18,0,2,0,0,1,0,0,1301,10,940
1100,서울특별시,1105,광진구,,중곡제1동제3투,2290,1414,660,687,33,0,13,0,0,0,2,1,0,0,1396,18,876
1100,서울특별시,1105,광진구,,중곡제1동제4투,1884,1161,518,572,37,0,8,1,0,0,1,0,1,0,1138,23,723
1100,서울특별시,1105,광진구,중곡제2동,소계,17181,12522,6232,5619,396,16,79,1,3,5,14,17,3,10,12395,127,4659
1100,서울특별시,1105,광진구,,관내사전투표,5512,5512,3146,2129,145,7,25,0,2,1,4,6,1,4,5470,42,0
1100,서울특별시,1105,광진구,,중곡제2동제1투,2159,1226,515,629,46,1,9,0,0,0,0,4,0,3,1207,19,933
1100,서울특별시,1105,광진구,,중곡제2동제2투,2535,1610,703,809,66,2,15,0,0,0,1,2,0,0,1598,12,925
1100,서울특별시,1105,광진구,,중곡제2동제3투,2721,1725,783,817,77,5,12,0,0,0,5,1,0,3,1703,22,996
1100,서울특별시,1105,광진구,,중곡제2동제4투,1806,1033,464,517,21,0,9,1,0,2,0,2,1,0,1017,16,773
1100,서울특별시,1105,광진구,,중곡제2동제5투,2448,1416,621,718,41,1,9,0,1,2,4,2,1,0,1400,16,1032
1100,서울특별시,1105,광진구,중곡제3동,소계,13288,9549,4682,4371,266,10,92,0,1,4,6,6,3,4,9445,104,3739
1100,서울특별시,1105,광진구,,관내사전투표,3752,3752,2120,1481,90,3,24,0,0,1,1,3,1,1,3725,27,0
1100,서울특별시,1105,광진구,,중곡제3동제1투,1942,1290,573,635,45,3,15,0,0,2,0,2,0,0,1275,15,652
1100,서울특별시,1105,광진구,,중곡제3동제2투,1800,1183,532,584,34,0,16,0,1,0,3,0,0,1,1171,12,617
1100,서울특별시,1105,광진구,,중곡제3동제3투,1885,1127,493,557,37,2,11,0,0,0,1,1,0,0,1102,25,758
1100,서울특별시,1105,광진구,,중곡제3동제4투,2120,1180,535,574,36,1,14,0,0,1,1,0,2,1,1165,15,940
1100,서울특별시,1105,광진구,,중곡제3동제5투,1789,1017,429,540,24,1,12,0,0,0,0,0,0,1,1007,10,772
1100,서울특별시,1105,광진구,중곡제4동,소계,23814,17762,8871,8061,474,8,139,2,3,3,24,15,2,7,17609,153,6052
1100,서울특별시,1105,광진구,,관내사전투표,7862,7860,4430,3175,167,2,37,1,1,0,4,8,0,0,7825,35,2
1100,서울특별시,1105,광진구,,중곡제4동제1투,2161,1424,610,738,40,1,14,0,0,1,2,1,0,1,1408,16,737
1100,서울특별시,1105,광진구,,중곡제4동제2투,2660,1857,915,847,48,1,13,0,0,1,4,1,0,1,1831,26,803
1100,서울특별시,1105,광진구,,중곡제4동제3투,2174,1230,531,618,48,1,17,0,1,0,0,3,0,1,1220,10,944
1100,서울특별시,1105,광진구,,중곡제4동제4투,2007,1233,572,577,48,0,12,0,1,1,2,1,0,1,1215,18,774
1100,서울특별시,1105,광진구,,중곡제4동제5투,2362,1455,662,709,52,0,16,0,0,0,1,0,0,1,1441,14,907
1100,서울특별시,1105,광진구,,중곡제4동제6투,2192,1293,547,676,27,2,17,0,0,0,3,0,0,1,1273,20,899
1100,서울특별시,1105,광진구,,중곡제4동제7투,2396,1410,604,721,44,1,13,1,0,0,8,1,2,1,1396,14,986
1100,서울특별시,1105,광진구,능동,소계,9582,7416,3601,3391,269,8,40,4,0,2,10,4,1,4,7334,82,2166
1100,서울특별시,1105,광진구,,관내사전투표,3509,3509,1938,1408,117,3,13,2,0,0,0,1,0,1,3483,26,0
1100,서울특별시,1105,광진구,,능동제1투,1677,995,382,550,35,2,5,1,0,2,1,0,0,1,979,16,682
1100,서울특별시,1105,광진구,,능동제2투,1933,1238,573,581,46,0,12,1,0,0,8,2,1,1,1225,13,695
1100,서울특별시,1105,광진구,,능동제3투,2463,1674,708,852,71,3,10,0,0,0,1,1,0,1,1647,27,789
1100,서울특별시,1105,광진구,구의제1동,소계,18672,13974,6834,6394,455,7,96,6,3,5,11,8,4,5,13828,146,4698
1100,서울특별시,1105,광진구,,관내사전투표,6708,6707,3703,2718,196,1,32,2,3,0,1,4,2,2,6664,43,1
1100,서울특별시,1105,광진구,,구의제1동제1투,2762,1594,640,858,55,2,12,2,0,0,1,0,1,0,1571,23,1168
1100,서울특별시,1105,광진구,,구의제1동제2투,2157,1365,597,691,48,1,11,0,0,4,2,1,0,0,1355,10,792
1100,서울특별시,1105,광진구,,구의제1동제3투,2386,1475,645,744,47,2,12,1,0,1,2,2,0,2,1458,17,911
1100,서울특별시,1105,광진구,,구의제1동제4투,2230,1375,594,698,44,1,11,0,0,0,2,1,0,1,1352,23,855
1100,서울특별시,1105,광진구,,구의제1동제5투,2429,1458,655,685,65,0,18,1,0,0,3,0,1,0,1428,30,971
1100,서울특별시,1105,광진구,구의제2동,소계,20422,15377,7679,6977,435,9,87,3,4,1,16,14,1,5,15231,146,5045
1100,서울특별시,1105,광진구,,관내사전투표,5723,5723,3333,2200,133,3,14,1,2,0,4,1,0,1,5692,31,0
1100,서울특별시,1105,광진구,,구의제2동제1투,2071,1179,533,568,52,0,8,1,1,0,3,1,0,0,1167,12,892
1100,서울특별시,1105,광진구,,구의제2동제2투,2192,1607,636,885,67,0,4,0,0,0,1,0,0,0,1593,14,585
1100,서울특별시,1105,광진구,,구의제2동제3투,1917,1207,555,588,33,3,4,0,0,0,1,3,0,1,1188,19,710
1100,서울특별시,1105,광진구,,구의제2동제4투,2724,1818,850,866,46,1,14,0,0,0,3,5,1,2,1788,30,906
1100,서울특별시,1105,광진구,,구의제2동제5투,2692,1800,779,931,46,0,23,1,1,0,1,3,0,0,1785,15,892
1100,서울특별시,1105,광진구,,구의제2동제6투,3103,2043,993,939,58,2,20,0,0,1,3,1,0,1,2018,25,1060
1100,서울특별시,1105,광진구,구의제3동,소계,22047,17486,7030,9721,481,9,60,4,0,7,10,6,3,7,17338,148,4561
1100,서울특별시,1105,광진구,,관내사전투표,6806,6801,3322,3251,167,4,15,1,0,0,2,2,1,2,6767,34,5
1100,서울특별시,1105,광진구,,구의제3동제1투,2556,1934,581,1282,44,1,5,1,0,0,0,1,0,0,1915,19,622
1100,서울특별시,1105,광진구,,구의제3동제2투,2331,1476,646,727,77,0,9,0,0,0,2,0,0,0,1461,15,855
1100,서울특별시,1105,광진구,,구의제3동제3투,2857,1887,818,976,43,3,11,1,0,1,3,2,2,2,1862,25,970
1100,서울특별시,1105,광진구,,구의제3동제4투,2195,1443,429,930,55,1,6,0,0,4,0,0,0,2,1427,16,752
1100,서울특별시,1105,광진구,,구의제3동제5투,2785,2004,712,1201,55,0,9,1,0,1,2,1,0,1,1983,21,781
1100,서울특별시,1105,광진구,,구의제3동제6투,2517,1941,522,1354,40,0,5,0,0,1,1,0,0,0,1923,18,576
1100,서울특별시,1105,광진구,광장동,소계,24208,19394,7687,11008,490,6,36,4,5,3,10,4,3,1,19257,137,4814
1100,서울특별시,1105,광진구,,관내사전투표,6792,6796,3279,3333,136,4,10,1,0,2,0,2,1,0,6768,28,-4
1100,서울특별시,1105,광진구,,광장동제1투,3530,2305,777,1444,51,0,4,1,1,0,3,0,1,0,2282,23,1225
1100,서울특별시,1105,광진구,,광장동제2투,2463,1729,490,1188,35,0,3,1,2,0,1,0,0,0,1720,9,734
1100,서울특별시,1105,광진구,,광장동제3투,2573,1943,768,1088,57,1,4,0,0,1,0,0,0,0,1919,24,630
1100,서울특별시,1105,광진구,,광장동제4투,2719,2059,787,1177,62,1,3,1,0,0,2,0,0,0,2033,26,660
1100,서울특별시,1105,광진구,,광장동제5투,3336,2482,932,1429,89,0,8,0,1,0,4,2,1,0,2466,16,854
1100,서울특별시,1105,광진구,,광장동제6투,2795,2080,654,1349,60,0,4,0,1,0,0,0,0,1,2069,11,715
1100,서울특별시,1105,광진구,자양제1동,소계,19073,14158,7087,6348,442,6,84,5,1,7,8,12,4,1,14005,153,4915
1100,서울특별시,1105,광진구,,관내사전투표,7149,7148,3983,2853,206,4,27,3,0,1,1,4,1,1,7084,64,1
1100,서울특별시,1105,광진구,,자양제1동제1투,2050,1154,508,562,47,0,11,0,0,1,1,4,1,0,1135,19,896
1100,서울특별시,1105,광진구,,자양제1동제2투,1974,1263,544,642,46,0,4,0,1,0,4,0,1,0,1242,21,711
1100,서울특별시,1105,광진구,,자양제1동제3투,2762,1685,722,874,57,1,10,1,0,2,1,1,0,0,1669,16,1077
1100,서울특별시,1105,광진구,,자양제1동제4투,1555,934,405,468,34,1,12,1,0,2,0,2,0,0,925,9,621
1100,서울특별시,1105,광진구,,자양제1동제5투,1727,873,403,413,29,0,12,0,0,0,0,1,1,0,859,14,854
1100,서울특별시,1105,광진구,,자양제1동제6투,1856,1101,522,536,23,0,8,0,0,1,1,0,0,0,1091,10,755
1100,서울특별시,1105,광진구,자양제2동,소계,18091,13516,6408,6520,371,6,73,5,1,5,14,12,0,3,13418,98,4575
1100,서울특별시,1105,광진구,,관내사전투표,4905,4905,2758,1986,111,4,13,1,0,0,4,4,0,1,4882,23,0
1100,서울특별시,1105,광진구,,자양제2동제1투,2308,1421,562,809,35,0,2,1,0,2,1,1,0,1,1414,7,887
1100,서울특별시,1105,광진구,,자양제2동제2투,2281,1600,560,956,50,1,7,0,0,2,7,2,0,0,1585,15,681
1100,서울특별시,1105,광진구,,자양제2동제3투,2096,1318,618,634,43,0,8,1,0,1,0,2,0,0,1307,11,778
1100,서울특별시,1105,광진구,,자양제2동제4투,2022,1338,551,709,48,0,11,0,0,0,0,0,0,1,1320,18,684
1100,서울특별시,1105,광진구,,자양제2동제5투,1967,1240,586,594,35,1,15,0,0,0,1,2,0,0,1234,6,727
1100,서울특별시,1105,광진구,,자양제2동제6투,2512,1694,773,832,49,0,17,2,1,0,1,1,0,0,1676,18,818
1100,서울특별시,1105,광진구,자양제3동,소계,22009,17772,7147,9972,441,6,48,1,0,4,15,5,1,11,17651,121,4237
1100,서울특별시,1105,광진구,,관내사전투표,8054,8054,3940,3881,176,3,13,1,0,0,1,2,0,2,8019,35,0
1100,서울특별시,1105,광진구,,자양제3동제1투,2117,1331,529,731,47,0,7,0,0,0,4,1,1,1,1321,10,786
1100,서울특별시,1105,광진구,,자양제3동제2투,2386,1555,528,962,31,1,8,0,0,0,1,0,0,1,1532,23,831
1100,서울특별시,1105,광진구,,자양제3동제3투,2032,1439,515,859,46,1,3,0,0,0,1,0,0,0,1425,14,593
1100,서울특별시,1105,광진구,,자양제3동제4투,1828,1335,484,795,41,0,3,0,0,0,5,0,0,7,1335,0,493
1100,서울특별시,1105,광진구,,자양제3동제5투,1841,1369,471,835,47,0,5,0,0,0,0,1,0,0,1359,10,472
1100,서울특별시,1105,광진구,,자양제3동제6투,1257,789,326,423,22,0,4,0,0,0,2,1,0,0,778,11,468
1100,서울특별시,1105,광진구,,자양제3동제7투,2494,1900,354,1486,31,1,5,0,0,4,1,0,0,0,1882,18,594
1100,서울특별시,1105,광진구,자양제4동,소계,15204,11184,5076,5595,300,9,71,2,2,3,10,8,1,5,11082,102,4020
1100,서울특별시,1105,광진구,,관내사전투표,5019,5019,2602,2228,127,2,25,1,2,1,2,5,1,1,4997,22,0
1100,서울특별시,1105,광진구,,자양제4동제1투,1682,946,384,506,24,2,10,0,0,2,3,1,0,0,932,14,736
1100,서울특별시,1105,광진구,,자양제4동제2투,1818,1145,384,709,30,2,7,0,0,0,2,0,0,1,1135,10,673
1100,서울특별시,1105,광진구,,자양제4동제3투,1444,869,343,489,23,0,5,0,0,0,0,0,0,1,861,8,575
1100,서울특별시,1105,광진구,,자양제4동제4투,1749,1020,453,501,33,1,10,0,0,0,0,0,0,0,998,22,729
1100,서울특별시,1105,광진구,,자양제4동제5투,1806,1109,457,590,31,2,10,1,0,0,1,1,0,1,1094,15,697
1100,서울특별시,1105,광진구,,자양제4동제6투,1686,1076,453,572,32,0,4,0,0,0,2,1,0,1,1065,11,610
1100,서울특별시,1105,광진구,화양동,소계,20156,13853,6192,6661,558,13,108,3,1,3,7,11,4,6,13567,286,6303
1100,서울특별시,1105,광진구,,관내사전투표,5689,5688,2883,2437,239,5,33,0,0,1,2,5,1,3,5609,79,1
1100,서울특별시,1105,광진구,,화양동제1투,3695,1999,838,1001,82,1,20,1,0,0,2,0,2,0,1947,52,1696
1100,서울특별시,1105,광진구,,화양동제2투,2322,1416,555,757,52,2,11,1,1,0,1,1,0,1,1382,34,906
1100,서울특별시,1105,광진구,,화양동제3투,2491,1413,571,742,57,0,12,1,0,0,1,1,0,1,1386,27,1078
1100,서울특별시,1105,광진구,,화양동제4투,1960,997,398,508,42,3,12,0,0,0,0,2,0,0,965,32,963
1100,서울특별시,1105,광진구,,화양동제5투,2043,1194,480,616,42,2,11,0,0,1,0,1,1,1,1155,39,849
1100,서울특별시,1105,광진구,,화양동제6투,1956,1146,467,600,44,0,9,0,0,1,1,1,0,0,1123,23,810
1100,서울특별시,1105,광진구,군자동,소계,15611,11347,5410,5245,384,14,88,1,1,2,14,9,3,2,11173,174,4264
1100,서울특별시,1105,광진구,,관내사전투표,4395,4395,2431,1740,140,7,20,0,1,1,2,3,2,0,4347,48,0
1100,서울특별시,1105,광진구,,군자동제1투,2212,1278,532,644,55,1,13,0,0,0,3,3,0,1,1252,26,934
1100,서울특별시,1105,광진구,,군자동제2투,1741,1122,514,543,38,0,4,0,0,0,1,0,1,0,1101,21,619
1100,서울특별시,1105,광진구,,군자동제3투,1634,1001,440,490,36,0,12,0,0,0,2,0,0,0,980,21,633
1100,서울특별시,1105,광진구,,군자동제4투,1707,1048,474,499,39,1,14,1,0,0,0,2,0,0,1030,18,659
1100,서울특별시,1105,광진구,,군자동제5투,1865,1244,495,675,40,1,13,0,0,0,1,0,0,0,1225,19,621
1100,서울특별시,1105,광진구,,군자동제6투,2057,1259,524,654,36,4,12,0,0,1,5,1,0,1,1238,21,798
1100,서울특별시,1105,광진구,잘못 투입·구분된 투표지,,0,4,3,1,0,0,0,0,0,0,0,0,0,0,4,0,-4
1100,서울특별시,1106,동대문구,합계,,300928,232106,108171,112890,6416,151,1304,44,32,55,184,232,80,78,229637,2469,68822
1100,서울특별시,1106,동대문구,거소·선상투표,,423,401,144,190,8,0,6,0,0,0,0,3,0,1,352,49,22
1100,서울특별시,1106,동대문구,관외사전투표,,31510,31506,15651,14069,1070,21,229,10,5,5,18,76,10,12,31176,330,4
1100,서울특별시,1106,동대문구,재외투표,,2201,1549,792,539,57,0,3,0,0,1,5,0,0,0,1397,152,652
1100,서울특별시,1106,동대문구,용신동,소계,25435,17841,8226,8759,492,10,110,4,2,4,22,15,2,5,17651,190,7594
1100,서울특별시,1106,동대문구,,관내사전투표,6853,6853,3644,2966,163,4,28,1,0,3,4,4,0,0,6817,36,0
1100,서울특별시,1106,동대문구,,용신동제1투,2396,1346,458,821,44,1,5,1,0,0,6,2,0,0,1338,8,1050
1100,서울특별시,1106,동대문구,,용신동제2투,2418,1438,642,694,41,0,23,0,1,0,3,2,0,2,1408,30,980
1100,서울특별시,1106,동대문구,,용신동제3투,2314,1287,591,631,30,0,11,0,0,0,4,1,0,2,1270,17,1027
1100,서울특별시,1106,동대문구,,용신동제4투,2031,1248,507,670,36,2,6,0,0,1,1,3,0,1,1227,21,783
1100,서울특별시,1106,동대문구,,용신동제5투,2562,1581,655,834,46,1,10,1,0,0,2,0,0,0,1549,32,981
1100,서울특별시,1106,동대문구,,용신동제6투,2239,1244,538,635,40,1,7,0,1,0,1,0,2,0,1225,19,995
1100,서울특별시,1106,동대문구,,용신동제7투,2044,1264,501,683,45,1,11,0,0,0,0,2,0,0,1243,21,780
1100,서울특별시,1106,동대문구,,용신동제8투,2578,1580,690,825,47,0,9,1,0,0,1,1,0,0,1574,6,998
1100,서울특별시,1106,동대문구,제기동,소계,19508,14050,6173,7227,375,9,78,1,4,6,18,5,10,9,13915,135,5458
1100,서울특별시,1106,동대문구,,관내사전투표,5643,5643,2905,2543,128,4,22,0,1,1,2,3,4,3,5616,27,0
1100,서울특별시,1106,동대문구,,제기동제1투,2590,1430,568,800,26,1,14,0,1,0,1,0,5,0,1416,14,1160
1100,서울특별시,1106,동대문구,,제기동제2투,2341,1463,519,876,43,2,1,0,0,0,2,0,0,0,1443,20,878
1100,서울특별시,1106,동대문구,,제기동제3투,2301,1204,471,661,34,0,9,0,2,1,7,0,0,2,1187,17,1097
1100,서울특별시,1106,동대문구,,제기동제4투,2273,1396,549,754,47,0,20,0,0,0,2,1,0,3,1376,20,877
1100,서울특별시,1106,동대문구,,제기동제5투,1998,1353,544,728,52,1,6,0,0,1,1,0,1,0,1334,19,645
1100,서울특별시,1106,동대문구,,제기동제6투,2362,1561,617,865,45,1,6,1,0,3,3,1,0,1,1543,18,801
1100,서울특별시,1106,동대문구,전농제1동,소계,22141,16093,7304,8033,421,10,88,3,2,8,9,17,6,7,15908,185,6048
1100,서울특별시,1106,동대문구,,관내사전투표,5337,5337,2785,2370,111,2,18,1,0,1,1,10,1,4,5304,33,0
1100,서울특별시,1106,동대문구,,전농제1동제1투,2241,1195,491,641,31,1,9,0,0,0,2,1,2,1,1179,16,1046
1100,서울특별시,1106,동대문구,,전농제1동제2투,2149,1376,538,759,40,0,11,1,1,0,1,0,0,0,1351,25,773
1100,서울특별시,1106,동대문구,,전농제1동제3투,2793,1718,721,875,62,3,13,0,0,1,4,3,2,0,1684,34,1075
1100,서울특별시,1106,동대문구,,전농제1동제4투,2006,1261,551,640,43,0,5,0,1,0,1,0,0,0,1241,20,745
1100,서울특별시,1106,동대문구,,전농제1동제5투,1960,1128,461,612,26,2,12,0,0,1,0,1,1,0,1116,12,832
1100,서울특별시,1106,동대문구,,전농제1동제6투,1675,1025,462,517,19,1,8,0,0,2,0,0,0,1,1010,15,650
1100,서울특별시,1106,동대문구,,전농제1동제7투,1799,1334,589,682,37,0,5,1,0,0,0,2,0,1,1317,17,465
1100,서울특별시,1106,동대문구,,전농제1동제8투,2181,1719,706,937,52,1,7,0,0,3,0,0,0,0,1706,13,462
1100,서울특별시,1106,동대문구,전농제2동,소계,15681,12218,5705,6047,274,8,52,3,2,3,9,9,0,3,12115,103,3463
1100,서울특별시,1106,동대문구,,관내사전투표,5511,5511,2928,2429,101,6,9,0,0,1,2,5,0,1,5482,29,0
1100,서울특별시,1106,동대문구,,전농제2동제1투,1702,1095,447,591,23,0,12,0,0,1,5,1,0,0,1080,15,607
1100,서울특별시,1106,동대문구,,전농제2동제2투,2302,1687,673,956,37,0,9,0,2,0,0,0,0,0,1677,10,615
1100,서울특별시,1106,동대문구,,전농제2동제3투,1735,1150,499,594,33,0,7,0,0,0,0,2,0,0,1135,15,585
1100,서울특별시,1106,동대문구,,전농제2동제4투,2764,1754,714,953,53,2,9,1,0,1,1,0,0,2,1736,18,1010
1100,서울특별시,1106,동대문구,,전농제2동제5투,1667,1021,444,524,27,0,6,2,0,0,1,1,0,0,1005,16,646
1100,서울특별시,1106,동대문구,답십리제1동,소계,22114,16956,7763,8468,448,18,65,1,3,1,12,14,1,6,16800,156,5158
1100,서울특별시,1106,동대문구,,관내사전투표,6223,6223,3307,2688,154,9,15,1,1,0,3,7,0,1,6186,37,0
1100,서울특별시,1106,동대문구,,답십리제1동제1투,2203,1172,512,597,35,0,8,0,0,0,3,1,0,1,1157,15,1031
1100,서울특별시,1106,동대문구,,답십리제1동제2투,2546,1580,719,780,41,4,9,0,1,0,0,2,0,1,1557,23,966
1100,서울특별시,1106,동대문구,,답십리제1동제3투,1958,1501,552,882,46,2,7,0,0,0,1,0,0,0,1490,11,457
1100,서울특별시,1106,동대문구,,답십리제1동제4투,2009,1465,592,819,31,0,5,0,1,0,1,0,0,0,1449,16,544
1100,서울특별시,1106,동대문구,,답십리제1동제5투,2528,1675,677,923,45,1,4,0,0,0,1,2,0,1,1654,21,853
1100,서울특별시,1106,동대문구,,답십리제1동제6투,1528,1023,437,538,22,0,10,0,0,1,1,2,0,2,1013,10,505
1100,서울특별시,1106,동대문구,,답십리제1동제7투,3119,2317,967,1241,74,2,7,0,0,0,2,0,1,0,2294,23,802
1100,서울특별시,1106,동대문구,답십리제2동,소계,21777,16627,7897,8086,388,5,82,3,2,4,12,14,4,5,16502,125,5150
1100,서울특별시,1106,동대문구,,관내사전투표,5689,5689,3090,2417,128,2,19,0,0,1,2,7,0,2,5668,21,0
1100,서울특별시,1106,동대문구,,답십리제2동제1투,2771,1684,687,907,64,0,6,0,0,0,2,0,0,1,1667,17,1087
1100,서울특별시,1106,동대문구,,답십리제2동제2투,1820,1205,512,642,26,0,9,0,0,1,0,1,0,0,1191,14,615
1100,서울특별시,1106,동대문구,,답십리제2동제3투,1605,1124,490,588,27,0,5,0,0,0,0,0,2,0,1112,12,481
1100,서울특별시,1106,동대문구,,답십리제2동제4투,2347,1714,808,841,36,1,13,1,0,1,4,3,0,1,1709,5,633
1100,서울특별시,1106,동대문구,,답십리제2동제5투,2252,1632,727,845,36,1,5,1,1,0,1,0,1,0,1618,14,620
1100,서울특별시,1106,동대문구,,답십리제2동제6투,2711,2042,848,1103,44,1,12,1,0,0,2,3,1,0,2015,27,669
1100,서울특별시,1106,동대문구,,답십리제2동제7투,2582,1537,735,743,27,0,13,0,1,1,1,0,0,1,1522,15,1045
1100,서울특별시,1106,동대문구,장안제1동,소계,30784,22762,11171,10632,578,11,138,5,6,2,14,10,3,4,22574,188,8022
1100,서울특별시,1106,동대문구,,관내사전투표,7974,7974,4575,3154,166,5,21,1,0,0,0,5,1,2,7930,44,0
1100,서울특별시,1106,동대문구,,장안제1동제1투,2878,1560,709,754,52,1,18,1,0,0,4,0,1,0,1540,20,1318
1100,서울특별시,1106,동대문구,,장안제1동제2투,3175,2003,860,1037,61,1,11,1,1,1,1,2,0,0,1976,27,1172
1100,서울특별시,1106,동대문구,,장안제1동제3투,2998,1637,790,760,45,0,20,0,0,0,1,1,0,0,1617,20,1361
1100,서울특별시,1106,동대문구,,장안제1동제4투,3436,2184,993,1093,60,1,12,0,3,0,2,0,0,0,2164,20,1252
1100,서울특별시,1106,동대문구,,장안제1동제5투,2332,1575,759,746,36,0,16,0,0,0,3,0,0,0,1560,15,757
1100,서울특별시,1106,동대문구,,장안제1동제6투,2833,1835,854,886,43,1,24,1,2,0,2,2,0,1,1816,19,998
1100,서울특별시,1106,동대문구,,장안제1동제7투,2430,1834,742,1023,49,0,8,0,0,0,1,0,1,1,1825,9,596
1100,서울특별시,1106,동대문구,,장안제1동제8투,2728,2160,889,1179,66,2,8,1,0,1,0,0,0,0,2146,14,568
1100,서울특별시,1106,동대문구,장안제2동,소계,26063,19568,9600,9265,446,15,92,3,1,2,11,10,5,8,19458,110,6495
1100,서울특별시,1106,동대문구,,관내사전투표,7189,7188,4018,2953,153,4,24,1,1,1,3,5,1,2,7166,22,1
1100,서울특별시,1106,동대문구,,장안제2동제1투,1541,836,361,448,15,1,4,0,0,0,1,2,1,0,833,3,705
1100,서울특별시,1106,동대문구,,장안제2동제2투,2534,1670,733,869,39,1,5,0,0,0,2,0,1,2,1652,18,864
1100,서울특별시,1106,동대문구,,장안제2동제3투,1816,1138,491,595,23,3,13,0,0,0,2,1,1,2,1131,7,678
1100,서울특별시,1106,동대문구,,장안제2동제4투,2137,1335,645,641,30,0,11,1,0,0,0,1,0,0,1329,6,802
1100,서울특별시,1106,동대문구,,장안제2동제5투,3591,2306,1124,1071,63,2,17,1,0,0,1,1,0,1,2281,25,1285
1100,서울특별시,1106,동대문구,,장안제2동제6투,1865,1225,531,636,37,2,8,0,0,0,1,0,1,1,1217,8,640
1100,서울특별시,1106,동대문구,,장안제2동제7투,3133,2283,990,1217,54,1,7,0,0,0,1,0,0,0,2270,13,850
1100,서울특별시,1106,동대문구,,장안제2동제8투,2257,1587,707,835,32,1,3,0,0,1,0,0,0,0,1579,8,670
1100,서울특별시,1106,동대문구,청량리동,소계,15766,11726,4992,6211,263,7,83,2,1,7,16,8,8,3,11601,125,4040
1100,서울특별시,1106,동대문구,,관내사전투표,4403,4403,2206,2056,78,2,19,1,0,0,3,4,1,1,4371,32,0
1100,서울특별시,1106,동대문구,,청량리동제1투,2020,1094,462,570,29,1,11,1,0,3,0,0,2,0,1079,15,926
1100,서울특별시,1106,동대문구,,청량리동제2투,2409,1782,760,923,53,1,18,0,0,0,3,2,1,0,1761,21,627
1100,서울특별시,1106,동대문구,,청량리동제3투,874,531,215,290,13,1,1,0,0,1,0,0,1,1,523,8,343
1100,서울특별시,1106,동대문구,,청량리동제4투,1456,822,330,450,18,0,7,0,0,2,0,2,0,0,809,13,634
1100,서울특별시,1106,동대문구,,청량리동제5투,1994,1300,485,754,34,2,12,0,0,0,2,0,0,0,1289,11,694
1100,서울특별시,1106,동대문구,,청량리동제6투,2610,1794,534,1168,38,0,15,0,1,1,8,0,3,1,1769,25,816
1100,서울특별시,1106,동대문구,회기동,소계,10692,8522,3659,4296,334,11,53,2,0,0,4,8,6,0,8373,149,2170
1100,서울특별시,1106,동대문구,,관내사전투표,5094,5094,2402,2369,202,9,28,0,0,0,0,5,2,0,5017,77,0
1100,서울특별시,1106,동대문구,,회기동제1투,2194,1292,454,730,59,0,13,0,0,0,1,0,1,0,1258,34,902
1100,서울특별시,1106,동대문구,,회기동제2투,1804,1163,435,660,39,1,4,1,0,0,2,1,3,0,1146,17,641
1100,서울특별시,1106,동대문구,,회기동제3투,1600,973,368,537,34,1,8,1,0,0,1,2,0,0,952,21,627
1100,서울특별시,1106,동대문구,휘경제1동,소계,10682,7939,3550,3981,236,5,36,1,0,4,4,9,1,3,7830,109,2743
1100,서울특별시,1106,동대문구,,관내사전투표,3593,3593,1855,1600,89,1,8,0,0,0,3,3,1,0,3560,33,0
1100,서울특별시,1106,동대문구,,휘경제1동제1투,2363,1482,563,836,52,1,8,1,0,1,0,1,0,0,1463,19,881
1100,서울특별시,1106,동대문구,,휘경제1동제2투,2305,1479,572,825,46,0,9,0,0,2,0,3,0,0,1457,22,826
1100,서울특별시,1106,동대문구,,휘경제1동제3투,2421,1385,560,720,49,3,11,0,0,1,1,2,0,3,1350,35,1036
1100,서울특별시,1106,동대문구,휘경제2동,소계,17216,12700,5757,6306,385,7,75,4,1,2,11,7,7,4,12566,134,4516
1100,서울특별시,1106,동대문구,,관내사전투표,3413,3413,1830,1469,73,1,13,1,0,0,1,4,0,1,3393,20,0
1100,서울특별시,1106,동대문구,,휘경제2동제1투,1748,1016,400,566,29,0,5,0,1,0,1,0,1,0,1003,13,732
1100,서울특별시,1106,동대문구,,휘경제2동제2투,1993,1558,685,803,52,0,5,0,0,0,1,1,1,0,1548,10,435
1100,서울특별시,1106,동대문구,,휘경제2동제3투,2947,1849,782,949,71,2,7,1,0,1,2,1,2,3,1821,28,1098
1100,서울특별시,1106,동대문구,,휘경제2동제4투,2823,1781,745,916,54,3,22,2,0,0,2,0,3,0,1747,34,1042
1100,서울특별시,1106,동대문구,,휘경제2동제5투,2370,1800,763,952,57,1,13,0,0,1,0,0,0,0,1787,13,570
1100,서울특별시,1106,동대문구,,휘경제2동제6투,1922,1283,552,651,49,0,10,0,0,0,4,1,0,0,1267,16,639
1100,서울특별시,1106,동대문구,이문제1동,소계,13948,10256,4377,5303,344,9,57,1,3,0,9,11,9,3,10126,130,3692
1100,서울특별시,1106,동대문구,,관내사전투표,3830,3830,1947,1744,99,2,15,0,0,0,0,2,1,0,3810,20,0
1100,서울특별시,1106,동대문구,,이문제1동제1투,1674,918,412,459,17,1,15,1,0,0,0,2,1,0,908,10,756
1100,서울특별시,1106,동대문구,,이문제1동제2투,1608,962,386,521,32,0,8,0,0,0,1,1,1,0,950,12,646
1100,서울특별시,1106,동대문구,,이문제1동제3투,1517,1133,367,696,46,1,2,0,0,0,4,0,1,0,1117,16,384
1100,서울특별시,1106,동대문구,,이문제1동제4투,1306,786,295,429,39,1,2,0,0,0,0,0,1,1,768,18,520
1100,서울특별시,1106,동대문구,,이문제1동제5투,1938,1308,497,734,51,1,4,0,2,0,0,2,1,1,1293,15,630
1100,서울특별시,1106,동대문구,,이문제1동제6투,2075,1319,473,720,60,3,11,0,1,0,4,4,3,1,1280,39,756
1100,서울특별시,1106,동대문구,이문제2동,소계,14987,11389,5409,5476,297,5,57,1,0,6,10,16,8,5,11290,99,3598
1100,서울특별시,1106,동대문구,,관내사전투표,4151,4151,2326,1688,84,1,15,1,0,0,1,8,1,2,4127,24,0
1100,서울특별시,1106,동대문구,,이문제2동제1투,2462,1405,597,724,50,2,11,0,0,2,0,3,1,1,1391,14,1057
1100,서울특별시,1106,동대문구,,이문제2동제2투,1583,852,401,403,22,0,9,0,0,0,0,3,2,0,840,12,731
1100,서울특별시,1106,동대문구,,이문제2동제3투,2123,1479,578,820,53,2,5,0,0,0,6,0,0,1,1465,14,644
1100,서울특별시,1106,동대문구,,이문제2동제4투,2282,1752,761,914,48,0,9,0,0,0,2,1,2,1,1738,14,530
1100,서울특별시,1106,동대문구,,이문제2동제5투,2386,1750,746,927,40,0,8,0,0,4,1,1,2,0,1729,21,636
1100,서울특별시,1106,동대문구,잘못 투입·구분된 투표지,,0,3,1,2,0,0,0,0,0,0,0,0,0,0,3,0,-3
1100,서울특별시,1107,중랑구,합계,,347108,260862,130381,118201,6899,156,1961,59,30,73,236,292,60,75,258423,2439,86246
1100,서울특별시,1107,중랑구,거소·선상투표,,560,525,202,227,11,0,19,0,0,1,1,0,1,2,464,61,35
1100,서울특별시,1107,중랑구,관외사전투표,,30398,30394,16229,12583,878,24,261,6,2,6,15,86,2,11,30103,291,4
1100,서울특별시,1107,중랑구,재외투표,,1746,1240,734,358,44,1,5,1,0,0,2,0,0,0,1145,95,506
1100,서울특별시,1107,중랑구,면목본동,소계,28015,19404,9857,8612,514,9,156,2,3,4,18,21,4,7,19207,197,8611
1100,서울특별시,1107,중랑구,,관내사전투표,8049,8049,4523,3249,182,3,42,0,0,1,2,5,0,3,8010,39,0
1100,서울특별시,1107,중랑구,,면목본동제1투,3353,1767,744,898,55,2,24,0,0,1,2,4,1,0,1731,36,1586
1100,서울특별시,1107,중랑구,,면목본동제2투,2744,1641,749,785,59,2,11,0,0,0,0,3,1,1,1611,30,1103
1100,서울특별시,1107,중랑구,,면목본동제3투,2977,1795,881,820,52,0,16,0,0,1,5,2,0,2,1779,16,1182
1100,서울특별시,1107,중랑구,,면목본동제4투,2692,1576,793,707,31,1,22,0,0,0,3,2,1,1,1561,15,1116
1100,서울특별시,1107,중랑구,,면목본동제5투,2578,1434,709,661,35,0,8,2,0,0,0,2,1,0,1418,16,1144
1100,서울특별시,1107,중랑구,,면목본동제6투,3059,1688,804,777,55,0,22,0,2,1,4,3,0,0,1668,20,1371
1100,서울특별시,1107,중랑구,,면목본동제7투,2563,1454,654,715,45,1,11,0,1,0,2,0,0,0,1429,25,1109
1100,서울특별시,1107,중랑구,면목제2동,소계,18742,12934,6526,5822,319,9,91,4,3,6,13,13,4,3,12813,121,5808
1100,서울특별시,1107,중랑구,,관내사전투표,5222,5222,2879,2179,103,3,20,1,0,0,0,7,2,0,5194,28,0
1100,서울특별시,1107,중랑구,,면목제2동제1투,2951,1593,744,758,52,1,13,1,1,1,6,3,1,0,1581,12,1358
1100,서울특별시,1107,중랑구,,면목제2동제2투,2183,1332,589,674,35,1,15,1,0,1,1,0,0,1,1318,14,851
1100,서울특별시,1107,중랑구,,면목제2동제3투,2882,1630,763,770,50,0,17,1,1,1,4,0,0,1,1608,22,1252
1100,서울특별시,1107,중랑구,,면목제2동제4투,2752,1599,784,725,43,3,16,0,0,3,1,2,1,0,1578,21,1153
1100,서울특별시,1107,중랑구,,면목제2동제5투,2752,1558,767,716,36,1,10,0,1,0,1,1,0,1,1534,24,1194
1100,서울특별시,1107,중랑구,면목제3·8동,소계,19809,13815,6846,6321,348,9,125,3,0,2,13,14,6,7,13694,121,5994
1100,서울특별시,1107,중랑구,,관내사전투표,5214,5214,2876,2130,127,5,31,3,0,2,2,6,3,1,5186,28,0
1100,서울특별시,1107,중랑구,,면목제3·8동제1투,2280,1146,535,542,33,1,13,0,0,0,2,0,2,1,1129,17,1134
1100,서울특별시,1107,중랑구,,면목제3·8동제2투,1916,1120,504,560,26,0,14,0,0,0,1,1,0,0,1106,14,796
1100,서울특별시,1107,중랑구,,면목제3·8동제3투,2043,1126,529,550,25,0,12,0,0,0,1,2,0,1,1120,6,917
1100,서울특별시,1107,중랑구,,면목제3·8동제4투,2053,1212,562,591,31,0,10,0,0,0,2,0,1,1,1198,14,841
1100,서울특별시,1107,중랑구,,면목제3·8동제5투,2079,1390,641,690,30,1,10,0,0,0,1,3,0,0,1376,14,689
1100,서울특별시,1107,중랑구,,면목제3·8동제6투,2030,1152,496,583,35,0,14,0,0,0,4,2,0,3,1137,15,878
1100,서울특별시,1107,중랑구,,면목제3·8동제7투,2194,1455,703,675,41,2,21,0,0,0,0,0,0,0,1442,13,739
1100,서울특별시,1107,중랑구,면목제4동,소계,15323,10942,5469,4971,274,6,90,1,2,4,11,4,3,2,10837,105,4381
1100,서울특별시,1107,중랑구,,관내사전투표,4710,4710,2679,1867,111,1,25,1,2,0,2,1,1,0,4690,20,0
1100,서울특별시,1107,중랑구,,면목제4동제1투,1977,1114,482,572,29,1,13,0,0,1,3,2,0,0,1103,11,863
1100,서울특별시,1107,중랑구,,면목제4동제2투,2433,1449,662,716,28,2,17,0,0,1,1,1,0,0,1428,21,984
1100,서울특별시,1107,중랑구,,면목제4동제3투,2167,1319,592,657,41,0,10,0,0,0,2,0,0,1,1303,16,848
1100,서울특별시,1107,중랑구,,면목제4동제4투,2093,1257,574,616,40,1,9,0,0,0,2,0,0,0,1242,15,836
1100,서울특별시,1107,중랑구,,면목제4동제5투,1943,1093,480,543,25,1,16,0,0,2,1,0,2,1,1071,22,850
1100,서울특별시,1107,중랑구,면목제5동,소계,11853,8904,4678,3841,238,6,63,2,0,2,5,5,1,2,8843,61,2949
1100,서울특별시,1107,중랑구,,관내사전투표,4074,4074,2407,1536,89,3,19,1,0,0,1,2,1,0,4059,15,0
1100,서울특별시,1107,중랑구,,면목제5동제1투,2465,1316,633,613,37,1,14,0,0,1,0,0,0,2,1301,15,1149
1100,서울특별시,1107,중랑구,,면목제5동제2투,2485,1344,674,600,30,1,18,1,0,1,2,2,0,0,1329,15,1141
1100,서울특별시,1107,중랑구,,면목제5동제3투,2829,2170,964,1092,82,1,12,0,0,0,2,1,0,0,2154,16,659
1100,서울특별시,1107,중랑구,면목제7동,소계,18086,13180,6433,6187,335,7,97,0,0,5,10,5,2,2,13083,97,4906
1100,서울특별시,1107,중랑구,,관내사전투표,6445,6445,3494,2727,150,5,35,0,0,1,1,3,0,1,6417,28,0
1100,서울특별시,1107,중랑구,,면목제7동제1투,2321,1189,552,567,37,1,12,0,0,2,3,0,1,1,1176,13,1132
1100,서울특별시,1107,중랑구,,면목제7동제2투,2420,1335,581,690,33,0,16,0,0,0,0,1,0,0,1321,14,1085
1100,서울특별시,1107,중랑구,,면목제7동제3투,1993,1061,504,505,22,0,12,0,0,0,3,1,0,0,1047,14,932
1100,서울특별시,1107,중랑구,,면목제7동제4투,2300,1435,573,799,37,1,6,0,0,1,1,0,0,0,1418,17,865
1100,서울특별시,1107,중랑구,,면목제7동제5투,2607,1715,729,899,56,0,16,0,0,1,2,0,1,0,1704,11,892
1100,서울특별시,1107,중랑구,상봉제1동,소계,16899,12310,5796,5923,338,6,92,5,3,5,13,8,2,7,12198,112,4589
1100,서울특별시,1107,중랑구,,관내사전투표,3993,3993,2167,1685,88,3,21,0,0,0,0,4,0,0,3968,25,0
1100,서울특별시,1107,중랑구,,상봉제1동제1투,3228,1702,767,823,57,0,21,1,2,2,1,1,0,0,1675,27,1526
1100,서울특별시,1107,중랑구,,상봉제1동제2투,2899,2074,920,1053,60,1,8,2,0,0,3,2,0,4,2053,21,825
1100,서울특별시,1107,중랑구,,상봉제1동제3투,2965,1997,893,1000,58,1,19,0,0,1,4,0,1,2,1979,18,968
1100,서울특별시,1107,중랑구,,상봉제1동제4투,2516,1596,687,815,51,0,19,0,1,2,4,1,1,0,1581,15,920
1100,서울특별시,1107,중랑구,,상봉제1동제5투,1298,948,362,547,24,1,4,2,0,0,1,0,0,1,942,6,350
1100,서울특별시,1107,중랑구,상봉제2동,소계,17063,11837,5961,5275,379,11,72,5,2,1,11,14,2,2,11735,102,5226
1100,서울특별시,1107,중랑구,,관내사전투표,5383,5378,3050,2079,178,5,16,1,1,0,0,5,0,2,5337,41,5
1100,서울특별시,1107,중랑구,,상봉제2동제1투,3199,1621,749,778,56,1,14,1,0,0,4,4,1,0,1608,13,1578
1100,서울특별시,1107,중랑구,,상봉제2동제2투,3394,2074,855,1135,48,1,17,2,0,1,5,1,0,0,2065,9,1320
1100,서울특별시,1107,중랑구,,상봉제2동제3투,2671,1465,683,682,58,1,13,0,1,0,1,2,1,0,1442,23,1206
1100,서울특별시,1107,중랑구,,상봉제2동제4투,2416,1299,624,601,39,3,12,1,0,0,1,2,0,0,1283,16,1117
1100,서울특별시,1107,중랑구,중화제1동,소계,17007,12794,6352,5820,358,9,105,6,3,6,3,13,2,2,12679,115,4213
1100,서울특별시,1107,중랑구,,관내사전투표,6617,6616,3659,2710,169,2,32,3,1,1,1,6,1,1,6586,30,1
1100,서울특별시,1107,중랑구,,중화제1동제1투,2801,1508,675,742,37,1,18,2,0,3,0,0,0,0,1478,30,1293
1100,서울특별시,1107,중랑구,,중화제1동제2투,2761,1618,720,788,55,3,27,1,0,1,0,3,0,0,1598,20,1143
1100,서울특별시,1107,중랑구,,중화제1동제3투,2911,1752,773,871,55,3,21,0,1,1,2,2,1,1,1731,21,1159
1100,서울특별시,1107,중랑구,,중화제1동제4투,1917,1300,525,709,42,0,7,0,1,0,0,2,0,0,1286,14,617
1100,서울특별시,1107,중랑구,중화제2동,소계,19070,12494,6355,5530,311,9,123,2,4,5,13,12,3,0,12367,127,6576
1100,서울특별시,1107,중랑구,,관내사전투표,4121,4119,2365,1602,97,2,22,1,1,1,3,2,0,0,4096,23,2
1100,서울특별시,1107,중랑구,,중화제2동제1투,2274,1228,575,586,27,3,13,0,3,2,0,3,0,0,1212,16,1046
1100,서울특별시,1107,중랑구,,중화제2동제2투,2780,1487,683,715,44,1,18,1,0,0,2,2,1,0,1467,20,1293
1100,서울특별시,1107,중랑구,,중화제2동제3투,2735,1573,740,759,37,1,19,0,0,0,0,0,0,0,1556,17,1162
1100,서울특별시,1107,중랑구,,중화제2동제4투,2619,1501,769,645,39,0,18,0,0,0,4,1,1,0,1477,24,1118
1100,서울특별시,1107,중랑구,,중화제2동제5투,2236,1332,639,632,32,1,11,0,0,0,4,2,1,0,1322,10,904
1100,서울특별시,1107,중랑구,,중화제2동제6투,2305,1254,584,591,35,1,22,0,0,2,0,2,0,0,1237,17,1051
1100,서울특별시,1107,중랑구,묵제1동,소계,25776,19273,9153,9285,482,6,121,4,0,4,19,10,6,3,19093,180,6503
1100,서울특별시,1107,중랑구,,관내사전투표,7212,7211,3961,3012,149,3,29,1,0,1,3,4,4,1,7168,43,1
1100,서울특별시,1107,중랑구,,묵제1동제1투,2606,1732,722,927,45,0,11,1,0,0,1,0,0,0,1707,25,874
1100,서울특별시,1107,중랑구,,묵제1동제2투,2322,1426,651,696,38,0,16,0,0,1,1,2,0,1,1406,20,896
1100,서울특별시,1107,중랑구,,묵제1동제3투,2206,1664,602,998,41,0,5,1,0,1,2,0,0,0,1650,14,542
1100,서울특별시,1107,중랑구,,묵제1동제4투,2760,1829,813,920,57,1,16,0,0,0,4,0,2,0,1813,16,931
1100,서울특별시,1107,중랑구,,묵제1동제5투,3347,2105,925,1062,70,2,19,0,0,0,2,1,0,1,2082,23,1242
1100,서울특별시,1107,중랑구,,묵제1동제6투,2938,2030,892,1059,42,0,15,1,0,1,0,2,0,0,2012,18,908
1100,서울특별시,1107,중랑구,,묵제1동제7투,2385,1276,587,611,40,0,10,0,0,0,6,1,0,0,1255,21,1109
1100,서울특별시,1107,중랑구,묵제2동,소계,16512,12326,6309,5462,326,3,97,3,1,2,15,20,2,4,12244,82,4186
1100,서울특별시,1107,중랑구,,관내사전투표,5633,5633,3217,2204,139,2,32,1,1,0,3,9,1,1,5610,23,0
1100,서울특별시,1107,중랑구,,묵제2동제1투,2833,1874,849,943,42,0,14,0,0,0,1,3,0,2,1854,20,959
1100,서울특별시,1107,중랑구,,묵제2동제2투,2635,1538,695,740,55,0,15,2,0,1,5,6,0,0,1519,19,1097
1100,서울특별시,1107,중랑구,,묵제2동제3투,2660,1659,784,803,43,0,12,0,0,1,5,1,1,0,1650,9,1001
1100,서울특별시,1107,중랑구,,묵제2동제4투,2751,1622,764,772,47,1,24,0,0,0,1,1,0,1,1611,11,1129
1100,서울특별시,1107,중랑구,망우본동,소계,27120,19670,9324,9515,468,11,129,7,4,4,22,20,5,2,19511,159,7450
1100,서울특별시,1107,중랑구,,관내사전투표,7784,7784,4183,3364,146,5,25,2,2,2,4,10,2,0,7745,39,0
1100,서울특별시,1107,중랑구,,망우본동제1투,2408,1302,485,757,32,1,13,2,0,0,3,2,0,0,1295,7,1106
1100,서울특별시,1107,중랑구,,망우본동제2투,2847,1760,738,935,48,1,17,0,0,0,2,1,0,2,1744,16,1087
1100,서울특별시,1107,중랑구,,망우본동제3투,2378,1553,661,813,44,1,13,0,0,0,1,1,1,0,1535,18,825
1100,서울특별시,1107,중랑구,,망우본동제4투,1961,1244,497,683,36,0,12,0,1,0,3,0,0,0,1232,12,717
1100,서울특별시,1107,중랑구,,망우본동제5투,2164,1240,511,664,31,1,10,0,0,1,2,2,0,0,1222,18,924
1100,서울특별시,1107,중랑구,,망우본동제6투,2893,1731,769,869,44,1,18,0,0,0,3,4,1,0,1709,22,1162
1100,서울특별시,1107,중랑구,,망우본동제7투,3474,2155,983,1075,54,1,16,2,1,0,4,0,1,0,2137,18,1319
1100,서울특별시,1107,중랑구,,망우본동제8투,1211,901,497,355,33,0,5,1,0,1,0,0,0,0,892,9,310
1100,서울특별시,1107,중랑구,망우제3동,소계,15145,10959,5639,4794,258,11,112,1,1,3,19,14,4,9,10865,94,4186
1100,서울특별시,1107,중랑구,,관내사전투표,5639,5639,3194,2248,106,6,36,1,0,0,3,3,2,8,5607,32,0
1100,서울특별시,1107,중랑구,,망우제3동제1투,1918,988,440,486,33,1,11,0,0,0,4,3,0,0,978,10,930
1100,서울특별시,1107,중랑구,,망우제3동제2투,2685,1562,713,765,38,2,22,0,1,1,3,1,2,1,1549,13,1123
1100,서울특별시,1107,중랑구,,망우제3동제3투,2829,1637,795,737,47,1,26,0,0,2,4,4,0,0,1616,21,1192
1100,서울특별시,1107,중랑구,,망우제3동제4투,2074,1133,497,558,34,1,17,0,0,0,5,3,0,0,1115,18,941
1100,서울특별시,1107,중랑구,신내제1동,소계,27198,20680,9941,9873,529,12,113,4,1,7,13,13,7,4,20517,163,6518
1100,서울특별시,1107,중랑구,,관내사전투표,6289,6289,3466,2639,120,4,20,1,0,1,0,6,1,2,6260,29,0
1100,서울특별시,1107,중랑구,,신내제1동제1투,2258,1387,570,755,37,1,2,0,1,1,1,1,0,0,1369,18,871
1100,서울특별시,1107,중랑구,,신내제1동제2투,1979,1519,621,824,42,0,10,1,0,1,0,1,1,0,1501,18,460
1100,서울특별시,1107,중랑구,,신내제1동제3투,2050,1352,566,721,38,0,12,2,0,0,1,0,0,1,1341,11,698
1100,서울특별시,1107,중랑구,,신내제1동제4투,3255,2137,1104,938,57,2,10,0,0,0,2,2,1,0,2116,21,1118
1100,서울특별시,1107,중랑구,,신내제1동제5투,2212,1510,610,822,40,2,13,0,0,1,0,1,0,1,1490,20,702
1100,서울특별시,1107,중랑구,,신내제1동제6투,1710,1063,426,583,30,0,10,0,0,0,2,0,1,0,1052,11,647
1100,서울특별시,1107,중랑구,,신내제1동제7투,2111,1506,601,838,49,0,7,0,0,0,1,1,1,0,1498,8,605
1100,서울특별시,1107,중랑구,,신내제1동제8투,2943,2165,1092,986,52,1,17,0,0,2,1,0,1,0,2152,13,778
1100,서울특별시,1107,중랑구,,신내제1동제9투,2391,1752,885,767,64,2,12,0,0,1,5,1,1,0,1738,14,639
1100,서울특별시,1107,중랑구,신내제2동,소계,20786,17179,8576,7801,489,7,90,3,1,6,20,20,4,6,17023,156,3607
1100,서울특별시,1107,중랑구,,관내사전투표,9181,9179,5035,3792,245,4,37,2,0,1,4,11,1,2,9134,45,2
1100,서울특별시,1107,중랑구,,신내제2동제1투,1927,1252,553,616,47,2,8,0,0,0,0,1,0,0,1227,25,675
1100,서울특별시,1107,중랑구,,신내제2동제2투,2519,1876,913,857,67,0,12,0,0,1,1,1,1,0,1853,23,643
1100,서울특별시,1107,중랑구,,신내제2동제3투,2597,1864,752,1013,59,0,12,0,0,3,3,2,1,0,1845,19,733
1100,서울특별시,1107,중랑구,,신내제2동제4투,2438,1685,779,824,40,0,11,0,0,1,5,2,0,1,1663,22,753
1100,서울특별시,1107,중랑구,,신내제2동제5투,2124,1323,544,699,31,1,10,1,1,0,7,3,1,3,1301,22,801
1100,서울특별시,1107,중랑구,잘못 투입·구분된 투표지,,0,2,1,1,0,0,0,0,0,0,0,0,0,0,2,0,-2
1100,서울특별시,1108,성북구,합계,,375880,292187,142702,135044,8952,169,1632,99,36,89,202,278,69,87,289359,2828,83693
1100,서울특별시,1108,성북구,거소·선상투표,,517,492,197,206,11,2,8,1,2,0,0,0,2,1,430,62,25
1100,서울특별시,1108,성북구,관외사전투표,,38840,38834,20066,16561,1351,29,286,21,5,10,9,74,9,11,38432,402,6
1100,서울특별시,1108,성북구,재외투표,,3191,2344,1366,697,76,1,14,0,0,0,1,2,0,0,2157,187,847
1100,서울특별시,1108,성북구,성북동,소계,13366,10046,4788,4713,369,7,63,7,3,5,9,6,1,2,9973,73,3320
1100,서울특별시,1108,성북구,,관내사전투표,5013,5012,2761,2019,177,0,20,2,2,0,1,4,0,1,4987,25,1
1100,서울특별시,1108,성북구,,성북동제1투,2379,1501,649,726,74,2,18,3,0,3,2,1,0,0,1478,23,878
1100,서울특별시,1108,성북구,,성북동제2투,2290,1245,486,695,42,1,6,0,1,2,2,1,1,0,1237,8,1045
1100,서울특별시,1108,성북구,,성북동제3투,1643,1035,352,643,19,1,9,1,0,0,2,0,0,1,1028,7,608
1100,서울특별시,1108,성북구,,성북동제4투,2041,1253,540,630,57,3,10,1,0,0,2,0,0,0,1243,10,788
1100,서울특별시,1108,성북구,삼선동,소계,20789,15894,7989,7025,601,10,81,1,1,10,11,12,4,5,15750,144,4895
1100,서울특별시,1108,성북구,,관내사전투표,8089,8088,4477,3183,335,3,30,0,0,3,6,5,2,1,8045,43,1
1100,서울특별시,1108,성북구,,삼선동제1투,3055,1748,706,926,67,2,12,1,0,2,0,2,0,1,1719,29,1307
1100,서울특별시,1108,성북구,,삼선동제2투,2208,1359,643,633,48,1,9,0,0,0,2,2,1,1,1340,19,849
1100,서울특별시,1108,성북구,,삼선동제3투,2059,1530,728,736,45,1,6,0,1,2,1,0,0,0,1520,10,529
1100,서울특별시,1108,성북구,,삼선동제4투,2846,1793,800,906,49,1,15,0,0,2,1,0,1,1,1776,17,1053
1100,서울특별시,1108,성북구,,삼선동제5투,2532,1376,635,641,57,2,9,0,0,1,1,3,0,1,1350,26,1156
1100,서울특별시,1108,성북구,동선동,소계,12067,8614,4304,3750,380,8,54,3,0,1,2,9,1,4,8516,98,3453
1100,서울특별시,1108,성북구,,관내사전투표,3752,3752,2163,1390,156,1,14,0,0,0,0,4,0,2,3730,22,0
1100,서울특별시,1108,성북구,,동선동제1투,1507,776,325,386,39,4,3,2,0,0,0,2,0,0,761,15,731
1100,서울특별시,1108,성북구,,동선동제2투,2160,1239,600,545,65,0,10,1,0,1,0,1,1,1,1225,14,921
1100,서울특별시,1108,성북구,,동선동제3투,1936,1132,493,562,44,3,11,0,0,0,1,1,0,1,1116,16,804
1100,서울특별시,1108,성북구,,동선동제4투,2712,1715,723,867,76,0,16,0,0,0,1,1,0,0,1684,31,997
1100,서울특별시,1108,성북구,돈암제1동,소계,12170,9679,4525,4679,318,4,34,3,1,1,12,13,1,5,9596,83,2491
1100,서울특별시,1108,성북구,,관내사전투표,4326,4326,2248,1916,124,1,8,1,0,0,0,5,0,2,4305,21,0
1100,서울특별시,1108,성북구,,돈암제1동제1투,1765,1197,512,616,37,1,7,1,0,1,1,4,0,1,1181,16,568
1100,서울특별시,1108,성북구,,돈암제1동제2투,1745,1172,468,642,38,1,5,0,0,0,6,0,0,0,1160,12,573
1100,서울특별시,1108,성북구,,돈암제1동제3투,2554,1844,771,971,75,0,2,0,0,0,2,4,1,0,1826,18,710
1100,서울특별시,1108,성북구,,돈암제1동제4투,1780,1140,526,534,44,1,12,1,1,0,3,0,0,2,1124,16,640
1100,서울특별시,1108,성북구,돈암제2동,소계,17237,13623,6249,6766,415,2,58,2,0,1,10,8,4,1,13516,107,3614
1100,서울특별시,1108,성북구,,관내사전투표,5642,5642,3087,2370,142,1,11,1,0,0,2,1,3,1,5619,23,0
1100,서울특별시,1108,성북구,,돈암제2동제1투,2696,1738,660,965,81,0,12,1,0,0,1,1,0,0,1721,17,958
1100,서울특별시,1108,성북구,,돈암제2동제2투,2139,1503,561,861,55,0,7,0,0,1,2,0,0,0,1487,16,636
1100,서울특별시,1108,성북구,,돈암제2동제3투,2331,1615,787,751,49,1,7,0,0,0,1,2,1,0,1599,16,716
1100,서울특별시,1108,성북구,,돈암제2동제4투,2389,1735,608,1056,44,0,4,0,0,0,4,2,0,0,1718,17,654
1100,서울특별시,1108,성북구,,돈암제2동제5투,2040,1390,546,763,44,0,17,0,0,0,0,2,0,0,1372,18,650
1100,서울특별시,1108,성북구,안암동,소계,11838,8717,3781,4345,378,11,42,4,1,1,14,5,1,5,8588,129,3121
1100,서울특별시,1108,성북구,,관내사전투표,3670,3670,1834,1619,160,5,13,1,1,0,2,1,1,2,3639,31,0
1100,서울특별시,1108,성북구,,안암동제1투,1610,891,375,439,42,0,13,1,0,0,1,1,0,0,872,19,719
1100,서울특별시,1108,성북구,,안암동제2투,1997,1265,402,763,64,3,5,0,0,0,0,2,0,1,1240,25,732
1100,서울특별시,1108,성북구,,안암동제3투,2652,1634,678,834,75,1,6,1,0,1,8,1,0,2,1607,27,1018
1100,서울특별시,1108,성북구,,안암동제4투,1909,1257,492,690,37,2,5,1,0,0,3,0,0,0,1230,27,652
1100,서울특별시,1108,성북구,보문동,소계,11878,8510,4161,3916,272,5,41,1,0,4,5,7,1,3,8416,94,3368
1100,서울특별시,1108,성북구,,관내사전투표,4040,4040,2225,1666,99,2,15,0,0,1,0,2,0,1,4011,29,0
1100,서울특별시,1108,성북구,,보문동제1투,2825,1458,635,740,45,1,9,0,0,2,3,1,0,1,1437,21,1367
1100,서울특별시,1108,성북구,,보문동제2투,2059,1210,520,597,60,1,9,1,0,1,2,2,1,0,1194,16,849
1100,서울특별시,1108,성북구,,보문동제3투,2954,1802,781,913,68,1,8,0,0,0,0,2,0,1,1774,28,1152
1100,서울특별시,1108,성북구,정릉제1동,소계,14023,10973,5321,5194,295,5,43,1,3,0,3,3,2,3,10873,100,3050
1100,서울특별시,1108,성북구,,관내사전투표,5143,5143,2816,2174,102,3,17,0,0,0,2,1,0,1,5116,27,0
1100,서울특별시,1108,성북구,,정릉제1동제1투,2121,1321,540,705,49,0,9,0,1,0,0,0,0,0,1304,17,800
1100,서울특별시,1108,성북구,,정릉제1동제2투,2341,1430,600,749,48,0,7,0,2,0,0,0,0,2,1408,22,911
1100,서울특별시,1108,성북구,,정릉제1동제3투,2355,1610,720,809,55,0,6,1,0,0,0,2,1,0,1594,16,745
1100,서울특별시,1108,성북구,,정릉제1동제4투,2063,1469,645,757,41,2,4,0,0,0,1,0,1,0,1451,18,594
1100,서울특별시,1108,성북구,정릉제2동,소계,17535,12994,6289,6126,341,13,83,3,1,4,11,10,3,4,12888,106,4541
1100,서울특별시,1108,성북구,,관내사전투표,6415,6415,3481,2723,123,7,28,2,0,2,3,4,1,2,6376,39,0
1100,서울특별시,1108,성북구,,정릉제2동제1투,2602,1701,662,941,66,1,14,0,0,0,0,1,0,0,1685,16,901
1100,서울특별시,1108,성북구,,정릉제2동제2투,2962,1645,747,807,49,1,13,0,1,1,2,1,1,1,1624,21,1317
1100,서울특별시,1108,성북구,,정릉제2동제3투,2634,1456,645,728,42,2,13,0,0,0,3,1,1,0,1435,21,1178
1100,서울특별시,1108,성북구,,정릉제2동제4투,2922,1777,754,927,61,2,15,1,0,1,3,3,0,1,1768,9,1145
1100,서울특별시,1108,성북구,정릉제3동,소계,10854,7451,3397,3671,219,5,61,2,3,0,6,3,3,2,7372,79,3403
1100,서울특별시,1108,성북구,,관내사전투표,3353,3353,1742,1467,89,2,22,0,2,0,1,1,1,0,3327,26,0
1100,서울특별시,1108,성북구,,정릉제3동제1투,1995,1036,439,530,38,2,8,1,1,0,1,0,0,1,1021,15,959
1100,서울특별시,1108,성북구,,정릉제3동제2투,896,464,165,265,14,0,6,1,0,0,3,0,1,1,456,8,432
1100,서울특별시,1108,성북구,,정릉제3동제3투,2779,1581,668,825,49,1,14,0,0,0,0,1,1,0,1559,22,1198
1100,서울특별시,1108,성북구,,정릉제3동제4투,1831,1017,383,584,29,0,11,0,0,0,1,1,0,0,1009,8,814
1100,서울특별시,1108,성북구,정릉제4동,소계,19605,14720,7269,6806,400,8,83,9,2,6,14,15,5,6,14623,97,4885
1100,서울특별시,1108,성북구,,관내사전투표,6823,6821,3775,2835,139,2,21,5,0,0,4,8,3,2,6794,27,2
1100,서울특별시,1108,성북구,,정릉제4동제1투,2259,1469,600,785,52,0,13,0,1,1,5,2,0,1,1460,9,790
1100,서울특별시,1108,성북구,,정릉제4동제2투,3094,1617,764,754,56,3,21,1,0,1,0,0,0,1,1601,16,1477
1100,서울특별시,1108,성북구,,정릉제4동제3투,2504,1450,601,761,59,1,9,1,1,0,3,1,2,0,1439,11,1054
1100,서울특별시,1108,성북구,,정릉제4동제4투,1789,1140,490,601,29,0,3,1,0,4,1,1,0,0,1130,10,649
1100,서울특별시,1108,성북구,,정릉제4동제5투,3136,2223,1039,1070,65,2,16,1,0,0,1,3,0,2,2199,24,913
1100,서울특별시,1108,성북구,길음제1동,소계,24527,19612,9387,9428,551,10,71,6,4,5,10,15,5,3,19495,117,4915
1100,서울특별시,1108,성북구,,관내사전투표,7796,7796,4394,3184,160,3,20,2,0,0,3,8,1,0,7775,21,0
1100,서울특별시,1108,성북구,,길음제1동제1투,2444,1782,806,890,60,1,6,1,0,1,4,1,2,0,1772,10,662
1100,서울특별시,1108,성북구,,길음제1동제2투,2795,1987,887,998,70,2,4,1,0,2,1,1,0,0,1966,21,808
1100,서울특별시,1108,성북구,,길음제1동제3투,2645,1579,668,828,52,0,11,1,1,1,1,1,2,1,1567,12,1066
1100,서울특별시,1108,성북구,,길음제1동제4투,2627,1807,673,1029,66,1,11,0,2,1,1,1,0,1,1786,21,820
1100,서울특별시,1108,성북구,,길음제1동제5투,2505,1822,779,955,66,1,10,1,0,0,0,2,0,1,1815,7,683
1100,서울특별시,1108,성북구,,길음제1동제6투,1751,1332,565,707,41,2,5,0,0,0,0,0,0,0,1320,12,419
1100,서울특별시,1108,성북구,,길음제1동제7투,1964,1507,615,837,36,0,4,0,1,0,0,1,0,0,1494,13,457
1100,서울특별시,1108,성북구,길음제2동,소계,13021,10075,4571,5071,282,2,51,1,1,5,10,8,3,1,10006,69,2946
1100,서울특별시,1108,성북구,,관내사전투표,4137,4137,2148,1860,92,0,12,0,1,1,0,3,1,1,4119,18,0
1100,서울특별시,1108,성북구,,길음제2동제1투,1023,483,192,262,10,0,5,0,0,2,2,1,0,0,474,9,540
1100,서울특별시,1108,성북구,,길음제2동제2투,3249,2385,962,1298,88,2,14,0,0,1,3,1,2,0,2371,14,864
1100,서울특별시,1108,성북구,,길음제2동제3투,2691,1880,796,987,63,0,11,0,0,0,5,1,0,0,1863,17,811
1100,서울특별시,1108,성북구,,길음제2동제4투,1921,1190,473,664,29,0,9,1,0,1,0,2,0,0,1179,11,731
1100,서울특별시,1108,성북구,종암동,소계,29977,22874,11159,10654,668,9,99,5,1,11,15,14,7,10,22652,222,7103
1100,서울특별시,1108,성북구,,관내사전투표,9020,9018,5060,3636,214,5,25,2,0,0,1,8,3,1,8955,63,2
1100,서울특별시,1108,성북구,,종암동제1투,2813,1889,841,939,73,0,10,0,1,0,1,1,1,2,1869,20,924
1100,서울특별시,1108,성북구,,종암동제2투,2981,2022,914,1011,67,0,11,0,0,0,2,0,0,1,2006,16,959
1100,서울특별시,1108,성북구,,종암동제3투,2675,1791,761,944,53,1,5,0,0,1,0,1,0,1,1767,24,884
1100,서울특별시,1108,성북구,,종암동제4투,2949,1997,789,1090,69,1,11,1,0,1,1,1,0,1,1965,32,952
1100,서울특별시,1108,성북구,,종암동제5투,1898,1012,446,526,17,0,3,0,0,2,2,2,0,0,998,14,886
1100,서울특별시,1108,성북구,,종암동제6투,2626,1931,872,959,62,1,13,1,0,4,0,0,2,4,1918,13,695
1100,서울특별시,1108,성북구,,종암동제7투,2708,1621,747,781,51,1,15,1,0,0,2,1,0,0,1599,22,1087
1100,서울특별시,1108,성북구,,종암동제8투,2307,1593,729,768,62,0,6,0,0,3,6,0,1,0,1575,18,714
1100,서울특별시,1108,성북구,월곡제1동,소계,20405,15636,8305,6648,408,8,82,4,2,10,14,10,2,3,15496,140,4769
1100,서울특별시,1108,성북구,,관내사전투표,6957,6957,4127,2589,160,2,26,0,0,6,2,5,1,1,6919,38,0
1100,서울특별시,1108,성북구,,월곡제1동제1투,2126,1300,572,669,28,1,6,0,1,2,0,1,0,0,1280,20,826
1100,서울특별시,1108,성북구,,월곡제1동제2투,1670,939,464,426,28,0,6,1,1,0,0,1,0,1,928,11,731
1100,서울특별시,1108,성북구,,월곡제1동제3투,2500,1501,731,690,44,0,19,0,0,1,2,1,0,1,1489,12,999
1100,서울특별시,1108,성북구,,월곡제1동제4투,2050,1416,674,677,31,4,8,2,0,0,0,1,1,0,1398,18,634
1100,서울특별시,1108,성북구,,월곡제1동제5투,2364,1596,801,705,51,1,11,1,0,0,4,1,0,0,1575,21,768
1100,서울특별시,1108,성북구,,월곡제1동제6투,2738,1927,936,892,66,0,6,0,0,1,6,0,0,0,1907,20,811
1100,서울특별시,1108,성북구,월곡제2동,소계,15741,11808,5837,5388,371,9,64,7,1,2,4,8,0,4,11695,113,3933
1100,서울특별시,1108,성북구,,관내사전투표,5107,5107,2824,2083,134,5,25,5,0,0,0,5,0,0,5081,26,0
1100,서울특별시,1108,성북구,,월곡제2동제1투,2527,1366,644,625,56,1,10,1,0,0,1,1,0,2,1341,25,1161
1100,서울특별시,1108,성북구,,월곡제2동제2투,2334,1477,653,752,46,0,7,0,0,0,1,1,0,0,1460,17,857
1100,서울특별시,1108,성북구,,월곡제2동제3투,2725,1733,788,841,64,0,14,0,0,0,0,1,0,1,1709,24,992
1100,서울특별시,1108,성북구,,월곡제2동제4투,3048,2125,928,1087,71,3,8,1,1,2,2,0,0,1,2104,21,923
1100,서울특별시,1108,성북구,장위제1동,소계,18530,13157,6710,5891,311,6,82,10,2,3,10,13,6,6,13050,107,5373
1100,서울특별시,1108,성북구,,관내사전투표,5433,5433,3135,2125,107,3,23,5,1,2,0,4,3,2,5410,23,0
1100,서울특별시,1108,성북구,,장위제1동제1투,2269,1273,602,600,37,2,15,2,0,0,1,1,1,1,1262,11,996
1100,서울특별시,1108,성북구,,장위제1동제2투,2738,1671,784,818,35,0,12,1,1,0,2,2,1,1,1657,14,1067
1100,서울특별시,1108,성북구,,장위제1동제3투,2297,1143,541,548,26,0,12,1,0,0,0,2,1,0,1131,12,1154
1100,서울특별시,1108,성북구,,장위제1동제4투,1508,815,360,404,26,0,5,1,0,0,0,0,0,1,797,18,693
1100,서울특별시,1108,성북구,,장위제1동제5투,1854,948,444,449,24,0,7,0,0,0,5,4,0,0,933,15,906
1100,서울특별시,1108,성북구,,장위제1동제6투,2431,1874,844,947,56,1,8,0,0,1,2,0,0,1,1860,14,557
1100,서울특별시,1108,성북구,장위제2동,소계,11319,7986,3852,3819,176,4,63,0,0,1,8,6,0,1,7930,56,3333
1100,서울특별시,1108,성북구,,관내사전투표,3274,3274,1784,1385,73,2,10,0,0,0,0,2,0,0,3256,18,0
1100,서울특별시,1108,성북구,,장위제2동제1투,2110,1163,470,634,31,1,13,0,0,1,2,0,0,1,1153,10,947
1100,서울특별시,1108,성북구,,장위제2동제2투,1968,1291,590,649,19,0,16,0,0,0,1,3,0,0,1278,13,677
1100,서울특별시,1108,성북구,,장위제2동제3투,1740,1008,417,548,24,1,9,0,0,0,1,1,0,0,1001,7,732
1100,서울특별시,1108,성북구,,장위제2동제4투,2227,1250,591,603,29,0,15,0,0,0,4,0,0,0,1242,8,977
1100,서울특별시,1108,성북구,장위제3동,소계,11814,9181,4145,4638,258,1,37,4,0,4,8,12,1,1,9109,72,2633
1100,서울특별시,1108,성북구,,관내사전투표,3382,3382,1753,1506,88,0,9,1,0,2,0,5,0,0,3364,18,0
1100,서울특별시,1108,성북구,,장위제3동제1투,2651,1504,576,848,45,0,11,1,0,0,4,2,0,0,1487,17,1147
1100,서울특별시,1108,성북구,,장위제3동제2투,2910,2201,909,1196,59,0,12,0,0,1,2,2,1,0,2182,19,709
1100,서울특별시,1108,성북구,,장위제3동제3투,2871,2094,907,1088,66,1,5,2,0,1,2,3,0,1,2076,18,777
1100,서울특별시,1108,성북구,석관동,소계,26636,18965,9034,9050,501,10,132,4,3,5,16,25,8,6,18794,171,7671
1100,서울특별시,1108,성북구,,관내사전투표,5943,5942,3343,2411,118,4,33,1,0,1,0,5,6,1,5923,19,1
1100,서울특별시,1108,성북구,,석관동제1투,2895,1552,725,746,38,2,17,1,0,1,2,4,0,0,1536,16,1343
1100,서울특별시,1108,성북구,,석관동제2투,2451,1501,701,731,42,0,6,0,0,2,0,2,0,1,1485,16,950
1100,서울특별시,1108,성북구,,석관동제3투,3135,1827,786,944,36,0,23,1,2,0,4,5,1,3,1805,22,1308
1100,서울특별시,1108,성북구,,석관동제4투,2683,1846,779,970,63,1,8,0,0,0,1,4,1,0,1827,19,837
1100,서울특별시,1108,성북구,,석관동제5투,3054,2229,889,1227,71,1,13,0,0,1,4,0,0,0,2206,23,825
1100,서울특별시,1108,성북구,,석관동제6투,2240,1411,657,680,39,1,7,0,1,0,0,3,0,1,1389,22,829
1100,서울특별시,1108,성북구,,석관동제7투,2630,1655,736,822,55,1,14,1,0,0,5,0,0,0,1634,21,975
1100,서울특별시,1108,성북구,,석관동제8투,1605,1002,418,519,39,0,11,0,0,0,0,2,0,0,989,13,603
1100,서울특별시,1108,성북구,잘못 투입·구분된 투표지,,0,2,0,2,0,0,0,0,0,0,0,0,0,0,2,0,-2
1100,서울특별시,1109,강북구,합계,,268974,199448,103333,86540,5245,135,1518,69,29,52,173,249,61,73,197477,1971,69526
1100,서울특별시,1109,강북구,거소·선상투표,,461,426,194,172,10,0,7,0,0,0,0,0,0,0,383,43,35
1100,서울특별시,1109,강북구,관외사전투표,,24369,24366,13516,9501,737,22,225,18,6,6,7,73,6,17,24134,232,3
1100,서울특별시,1109,강북구,재외투표,,1570,1142,687,306,36,0,10,1,0,0,0,0,0,0,1040,102,428
1100,서울특별시,1109,강북구,삼양동,소계,18693,13033,6985,5457,323,10,100,7,1,6,12,11,4,0,12916,117,5660
1100,서울특별시,1109,강북구,,관내사전투표,4953,4953,2937,1853,96,8,23,3,0,1,2,6,0,0,4929,24,0
1100,서울특별시,1109,강북구,,삼양동제1투,968,409,189,198,9,0,4,0,0,0,1,0,0,0,401,8,559
1100,서울특별시,1109,강북구,,삼양동제2투,1836,1064,528,499,22,0,7,0,0,1,2,0,0,0,1059,5,772
1100,서울특별시,1109,강북구,,삼양동제3투,1691,872,459,368,22,0,8,0,0,0,1,1,0,0,859,13,819
1100,서울특별시,1109,강북구,,삼양동제4투,2327,1377,729,558,49,0,17,0,1,2,2,2,1,0,1361,16,950
1100,서울특별시,1109,강북구,,삼양동제5투,2447,1606,797,722,46,1,12,0,0,0,1,2,0,0,1581,25,841
1100,서울특별시,1109,강북구,,삼양동제6투,1444,736,388,302,23,1,11,1,0,2,1,0,1,0,730,6,708
1100,서울특별시,1109,강북구,,삼양동제7투,1067,591,257,309,12,0,6,2,0,0,0,0,0,0,586,5,476
1100,서울특별시,1109,강북구,,삼양동제8투,1960,1425,701,648,44,0,12,1,0,0,2,0,2,0,1410,15,535
1100,서울특별시,1109,강북구,미아동,소계,19342,14122,7463,5920,417,10,106,2,1,3,15,19,9,5,13970,152,5220
1100,서울특별시,1109,강북구,,관내사전투표,6734,6734,4025,2444,167,3,30,1,0,1,4,9,3,2,6689,45,0
1100,서울특별시,1109,강북구,,미아동제1투,2323,1301,578,634,44,1,17,1,1,0,3,0,0,1,1280,21,1022
1100,서울특별시,1109,강북구,,미아동제2투,1211,774,405,325,26,0,7,0,0,0,0,1,1,1,766,8,437
1100,서울특별시,1109,강북구,,미아동제3투,2987,1798,803,886,61,2,16,0,0,0,2,2,2,0,1774,24,1189
1100,서울특별시,1109,강북구,,미아동제4투,2188,1298,632,594,35,0,8,0,0,1,2,0,2,0,1274,24,890
1100,서울특별시,1109,강북구,,미아동제5투,1924,1164,516,555,46,2,18,0,0,1,1,2,1,1,1143,21,760
1100,서울특별시,1109,강북구,,미아동제6투,1975,1053,504,482,38,2,10,0,0,0,3,5,0,0,1044,9,922
1100,서울특별시,1109,강북구,송중동,소계,22194,15558,7815,7031,408,12,116,3,2,7,12,20,4,6,15436,122,6636
1100,서울특별시,1109,강북구,,관내사전투표,5539,5538,3177,2179,123,6,19,0,0,0,0,5,2,1,5512,26,1
1100,서울특별시,1109,강북구,,송중동제1투,1940,967,447,474,25,0,8,0,0,1,0,2,0,1,958,9,973
1100,서울특별시,1109,강북구,,송중동제2투,1956,1043,460,526,28,1,13,0,0,0,1,3,0,0,1032,11,913
1100,서울특별시,1109,강북구,,송중동제3투,2410,1582,716,775,53,1,16,1,2,0,3,1,1,0,1569,13,828
1100,서울특별시,1109,강북구,,송중동제4투,2246,1379,635,680,31,1,9,1,0,2,0,1,1,0,1361,18,867
1100,서울특별시,1109,강북구,,송중동제5투,2010,1479,645,767,52,0,5,0,0,0,2,0,0,0,1471,8,531
1100,서울특별시,1109,강북구,,송중동제6투,1854,1106,519,518,36,1,14,1,0,1,1,3,0,1,1095,11,748
1100,서울특별시,1109,강북구,,송중동제7투,2383,1442,679,681,40,1,17,0,0,2,3,4,0,2,1429,13,941
1100,서울특별시,1109,강북구,,송중동제8투,1856,1022,537,431,20,1,15,0,0,1,2,1,0,1,1009,13,834
1100,서울특별시,1109,강북구,송천동,소계,21430,15146,7854,6639,381,8,107,5,3,3,11,19,2,3,15035,111,6284
1100,서울특별시,1109,강북구,,관내사전투표,5906,5906,3458,2275,103,4,22,1,1,2,1,10,1,2,5880,26,0
1100,서울특별시,1109,강북구,,송천동제1투,2059,998,482,460,37,2,8,0,0,0,0,3,0,0,992,6,1061
1100,서울특별시,1109,강북구,,송천동제2투,1643,972,478,447,23,0,17,0,0,0,3,0,0,0,968,4,671
1100,서울특별시,1109,강북구,,송천동제3투,1919,1208,521,618,42,0,11,0,0,0,2,0,1,0,1195,13,711
1100,서울특별시,1109,강북구,,송천동제4투,1884,1311,589,650,48,0,11,0,0,0,1,0,0,0,1299,12,573
1100,서울특별시,1109,강북구,,송천동제5투,2110,1257,597,607,29,1,10,0,0,0,2,2,0,0,1248,9,853
1100,서울특별시,1109,강북구,,송천동제6투,1828,1041,515,483,24,0,4,2,0,0,2,2,0,0,1032,9,787
1100,서울특별시,1109,강북구,,송천동제7투,2225,1363,688,591,47,0,15,1,0,0,0,1,0,1,1344,19,862
1100,서울특별시,1109,강북구,,송천동제8투,1856,1090,526,508,28,1,9,1,2,1,0,1,0,0,1077,13,766
1100,서울특별시,1109,강북구,삼각산동,소계,22797,18186,9355,8013,551,12,77,1,2,4,13,13,5,5,18051,135,4611
1100,서울특별시,1109,강북구,,관내사전투표,7292,7291,4229,2798,207,4,18,0,2,0,2,5,1,4,7270,21,1
1100,서울특별시,1109,강북구,,삼각산동제1투,1778,1154,543,551,35,0,3,0,0,0,0,2,1,1,1136,18,624
1100,서울특별시,1109,강북구,,삼각산동제2투,1633,875,429,408,14,1,4,0,0,0,1,0,3,0,860,15,758
1100,서울특별시,1109,강북구,,삼각산동제3투,2261,1645,804,763,46,2,7,0,0,3,5,0,0,0,1630,15,616
1100,서울특별시,1109,강북구,,삼각산동제4투,1899,1471,676,702,62,2,7,0,0,0,2,2,0,0,1453,18,428
1100,서울특별시,1109,강북구,,삼각산동제5투,2501,1960,978,875,72,2,12,0,0,1,1,2,0,0,1943,17,541
1100,서울특별시,1109,강북구,,삼각산동제6투,1935,1268,512,695,42,0,7,0,0,0,0,0,0,0,1256,12,667
1100,서울특별시,1109,강북구,,삼각산동제7투,1584,1118,516,551,30,1,8,1,0,0,2,1,0,0,1110,8,466
1100,서울특별시,1109,강북구,,삼각산동제8투,1914,1404,668,670,43,0,11,0,0,0,0,1,0,0,1393,11,510
1100,서울특별시,1109,강북구,우이동,소계,16671,11950,5876,5525,298,5,95,8,2,2,7,11,4,2,11835,115,4721
1100,서울특별시,1109,강북구,,관내사전투표,5075,5075,2831,2072,112,3,16,3,0,1,1,7,0,1,5047,28,0
1100,서울특별시,1109,강북구,,우이동제1투,1754,896,376,480,20,1,9,0,0,0,1,0,0,1,888,8,858
1100,서울특별시,1109,강북구,,우이동제2투,2240,1250,590,586,35,1,17,0,1,0,1,1,1,0,1233,17,990
1100,서울특별시,1109,강북구,,우이동제3투,2188,1205,529,586,41,0,18,4,0,1,1,1,2,0,1183,22,983
1100,서울특별시,1109,강북구,,우이동제4투,2856,1789,832,873,40,0,20,0,0,0,1,1,0,0,1767,22,1067
1100,서울특별시,1109,강북구,,우이동제5투,2558,1735,718,928,50,0,15,1,1,0,2,1,1,0,1717,18,823
1100,서울특별시,1109,강북구,인수동,소계,23853,16622,8537,7386,362,9,127,6,1,4,14,18,4,4,16472,150,7231
1100,서울특별시,1109,강북구,,관내사전투표,7669,7667,4374,3087,110,6,30,2,0,1,1,12,1,2,7626,41,2
1100,서울특별시,1109,강북구,,인수동제1투,1729,855,391,416,24,0,7,1,0,1,2,0,1,0,843,12,874
1100,서울특별시,1109,강북구,,인수동제2투,1472,797,320,438,24,1,4,1,0,0,1,0,0,0,789,8,675
1100,서울특별시,1109,강북구,,인수동제3투,2009,1144,544,533,31,0,16,0,0,0,2,1,0,1,1128,16,865
1100,서울특별시,1109,강북구,,인수동제4투,1771,1127,494,575,31,0,12,1,0,0,0,2,1,1,1117,10,644
1100,서울특별시,1109,강북구,,인수동제5투,2011,1020,485,487,19,1,12,0,1,0,2,0,1,0,1008,12,991
1100,서울특별시,1109,강북구,,인수동제6투,2147,1199,558,574,36,0,19,0,0,1,1,1,0,0,1190,9,948
1100,서울특별시,1109,강북구,,인수동제7투,2659,1472,717,667,50,1,12,1,0,0,0,2,0,0,1450,22,1187
1100,서울특별시,1109,강북구,,인수동제8투,2386,1341,654,609,37,0,15,0,0,1,5,0,0,0,1321,20,1045
1100,서울특별시,1109,강북구,번1동,소계,15331,10314,5211,4616,250,5,80,2,3,1,20,11,2,1,10202,112,5017
1100,서울특별시,1109,강북구,,관내사전투표,4622,4622,2597,1863,105,1,17,0,1,0,3,5,1,0,4593,29,0
1100,서울특별시,1109,강북구,,번1동제1투,2326,1065,467,527,33,1,14,1,0,1,2,1,0,0,1047,18,1261
1100,서울특별시,1109,강북구,,번1동제2투,1939,1066,505,511,26,0,6,0,0,0,2,2,0,0,1052,14,873
1100,서울특별시,1109,강북구,,번1동제3투,2509,1309,589,651,32,2,15,0,0,0,5,1,0,0,1295,14,1200
1100,서울특별시,1109,강북구,,번1동제4투,2235,1261,616,562,35,1,19,1,1,0,4,0,0,0,1239,22,974
1100,서울특별시,1109,강북구,,번1동제5투,1700,991,437,502,19,0,9,0,1,0,4,2,1,1,976,15,709
1100,서울특별시,1109,강북구,번2동,소계,13125,9399,4907,4062,229,5,67,2,2,0,18,7,3,5,9307,92,3726
1100,서울특별시,1109,강북구,,관내사전투표,3943,3943,2260,1555,77,1,20,1,1,0,2,4,1,1,3923,20,0
1100,서울특별시,1109,강북구,,번2동제1투,1979,1257,553,644,34,1,9,0,0,0,1,0,1,0,1243,14,722
1100,서울특별시,1109,강북구,,번2동제2투,1412,796,377,373,21,2,9,0,1,0,1,0,0,1,785,11,616
1100,서울특별시,1109,강북구,,번2동제3투,2144,1210,594,544,39,0,7,0,0,0,8,1,0,1,1194,16,934
1100,서울특별시,1109,강북구,,번2동제4투,1782,1041,529,454,33,0,8,0,0,0,2,1,1,1,1029,12,741
1100,서울특별시,1109,강북구,,번2동제5투,1865,1152,594,492,25,1,14,1,0,0,4,1,0,1,1133,19,713
1100,서울특별시,1109,강북구,번3동,소계,13454,9839,4932,4487,240,10,54,1,2,4,11,6,4,5,9756,83,3615
1100,서울특별시,1109,강북구,,관내사전투표,4276,4274,2346,1792,94,2,11,1,0,1,3,2,0,0,4252,22,2
1100,서울특별시,1109,강북구,,번3동제1투,1436,712,332,346,11,1,11,0,0,2,1,0,1,1,706,6,724
1100,서울특별시,1109,강북구,,번3동제2투,1917,1258,585,614,37,0,7,0,1,0,2,2,0,0,1248,10,659
1100,서울특별시,1109,강북구,,번3동제3투,1463,798,366,392,18,1,4,0,1,0,2,1,0,0,785,13,665
1100,서울특별시,1109,강북구,,번3동제4투,2132,1375,647,644,44,5,12,0,0,0,2,0,2,2,1358,17,757
1100,서울특별시,1109,강북구,,번3동제5투,2230,1422,656,699,36,1,9,0,0,1,1,1,1,2,1407,15,808
1100,서울특별시,1109,강북구,수유1동,소계,17488,12051,6381,5082,319,5,100,0,3,5,14,11,6,6,11932,119,5437
1100,서울특별시,1109,강북구,,관내사전투표,5610,5610,3382,2042,114,1,23,0,1,1,2,5,4,3,5578,32,0
1100,서울특별시,1109,강북구,,수유1동제1투,2187,1093,499,528,27,1,15,0,0,1,4,1,0,0,1076,17,1094
1100,서울특별시,1109,강북구,,수유1동제2투,2112,1233,576,584,44,0,13,0,1,0,2,1,2,1,1224,9,879
1100,서울특별시,1109,강북구,,수유1동제3투,2218,1212,573,564,41,0,15,0,0,2,0,2,0,1,1198,14,1006
1100,서울특별시,1109,강북구,,수유1동제4투,2253,1234,579,573,42,2,18,0,0,0,0,1,0,0,1215,19,1019
1100,서울특별시,1109,강북구,,수유1동제5투,3108,1669,772,791,51,1,16,0,1,1,6,1,0,1,1641,28,1439
1100,서울특별시,1109,강북구,수유2동,소계,17561,12876,6299,6030,293,12,98,3,1,2,11,9,5,7,12770,106,4685
1100,서울특별시,1109,강북구,,관내사전투표,6528,6528,3548,2777,130,4,30,1,1,0,3,0,1,4,6499,29,0
1100,서울특별시,1109,강북구,,수유2동제1투,2065,1154,463,642,27,1,7,0,0,0,5,1,0,0,1146,8,911
1100,서울특별시,1109,강북구,,수유2동제2투,2801,1555,744,716,39,3,22,1,0,0,1,2,0,0,1528,27,1246
1100,서울특별시,1109,강북구,,수유2동제3투,2028,1435,504,860,42,1,6,0,0,1,0,2,3,2,1421,14,593
1100,서울특별시,1109,강북구,,수유2동제4투,1860,1008,473,483,23,2,10,1,0,0,2,1,1,1,997,11,852
1100,서울특별시,1109,강북구,,수유2동제5투,2279,1196,567,552,32,1,23,0,0,1,0,3,0,0,1179,17,1083
1100,서울특별시,1109,강북구,수유3동,소계,20635,14415,7319,6312,391,10,149,10,0,5,8,21,3,7,14235,180,6220
1100,서울특별시,1109,강북구,,관내사전투표,6461,6461,3608,2517,194,4,61,4,0,1,1,9,0,1,6400,61,0
1100,서울특별시,1109,강북구,,수유3동제1투,1461,730,309,378,20,1,7,0,0,0,1,0,1,0,717,13,731
1100,서울특별시,1109,강북구,,수유3동제2투,2645,1569,740,725,45,1,29,0,0,1,0,5,0,1,1547,22,1076
1100,서울특별시,1109,강북구,,수유3동제3투,2307,1151,513,576,27,0,12,2,0,1,0,0,0,1,1132,19,1156
1100,서울특별시,1109,강북구,,수유3동제4투,2388,1496,716,707,26,0,11,1,0,1,3,1,0,2,1468,28,892
1100,서울특별시,1109,강북구,,수유3동제5투,2725,1401,660,655,39,3,18,1,0,1,1,2,1,1,1382,19,1324
1100,서울특별시,1109,강북구,,수유3동제6투,2648,1607,773,754,40,1,11,2,0,0,2,4,1,1,1589,18,1041
1100,서울특별시,1109,강북구,잘못 투입·구분된 투표지,,0,3,2,1,0,0,0,0,0,0,0,0,0,0,3,0,-3
1100,서울특별시,1110,도봉구,합계,,281812,216036,106546,99780,5605,127,1457,53,46,48,136,239,41,77,214155,1881,65776
1100,서울특별시,1110,도봉구,거소·선상투표,,498,459,197,194,7,2,10,0,0,0,0,0,0,0,410,49,39
1100,서울특별시,1110,도봉구,관외사전투표,,26295,26281,14006,10932,739,16,224,11,5,6,11,83,3,15,26051,230,14
1100,서울특별시,1110,도봉구,재외투표,,1698,1229,706,384,38,1,3,0,1,0,0,0,0,0,1133,96,469
1100,서울특별시,1110,도봉구,쌍문1동,소계,16362,11605,5938,5130,305,9,83,2,4,3,11,16,3,2,11506,99,4757
1100,서울특별시,1110,도봉구,,관내사전투표,4503,4503,2622,1736,96,4,10,1,1,1,3,7,2,1,4484,19,0
1100,서울특별시,1110,도봉구,,쌍문1동제1투,2327,1219,549,603,37,0,11,1,0,0,5,2,0,0,1208,11,1108
1100,서울특별시,1110,도봉구,,쌍문1동제2투,2295,1279,620,575,43,2,19,0,0,0,1,1,0,0,1261,18,1016
1100,서울특별시,1110,도봉구,,쌍문1동제3투,1895,1220,529,625,37,2,4,0,1,1,0,6,0,0,1205,15,675
1100,서울특별시,1110,도봉구,,쌍문1동제4투,3023,1933,941,907,46,1,21,0,0,1,1,0,0,0,1918,15,1090
1100,서울특별시,1110,도봉구,,쌍문1동제5투,2319,1451,677,684,46,0,18,0,2,0,1,0,1,1,1430,21,868
1100,서울특별시,1110,도봉구,쌍문2동,소계,15533,11271,5575,5187,291,8,93,1,1,3,3,8,2,3,11175,96,4262
1100,서울특별시,1110,도봉구,,관내사전투표,4586,4586,2613,1822,94,1,22,1,1,1,0,6,0,1,4562,24,0
1100,서울특별시,1110,도봉구,,쌍문2동제1투,2554,1355,603,681,45,0,14,0,0,1,0,1,0,1,1346,9,1199
1100,서울특별시,1110,도봉구,,쌍문2동제2투,2380,1390,629,697,29,3,16,0,0,0,0,0,0,0,1374,16,990
1100,서울특별시,1110,도봉구,,쌍문2동제3투,1765,1106,449,592,35,2,13,0,0,0,2,0,0,1,1094,12,659
1100,서울특별시,1110,도봉구,,쌍문2동제4투,2184,1581,684,820,40,2,7,0,0,1,1,0,0,0,1555,26,603
1100,서울특별시,1110,도봉구,,쌍문2동제5투,2064,1253,597,575,48,0,21,0,0,0,0,1,2,0,1244,9,811
1100,서울특별시,1110,도봉구,쌍문3동,소계,13770,9962,5022,4482,260,3,69,2,3,2,8,11,1,2,9865,97,3808
1100,서울특별시,1110,도봉구,,관내사전투표,4151,4151,2392,1623,90,1,19,2,0,0,2,3,0,0,4132,19,0
1100,서울특별시,1110,도봉구,,쌍문3동제1투,2676,1639,746,792,50,1,19,0,2,1,2,3,0,0,1616,23,1037
1100,서울특별시,1110,도봉구,,쌍문3동제2투,2511,1451,678,701,37,0,11,0,0,0,2,2,1,1,1433,18,1060
1100,서울특별시,1110,도봉구,,쌍문3동제3투,2234,1363,619,654,48,1,13,0,1,0,2,1,0,0,1339,24,871
1100,서울특별시,1110,도봉구,,쌍문3동제4투,2198,1358,587,712,35,0,7,0,0,1,0,2,0,1,1345,13,840
1100,서울특별시,1110,도봉구,쌍문4동,소계,13550,10492,4945,5062,316,9,64,0,4,3,5,6,1,3,10418,74,3058
1100,서울특별시,1110,도봉구,,관내사전투표,4338,4338,2352,1854,93,2,18,0,0,0,1,3,0,1,4324,14,0
1100,서울특별시,1110,도봉구,,쌍문4동제1투,2097,1316,564,677,43,2,13,0,1,0,0,1,0,0,1301,15,781
1100,서울특별시,1110,도봉구,,쌍문4동제2투,2329,1598,656,861,52,2,12,0,0,0,2,0,1,1,1587,11,731
1100,서울특별시,1110,도봉구,,쌍문4동제3투,2210,1574,630,849,66,2,10,0,1,0,0,1,0,1,1560,14,636
1100,서울특별시,1110,도봉구,,쌍문4동제4투,2576,1666,743,821,62,1,11,0,2,3,2,1,0,0,1646,20,910
1100,서울특별시,1110,도봉구,방학1동,소계,21563,15256,7294,7321,383,8,95,1,3,3,9,15,4,5,15141,115,6307
1100,서울특별시,1110,도봉구,,관내사전투표,4943,4943,2789,2010,90,1,14,0,1,1,1,8,1,3,4919,24,0
1100,서울특별시,1110,도봉구,,방학1동제1투,2234,1156,518,577,34,1,12,1,0,1,1,1,0,0,1146,10,1078
1100,서울특별시,1110,도봉구,,방학1동제2투,2180,1309,611,626,43,2,11,0,1,1,2,0,1,0,1298,11,871
1100,서울특별시,1110,도봉구,,방학1동제3투,2624,1601,775,753,47,0,10,0,0,0,1,0,1,0,1587,14,1023
1100,서울특별시,1110,도봉구,,방학1동제4투,2853,1786,774,917,50,1,20,0,0,0,1,4,1,0,1768,18,1067
1100,서울특별시,1110,도봉구,,방학1동제5투,2835,1737,840,796,55,2,20,0,0,0,1,1,0,1,1716,21,1098
1100,서울특별시,1110,도봉구,,방학1동제6투,1871,1237,441,751,32,1,3,0,0,0,1,1,0,0,1230,7,634
1100,서울특별시,1110,도봉구,,방학1동제7투,2023,1487,546,891,32,0,5,0,1,0,1,0,0,1,1477,10,536
1100,서울특별시,1110,도봉구,방학2동,소계,16480,11621,5998,5155,245,9,95,2,1,5,8,13,3,1,11535,86,4859
1100,서울특별시,1110,도봉구,,관내사전투표,5310,5310,3069,2119,73,2,21,1,0,3,1,5,0,1,5295,15,0
1100,서울특별시,1110,도봉구,,방학2동제1투,1937,990,480,460,19,2,16,0,0,1,2,0,0,0,980,10,947
1100,서울특별시,1110,도봉구,,방학2동제2투,1533,908,430,428,29,0,7,1,0,0,0,0,2,0,897,11,625
1100,서울특별시,1110,도봉구,,방학2동제3투,1957,1102,521,506,33,3,21,0,0,0,2,5,1,0,1092,10,855
1100,서울특별시,1110,도봉구,,방학2동제4투,2066,1304,584,651,34,1,11,0,0,0,1,1,0,0,1283,21,762
1100,서울특별시,1110,도봉구,,방학2동제5투,1789,930,422,464,27,0,8,0,1,1,1,1,0,0,925,5,859
1100,서울특별시,1110,도봉구,,방학2동제6투,1888,1077,492,527,30,1,11,0,0,0,1,1,0,0,1063,14,811
1100,서울특별시,1110,도봉구,방학3동,소계,21607,16948,8166,8073,450,9,96,8,0,2,11,10,4,7,16836,112,4659
1100,서울특별시,1110,도봉구,,관내사전투표,7900,7900,4261,3389,193,3,21,1,0,1,0,6,1,2,7878,22,0
1100,서울특별시,1110,도봉구,,방학3동제1투,1913,1196,507,612,45,0,13,0,0,0,2,0,0,2,1181,15,717
1100,서울특별시,1110,도봉구,,방학3동제2투,2212,1500,647,776,47,1,18,0,0,0,2,0,0,0,1491,9,712
1100,서울특별시,1110,도봉구,,방학3동제3투,2296,1340,516,761,28,0,3,2,0,0,4,0,2,0,1316,24,956
1100,서울특별시,1110,도봉구,,방학3동제4투,1733,1073,467,559,24,1,10,1,0,0,1,0,0,1,1064,9,660
1100,서울특별시,1110,도봉구,,방학3동제5투,1807,1291,537,692,35,2,7,1,0,1,0,0,0,1,1276,15,516
1100,서울특별시,1110,도봉구,,방학3동제6투,1853,1355,611,678,36,2,10,1,0,0,2,3,1,0,1344,11,498
1100,서울특별시,1110,도봉구,,방학3동제7투,1893,1293,620,606,42,0,14,2,0,0,0,1,0,1,1286,7,600
1100,서울특별시,1110,도봉구,창1동,소계,18602,13777,6655,6508,384,4,78,2,1,3,8,5,4,6,13658,119,4825
1100,서울특별시,1110,도봉구,,관내사전투표,4575,4575,2653,1781,101,1,15,1,0,0,1,0,2,1,4556,19,0
1100,서울특별시,1110,도봉구,,창1동제1투,2425,1741,678,969,67,0,7,0,1,0,2,0,1,2,1727,14,684
1100,서울특별시,1110,도봉구,,창1동제2투,1947,1055,449,555,28,1,5,0,0,1,1,0,0,0,1040,15,892
1100,서울특별시,1110,도봉구,,창1동제3투,2252,1212,567,581,32,0,13,1,0,0,2,3,0,0,1199,13,1040
1100,서울특별시,1110,도봉구,,창1동제4투,2594,1780,780,913,48,2,15,0,0,0,0,2,1,0,1761,19,814
1100,서울특별시,1110,도봉구,,창1동제5투,2749,2054,923,1031,64,0,12,0,0,2,2,0,0,2,2036,18,695
1100,서울특별시,1110,도봉구,,창1동제6투,2060,1360,605,678,44,0,11,0,0,0,0,0,0,1,1339,21,700
1100,서울특별시,1110,도봉구,창2동,소계,23404,16727,8540,7400,451,11,141,1,3,1,13,13,3,8,16585,142,6677
1100,서울특별시,1110,도봉구,,관내사전투표,6606,6605,3760,2624,135,5,34,1,0,0,3,6,0,3,6571,34,1
1100,서울특별시,1110,도봉구,,창2동제1투,2517,1383,659,641,43,0,18,0,1,0,0,0,1,0,1363,20,1134
1100,서울특별시,1110,도봉구,,창2동제2투,2793,1583,757,735,50,2,15,0,0,0,3,2,0,2,1566,17,1210
1100,서울특별시,1110,도봉구,,창2동제3투,2651,1772,899,769,61,0,21,0,0,0,1,2,1,0,1754,18,879
1100,서울특별시,1110,도봉구,,창2동제4투,3013,1970,821,1049,59,1,19,0,0,0,2,1,0,2,1954,16,1043
1100,서울특별시,1110,도봉구,,창2동제5투,2819,1692,806,789,54,2,20,0,2,0,1,1,1,1,1677,15,1127
1100,서울특별시,1110,도봉구,,창2동제6투,3005,1722,838,793,49,1,14,0,0,1,3,1,0,0,1700,22,1283
1100,서울특별시,1110,도봉구,창3동,소계,10985,7650,3944,3353,184,4,46,3,2,5,10,9,2,4,7566,84,3335
1100,서울특별시,1110,도봉구,,관내사전투표,3373,3372,1928,1348,62,1,9,1,0,2,1,1,1,2,3356,16,1
1100,서울특별시,1110,도봉구,,창3동제1투,1734,910,413,430,28,1,13,1,1,1,4,2,0,0,894,16,824
1100,서울특별시,1110,도봉구,,창3동제2투,2139,1181,535,569,38,0,9,0,1,0,4,4,0,0,1160,21,958
1100,서울특별시,1110,도봉구,,창3동제3투,1631,842,406,387,25,1,6,0,0,0,0,0,0,1,826,16,789
1100,서울특별시,1110,도봉구,,창3동제4투,2108,1345,662,619,31,1,9,1,0,2,1,2,1,1,1330,15,763
1100,서울특별시,1110,도봉구,창4동,소계,21253,17111,8014,8416,437,7,83,7,3,5,8,9,1,5,16995,116,4142
1100,서울특별시,1110,도봉구,,관내사전투표,6356,6356,3337,2823,131,2,23,2,1,2,2,3,0,2,6328,28,0
1100,서울특별시,1110,도봉구,,창4동제1투,2332,1471,720,687,41,1,9,1,0,0,0,2,0,0,1461,10,861
1100,서울특별시,1110,도봉구,,창4동제2투,2001,1323,574,666,39,0,15,3,1,1,2,1,0,0,1302,21,678
1100,서울특별시,1110,도봉구,,창4동제3투,2443,1682,660,940,51,2,9,0,0,0,1,1,1,1,1666,16,761
1100,서울특별시,1110,도봉구,,창4동제4투,2799,2210,944,1173,58,0,8,1,0,1,0,1,0,1,2187,23,589
1100,서울특별시,1110,도봉구,,창4동제5투,2382,1782,732,978,57,1,7,0,0,0,1,0,0,0,1776,6,600
1100,서울특별시,1110,도봉구,,창4동제6투,2940,2287,1047,1149,60,1,12,0,1,1,2,1,0,1,2275,12,653
1100,서울특별시,1110,도봉구,창5동,소계,19540,15097,6855,7630,376,12,77,6,1,3,11,9,4,6,14990,107,4443
1100,서울특별시,1110,도봉구,,관내사전투표,5742,5742,3001,2588,99,5,19,3,0,2,1,3,0,2,5723,19,0
1100,서울특별시,1110,도봉구,,창5동제1투,2270,1494,701,723,43,0,11,0,0,0,0,2,1,2,1483,11,776
1100,서울특별시,1110,도봉구,,창5동제2투,1723,1113,479,584,30,1,8,1,0,0,2,0,0,1,1106,7,610
1100,서울특별시,1110,도봉구,,창5동제3투,2309,1552,672,799,46,3,11,0,0,0,1,2,1,0,1535,17,757
1100,서울특별시,1110,도봉구,,창5동제4투,2196,1383,566,732,49,1,11,0,0,1,3,0,0,0,1363,20,813
1100,서울특별시,1110,도봉구,,창5동제5투,1468,1157,392,720,29,1,3,1,1,0,2,1,0,0,1150,7,311
1100,서울특별시,1110,도봉구,,창5동제6투,2075,1583,544,977,40,1,3,1,0,0,2,0,0,1,1569,14,492
1100,서울특별시,1110,도봉구,,창5동제7투,1757,1073,500,507,40,0,11,0,0,0,0,1,2,0,1061,12,684
1100,서울특별시,1110,도봉구,도봉1동,소계,18352,13240,6406,6228,313,6,113,4,4,4,11,17,4,3,13113,127,5112
1100,서울특별시,1110,도봉구,,관내사전투표,5170,5168,2790,2202,98,3,19,1,1,1,1,8,1,0,5125,43,2
1100,서울특별시,1110,도봉구,,도봉1동제1투,2169,1179,530,576,35,1,18,0,0,1,1,1,0,0,1163,16,990
1100,서울특별시,1110,도봉구,,도봉1동제2투,3130,1997,944,965,43,0,26,1,1,0,3,2,1,0,1986,11,1133
1100,서울특별시,1110,도봉구,,도봉1동제3투,1631,988,437,505,23,0,13,0,0,0,2,1,0,0,981,7,643
1100,서울특별시,1110,도봉구,,도봉1동제4투,1248,775,369,369,17,0,6,0,0,0,1,1,1,1,765,10,473
1100,서울특별시,1110,도봉구,,도봉1동제5투,2011,1355,554,728,38,0,9,1,2,1,2,2,1,2,1340,15,656
1100,서울특별시,1110,도봉구,,도봉1동제6투,2993,1778,782,883,59,2,22,1,0,1,1,2,0,0,1753,25,1215
1100,서울특별시,1110,도봉구,도봉2동,소계,22320,17297,8280,8320,424,9,87,3,10,0,9,14,2,7,17165,132,5023
1100,서울특별시,1110,도봉구,,관내사전투표,5881,5881,3264,2462,105,3,15,2,0,0,1,7,0,0,5859,22,0
1100,서울특별시,1110,도봉구,,도봉2동제1투,1486,782,347,390,30,1,4,0,1,0,0,1,0,1,775,7,704
1100,서울특별시,1110,도봉구,,도봉2동제2투,2123,1524,669,803,33,0,3,0,1,0,3,0,0,0,1512,12,599
1100,서울특별시,1110,도봉구,,도봉2동제3투,1863,1054,504,490,25,0,20,0,1,0,1,0,1,0,1042,12,809
1100,서울특별시,1110,도봉구,,도봉2동제4투,1981,1289,611,609,37,2,8,0,2,0,1,0,0,1,1271,18,692
1100,서울특별시,1110,도봉구,,도봉2동제5투,3159,2240,935,1198,65,1,10,0,4,0,1,2,0,1,2217,23,919
1100,서울특별시,1110,도봉구,,도봉2동제6투,2765,2165,946,1124,60,1,12,0,1,0,0,2,0,1,2147,18,600
1100,서울특별시,1110,도봉구,,도봉2동제7투,3062,2362,1004,1244,69,1,15,1,0,0,2,2,1,3,2342,20,700
1100,서울특별시,1110,도봉구,잘못 투입·구분된 투표지,,0,13,5,5,2,0,0,0,0,0,0,1,0,0,13,0,-13
1100,서울특별시,1111,노원구,합계,,441879,349297,169275,163340,10021,207,1933,76,46,96,242,449,76,112,345873,3424,92582
1100,서울특별시,1111,노원구,거소·선상투표,,839,780,323,330,21,3,12,1,2,1,1,0,0,0,694,86,59
1100,서울특별시,1111,노원구,관외사전투표,,42392,42386,21443,18797,1212,34,312,12,7,4,25,85,15,22,41968,418,6
1100,서울특별시,1111,노원구,재외투표,,2817,2073,1207,567,77,1,2,0,0,1,1,1,0,0,1857,216,744
1100,서울특별시,1111,노원구,월계1동,소계,17828,13465,6219,6612,349,9,82,2,2,3,15,24,1,2,13320,145,4363
1100,서울특별시,1111,노원구,,관내사전투표,6139,6139,3206,2724,128,0,26,1,1,0,3,12,0,0,6101,38,0
1100,서울특별시,1111,노원구,,월계1동제1투,2240,1338,559,702,50,0,5,0,0,1,4,0,0,0,1321,17,902
1100,서울특별시,1111,노원구,,월계1동제2투,1785,1187,483,640,33,3,7,0,0,1,2,2,0,1,1172,15,598
1100,서울특별시,1111,노원구,,월계1동제3투,2868,1882,745,1022,53,3,18,0,1,0,2,3,0,0,1847,35,986
1100,서울특별시,1111,노원구,,월계1동제4투,2489,1449,581,785,37,1,14,1,0,1,1,4,1,1,1427,22,1040
1100,서울특별시,1111,노원구,,월계1동제5투,2307,1470,645,739,48,2,12,0,0,0,3,3,0,0,1452,18,837
1100,서울특별시,1111,노원구,월계2동,소계,19877,14638,7114,6837,389,7,77,4,0,6,16,36,4,7,14497,141,5239
1100,서울특별시,1111,노원구,,관내사전투표,5284,5284,2919,2168,127,2,19,1,0,3,1,13,2,0,5255,29,0
1100,서울특별시,1111,노원구,,월계2동제1투,2545,1471,635,740,48,1,14,2,0,3,5,3,0,2,1453,18,1074
1100,서울특별시,1111,노원구,,월계2동제2투,2056,1284,643,590,25,1,3,0,0,0,1,3,0,1,1267,17,772
1100,서울특별시,1111,노원구,,월계2동제3투,2308,1625,725,817,54,0,6,0,0,0,0,1,0,1,1604,21,683
1100,서울특별시,1111,노원구,,월계2동제4투,3124,2098,977,1016,60,3,16,1,0,0,1,4,1,1,2080,18,1026
1100,서울특별시,1111,노원구,,월계2동제5투,2325,1390,595,715,25,0,15,0,0,0,5,9,0,2,1366,24,935
1100,서울특별시,1111,노원구,,월계2동제6투,2235,1486,620,791,50,0,4,0,0,0,3,3,1,0,1472,14,749
1100,서울특별시,1111,노원구,월계3동,소계,22335,17155,7902,8425,471,5,100,2,3,6,13,42,5,7,16981,174,5180
1100,서울특별시,1111,노원구,,관내사전투표,4438,4437,2426,1847,110,1,13,0,1,0,1,13,1,1,4414,23,1
1100,서울특별시,1111,노원구,,월계3동제1투,1823,1203,487,655,27,0,8,0,0,0,0,7,0,0,1184,19,620
1100,서울특별시,1111,노원구,,월계3동제2투,2156,1613,750,775,51,0,11,1,0,1,2,4,1,0,1596,17,543
1100,서울특별시,1111,노원구,,월계3동제3투,2075,1534,616,841,50,1,7,1,0,0,2,1,0,0,1519,15,541
1100,서울특별시,1111,노원구,,월계3동제4투,2097,1478,719,679,42,1,11,0,0,2,1,7,0,1,1463,15,619
1100,서울특별시,1111,노원구,,월계3동제5투,2730,2130,883,1140,67,1,9,0,0,3,0,2,1,1,2107,23,600
1100,서울특별시,1111,노원구,,월계3동제6투,2652,2060,823,1141,54,0,12,0,0,0,4,3,0,1,2038,22,592
1100,서울특별시,1111,노원구,,월계3동제7투,1433,1029,450,525,23,0,9,0,2,0,0,1,2,1,1013,16,404
1100,서울특별시,1111,노원구,,월계3동제8투,1394,837,387,407,23,0,6,0,0,0,1,3,0,0,827,10,557
1100,서울특별시,1111,노원구,,월계3동제9투,1537,834,361,415,24,1,14,0,0,0,2,1,0,2,820,14,703
1100,서울특별시,1111,노원구,공릉1동,소계,29596,22277,10865,10276,649,20,150,7,3,6,9,41,5,6,22037,240,7319
1100,서울특별시,1111,노원구,,관내사전투표,9080,9080,4855,3864,232,7,41,0,0,3,1,16,0,0,9019,61,0
1100,서울특별시,1111,노원구,,공릉1동제1투,2546,1502,680,711,59,0,16,1,0,0,1,1,1,1,1471,31,1044
1100,서울특별시,1111,노원구,,공릉1동제2투,3228,2118,999,982,81,4,23,1,1,0,2,2,0,1,2096,22,1110
1100,서울특별시,1111,노원구,,공릉1동제3투,2455,1205,539,583,35,2,11,1,1,1,0,2,0,0,1175,30,1250
1100,서울특별시,1111,노원구,,공릉1동제4투,2141,1381,601,704,42,2,11,0,0,0,1,1,0,0,1362,19,760
1100,서울특별시,1111,노원구,,공릉1동제5투,1960,1257,551,622,33,1,17,2,0,0,1,9,2,0,1238,19,703
1100,서울특별시,1111,노원구,,공릉1동제6투,1478,942,425,475,25,2,3,1,1,0,1,3,0,1,937,5,536
1100,서울특별시,1111,노원구,,공릉1동제7투,2145,1483,708,710,33,1,12,1,0,0,0,3,0,1,1469,14,662
1100,서울특별시,1111,노원구,,공릉1동제8투,2121,1474,679,713,47,0,6,0,0,0,2,1,2,1,1451,23,647
1100,서울특별시,1111,노원구,,공릉1동제9투,2442,1835,828,912,62,1,10,0,0,2,0,3,0,1,1819,16,607
1100,서울특별시,1111,노원구,공릉2동,소계,29659,23233,10979,11104,745,15,117,2,1,8,15,46,0,5,23037,196,6426
1100,서울특별시,1111,노원구,,관내사전투표,8290,8290,4582,3405,213,3,36,1,0,2,1,12,0,1,8256,34,0
1100,서울특별시,1111,노원구,,공릉2동제1투,2500,1596,662,831,65,3,13,0,0,0,2,4,0,0,1580,16,904
1100,서울특별시,1111,노원구,,공릉2동제2투,2751,2057,902,1050,73,0,6,0,0,0,0,5,0,0,2036,21,694
1100,서울특별시,1111,노원구,,공릉2동제3투,2923,2066,888,1048,69,3,14,0,0,1,3,3,0,1,2030,36,857
1100,서울특별시,1111,노원구,,공릉2동제4투,2661,1874,855,923,68,1,3,0,1,1,0,8,0,0,1860,14,787
1100,서울특별시,1111,노원구,,공릉2동제5투,2718,1992,868,1019,69,1,11,0,0,1,4,3,0,0,1976,16,726
1100,서울특별시,1111,노원구,,공릉2동제6투,2436,1666,703,856,62,1,11,1,0,2,2,6,0,1,1645,21,770
1100,서울특별시,1111,노원구,,공릉2동제7투,2392,1564,669,801,53,2,11,0,0,1,1,4,0,0,1542,22,828
1100,서울특별시,1111,노원구,,공릉2동제8투,1155,817,246,526,30,1,4,0,0,0,0,1,0,0,808,9,338
1100,서울특별시,1111,노원구,,공릉2동제9투,1833,1311,604,645,43,0,8,0,0,0,2,0,0,2,1304,7,522
1100,서울특별시,1111,노원구,하계1동,소계,19742,15139,6969,7444,416,5,88,1,2,9,8,6,4,7,14959,180,4603
1100,서울특별시,1111,노원구,,관내사전투표,5529,5529,2888,2413,129,1,27,1,1,1,0,5,1,4,5471,58,0
1100,서울특별시,1111,노원구,,하계1동제1투,1887,1239,472,703,43,1,6,0,0,0,1,0,0,1,1227,12,648
1100,서울특별시,1111,노원구,,하계1동제2투,2109,1387,639,684,36,0,8,0,0,0,2,0,1,1,1371,16,722
1100,서울특별시,1111,노원구,,하계1동제3투,2511,1536,643,821,35,1,13,0,1,3,2,0,0,0,1519,17,975
1100,서울특별시,1111,노원구,,하계1동제4투,2672,1924,790,1041,56,1,8,0,0,1,1,0,1,0,1899,25,748
1100,서울특별시,1111,노원구,,하계1동제5투,2321,1474,648,739,35,0,15,0,0,1,2,1,1,1,1443,31,847
1100,서울특별시,1111,노원구,,하계1동제6투,2713,2050,889,1043,82,1,11,0,0,3,0,0,0,0,2029,21,663
1100,서울특별시,1111,노원구,하계2동,소계,18283,14823,7373,6783,432,10,57,4,2,0,9,24,0,5,14699,124,3460
1100,서울특별시,1111,노원구,,관내사전투표,6386,6386,3506,2662,139,1,21,3,0,0,1,15,0,2,6350,36,0
1100,서울특별시,1111,노원구,,하계2동제1투,2167,1363,620,647,56,0,13,0,0,0,1,1,0,1,1339,24,804
1100,서울특별시,1111,노원구,,하계2동제2투,1594,905,425,441,20,3,6,0,0,0,0,2,0,0,897,8,689
1100,서울특별시,1111,노원구,,하계2동제3투,2905,2314,1031,1173,65,4,6,0,1,0,5,2,0,2,2289,25,591
1100,서울특별시,1111,노원구,,하계2동제4투,2504,1816,861,846,76,1,5,1,0,0,1,4,0,0,1795,21,688
1100,서울특별시,1111,노원구,,하계2동제5투,2727,2039,930,1014,76,1,6,0,1,0,1,0,0,0,2029,10,688
1100,서울특별시,1111,노원구,중계본동,소계,16374,12794,6342,5852,399,7,58,1,1,3,7,4,0,4,12678,116,3580
1100,서울특별시,1111,노원구,,관내사전투표,5023,5023,2937,1916,133,2,8,0,0,0,0,1,0,2,4999,24,0
1100,서울특별시,1111,노원구,,중계본동제1투,1493,939,368,524,31,0,5,0,0,0,0,0,0,0,928,11,554
1100,서울특별시,1111,노원구,,중계본동제2투,361,157,65,86,3,0,2,0,0,0,0,0,0,0,156,1,204
1100,서울특별시,1111,노원구,,중계본동제3투,2106,1416,627,692,65,2,11,0,0,0,2,1,0,0,1400,16,690
1100,서울특별시,1111,노원구,,중계본동제4투,2494,1796,868,823,56,2,14,0,1,0,3,1,0,2,1770,26,698
1100,서울특별시,1111,노원구,,중계본동제5투,2305,1564,695,789,52,0,7,1,0,1,1,0,0,0,1546,18,741
1100,서울특별시,1111,노원구,,중계본동제6투,2592,1899,782,1022,59,1,11,0,0,2,1,1,0,0,1879,20,693
1100,서울특별시,1111,노원구,중계1동,소계,18967,15205,7511,7061,437,7,42,0,2,5,5,12,3,6,15091,114,3762
1100,서울특별시,1111,노원구,,관내사전투표,6358,6357,3593,2555,155,3,12,0,1,1,0,4,1,2,6327,30,1
1100,서울특별시,1111,노원구,,중계1동제1투,2416,1564,691,788,55,1,9,0,0,0,0,1,1,1,1547,17,852
1100,서울특별시,1111,노원구,,중계1동제2투,2594,1719,809,836,44,2,1,0,0,2,0,1,0,0,1695,24,875
1100,서울특별시,1111,노원구,,중계1동제3투,2367,1733,817,832,60,1,6,0,0,0,1,0,1,1,1719,14,634
1100,서울특별시,1111,노원구,,중계1동제4투,2751,2037,889,1051,71,0,6,0,1,0,2,2,0,1,2023,14,714
1100,서울특별시,1111,노원구,,중계1동제5투,2481,1795,712,999,52,0,8,0,0,2,2,4,0,1,1780,15,686
1100,서울특별시,1111,노원구,중계2·3동,소계,27824,21176,10673,9530,609,9,124,1,2,9,14,10,7,7,20995,181,6648
1100,서울특별시,1111,노원구,,관내사전투표,7717,7717,4382,3058,187,7,36,0,0,0,3,5,0,3,7681,36,0
1100,서울특별시,1111,노원구,,중계2·3동제1투,2178,1443,663,693,57,0,7,0,1,0,1,0,0,0,1422,21,735
1100,서울특별시,1111,노원구,,중계2·3동제2투,2318,1780,801,894,64,0,6,0,0,0,0,1,0,1,1767,13,538
1100,서울특별시,1111,노원구,,중계2·3동제3투,1909,1404,640,697,45,0,5,0,0,0,1,1,0,0,1389,15,505
1100,서울특별시,1111,노원구,,중계2·3동제4투,2078,1374,679,630,45,1,4,0,0,1,0,0,2,1,1363,11,704
1100,서울특별시,1111,노원구,,중계2·3동제5투,2052,1281,576,632,47,0,7,0,0,1,3,1,1,0,1268,13,771
1100,서울특별시,1111,노원구,,중계2·3동제6투,2005,1377,606,675,58,0,16,0,1,2,0,0,0,1,1359,18,628
1100,서울특별시,1111,노원구,,중계2·3동제7투,1842,1337,670,609,26,1,10,0,0,1,1,0,2,1,1321,16,505
1100,서울특별시,1111,노원구,,중계2·3동제8투,2051,1236,593,578,30,0,14,1,0,2,2,1,0,0,1221,15,815
1100,서울특별시,1111,노원구,,중계2·3동제9투,1411,906,424,447,15,0,4,0,0,0,1,1,1,0,893,13,505
1100,서울특별시,1111,노원구,,중계2·3동제10투,2263,1321,639,617,35,0,15,0,0,2,2,0,1,0,1311,10,942
1100,서울특별시,1111,노원구,중계4동,소계,15732,12152,5984,5617,333,7,66,5,4,5,12,11,2,4,12050,102,3580
1100,서울특별시,1111,노원구,,관내사전투표,5183,5182,2890,2124,108,2,23,3,1,1,2,3,1,2,5160,22,1
1100,서울특별시,1111,노원구,,중계4동제1투,2724,1699,770,833,50,0,18,1,1,2,3,3,1,0,1682,17,1025
1100,서울특별시,1111,노원구,,중계4동제2투,1991,1223,522,637,32,2,8,0,1,0,1,2,0,0,1205,18,768
1100,서울특별시,1111,노원구,,중계4동제3투,3166,2263,997,1153,68,2,11,0,1,1,3,2,0,0,2238,25,903
1100,서울특별시,1111,노원구,,중계4동제4투,2668,1785,805,870,75,1,6,1,0,1,3,1,0,2,1765,20,883
1100,서울특별시,1111,노원구,상계1동,소계,29365,22044,10741,10288,644,7,131,8,1,5,21,15,4,3,21868,176,7321
1100,서울특별시,1111,노원구,,관내사전투표,7697,7697,4284,3164,164,3,31,3,0,0,7,5,2,1,7664,33,0
1100,서울특별시,1111,노원구,,상계1동제1투,3028,1633,745,792,55,0,13,1,0,1,1,0,0,1,1609,24,1395
1100,서울특별시,1111,노원구,,상계1동제2투,2401,1519,740,690,61,0,15,0,0,0,0,4,0,0,1510,9,882
1100,서울특별시,1111,노원구,,상계1동제3투,2925,2064,1050,897,70,1,10,1,1,0,6,3,1,0,2040,24,861
1100,서울특별시,1111,노원구,,상계1동제4투,2547,1698,590,1028,43,0,16,1,0,1,1,0,0,0,1680,18,849
1100,서울특별시,1111,노원구,,상계1동제5투,2790,1903,910,897,61,1,14,1,0,0,1,2,1,1,1889,14,887
1100,서울특별시,1111,노원구,,상계1동제6투,2453,1728,750,885,55,2,14,0,0,1,1,0,0,0,1708,20,725
1100,서울특별시,1111,노원구,,상계1동제7투,2585,1737,757,901,51,0,7,0,0,1,2,1,0,0,1720,17,848
1100,서울특별시,1111,노원구,,상계1동제8투,2939,2065,915,1034,84,0,11,1,0,1,2,0,0,0,2048,17,874
1100,서울특별시,1111,노원구,상계2동,소계,17138,13045,6142,6317,362,13,73,3,1,1,7,11,3,5,12938,107,4093
1100,서울특별시,1111,노원구,,관내사전투표,6898,6897,3568,3097,155,4,28,1,1,0,0,8,2,3,6867,30,1
1100,서울특별시,1111,노원구,,상계2동제1투,2507,1376,571,713,47,5,19,1,0,0,3,1,0,1,1361,15,1131
1100,서울특별시,1111,노원구,,상계2동제2투,2685,1633,662,886,51,2,7,0,0,0,4,1,1,0,1614,19,1052
1100,서울특별시,1111,노원구,,상계2동제3투,2507,1493,661,741,55,2,12,0,0,0,0,1,0,0,1472,21,1014
1100,서울특별시,1111,노원구,,상계2동제4투,2541,1646,680,880,54,0,7,1,0,1,0,0,0,1,1624,22,895
1100,서울특별시,1111,노원구,상계3·4동,소계,20076,14469,6910,6944,335,5,105,4,1,2,16,18,7,7,14354,115,5607
1100,서울특별시,1111,노원구,,관내사전투표,4951,4951,2704,2097,94,0,22,1,1,1,2,6,2,3,4933,18,0
1100,서울특별시,1111,노원구,,상계3·4동제1투,2991,1776,802,886,40,0,16,2,0,0,2,9,1,0,1758,18,1215
1100,서울특별시,1111,노원구,,상계3·4동제2투,2381,1806,795,917,56,2,17,0,0,0,1,0,2,0,1790,16,575
1100,서울특별시,1111,노원구,,상계3·4동제3투,2214,1580,747,761,37,0,10,1,0,1,2,1,1,0,1561,19,634
1100,서울특별시,1111,노원구,,상계3·4동제4투,1650,964,421,501,22,2,7,0,0,0,0,1,0,1,955,9,686
1100,서울특별시,1111,노원구,,상계3·4동제5투,2179,1563,645,843,47,1,8,0,0,0,7,0,1,2,1554,9,616
1100,서울특별시,1111,노원구,,상계3·4동제6투,1907,892,396,449,18,0,12,0,0,0,0,1,0,1,877,15,1015
1100,서울특별시,1111,노원구,,상계3·4동제7투,1803,937,400,490,21,0,13,0,0,0,2,0,0,0,926,11,866
1100,서울특별시,1111,노원구,상계5동,소계,19727,14726,7197,6905,356,9,91,4,2,4,14,22,3,4,14611,115,5001
1100,서울특별시,1111,노원구,,관내사전투표,6106,6106,3367,2542,108,2,34,2,1,1,1,11,0,4,6073,33,0
1100,서울특별시,1111,노원구,,상계5동제1투,2115,1101,493,550,26,3,12,0,0,1,5,0,0,0,1090,11,1014
1100,서울특별시,1111,노원구,,상계5동제2투,2561,1730,784,871,47,0,6,0,1,0,1,0,2,0,1712,18,831
1100,서울특별시,1111,노원구,,상계5동제3투,2028,1216,540,601,43,1,9,0,0,0,2,2,1,0,1199,17,812
1100,서울특별시,1111,노원구,,상계5동제4투,2451,1642,736,836,44,0,13,1,0,0,1,3,0,0,1634,8,809
1100,서울특별시,1111,노원구,,상계5동제5투,2098,1396,634,681,44,1,9,1,0,2,2,6,0,0,1380,16,702
1100,서울특별시,1111,노원구,,상계5동제6투,2368,1535,643,824,44,2,8,0,0,0,2,0,0,0,1523,12,833
1100,서울특별시,1111,노원구,상계6·7동,소계,25624,19973,9361,9648,642,11,90,6,2,8,14,20,5,4,19811,162,5651
1100,서울특별시,1111,노원구,,관내사전투표,6669,6668,3613,2767,221,3,19,2,1,1,2,6,0,2,6637,31,1
1100,서울특별시,1111,노원구,,상계6·7동제1투,2312,1582,599,892,69,0,8,1,0,0,2,1,0,0,1572,10,730
1100,서울특별시,1111,노원구,,상계6·7동제2투,2564,1763,768,898,64,0,10,0,0,0,2,4,1,1,1748,15,801
1100,서울특별시,1111,노원구,,상계6·7동제3투,2573,1841,849,914,51,0,10,0,0,0,2,1,1,0,1828,13,732
1100,서울특별시,1111,노원구,,상계6·7동제4투,3240,2334,1058,1162,64,1,11,0,1,3,2,3,1,1,2307,27,906
1100,서울특별시,1111,노원구,,상계6·7동제5투,2993,2067,918,1052,51,1,10,1,0,2,0,2,1,0,2038,29,926
1100,서울특별시,1111,노원구,,상계6·7동제6투,2691,1770,720,945,58,1,15,2,0,1,4,1,1,0,1748,22,921
1100,서울특별시,1111,노원구,,상계6·7동제7투,2582,1948,836,1018,64,5,7,0,0,1,0,2,0,0,1933,15,634
1100,서울특별시,1111,노원구,상계8동,소계,16727,13162,6567,5974,435,8,37,7,0,2,8,9,2,1,13050,112,3565
1100,서울특별시,1111,노원구,,관내사전투표,5864,5864,3323,2336,148,4,16,3,0,2,2,4,1,0,5839,25,0
1100,서울특별시,1111,노원구,,상계8동제1투,1973,1256,536,655,43,1,3,1,0,0,2,4,0,0,1245,11,717
1100,서울특별시,1111,노원구,,상계8동제2투,2575,1827,871,857,61,1,4,1,0,0,2,0,1,1,1799,28,748
1100,서울특별시,1111,노원구,,상계8동제3투,2300,1556,634,824,66,1,6,1,0,0,2,0,0,0,1534,22,744
1100,서울특별시,1111,노원구,,상계8동제4투,1662,992,465,466,48,1,1,0,0,0,0,0,0,0,981,11,670
1100,서울특별시,1111,노원구,,상계8동제5투,2353,1667,738,836,69,0,7,1,0,0,0,1,0,0,1652,15,686
1100,서울특별시,1111,노원구,상계9동,소계,16208,12864,6059,6223,375,6,62,0,2,4,9,5,4,4,12753,111,3344
1100,서울특별시,1111,노원구,,관내사전투표,5922,5922,3118,2605,150,4,17,0,1,0,1,2,2,3,5903,19,0
1100,서울특별시,1111,노원구,,상계9동제1투,2372,1501,611,799,51,0,11,0,0,2,2,1,1,0,1478,23,871
1100,서울특별시,1111,노원구,,상계9동제2투,2455,1674,696,892,60,1,8,0,0,0,0,0,0,1,1658,16,781
1100,서울특별시,1111,노원구,,상계9동제3투,2469,1682,682,900,55,1,16,0,0,0,3,2,0,0,1659,23,787
1100,서울특별시,1111,노원구,,상계9동제4투,2990,2085,952,1027,59,0,10,0,1,2,3,0,1,0,2055,30,905
1100,서울특별시,1111,노원구,상계10동,소계,14749,11715,5393,5804,333,9,57,2,6,4,3,7,2,2,11622,93,3034
1100,서울특별시,1111,노원구,,관내사전투표,4806,4806,2588,2068,108,2,14,1,0,1,0,4,0,0,4786,20,0
1100,서울특별시,1111,노원구,,상계10동제1투,2303,1551,534,940,52,1,6,0,1,0,0,0,0,0,1534,17,752
1100,서울특별시,1111,노원구,,상계10동제2투,2355,1615,676,838,59,3,9,0,2,1,0,2,2,0,1592,23,740
1100,서울특별시,1111,노원구,,상계10동제3투,2854,2053,848,1102,62,1,19,0,1,1,1,0,0,1,2036,17,801
1100,서울특별시,1111,노원구,,상계10동제4투,2431,1690,747,856,52,2,9,1,2,1,2,1,0,1,1674,16,741
1100,서울특별시,1111,노원구,잘못 투입·구분된 투표지,,0,3,1,2,0,0,0,0,0,0,0,0,0,0,3,0,-3
1100,서울특별시,1112,은평구,합계,,417391,317971,161510,140666,9715,248,1934,117,49,71,252,293,76,89,315020,2951,99420
1100,서울특별시,1112,은평구,거소·선상투표,,1121,1050,438,321,40,9,25,10,6,4,5,5,5,8,876,174,71
1100,서울특별시,1112,은평구,관외사전투표,,40305,40295,21625,16534,1290,39,310,14,7,7,16,66,9,9,39926,369,10
1100,서울특별시,1112,은평구,재외투표,,3164,2300,1327,671,80,0,8,0,0,2,1,1,0,0,2090,210,864
1100,서울특별시,1112,은평구,녹번동,소계,28384,20496,10000,9556,609,13,115,7,2,0,19,11,3,5,20340,156,7888
1100,서울특별시,1112,은평구,,관내사전투표,8631,8631,4820,3503,219,3,29,4,0,0,3,5,0,2,8588,43,0
1100,서울특별시,1112,은평구,,녹번동제1투,2741,1421,650,693,46,0,16,0,0,0,4,1,0,1,1411,10,1320
1100,서울특별시,1112,은평구,,녹번동제2투,2894,1993,761,1122,70,2,10,0,0,0,3,1,0,1,1970,23,901
1100,서울특별시,1112,은평구,,녹번동제3투,2801,1554,742,735,44,1,9,2,0,0,1,1,0,1,1536,18,1247
1100,서울특별시,1112,은평구,,녹번동제4투,2498,1380,620,682,44,2,11,0,1,0,0,2,2,0,1364,16,1118
1100,서울특별시,1112,은평구,,녹번동제5투,3138,2200,870,1231,71,1,11,1,0,0,2,1,0,0,2188,12,938
1100,서울특별시,1112,은평구,,녹번동제6투,2786,1528,685,761,42,2,10,0,0,0,6,0,1,0,1507,21,1258
1100,서울특별시,1112,은평구,,녹번동제7투,2895,1789,852,829,73,2,19,0,1,0,0,0,0,0,1776,13,1106
1100,서울특별시,1112,은평구,응암제1동,소계,24561,18117,9099,8171,524,9,102,1,2,3,18,15,5,2,17951,166,6444
1100,서울특별시,1112,은평구,,관내사전투표,6669,6669,3790,2653,145,2,25,0,0,0,3,8,2,1,6629,40,0
1100,서울특별시,1112,은평구,,응암제1동제1투,2730,1534,771,687,42,2,10,0,0,0,2,0,0,0,1514,20,1196
1100,서울특별시,1112,은평구,,응암제1동제2투,1839,1330,542,711,51,0,6,0,0,1,1,3,0,1,1316,14,509
1100,서울특별시,1112,은평구,,응암제1동제3투,2956,1770,825,828,61,2,21,1,1,1,5,0,0,0,1745,25,1186
1100,서울특별시,1112,은평구,,응암제1동제4투,3030,1872,910,860,52,1,14,0,0,0,5,2,1,0,1845,27,1158
1100,서울특별시,1112,은평구,,응암제1동제5투,3805,2347,1131,1056,108,1,17,0,1,1,0,1,2,0,2318,29,1458
1100,서울특별시,1112,은평구,,응암제1동제6투,3532,2595,1130,1376,65,1,9,0,0,0,2,1,0,0,2584,11,937
1100,서울특별시,1112,은평구,응암제2동,소계,19417,14241,7098,6522,437,4,60,5,1,4,10,6,3,2,14152,89,5176
1100,서울특별시,1112,은평구,,관내사전투표,4654,4654,2682,1815,127,2,11,2,0,0,0,2,1,1,4643,11,0
1100,서울특별시,1112,은평구,,응암제2동제1투,3720,2080,960,1002,83,0,12,1,0,0,1,3,0,0,2062,18,1640
1100,서울특별시,1112,은평구,,응암제2동제2투,2653,1845,853,897,62,0,11,0,0,1,1,0,0,0,1825,20,808
1100,서울특별시,1112,은평구,,응암제2동제3투,2734,1892,850,952,63,0,6,2,1,0,3,0,0,0,1877,15,842
1100,서울특별시,1112,은평구,,응암제2동제4투,2900,2111,960,1074,51,2,9,0,0,2,2,0,1,1,2102,9,789
1100,서울특별시,1112,은평구,,응암제2동제5투,2756,1659,793,782,51,0,11,0,0,1,3,1,1,0,1643,16,1097
1100,서울특별시,1112,은평구,응암제3동,소계,21195,15181,7997,6494,437,19,92,3,2,3,9,13,3,10,15082,99,6014
1100,서울특별시,1112,은평구,,관내사전투표,7214,7214,4234,2740,171,6,23,3,1,0,2,6,0,3,7189,25,0
1100,서울특별시,1112,은평구,,응암제3동제1투,2716,1466,749,627,53,2,15,0,0,2,3,2,0,2,1455,11,1250
1100,서울특별시,1112,은평구,,응암제3동제2투,2479,1373,622,696,30,1,9,0,0,0,0,1,1,1,1361,12,1106
1100,서울특별시,1112,은평구,,응암제3동제3투,2632,1499,689,707,68,4,12,0,1,0,2,1,1,1,1486,13,1133
1100,서울특별시,1112,은평구,,응암제3동제4투,1763,925,432,442,29,1,7,0,0,0,1,1,1,1,915,10,838
1100,서울특별시,1112,은평구,,응암제3동제5투,2045,1286,564,647,46,3,9,0,0,1,0,1,0,1,1272,14,759
1100,서울특별시,1112,은평구,,응암제3동제6투,2346,1418,707,635,40,2,17,0,0,0,1,1,0,1,1404,14,928
1100,서울특별시,1112,은평구,증산동,소계,12046,9313,4604,4301,252,10,48,2,1,4,9,10,1,0,9242,71,2733
1100,서울특별시,1112,은평구,,관내사전투표,5058,5057,2726,2138,130,5,17,0,1,2,3,6,0,0,5028,29,1
1100,서울특별시,1112,은평구,,증산동제1투,1868,1091,505,529,32,1,7,1,0,2,1,2,1,0,1081,10,777
1100,서울특별시,1112,은평구,,증산동제2투,2376,1442,641,722,40,3,13,1,0,0,3,0,0,0,1423,19,934
1100,서울특별시,1112,은평구,,증산동제3투,1681,1002,426,524,31,0,9,0,0,0,2,2,0,0,994,8,679
1100,서울특별시,1112,은평구,,증산동제4투,1063,721,306,388,19,1,2,0,0,0,0,0,0,0,716,5,342
1100,서울특별시,1112,은평구,수색동,소계,10156,7936,3598,3979,223,2,37,2,4,2,5,20,2,1,7875,61,2220
1100,서울특별시,1112,은평구,,관내사전투표,3544,3523,1814,1578,75,1,16,0,3,0,0,19,2,0,3508,15,21
1100,서울특별시,1112,은평구,,수색동제1투,2264,1446,593,765,57,1,8,1,0,2,0,0,0,0,1427,19,818
1100,서울특별시,1112,은평구,,수색동제2투,2146,1365,507,797,40,0,8,0,0,0,2,0,0,1,1355,10,781
1100,서울특별시,1112,은평구,,수색동제3투,2202,1602,684,839,51,0,5,1,1,0,3,1,0,0,1585,17,600
1100,서울특별시,1112,은평구,신사제1동,소계,23171,17634,9223,7614,471,13,112,6,2,6,17,13,5,5,17487,147,5537
1100,서울특별시,1112,은평구,,관내사전투표,9278,9275,5324,3628,199,4,43,3,1,2,7,6,1,3,9221,54,3
1100,서울특별시,1112,은평구,,신사제1동제1투,2979,1658,787,764,56,1,19,1,0,0,1,0,0,1,1630,28,1321
1100,서울특별시,1112,은평구,,신사제1동제2투,2652,1564,724,756,51,2,12,0,0,1,3,1,2,0,1552,12,1088
1100,서울특별시,1112,은평구,,신사제1동제3투,2967,1799,846,849,58,1,16,1,1,0,2,2,1,0,1777,22,1168
1100,서울특별시,1112,은평구,,신사제1동제4투,2190,1282,600,621,40,2,7,0,0,1,0,1,0,0,1272,10,908
1100,서울특별시,1112,은평구,,신사제1동제5투,3105,2056,942,996,67,3,15,1,0,2,4,3,1,1,2035,21,1049
1100,서울특별시,1112,은평구,신사제2동,소계,14785,10439,5163,4733,319,9,84,2,2,2,12,9,4,2,10341,98,4346
1100,서울특별시,1112,은평구,,관내사전투표,4030,4030,2183,1694,106,1,16,0,0,0,3,4,1,1,4009,21,0
1100,서울특별시,1112,은평구,,신사제2동제1투,1998,1220,556,580,44,3,16,0,0,0,2,2,0,0,1203,17,778
1100,서울특별시,1112,은평구,,신사제2동제2투,2351,1442,679,683,41,1,15,0,0,1,5,1,0,0,1426,16,909
1100,서울특별시,1112,은평구,,신사제2동제3투,2557,1458,717,645,55,1,20,1,1,1,0,1,2,0,1444,14,1099
1100,서울특별시,1112,은평구,,신사제2동제4투,1906,1200,564,564,38,1,11,1,0,0,1,1,0,1,1182,18,706
1100,서울특별시,1112,은평구,,신사제2동제5투,1943,1089,464,567,35,2,6,0,1,0,1,0,1,0,1077,12,854
1100,서울특별시,1112,은평구,갈현제2동,소계,22881,16522,8597,7051,549,16,121,5,1,5,11,12,1,5,16374,148,6359
1100,서울특별시,1112,은평구,,관내사전투표,7397,7395,4285,2786,233,4,31,2,0,0,3,5,1,3,7353,42,2
1100,서울특별시,1112,은평구,,갈현제2동제1투,3173,1677,748,807,68,2,21,1,1,2,2,2,0,1,1655,22,1496
1100,서울특별시,1112,은평구,,갈현제2동제2투,3361,2048,944,979,71,2,23,2,0,0,5,3,0,0,2029,19,1313
1100,서울특별시,1112,은평구,,갈현제2동제3투,3092,1805,895,804,58,6,16,0,0,0,1,1,0,0,1781,24,1287
1100,서울특별시,1112,은평구,,갈현제2동제4투,3258,1975,964,915,57,2,11,0,0,2,0,1,0,0,1952,23,1283
1100,서울특별시,1112,은평구,,갈현제2동제5투,2600,1622,761,760,62,0,19,0,0,1,0,0,0,1,1604,18,978
1100,서울특별시,1112,은평구,구산동,소계,25140,17850,9293,7698,506,21,118,7,5,4,5,22,4,10,17693,157,7290
1100,서울특별시,1112,은평구,,관내사전투표,7257,7257,4215,2773,174,6,34,3,0,3,2,6,1,5,7222,35,0
1100,서울특별시,1112,은평구,,구산동제1투,3117,1655,789,779,45,3,15,0,0,0,1,2,2,1,1637,18,1462
1100,서울특별시,1112,은평구,,구산동제2투,3650,2253,1133,996,80,3,15,2,1,0,0,2,0,0,2232,21,1397
1100,서울특별시,1112,은평구,,구산동제3투,2786,1551,749,696,48,5,13,1,1,1,2,2,0,2,1520,31,1235
1100,서울특별시,1112,은평구,,구산동제4투,2124,1280,628,571,41,0,16,0,1,0,0,9,1,1,1268,12,844
1100,서울특별시,1112,은평구,,구산동제5투,3125,1877,870,899,69,1,14,1,2,0,0,0,0,1,1857,20,1248
1100,서울특별시,1112,은평구,,구산동제6투,3081,1977,909,984,49,3,11,0,0,0,0,1,0,0,1957,20,1104
1100,서울특별시,1112,은평구,갈현제1동,소계,17969,12831,6297,5865,398,9,99,8,0,2,21,4,6,4,12713,118,5138
1100,서울특별시,1112,은평구,,관내사전투표,6746,6745,3629,2815,187,6,38,5,0,0,5,3,2,3,6693,52,1
1100,서울특별시,1112,은평구,,갈현제1동제1투,1831,954,414,481,29,0,11,1,0,0,1,0,0,1,938,16,877
1100,서울특별시,1112,은평구,,갈현제1동제2투,1677,839,336,445,35,1,8,0,0,0,3,0,2,0,830,9,838
1100,서울특별시,1112,은평구,,갈현제1동제3투,2467,1347,604,666,37,1,17,0,0,1,4,0,0,0,1330,17,1120
1100,서울특별시,1112,은평구,,갈현제1동제4투,2767,1507,652,765,54,0,13,1,0,1,4,1,2,0,1493,14,1260
1100,서울특별시,1112,은평구,,갈현제1동제5투,2481,1439,662,693,56,1,12,1,0,0,4,0,0,0,1429,10,1042
1100,서울특별시,1112,은평구,진관동,소계,39815,31343,15442,14532,970,18,106,18,0,5,12,11,4,5,31123,220,8472
1100,서울특별시,1112,은평구,,관내사전투표,11482,11482,6558,4560,270,3,24,8,0,1,1,7,0,3,11435,47,0
1100,서울특별시,1112,은평구,,진관동제1투,2686,1936,842,1006,64,1,8,0,0,1,1,0,1,0,1924,12,750
1100,서울특별시,1112,은평구,,진관동제2투,2843,2123,920,1106,73,0,9,0,0,1,1,0,0,0,2110,13,720
1100,서울특별시,1112,은평구,,진관동제3투,2314,1668,764,816,58,2,5,1,0,1,4,0,0,0,1651,17,646
1100,서울특별시,1112,은평구,,진관동제4투,2474,1694,670,934,58,0,10,2,0,0,0,0,1,0,1675,19,780
1100,서울특별시,1112,은평구,,진관동제5투,2315,1644,797,757,62,2,5,2,0,0,0,1,0,0,1626,18,671
1100,서울특별시,1112,은평구,,진관동제6투,2645,1928,766,1093,56,1,4,0,0,0,0,0,0,0,1920,8,717
1100,서울특별시,1112,은평구,,진관동제7투,2055,1429,580,774,57,0,5,1,0,0,2,1,0,0,1420,9,626
1100,서울특별시,1112,은평구,,진관동제8투,2367,1789,771,940,54,3,3,0,0,0,2,0,0,1,1774,15,578
1100,서울특별시,1112,은평구,,진관동제9투,3030,2205,1040,1058,71,4,13,2,0,0,0,2,2,0,2192,13,825
1100,서울특별시,1112,은평구,,진관동제10투,2886,2070,1110,859,71,0,9,1,0,0,1,0,0,0,2051,19,816
1100,서울특별시,1112,은평구,,진관동제11투,2718,1375,624,629,76,2,11,1,0,1,0,0,0,1,1345,30,1343
1100,서울특별시,1112,은평구,불광제1동,소계,30892,23542,11213,11204,748,17,125,8,3,5,13,22,4,8,23370,172,7350
1100,서울특별시,1112,은평구,,관내사전투표,9408,9408,5137,3914,261,4,31,4,1,2,2,10,1,2,9369,39,0
1100,서울특별시,1112,은평구,,불광제1동제1투,2435,1328,545,703,56,2,8,0,0,0,1,0,1,1,1317,11,1107
1100,서울특별시,1112,은평구,,불광제1동제2투,3005,2094,827,1171,62,0,11,0,0,2,1,4,1,0,2079,15,911
1100,서울특별시,1112,은평구,,불광제1동제3투,2408,1446,641,721,48,2,14,0,0,0,0,0,0,0,1426,20,962
1100,서울특별시,1112,은평구,,불광제1동제4투,2144,1706,612,1002,57,1,9,1,1,0,1,1,0,1,1686,20,438
1100,서울특별시,1112,은평구,,불광제1동제5투,3148,2261,1028,1101,86,3,13,1,0,0,5,4,0,1,2242,19,887
1100,서울특별시,1112,은평구,,불광제1동제6투,2393,1568,780,704,53,2,15,1,1,1,1,0,1,0,1559,9,825
1100,서울특별시,1112,은평구,,불광제1동제7투,3637,2374,1016,1252,67,1,9,0,0,0,2,3,0,1,2351,23,1263
1100,서울특별시,1112,은평구,,불광제1동제8투,2314,1357,627,636,58,2,15,1,0,0,0,0,0,2,1341,16,957
1100,서울특별시,1112,은평구,불광제2동,소계,23879,17215,8589,7799,488,3,139,7,5,2,22,8,3,4,17069,146,6664
1100,서울특별시,1112,은평구,,관내사전투표,7697,7697,4306,3124,192,0,26,3,1,2,6,2,0,1,7663,34,0
1100,서울특별시,1112,은평구,,불광제2동제1투,2336,1335,570,697,30,0,12,1,1,0,1,3,1,1,1317,18,1001
1100,서울특별시,1112,은평구,,불광제2동제2투,2643,1606,790,725,50,0,16,0,0,0,3,0,1,0,1585,21,1037
1100,서울특별시,1112,은평구,,불광제2동제3투,2539,1414,669,651,45,0,26,0,1,0,3,0,0,0,1395,19,1125
1100,서울특별시,1112,은평구,,불광제2동제4투,1920,1054,411,577,28,0,14,0,1,0,4,2,0,0,1037,17,866
1100,서울특별시,1112,은평구,,불광제2동제5투,2314,1392,588,728,40,1,17,0,1,0,1,0,0,0,1376,16,922
1100,서울특별시,1112,은평구,,불광제2동제6투,1951,1158,552,537,41,1,10,1,0,0,4,1,1,2,1150,8,793
1100,서울특별시,1112,은평구,,불광제2동제7투,2479,1559,703,760,62,1,18,2,0,0,0,0,0,0,1546,13,920
1100,서울특별시,1112,은평구,대조동,소계,21733,15102,7723,6582,520,12,80,6,1,5,13,22,2,5,14971,131,6631
1100,서울특별시,1112,은평구,,관내사전투표,6490,6490,3693,2497,205,6,27,2,0,2,0,9,1,4,6446,44,0
1100,서울특별시,1112,은평구,,대조동제1투,3523,1935,884,906,99,1,17,1,0,0,1,4,0,0,1913,22,1588
1100,서울특별시,1112,은평구,,대조동제2투,3333,1755,813,846,71,1,5,0,1,0,0,1,0,0,1738,17,1578
1100,서울특별시,1112,은평구,,대조동제3투,2100,1288,601,621,45,2,6,0,0,0,2,1,0,1,1279,9,812
1100,서울특별시,1112,은평구,,대조동제4투,768,427,202,197,17,0,2,1,0,0,0,2,0,0,421,6,341
1100,서울특별시,1112,은평구,,대조동제5투,2650,1519,704,724,42,0,10,1,0,3,9,2,1,0,1496,23,1131
1100,서울특별시,1112,은평구,,대조동제6투,2869,1688,826,791,41,2,13,1,0,0,1,3,0,0,1678,10,1181
1100,서울특별시,1112,은평구,역촌동,소계,36777,26560,14182,11038,854,25,153,6,5,6,34,23,12,4,26342,218,10217
1100,서울특별시,1112,은평구,,관내사전투표,12327,12327,7264,4581,321,11,46,3,1,0,9,12,8,2,12258,69,0
1100,서울특별시,1112,은평구,,역촌동제1투,2804,1375,664,631,53,3,7,0,2,1,4,1,0,0,1366,9,1429
1100,서울특별시,1112,은평구,,역촌동제2투,2822,1727,861,773,54,2,10,1,0,1,4,1,0,1,1708,19,1095
1100,서울특별시,1112,은평구,,역촌동제3투,2735,1599,787,721,50,2,11,0,0,1,6,3,0,0,1581,18,1136
1100,서울특별시,1112,은평구,,역촌동제4투,2625,1463,687,672,72,2,18,0,0,0,0,1,1,0,1453,10,1162
1100,서울특별시,1112,은평구,,역촌동제5투,2191,1279,594,593,51,2,15,0,0,0,0,0,0,0,1255,24,912
1100,서울특별시,1112,은평구,,역촌동제6투,2215,1354,647,640,38,0,8,0,0,0,1,2,2,0,1338,16,861
1100,서울특별시,1112,은평구,,역촌동제7투,2607,1590,813,675,64,0,14,0,1,0,1,2,1,0,1571,19,1017
1100,서울특별시,1112,은평구,,역촌동제8투,3017,1849,894,845,69,1,14,0,1,1,6,0,0,0,1831,18,1168
1100,서울특별시,1112,은평구,,역촌동제9투,3434,1997,971,907,82,2,10,2,0,2,3,1,0,1,1981,16,1437
1100,서울특별시,1112,은평구,잘못 투입·구분된 투표지,,0,4,2,1,0,0,0,0,0,0,0,0,0,0,3,1,-4
1100,서울특별시,1113,서대문구,합계,,269615,210460,100702,98924,6886,119,1070,57,30,38,153,263,47,63,208352,2108,59155
1100,서울특별시,1113,서대문구,거소·선상투표,,412,387,154,180,6,1,9,0,0,0,0,0,0,0,350,37,25
1100,서울특별시,1113,서대문구,관외사전투표,,30407,30406,15463,13229,1141,18,188,7,2,5,14,57,5,10,30139,267,1
1100,서울특별시,1113,서대문구,재외투표,,2696,1957,1093,625,65,1,8,0,0,0,0,0,0,0,1792,165,739
1100,서울특별시,1113,서대문구,충현동,소계,14332,10374,4579,5271,335,10,56,2,1,2,7,15,2,3,10283,91,3958
1100,서울특별시,1113,서대문구,,관내사전투표,3265,3264,1687,1460,80,4,11,1,0,1,2,7,0,0,3253,11,1
1100,서울특별시,1113,서대문구,,충현동제1투,2247,1224,511,646,42,2,9,0,0,0,1,3,0,0,1214,10,1023
1100,서울특별시,1113,서대문구,,충현동제2투,1845,1098,408,624,36,1,11,0,1,0,2,2,0,0,1085,13,747
1100,서울특별시,1113,서대문구,,충현동제3투,2328,1690,698,908,56,2,2,0,0,0,0,2,1,1,1670,20,638
1100,서울특별시,1113,서대문구,,충현동제4투,2384,1593,687,808,62,1,15,1,0,0,2,1,1,2,1580,13,791
1100,서울특별시,1113,서대문구,,충현동제5투,2263,1505,588,825,59,0,8,0,0,1,0,0,0,0,1481,24,758
1100,서울특별시,1113,서대문구,천연동,소계,13487,10601,4907,5222,301,6,37,1,2,4,10,12,0,3,10505,96,2886
1100,서울특별시,1113,서대문구,,관내사전투표,4558,4558,2377,2020,113,4,15,1,0,0,0,8,0,0,4538,20,0
1100,서울특별시,1113,서대문구,,천연동제1투,1860,1135,453,633,34,0,1,0,0,0,4,0,0,0,1125,10,725
1100,서울특별시,1113,서대문구,,천연동제2투,2204,1469,638,738,56,0,7,0,1,3,1,4,0,0,1448,21,735
1100,서울특별시,1113,서대문구,,천연동제3투,1987,1325,582,676,42,1,5,0,1,0,2,0,0,1,1310,15,662
1100,서울특별시,1113,서대문구,,천연동제4투,422,308,154,141,6,1,1,0,0,1,1,0,0,1,306,2,114
1100,서울특별시,1113,서대문구,,천연동제5투,2456,1806,703,1014,50,0,8,0,0,0,2,0,0,1,1778,28,650
1100,서울특별시,1113,서대문구,북아현동,소계,13201,10367,4730,5164,339,5,35,1,2,4,7,8,0,3,10298,69,2834
1100,서울특별시,1113,서대문구,,관내사전투표,4897,4897,2614,2106,132,3,16,0,0,3,0,3,0,1,4878,19,0
1100,서울특별시,1113,서대문구,,북아현동제1투,1593,917,369,499,27,0,2,0,0,0,5,1,0,0,903,14,676
1100,서울특별시,1113,서대문구,,북아현동제2투,1765,1029,407,550,39,1,6,0,1,0,1,4,0,1,1010,19,736
1100,서울특별시,1113,서대문구,,북아현동제3투,2412,1694,714,902,61,0,4,1,1,0,1,0,0,1,1685,9,718
1100,서울특별시,1113,서대문구,,북아현동제4투,2534,1830,626,1107,80,1,7,0,0,1,0,0,0,0,1822,8,704
1100,서울특별시,1113,서대문구,신촌동,소계,14866,10186,4316,5177,450,13,44,4,2,1,5,7,1,5,10025,161,4680
1100,서울특별시,1113,서대문구,,관내사전투표,3274,3274,1524,1540,143,5,14,1,0,0,1,2,0,3,3233,41,0
1100,서울특별시,1113,서대문구,,신촌동제1투,1678,1048,397,584,47,0,5,0,0,0,0,0,0,1,1034,14,630
1100,서울특별시,1113,서대문구,,신촌동제2투,2835,1945,820,1007,86,1,4,2,1,1,2,2,0,0,1926,19,890
1100,서울특별시,1113,서대문구,,신촌동제3투,2373,1180,490,616,39,3,8,0,0,0,0,3,1,0,1160,20,1193
1100,서울특별시,1113,서대문구,,신촌동제4투,2412,1416,520,774,72,3,6,0,0,0,2,0,0,0,1377,39,996
1100,서울특별시,1113,서대문구,,신촌동제5투,2294,1323,565,656,63,1,7,1,1,0,0,0,0,1,1295,28,971
1100,서울특별시,1113,서대문구,연희동,소계,25760,18534,8110,9295,752,10,90,11,2,3,14,24,6,3,18320,214,7226
1100,서울특별시,1113,서대문구,,관내사전투표,6392,6393,3275,2820,229,4,18,5,0,0,0,9,0,2,6362,31,-1
1100,서울특별시,1113,서대문구,,연희동제1투,2594,1384,509,773,66,1,8,0,0,2,2,4,1,0,1366,18,1210
1100,서울특별시,1113,서대문구,,연희동제2투,1685,1157,418,665,58,0,5,0,1,0,1,0,1,0,1149,8,528
1100,서울특별시,1113,서대문구,,연희동제3투,2160,1326,524,720,51,0,8,1,0,0,1,0,2,0,1307,19,834
1100,서울특별시,1113,서대문구,,연희동제4투,1239,797,415,335,30,0,4,1,0,0,1,1,0,1,788,9,442
1100,서울특별시,1113,서대문구,,연희동제5투,2156,1452,656,705,55,0,13,0,0,0,3,1,0,0,1433,19,704
1100,서울특별시,1113,서대문구,,연희동제6투,2089,1316,574,652,51,1,11,0,0,0,3,5,2,0,1299,17,773
1100,서울특별시,1113,서대문구,,연희동제7투,2282,1426,479,863,59,1,2,1,0,1,2,0,0,0,1408,18,856
1100,서울특별시,1113,서대문구,,연희동제8투,2678,1667,609,909,92,0,10,3,1,0,1,3,0,0,1628,39,1011
1100,서울특별시,1113,서대문구,,연희동제9투,2485,1616,651,853,61,3,11,0,0,0,0,1,0,0,1580,36,869
1100,서울특별시,1113,서대문구,홍제제1동,소계,16962,12702,5968,6057,429,4,80,5,2,1,16,20,4,2,12588,114,4260
1100,서울특별시,1113,서대문구,,관내사전투표,3783,3783,2011,1635,105,1,10,0,1,0,3,4,0,0,3770,13,0
1100,서울특별시,1113,서대문구,,홍제제1동제1투,2020,1238,569,599,31,0,18,0,0,0,2,2,0,0,1221,17,782
1100,서울특별시,1113,서대문구,,홍제제1동제2투,2375,1714,733,887,50,0,11,1,0,1,4,3,2,1,1693,21,661
1100,서울특별시,1113,서대문구,,홍제제1동제3투,2260,1578,783,705,58,0,11,1,0,0,2,5,0,1,1566,12,682
1100,서울특별시,1113,서대문구,,홍제제1동제4투,1745,1125,538,511,43,2,12,1,0,0,1,1,1,0,1110,15,620
1100,서울특별시,1113,서대문구,,홍제제1동제5투,2135,1471,646,734,62,1,8,1,1,0,0,3,0,0,1456,15,664
1100,서울특별시,1113,서대문구,,홍제제1동제6투,1714,1113,420,621,49,0,5,0,0,0,3,2,1,0,1101,12,601
1100,서울특별시,1113,서대문구,,홍제제1동제7투,930,680,268,365,31,0,5,1,0,0,1,0,0,0,671,9,250
1100,서울특별시,1113,서대문구,홍제제2동,소계,12169,9847,4582,4824,296,4,51,1,1,3,2,18,1,2,9785,62,2322
1100,서울특별시,1113,서대문구,,관내사전투표,5063,5061,2653,2213,144,2,15,1,0,2,1,10,0,1,5042,19,2
1100,서울특별시,1113,서대문구,,홍제제2동제1투,1580,937,429,458,26,0,7,0,0,0,0,2,0,0,922,15,643
1100,서울특별시,1113,서대문구,,홍제제2동제2투,2154,1532,592,873,45,0,9,0,0,0,0,1,1,0,1521,11,622
1100,서울특별시,1113,서대문구,,홍제제2동제3투,1734,1173,440,668,39,2,12,0,0,0,1,2,0,0,1164,9,561
1100,서울특별시,1113,서대문구,,홍제제2동제4투,1638,1144,468,612,42,0,8,0,1,1,0,3,0,1,1136,8,494
1100,서울특별시,1113,서대문구,홍제제3동,소계,12718,9419,4721,4243,266,6,61,1,0,4,10,13,2,2,9329,90,3299
1100,서울특별시,1113,서대문구,,관내사전투표,4073,4073,2329,1603,87,4,14,0,0,0,2,4,1,1,4045,28,0
1100,서울특별시,1113,서대문구,,홍제제3동제1투,1797,955,477,422,27,1,15,0,0,1,1,1,0,0,945,10,842
1100,서울특별시,1113,서대문구,,홍제제3동제2투,2070,1332,584,668,42,1,10,0,0,0,7,4,0,0,1316,16,738
1100,서울특별시,1113,서대문구,,홍제제3동제3투,1954,1254,549,620,53,0,12,0,0,1,0,1,1,1,1238,16,700
1100,서울특별시,1113,서대문구,,홍제제3동제4투,1974,1205,546,597,33,0,8,1,0,2,0,2,0,0,1189,16,769
1100,서울특별시,1113,서대문구,,홍제제3동제5투,850,600,236,333,24,0,2,0,0,0,0,1,0,0,596,4,250
1100,서울특별시,1113,서대문구,홍은제1동,소계,17893,13661,6849,6192,373,6,81,7,2,2,8,24,4,4,13552,109,4232
1100,서울특별시,1113,서대문구,,관내사전투표,6016,6016,3441,2385,125,3,14,4,0,0,3,10,0,2,5987,29,0
1100,서울특별시,1113,서대문구,,홍은제1동제1투,1208,583,260,287,17,0,10,0,0,1,0,2,0,0,577,6,625
1100,서울특별시,1113,서대문구,,홍은제1동제2투,2652,1782,794,898,50,0,13,1,0,1,1,5,0,0,1763,19,870
1100,서울특별시,1113,서대문구,,홍은제1동제3투,2109,1463,588,808,39,0,15,1,1,0,0,2,0,0,1454,9,646
1100,서울특별시,1113,서대문구,,홍은제1동제4투,1645,1171,541,560,50,0,8,0,1,0,0,0,0,1,1161,10,474
1100,서울특별시,1113,서대문구,,홍은제1동제5투,2116,1375,590,706,45,2,12,1,0,0,2,1,1,1,1361,14,741
1100,서울특별시,1113,서대문구,,홍은제1동제6투,2147,1271,635,548,47,1,9,0,0,0,2,4,3,0,1249,22,876
1100,서울특별시,1113,서대문구,홍은제2동,소계,20473,14690,7340,6629,416,10,92,4,4,2,19,24,5,5,14550,140,5783
1100,서울특별시,1113,서대문구,,관내사전투표,6082,6082,3523,2352,136,5,22,0,0,1,2,11,2,1,6055,27,0
1100,서울특별시,1113,서대문구,,홍은제2동제1투,2568,1303,546,668,53,2,13,0,0,0,6,2,0,0,1290,13,1265
1100,서울특별시,1113,서대문구,,홍은제2동제2투,1951,1283,520,701,37,1,5,1,0,0,0,1,0,1,1267,16,668
1100,서울특별시,1113,서대문구,,홍은제2동제3투,2895,1989,892,982,70,0,12,0,0,0,5,3,2,0,1966,23,906
1100,서울특별시,1113,서대문구,,홍은제2동제4투,2321,1419,703,632,46,1,14,0,0,1,0,4,1,0,1402,17,902
1100,서울특별시,1113,서대문구,,홍은제2동제5투,2421,1265,586,600,33,1,16,1,1,0,2,3,0,3,1246,19,1156
1100,서울특별시,1113,서대문구,,홍은제2동제6투,2235,1349,570,694,41,0,10,2,3,0,4,0,0,0,1324,25,886
1100,서울특별시,1113,서대문구,남가좌제1동,소계,12944,10741,4982,5306,328,3,31,3,1,1,3,14,2,1,10675,66,2203
1100,서울특별시,1113,서대문구,,관내사전투표,5545,5545,2899,2449,147,1,10,0,1,0,1,9,2,0,5519,26,0
1100,서울특별시,1113,서대문구,,남가좌제1동제1투,2021,1375,507,802,47,1,5,0,0,1,1,1,0,0,1365,10,646
1100,서울특별시,1113,서대문구,,남가좌제1동제2투,1828,1339,543,739,44,1,3,0,0,0,0,0,0,0,1330,9,489
1100,서울특별시,1113,서대문구,,남가좌제1동제3투,2223,1604,713,808,57,0,8,1,0,0,0,4,0,1,1592,12,619
1100,서울특별시,1113,서대문구,,남가좌제1동제4투,1327,878,320,508,33,0,5,2,0,0,1,0,0,0,869,9,449
1100,서울특별시,1113,서대문구,남가좌제2동,소계,22063,16900,8158,7939,524,8,71,4,6,1,13,11,7,5,16747,153,5163
1100,서울특별시,1113,서대문구,,관내사전투표,6309,6309,3560,2519,162,5,12,3,0,0,1,4,1,2,6269,40,0
1100,서울특별시,1113,서대문구,,남가좌제2동제1투,2063,1092,495,518,51,2,7,0,0,0,2,1,2,0,1078,14,971
1100,서울특별시,1113,서대문구,,남가좌제2동제2투,1818,1134,536,536,32,0,8,1,1,1,0,1,1,0,1117,17,684
1100,서울특별시,1113,서대문구,,남가좌제2동제3투,2187,1556,621,870,44,0,4,0,0,0,2,1,0,0,1542,14,631
1100,서울특별시,1113,서대문구,,남가좌제2동제4투,2828,2130,911,1123,74,1,9,0,1,0,1,0,0,2,2122,8,698
1100,서울특별시,1113,서대문구,,남가좌제2동제5투,2885,2168,931,1136,62,0,11,0,3,0,1,1,0,0,2145,23,717
1100,서울특별시,1113,서대문구,,남가좌제2동제6투,1920,1136,520,527,40,0,15,0,1,0,5,2,2,1,1113,23,784
1100,서울특별시,1113,서대문구,,남가좌제2동제7투,2053,1375,584,710,59,0,5,0,0,0,1,1,1,0,1361,14,678
1100,서울특별시,1113,서대문구,북가좌제1동,소계,15075,12253,5719,6021,351,4,47,2,1,2,7,4,2,4,12164,89,2822
1100,서울특별시,1113,서대문구,,관내사전투표,6397,6397,3397,2778,167,2,18,1,0,1,3,2,2,2,6373,24,0
1100,서울특별시,1113,서대문구,,북가좌제1동제1투,1887,1265,492,714,42,0,6,0,0,0,3,0,0,0,1257,8,622
1100,서울특별시,1113,서대문구,,북가좌제1동제2투,1485,922,401,469,29,1,10,0,0,1,1,1,0,0,913,9,563
1100,서울특별시,1113,서대문구,,북가좌제1동제3투,1670,1097,446,594,35,0,2,0,1,0,0,1,0,0,1079,18,573
1100,서울특별시,1113,서대문구,,북가좌제1동제4투,2210,1568,615,868,57,0,9,1,0,0,0,0,0,2,1552,16,642
1100,서울특별시,1113,서대문구,,북가좌제1동제5투,1426,1004,368,598,21,1,2,0,0,0,0,0,0,0,990,14,422
1100,서울특별시,1113,서대문구,북가좌제2동,소계,24157,17433,9031,7548,514,10,89,4,2,3,18,12,6,11,17248,185,6724
1100,서울특별시,1113,서대문구,,관내사전투표,6230,6230,3669,2333,156,0,23,1,0,0,2,6,4,1,6195,35,0
1100,서울특별시,1113,서대문구,,북가좌제2동제1투,2958,1720,836,790,45,3,18,1,0,1,2,1,0,1,1698,22,1238
1100,서울특별시,1113,서대문구,,북가좌제2동제2투,2500,1508,739,699,43,2,9,0,0,0,3,1,1,1,1498,10,992
1100,서울특별시,1113,서대문구,,북가좌제2동제3투,1964,1202,563,583,32,0,5,0,0,0,4,1,0,0,1188,14,762
1100,서울특별시,1113,서대문구,,북가좌제2동제4투,2530,1850,761,983,66,1,2,0,0,0,0,0,0,3,1816,34,680
1100,서울특별시,1113,서대문구,,북가좌제2동제5투,2301,1493,763,636,51,0,15,0,0,1,4,0,0,0,1470,23,808
1100,서울특별시,1113,서대문구,,북가좌제2동제6투,2567,1441,686,664,53,3,6,2,2,0,1,1,1,3,1422,19,1126
1100,서울특별시,1113,서대문구,,북가좌제2동제7투,3107,1989,1014,860,68,1,11,0,0,1,2,2,0,2,1961,28,1118
1100,서울특별시,1113,서대문구,잘못 투입·구분된 투표지,,0,2,0,2,0,0,0,0,0,0,0,0,0,0,2,0,-2
1100,서울특별시,1114,마포구,합계,,324091,256218,117916,124327,9308,180,1174,71,34,75,160,201,50,58,253554,2664,67873
1100,서울특별시,1114,마포구,거소·선상투표,,438,422,152,205,8,0,5,0,0,1,2,0,1,0,374,48,16
1100,서울특별시,1114,마포구,관외사전투표,,34702,34699,17027,15755,1322,25,188,7,2,9,7,40,9,11,34402,297,3
1100,서울특별시,1114,마포구,재외투표,,3563,2588,1339,919,89,0,2,2,0,1,2,0,0,0,2354,234,975
1100,서울특별시,1114,마포구,공덕동,소계,25890,18833,8282,9631,598,8,75,1,3,5,14,15,5,3,18640,193,7057
1100,서울특별시,1114,마포구,,관내사전투표,5179,5179,2718,2264,136,1,15,1,0,0,2,6,1,1,5145,34,0
1100,서울특별시,1114,마포구,,공덕동제1투,2423,1534,700,757,45,1,10,0,0,2,4,3,0,0,1522,12,889
1100,서울특별시,1114,마포구,,공덕동제2투,2812,1958,668,1199,66,2,2,0,0,0,1,0,0,0,1938,20,854
1100,서울특별시,1114,마포구,,공덕동제3투,1860,1112,514,527,44,1,5,0,1,0,3,0,0,0,1095,17,748
1100,서울특별시,1114,마포구,,공덕동제4투,1976,1171,603,493,31,1,11,0,2,0,0,1,2,1,1145,26,805
1100,서울특별시,1114,마포구,,공덕동제5투,2259,1548,758,710,53,0,11,0,0,0,1,2,0,0,1535,13,711
1100,서울특별시,1114,마포구,,공덕동제6투,1817,1125,457,615,31,1,3,0,0,0,1,1,1,1,1111,14,692
1100,서울특별시,1114,마포구,,공덕동제7투,2284,1455,581,773,67,0,9,0,0,0,0,0,0,0,1430,25,829
1100,서울특별시,1114,마포구,,공덕동제8투,2420,1793,591,1122,61,1,3,0,0,2,0,0,1,0,1781,12,627
1100,서울특별시,1114,마포구,,공덕동제9투,2860,1958,692,1171,64,0,6,0,0,1,2,2,0,0,1938,20,902
1100,서울특별시,1114,마포구,아현동,소계,19432,15528,6000,8881,465,11,44,0,2,4,4,9,1,1,15422,106,3904
1100,서울특별시,1114,마포구,,관내사전투표,6317,6315,2873,3218,166,6,15,0,0,0,2,3,1,0,6284,31,2
1100,서울특별시,1114,마포구,,아현동제1투,2401,1505,535,893,58,2,3,0,2,0,0,0,0,0,1493,12,896
1100,서울특별시,1114,마포구,,아현동제2투,1762,1189,400,731,36,0,8,0,0,1,1,1,0,0,1178,11,573
1100,서울특별시,1114,마포구,,아현동제3투,2161,1561,532,956,56,0,1,0,0,1,1,1,0,0,1548,13,600
1100,서울특별시,1114,마포구,,아현동제4투,1153,695,249,408,25,0,5,0,0,1,0,1,0,1,690,5,458
1100,서울특별시,1114,마포구,,아현동제5투,2582,1972,650,1247,56,0,4,0,0,1,0,1,0,0,1959,13,610
1100,서울특별시,1114,마포구,,아현동제6투,3056,2291,761,1428,68,3,8,0,0,0,0,2,0,0,2270,21,765
1100,서울특별시,1114,마포구,도화동,소계,17835,14536,5842,8017,443,6,56,7,3,12,9,6,3,0,14404,132,3299
1100,서울특별시,1114,마포구,,관내사전투표,6279,6279,2951,3087,177,3,14,2,2,3,1,3,1,0,6244,35,0
1100,서울특별시,1114,마포구,,도화동제1투,1785,1026,426,530,46,0,7,1,0,1,0,0,0,0,1011,15,759
1100,서울특별시,1114,마포구,,도화동제2투,1644,1162,343,770,28,1,3,0,0,3,2,0,1,0,1151,11,482
1100,서울특별시,1114,마포구,,도화동제3투,1481,1154,335,765,33,0,3,0,0,3,0,0,1,0,1140,14,327
1100,서울특별시,1114,마포구,,도화동제4투,1477,1159,435,663,39,1,5,1,0,0,0,1,0,0,1145,14,318
1100,서울특별시,1114,마포구,,도화동제5투,1427,899,370,474,24,0,10,3,1,1,3,0,0,0,886,13,528
1100,서울특별시,1114,마포구,,도화동제6투,2022,1606,502,1030,49,1,6,0,0,0,3,1,0,0,1592,14,416
1100,서울특별시,1114,마포구,,도화동제7투,1720,1251,480,698,47,0,8,0,0,1,0,1,0,0,1235,16,469
1100,서울특별시,1114,마포구,용강동,소계,16028,12799,5222,7015,376,4,48,3,1,4,10,10,3,1,12697,102,3229
1100,서울특별시,1114,마포구,,관내사전투표,5680,5680,2774,2721,151,0,7,1,0,0,0,3,0,0,5657,23,0
1100,서울특별시,1114,마포구,,용강동제1투,2186,1411,482,865,39,0,7,1,0,1,2,1,2,0,1400,11,775
1100,서울특별시,1114,마포구,,용강동제2투,1817,1184,399,721,33,0,9,0,0,0,1,4,0,0,1167,17,633
1100,서울특별시,1114,마포구,,용강동제3투,2588,1774,554,1125,63,2,8,0,0,2,4,0,0,0,1758,16,814
1100,서울특별시,1114,마포구,,용강동제4투,1808,1367,483,812,43,2,4,0,0,1,3,1,1,0,1350,17,441
1100,서울특별시,1114,마포구,,용강동제5투,1949,1383,530,771,47,0,13,1,1,0,0,1,0,1,1365,18,566
1100,서울특별시,1114,마포구,대흥동,소계,11115,7998,3417,4136,281,2,37,1,3,4,8,6,2,3,7900,98,3117
1100,서울특별시,1114,마포구,,관내사전투표,3203,3203,1588,1458,107,0,13,1,0,1,0,2,0,2,3172,31,0
1100,서울특별시,1114,마포구,,대흥동제1투,1782,1135,428,661,29,1,3,0,1,0,1,0,1,0,1125,10,647
1100,서울특별시,1114,마포구,,대흥동제2투,1738,1275,436,789,37,0,2,0,1,1,1,0,1,0,1268,7,463
1100,서울특별시,1114,마포구,,대흥동제3투,2269,1171,470,601,59,1,10,0,0,2,3,2,0,0,1148,23,1098
1100,서울특별시,1114,마포구,,대흥동제4투,2123,1214,495,627,49,0,9,0,1,0,3,2,0,1,1187,27,909
1100,서울특별시,1114,마포구,염리동,소계,13121,10229,4445,5324,309,9,35,2,2,2,9,6,2,3,10148,81,2892
1100,서울특별시,1114,마포구,,관내사전투표,4644,4644,2322,2152,114,4,20,1,0,0,3,2,0,1,4619,25,0
1100,서울특별시,1114,마포구,,염리동제1투,1619,848,307,489,33,3,2,1,0,0,1,0,0,2,838,10,771
1100,서울특별시,1114,마포구,,염리동제2투,3229,2202,796,1302,72,2,4,0,1,0,0,1,0,0,2178,24,1027
1100,서울특별시,1114,마포구,,염리동제3투,2266,1591,651,850,61,0,5,0,1,2,3,3,0,0,1576,15,675
1100,서울특별시,1114,마포구,,염리동제4투,1363,944,369,531,29,0,4,0,0,0,2,0,2,0,937,7,419
1100,서울특별시,1114,마포구,신수동,소계,16332,12632,5284,6745,402,6,52,6,0,2,8,12,2,6,12525,107,3700
1100,서울특별시,1114,마포구,,관내사전투표,5276,5276,2655,2428,128,1,26,0,0,0,1,6,0,2,5247,29,0
1100,서울특별시,1114,마포구,,신수동제1투,2119,1317,543,693,53,1,5,0,0,0,1,0,0,1,1297,20,802
1100,서울특별시,1114,마포구,,신수동제2투,1289,856,298,512,28,2,3,0,0,0,3,0,2,0,848,8,433
1100,서울특별시,1114,마포구,,신수동제3투,2661,1734,586,1055,66,1,4,4,0,0,1,1,0,0,1718,16,927
1100,서울특별시,1114,마포구,,신수동제4투,2566,1700,598,1002,65,1,7,1,0,0,1,5,0,1,1681,19,866
1100,서울특별시,1114,마포구,,신수동제5투,2421,1749,604,1055,62,0,7,1,0,2,1,0,0,2,1734,15,672
1100,서울특별시,1114,마포구,서강동,소계,19925,15596,6603,8191,558,8,58,3,5,3,8,10,2,2,15451,145,4329
1100,서울특별시,1114,마포구,,관내사전투표,6240,6239,3099,2877,196,3,19,1,1,0,2,4,0,0,6202,37,1
1100,서울특별시,1114,마포구,,서강동제1투,1827,1119,426,604,49,2,7,1,1,0,2,0,0,1,1093,26,708
1100,서울특별시,1114,마포구,,서강동제2투,2198,1602,590,928,58,1,9,0,1,0,1,0,0,0,1588,14,596
1100,서울특별시,1114,마포구,,서강동제3투,2552,1716,675,928,74,0,9,1,1,0,0,3,1,1,1693,23,836
1100,서울특별시,1114,마포구,,서강동제4투,2132,1385,549,769,46,0,2,0,0,1,1,1,1,0,1370,15,747
1100,서울특별시,1114,마포구,,서강동제5투,2233,1557,659,793,74,1,4,0,1,0,2,2,0,0,1536,21,676
1100,서울특별시,1114,마포구,,서강동제6투,2743,1978,605,1292,61,1,8,0,0,2,0,0,0,0,1969,9,765
1100,서울특별시,1114,마포구,서교동,소계,19355,13774,6412,6447,614,18,66,6,1,4,7,13,2,1,13591,183,5581
1100,서울특별시,1114,마포구,,관내사전투표,5219,5219,3013,1937,211,6,13,2,0,0,1,4,0,0,5187,32,0
1100,서울특별시,1114,마포구,,서교동제1투,2277,1425,517,761,88,2,12,1,0,0,2,1,0,0,1384,41,852
1100,서울특별시,1114,마포구,,서교동제2투,2611,1589,559,933,62,1,11,0,0,1,0,0,1,0,1568,21,1022
1100,서울특별시,1114,마포구,,서교동제3투,1935,1169,501,600,45,1,4,1,0,1,0,1,0,1,1155,14,766
1100,서울특별시,1114,마포구,,서교동제4투,2474,1370,634,618,89,3,7,1,0,0,1,1,0,0,1354,16,1104
1100,서울특별시,1114,마포구,,서교동제5투,1343,803,302,443,31,2,5,0,0,0,2,1,0,0,786,17,540
1100,서울특별시,1114,마포구,,서교동제6투,1458,924,336,521,45,2,5,1,0,2,1,1,0,0,914,10,534
1100,서울특별시,1114,마포구,,서교동제7투,2038,1275,550,634,43,1,9,0,1,0,0,4,1,0,1243,32,763
1100,서울특별시,1114,마포구,합정동,소계,15631,12133,5808,5536,559,7,61,1,2,4,16,10,0,4,12008,125,3498
1100,서울특별시,1114,마포구,,관내사전투표,5935,5935,3199,2359,288,3,25,1,0,2,1,7,0,2,5887,48,0
1100,서울특별시,1114,마포구,,합정동제1투,1722,1164,517,566,52,0,10,0,1,1,3,0,0,2,1152,12,558
1100,서울특별시,1114,마포구,,합정동제2투,1772,1095,481,532,63,1,3,0,0,0,1,0,0,0,1081,14,677
1100,서울특별시,1114,마포구,,합정동제3투,2539,1552,607,857,58,2,7,0,0,0,5,0,0,0,1536,16,987
1100,서울특별시,1114,마포구,,합정동제4투,1755,1164,485,602,45,0,9,0,0,1,2,2,0,0,1146,18,591
1100,서울특별시,1114,마포구,,합정동제5투,1908,1223,519,620,53,1,7,0,1,0,4,1,0,0,1206,17,685
1100,서울특별시,1114,마포구,망원1동,소계,17069,12973,6625,5526,562,12,72,7,2,2,9,10,3,5,12835,138,4096
1100,서울특별시,1114,마포구,,관내사전투표,6269,6267,3532,2378,270,4,27,3,1,2,1,4,1,4,6227,40,2
1100,서울특별시,1114,마포구,,망원1동제1투,1919,1021,473,469,48,0,9,0,0,0,1,1,0,0,1001,20,898
1100,서울특별시,1114,마포구,,망원1동제2투,2324,1472,735,635,64,2,11,1,1,0,1,3,0,1,1454,18,852
1100,서울특별시,1114,마포구,,망원1동제3투,2040,1231,609,520,67,2,7,0,0,0,1,2,0,0,1208,23,809
1100,서울특별시,1114,마포구,,망원1동제4투,2572,1677,744,830,67,2,12,0,0,0,4,0,0,0,1659,18,895
1100,서울특별시,1114,마포구,,망원1동제5투,1945,1305,532,694,46,2,6,3,0,0,1,0,2,0,1286,19,640
1100,서울특별시,1114,마포구,망원2동,소계,14842,11451,5998,4795,424,7,65,1,1,6,4,8,3,1,11313,138,3391
1100,서울특별시,1114,마포구,,관내사전투표,5066,5066,3048,1773,173,4,28,0,1,1,1,3,0,0,5032,34,0
1100,서울특별시,1114,마포구,,망원2동제1투,2029,1248,570,588,52,1,8,0,0,2,0,1,1,1,1224,24,781
1100,서울특별시,1114,마포구,,망원2동제2투,1675,1135,547,504,53,1,10,0,0,1,0,0,0,0,1116,19,540
1100,서울특별시,1114,마포구,,망원2동제3투,2199,1409,649,669,55,1,10,0,0,1,1,2,2,0,1390,19,790
1100,서울특별시,1114,마포구,,망원2동제4투,2153,1393,663,651,44,0,6,0,0,0,2,2,0,0,1368,25,760
1100,서울특별시,1114,마포구,,망원2동제5투,1720,1200,521,610,47,0,3,1,0,1,0,0,0,0,1183,17,520
1100,서울특별시,1114,마포구,연남동,소계,13113,9854,4730,4471,442,15,65,6,1,4,6,9,2,1,9752,102,3259
1100,서울특별시,1114,마포구,,관내사전투표,4462,4462,2488,1722,194,5,16,2,0,1,0,3,1,0,4432,30,0
1100,서울특별시,1114,마포구,,연남동제1투,1935,1082,448,542,56,0,13,1,1,0,2,2,0,0,1065,17,853
1100,서울특별시,1114,마포구,,연남동제2투,1569,980,397,520,37,0,8,1,0,0,0,1,0,0,964,16,589
1100,서울특별시,1114,마포구,,연남동제3투,2475,1562,628,819,76,2,11,1,0,1,0,1,1,1,1541,21,913
1100,서울특별시,1114,마포구,,연남동제4투,2672,1768,769,868,79,8,17,1,0,2,4,2,0,0,1750,18,904
1100,서울특별시,1114,마포구,성산1동,소계,14998,11182,5762,4703,502,9,65,10,3,1,6,9,3,3,11076,106,3816
1100,서울특별시,1114,마포구,,관내사전투표,4909,4909,2852,1760,223,5,21,3,0,1,0,4,1,2,4872,37,0
1100,서울특별시,1114,마포구,,성산1동제1투,1941,1113,514,523,44,2,6,1,1,0,2,2,1,0,1096,17,828
1100,서울특별시,1114,마포구,,성산1동제2투,2317,1595,821,679,66,0,10,1,0,0,0,1,1,0,1579,16,722
1100,서울특별시,1114,마포구,,성산1동제3투,1566,893,376,441,49,0,11,0,0,0,4,1,0,1,883,10,673
1100,서울특별시,1114,마포구,,성산1동제4투,2171,1367,612,674,58,1,7,1,1,0,0,0,0,0,1354,13,804
1100,서울특별시,1114,마포구,,성산1동제5투,2094,1305,587,626,62,1,10,4,1,0,0,1,0,0,1292,13,789
1100,서울특별시,1114,마포구,성산2동,소계,28563,21482,10423,9929,757,21,97,6,2,3,22,18,5,4,21287,195,7081
1100,서울특별시,1114,마포구,,관내사전투표,6935,6935,3879,2797,193,7,25,0,1,2,2,5,1,0,6912,23,0
1100,서울특별시,1114,마포구,,성산2동제1투,2209,1578,644,843,57,2,9,1,0,0,3,1,2,1,1563,15,631
1100,서울특별시,1114,마포구,,성산2동제2투,2759,1880,835,943,69,2,14,0,0,0,2,0,1,0,1866,14,879
1100,서울특별시,1114,마포구,,성산2동제3투,2361,1299,606,617,50,1,4,1,1,0,2,1,0,0,1283,16,1062
1100,서울특별시,1114,마포구,,성산2동제4투,2430,1709,759,834,75,1,11,1,0,1,3,3,0,0,1688,21,721
1100,서울특별시,1114,마포구,,성산2동제5투,2803,1806,898,744,116,0,1,0,0,0,0,1,0,0,1760,46,997
1100,서울특별시,1114,마포구,,성산2동제6투,2418,1557,793,690,36,3,11,0,0,0,1,4,1,1,1540,17,861
1100,서울특별시,1114,마포구,,성산2동제7투,2132,1597,721,795,54,1,6,0,0,0,2,2,0,2,1583,14,535
1100,서울특별시,1114,마포구,,성산2동제8투,2384,1608,685,840,51,4,8,1,0,0,5,0,0,0,1594,14,776
1100,서울특별시,1114,마포구,,성산2동제9투,2132,1513,603,826,56,0,8,2,0,0,2,1,0,0,1498,15,619
1100,서울특별시,1114,마포구,상암동,소계,22139,17505,8544,8098,597,12,83,2,1,4,9,10,2,9,17371,134,4634
1100,서울특별시,1114,마포구,,관내사전투표,6121,6116,3369,2514,173,4,17,1,0,2,2,3,1,4,6090,26,5
1100,서울특별시,1114,마포구,,상암동제1투,2252,1331,535,689,68,3,14,0,0,1,0,0,1,1,1312,19,921
1100,서울특별시,1114,마포구,,상암동제2투,1943,1278,547,655,45,3,10,0,0,0,1,3,0,2,1266,12,665
1100,서울특별시,1114,마포구,,상암동제3투,1682,1272,522,686,54,0,0,0,0,0,0,0,0,0,1262,10,410
1100,서울특별시,1114,마포구,,상암동제4투,2661,2074,791,1208,56,1,2,0,0,0,0,0,0,1,2059,15,587
1100,서울특별시,1114,마포구,,상암동제5투,2303,1697,804,797,62,0,15,1,0,0,0,2,0,0,1681,16,606
1100,서울특별시,1114,마포구,,상암동제6투,2475,1770,987,688,60,1,11,0,1,0,3,1,0,1,1753,17,705
1100,서울특별시,1114,마포구,,상암동제7투,2702,1967,989,861,79,0,14,0,0,1,3,1,0,0,1948,19,735
1100,서울특별시,1114,마포구,잘못 투입·구분된 투표지,,0,4,1,3,0,0,0,0,0,0,0,0,0,0,4,0,-4
1100,서울특별시,1115,양천구,합계,,378710,301379,138586,149780,7821,169,1646,75,39,81,213,181,55,94,298740,2639,77331
1100,서울특별시,1115,양천구,거소·선상투표,,529,501,200,223,9,1,8,0,1,0,0,1,0,0,443,58,28
1100,서울특별시,1115,양천구,관외사전투표,,35094,35087,17221,16166,963,39,270,16,3,7,15,53,3,21,34777,310,7
1100,서울특별시,1115,양천구,재외투표,,3097,2303,1225,802,72,0,3,0,0,0,0,1,0,0,2103,200,794
1100,서울특별시,1115,양천구,목1동,소계,21444,17429,6574,10253,406,5,51,1,3,2,12,3,2,2,17314,115,4015
1100,서울특별시,1115,양천구,,관내사전투표,6701,6701,2995,3531,129,2,14,1,0,0,2,1,0,2,6677,24,0
1100,서울특별시,1115,양천구,,목1동제1투,2338,1586,494,1029,47,0,1,0,1,0,1,0,0,0,1573,13,752
1100,서울특별시,1115,양천구,,목1동제2투,2451,1800,584,1151,45,0,4,0,0,0,0,0,0,0,1784,16,651
1100,서울특별시,1115,양천구,,목1동제3투,2774,1992,820,1088,47,1,16,0,0,0,4,0,0,0,1976,16,782
1100,서울특별시,1115,양천구,,목1동제4투,2226,1715,587,1054,42,0,5,0,0,0,4,1,0,0,1693,22,511
1100,서울특별시,1115,양천구,,목1동제5투,2541,1855,597,1181,56,1,7,0,1,2,0,0,0,0,1845,10,686
1100,서울특별시,1115,양천구,,목1동제6투,2413,1780,497,1219,40,1,4,0,1,0,1,1,2,0,1766,14,633
1100,서울특별시,1115,양천구,목2동,소계,23538,18212,8723,8542,590,9,107,8,2,6,24,6,7,2,18026,186,5326
1100,서울특별시,1115,양천구,,관내사전투표,7961,7962,4398,3222,242,2,30,3,0,1,7,3,3,1,7912,50,-1
1100,서울특별시,1115,양천구,,목2동제1투,2118,1215,509,644,35,0,10,0,0,0,3,1,0,0,1202,13,903
1100,서울특별시,1115,양천구,,목2동제2투,2091,1341,505,741,53,1,12,1,0,2,2,0,2,0,1319,22,750
1100,서울특별시,1115,양천구,,목2동제3투,2228,1515,654,753,57,2,18,1,0,1,4,0,1,0,1491,24,713
1100,서울특별시,1115,양천구,,목2동제4투,2143,1517,631,810,48,1,8,0,0,0,1,0,0,0,1499,18,626
1100,서울특별시,1115,양천구,,목2동제5투,1548,1029,460,508,35,0,6,1,1,0,3,0,0,1,1015,14,519
1100,서울특별시,1115,양천구,,목2동제6투,1638,1122,484,577,38,2,5,2,0,1,1,1,0,0,1111,11,516
1100,서울특별시,1115,양천구,,목2동제7투,1949,1256,547,637,40,0,9,0,0,1,2,0,0,0,1236,20,693
1100,서울특별시,1115,양천구,,목2동제8투,1862,1255,535,650,42,1,9,0,1,0,1,1,1,0,1241,14,607
1100,서울특별시,1115,양천구,목3동,소계,16882,12567,5798,6150,375,4,74,3,3,2,13,7,5,2,12436,131,4315
1100,서울특별시,1115,양천구,,관내사전투표,5881,5880,3158,2497,163,1,19,2,1,0,2,3,1,0,5847,33,1
1100,서울특별시,1115,양천구,,목3동제1투,1995,1435,418,968,27,0,5,0,0,0,1,0,0,1,1420,15,560
1100,서울특별시,1115,양천구,,목3동제2투,2412,1432,589,731,60,1,16,0,0,1,3,0,1,0,1402,30,980
1100,서울특별시,1115,양천구,,목3동제3투,2211,1253,502,675,42,2,6,0,0,1,5,1,1,0,1235,18,958
1100,서울특별시,1115,양천구,,목3동제4투,2275,1327,572,676,39,0,16,1,1,0,2,1,0,1,1309,18,948
1100,서울특별시,1115,양천구,,목3동제5투,2108,1240,559,603,44,0,12,0,1,0,0,2,2,0,1223,17,868
1100,서울특별시,1115,양천구,목4동,소계,20139,15555,7415,7520,386,8,77,2,1,8,12,10,4,17,15460,95,4584
1100,서울특별시,1115,양천구,,관내사전투표,7163,7163,3798,3156,144,2,22,1,0,3,2,2,1,1,7132,31,0
1100,서울특별시,1115,양천구,,목4동제1투,1995,1219,471,686,46,0,3,0,0,0,1,0,0,0,1207,12,776
1100,서울특별시,1115,양천구,,목4동제2투,1903,1104,472,585,25,0,4,0,1,0,3,0,0,14,1104,0,799
1100,서울특별시,1115,양천구,,목4동제3투,2316,1511,652,790,43,2,9,0,0,1,0,0,1,0,1498,13,805
1100,서울특별시,1115,양천구,,목4동제4투,2157,1369,612,675,44,0,15,1,0,0,2,3,1,0,1353,16,788
1100,서울특별시,1115,양천구,,목4동제5투,2159,1479,659,748,33,2,16,0,0,3,4,2,0,0,1467,12,680
1100,서울특별시,1115,양천구,,목4동제6투,2446,1710,751,880,51,2,8,0,0,1,0,3,1,2,1699,11,736
1100,서울특별시,1115,양천구,목5동,소계,28006,23149,7936,14478,526,4,44,6,0,12,7,8,2,2,23025,124,4857
1100,서울특별시,1115,양천구,,관내사전투표,9024,9024,3906,4896,180,1,13,2,0,1,0,3,0,1,9003,21,0
1100,서울특별시,1115,양천구,,목5동제1투,1929,1325,368,913,29,0,5,1,0,1,0,1,0,0,1318,7,604
1100,서울특별시,1115,양천구,,목5동제2투,2501,1887,593,1230,42,1,4,1,0,1,0,2,0,0,1874,13,614
1100,서울특별시,1115,양천구,,목5동제3투,2209,1542,379,1099,46,1,4,0,0,1,0,0,0,1,1531,11,667
1100,서울특별시,1115,양천구,,목5동제4투,2058,1642,406,1166,45,1,6,0,0,0,3,0,0,0,1627,15,416
1100,서울특별시,1115,양천구,,목5동제5투,2172,1476,428,1008,31,0,1,1,0,0,1,1,0,0,1471,5,696
1100,서울특별시,1115,양천구,,목5동제6투,1645,1286,378,860,31,0,1,0,0,6,3,1,0,0,1280,6,359
1100,서울특별시,1115,양천구,,목5동제7투,2226,1730,420,1253,36,0,4,0,0,1,0,0,0,0,1714,16,496
1100,서울특별시,1115,양천구,,목5동제8투,1953,1458,408,1003,31,0,4,1,0,0,0,0,1,0,1448,10,495
1100,서울특별시,1115,양천구,,목5동제9투,2289,1779,650,1050,55,0,2,0,0,1,0,0,1,0,1759,20,510
1100,서울특별시,1115,양천구,신월1동,소계,16840,11958,6256,5140,302,4,113,0,3,5,11,11,1,3,11849,109,4882
1100,서울특별시,1115,양천구,,관내사전투표,4566,4566,2675,1746,92,2,30,0,0,2,3,3,0,2,4555,11,0
1100,서울특별시,1115,양천구,,신월1동제1투,2721,1562,767,711,39,2,13,0,1,1,2,2,0,0,1538,24,1159
1100,서울특별시,1115,양천구,,신월1동제2투,2318,1314,610,615,47,0,16,0,1,0,1,2,0,1,1293,21,1004
1100,서울특별시,1115,양천구,,신월1동제3투,1904,1200,583,559,32,0,13,0,0,0,1,1,0,0,1189,11,704
1100,서울특별시,1115,양천구,,신월1동제4투,2460,1450,695,681,32,0,23,0,1,0,3,1,1,0,1437,13,1010
1100,서울특별시,1115,양천구,,신월1동제5투,2871,1866,926,828,60,0,18,0,0,2,1,2,0,0,1837,29,1005
1100,서울특별시,1115,양천구,신월2동,소계,14948,11163,5406,5286,276,9,68,9,0,0,7,4,2,3,11070,93,3785
1100,서울특별시,1115,양천구,,관내사전투표,4667,4667,2529,1983,106,3,16,3,0,0,2,1,0,2,4645,22,0
1100,서울특별시,1115,양천구,,신월2동제1투,1984,1185,551,576,29,1,6,1,0,0,2,2,0,0,1168,17,799
1100,서울특별시,1115,양천구,,신월2동제2투,1281,802,363,400,20,0,4,0,0,0,0,0,0,0,787,15,479
1100,서울특별시,1115,양천구,,신월2동제3투,2619,1787,707,1002,45,2,14,2,0,0,0,1,2,0,1775,12,832
1100,서울특별시,1115,양천구,,신월2동제4투,2375,1527,702,739,52,2,14,1,0,0,0,0,0,0,1510,17,848
1100,서울특별시,1115,양천구,,신월2동제5투,2022,1195,554,586,24,1,14,2,0,0,3,0,0,1,1185,10,827
1100,서울특별시,1115,양천구,신월3동,소계,11480,7645,3954,3321,183,5,76,3,1,2,14,9,1,2,7571,74,3835
1100,서울특별시,1115,양천구,,관내사전투표,3313,3313,1921,1279,65,2,20,2,0,1,3,3,0,1,3297,16,0
1100,서울특별시,1115,양천구,,신월3동제1투,2023,1038,482,497,26,0,14,0,0,0,6,2,0,0,1027,11,985
1100,서울특별시,1115,양천구,,신월3동제2투,2099,1147,549,526,40,1,8,0,0,0,3,2,0,0,1129,18,952
1100,서울특별시,1115,양천구,,신월3동제3투,1738,896,396,447,23,1,16,0,1,1,1,1,1,0,888,8,842
1100,서울특별시,1115,양천구,,신월3동제4투,2307,1251,606,572,29,1,18,1,0,0,1,1,0,1,1230,21,1056
1100,서울특별시,1115,양천구,신월4동,소계,14184,10829,5678,4665,285,5,74,4,2,2,6,4,5,9,10739,90,3355
1100,서울특별시,1115,양천구,,관내사전투표,5092,5092,3022,1902,110,1,11,3,1,0,2,2,2,4,5060,32,0
1100,서울특별시,1115,양천구,,신월4동제1투,2482,1534,688,763,49,1,16,0,0,0,2,1,0,4,1524,10,948
1100,서울특별시,1115,양천구,,신월4동제2투,2161,1383,650,665,37,0,17,1,1,0,1,1,1,1,1375,8,778
1100,서울특별시,1115,양천구,,신월4동제3투,2610,1679,782,796,52,2,20,0,0,0,1,0,2,0,1655,24,931
1100,서울특별시,1115,양천구,,신월4동제4투,1839,1141,536,539,37,1,10,0,0,2,0,0,0,0,1125,16,698
1100,서울특별시,1115,양천구,신월5동,소계,11955,8884,4533,3969,207,13,74,3,1,2,8,8,2,1,8821,63,3071
1100,서울특별시,1115,양천구,,관내사전투표,4725,4726,2615,1958,84,6,34,2,0,1,2,5,1,1,4709,17,-1
1100,서울특별시,1115,양천구,,신월5동제1투,2353,1419,634,704,43,3,14,1,0,0,1,2,0,0,1402,17,934
1100,서울특별시,1115,양천구,,신월5동제2투,2318,1288,603,618,40,1,11,0,1,0,2,1,0,0,1277,11,1030
1100,서울특별시,1115,양천구,,신월5동제3투,2559,1451,681,689,40,3,15,0,0,1,3,0,1,0,1433,18,1108
1100,서울특별시,1115,양천구,신월6동,소계,13265,11212,5394,5413,280,7,49,1,2,2,4,6,1,1,11160,52,2053
1100,서울특별시,1115,양천구,,관내사전투표,6588,6587,3502,2909,130,1,17,1,2,1,1,2,0,1,6567,20,1
1100,서울특별시,1115,양천구,,신월6동제1투,1581,1099,462,576,44,1,9,0,0,0,0,1,0,0,1093,6,482
1100,서울특별시,1115,양천구,,신월6동제2투,2014,1443,561,820,44,1,9,0,0,0,1,0,0,0,1436,7,571
1100,서울특별시,1115,양천구,,신월6동제3투,1145,783,407,339,20,2,6,0,0,0,2,0,1,0,777,6,362
1100,서울특별시,1115,양천구,,신월6동제4투,1937,1300,462,769,42,2,8,0,0,1,0,3,0,0,1287,13,637
1100,서울특별시,1115,양천구,신월7동,소계,16790,12474,6357,5577,313,6,79,2,2,5,3,13,2,2,12361,113,4316
1100,서울특별시,1115,양천구,,관내사전투표,5504,5502,3125,2186,124,2,21,1,2,1,1,10,1,0,5474,28,2
1100,서울특별시,1115,양천구,,신월7동제1투,1937,1000,477,463,33,1,7,0,0,2,0,0,1,0,984,16,937
1100,서울특별시,1115,양천구,,신월7동제2투,1966,1203,571,564,40,0,15,1,0,0,0,0,0,1,1192,11,763
1100,서울특별시,1115,양천구,,신월7동제3투,1661,974,436,495,25,2,6,0,0,0,1,0,0,0,965,9,687
1100,서울특별시,1115,양천구,,신월7동제4투,1543,886,384,451,25,1,15,0,0,0,1,1,0,0,878,8,657
1100,서울특별시,1115,양천구,,신월7동제5투,2141,1505,731,700,38,0,7,0,0,1,0,0,0,0,1477,28,636
1100,서울특별시,1115,양천구,,신월7동제6투,2038,1404,633,718,28,0,8,0,0,1,0,2,0,1,1391,13,634
1100,서울특별시,1115,양천구,신정1동,소계,15709,12977,5264,7224,320,4,39,2,1,3,12,5,1,4,12879,98,2732
1100,서울특별시,1115,양천구,,관내사전투표,6039,6039,3110,2762,113,2,13,1,0,0,4,4,1,0,6010,29,0
1100,서울특별시,1115,양천구,,신정1동제1투,2272,1453,565,817,46,0,7,0,0,0,1,0,0,1,1437,16,819
1100,서울특별시,1115,양천구,,신정1동제2투,2266,1612,544,979,56,1,8,1,1,2,2,0,0,3,1597,15,654
1100,서울특별시,1115,양천구,,신정1동제3투,1913,1472,361,1036,45,1,5,0,0,1,2,0,0,0,1451,21,441
1100,서울특별시,1115,양천구,,신정1동제4투,1808,1418,419,950,35,0,4,0,0,0,0,0,0,0,1408,10,390
1100,서울특별시,1115,양천구,,신정1동제5투,1411,983,265,680,25,0,2,0,0,0,3,1,0,0,976,7,428
1100,서울특별시,1115,양천구,신정2동,소계,16810,13851,6383,6942,340,6,45,1,4,3,11,4,3,5,13747,104,2959
1100,서울특별시,1115,양천구,,관내사전투표,7533,7532,3884,3425,158,4,13,0,0,1,3,4,1,0,7493,39,1
1100,서울특별시,1115,양천구,,신정2동제1투,2456,1585,644,862,49,0,5,1,2,0,5,0,0,3,1571,14,871
1100,서울특별시,1115,양천구,,신정2동제2투,2219,1568,647,849,33,0,7,0,2,1,2,0,2,1,1544,24,651
1100,서울특별시,1115,양천구,,신정2동제3투,2523,1750,686,998,45,0,6,0,0,0,1,0,0,1,1737,13,773
1100,서울특별시,1115,양천구,,신정2동제4투,2079,1416,522,808,55,2,14,0,0,1,0,0,0,0,1402,14,663
1100,서울특별시,1115,양천구,신정3동,소계,33094,24895,12036,11802,646,12,130,7,4,6,18,10,4,5,24680,215,8199
1100,서울특별시,1115,양천구,,관내사전투표,6278,6278,3502,2592,129,1,20,3,3,0,1,3,1,2,6257,21,0
1100,서울특별시,1115,양천구,,신정3동제1투,2312,1274,540,665,47,0,9,0,0,1,2,0,1,0,1265,9,1038
1100,서울특별시,1115,양천구,,신정3동제2투,1712,916,388,477,25,1,8,0,0,0,0,1,0,0,900,16,796
1100,서울특별시,1115,양천구,,신정3동제3투,2256,1639,652,885,64,2,10,0,0,1,2,0,0,0,1616,23,617
1100,서울특별시,1115,양천구,,신정3동제4투,2755,1698,797,816,42,2,15,1,0,1,2,1,1,0,1678,20,1057
1100,서울특별시,1115,양천구,,신정3동제5투,2499,1802,737,987,48,1,8,0,0,1,3,0,0,0,1785,17,697
1100,서울특별시,1115,양천구,,신정3동제6투,2239,1585,732,784,37,0,7,1,0,0,2,0,0,0,1563,22,654
1100,서울특별시,1115,양천구,,신정3동제7투,2167,1508,605,837,35,1,6,0,0,1,3,1,0,1,1490,18,659
1100,서울특별시,1115,양천구,,신정3동제8투,2359,1729,744,917,44,1,10,0,0,0,0,0,0,2,1718,11,630
1100,서울특별시,1115,양천구,,신정3동제9투,2563,1905,950,889,43,1,7,0,0,0,0,0,1,0,1891,14,658
1100,서울특별시,1115,양천구,,신정3동제10투,2480,1868,955,812,65,1,10,0,0,0,1,2,0,0,1846,22,612
1100,서울특별시,1115,양천구,,신정3동제11투,1777,1406,754,585,34,1,12,2,0,1,1,1,0,0,1391,15,371
1100,서울특별시,1115,양천구,,신정3동제12투,1697,1287,680,556,33,0,8,0,1,0,1,1,0,0,1280,7,410
1100,서울특별시,1115,양천구,신정4동,소계,25880,18902,9569,8410,545,11,135,6,2,8,14,13,6,7,18726,176,6978
1100,서울특별시,1115,양천구,,관내사전투표,6854,6856,3975,2655,161,4,21,3,1,0,5,2,1,3,6831,25,-2
1100,서울특별시,1115,양천구,,신정4동제1투,2820,1787,875,813,52,1,26,1,0,1,1,0,0,0,1770,17,1033
1100,서울특별시,1115,양천구,,신정4동제2투,2009,1242,553,606,33,1,14,0,0,2,1,3,1,0,1214,28,767
1100,서울특별시,1115,양천구,,신정4동제3투,2091,1134,484,578,40,1,16,1,0,2,0,1,1,0,1124,10,957
1100,서울특별시,1115,양천구,,신정4동제4투,2232,1513,636,795,53,1,5,0,1,1,3,1,0,0,1496,17,719
1100,서울특별시,1115,양천구,,신정4동제5투,2532,1719,831,778,63,2,19,0,0,0,1,3,1,2,1700,19,813
1100,서울특별시,1115,양천구,,신정4동제6투,2454,1543,781,683,45,0,14,1,0,0,0,0,0,1,1525,18,911
1100,서울특별시,1115,양천구,,신정4동제7투,2237,1390,668,637,54,1,5,0,0,1,1,0,2,1,1370,20,847
1100,서울특별시,1115,양천구,,신정4동제8투,2651,1718,766,865,44,0,15,0,0,1,2,3,0,0,1696,22,933
1100,서울특별시,1115,양천구,신정6동,소계,18049,15184,5679,8990,380,6,28,0,0,1,3,2,0,2,15091,93,2865
1100,서울특별시,1115,양천구,,관내사전투표,6106,6107,2759,3168,146,3,7,0,0,0,0,1,0,1,6085,22,-1
1100,서울특별시,1115,양천구,,신정6동제1투,1765,1242,350,835,37,1,3,0,0,0,1,0,0,0,1227,15,523
1100,서울특별시,1115,양천구,,신정6동제2투,1486,1075,309,734,22,1,0,0,0,1,0,0,0,0,1067,8,411
1100,서울특별시,1115,양천구,,신정6동제3투,2495,1987,599,1317,49,0,4,0,0,0,1,0,0,0,1970,17,508
1100,서울특별시,1115,양천구,,신정6동제4투,2413,1825,647,1119,45,0,3,0,0,0,1,0,0,1,1816,9,588
1100,서울특별시,1115,양천구,,신정6동제5투,2166,1730,623,1040,47,0,5,0,0,0,0,1,0,0,1716,14,436
1100,서울특별시,1115,양천구,,신정6동제6투,1618,1218,392,777,34,1,6,0,0,0,0,0,0,0,1210,8,400
1100,서울특별시,1115,양천구,신정7동,소계,20977,16594,6984,8903,417,11,101,1,4,5,19,3,4,4,16456,138,4383
1100,서울특별시,1115,양천구,,관내사전투표,5249,5249,2594,2500,103,3,19,0,2,0,0,0,1,3,5225,24,0
1100,서울특별시,1115,양천구,,신정7동제1투,1766,1114,345,706,44,1,3,0,1,1,2,0,0,0,1103,11,652
1100,서울특별시,1115,양천구,,신정7동제2투,2180,1670,653,933,63,1,6,1,0,0,0,0,0,0,1657,13,510
1100,서울특별시,1115,양천구,,신정7동제3투,2566,1743,773,904,29,1,14,0,0,0,1,1,1,0,1724,19,823
1100,서울특별시,1115,양천구,,신정7동제4투,2006,1461,512,888,37,1,8,0,1,0,2,1,0,0,1450,11,545
1100,서울특별시,1115,양천구,,신정7동제5투,1859,1304,565,659,31,2,24,0,0,3,4,1,1,1,1291,13,555
1100,서울특별시,1115,양천구,,신정7동제6투,1865,1287,574,640,30,1,17,0,0,1,7,0,0,0,1270,17,578
1100,서울특별시,1115,양천구,,신정7동제7투,1940,1522,528,923,46,1,4,0,0,0,3,0,1,0,1506,16,418
1100,서울특별시,1115,양천구,,신정7동제8투,1546,1244,440,750,34,0,6,0,0,0,0,0,0,0,1230,14,302
1100,서울특별시,1115,양천구,잘못 투입·구분된 투표지,,0,8,1,4,0,0,1,0,0,0,0,0,0,0,6,2,-8
1100,서울특별시,1116,강서구,합계,,504185,390247,190000,181510,11100,242,2458,91,59,95,297,328,79,117,386376,3871,113938
1100,서울특별시,1116,강서구,거소·선상투표,,767,733,307,316,9,1,12,0,1,0,0,1,1,1,649,84,34
1100,서울특별시,1116,강서구,관외사전투표,,46302,46268,23792,20126,1404,34,373,8,6,10,16,67,9,16,45861,407,34
1100,서울특별시,1116,강서구,재외투표,,3534,2586,1499,778,78,2,12,1,1,1,4,0,0,0,2376,210,948
1100,서울특별시,1116,강서구,염창동,소계,29526,23961,11265,11632,736,11,86,4,2,3,16,14,3,4,23776,185,5565
1100,서울특별시,1116,강서구,,관내사전투표,9337,9337,5096,3912,248,6,20,1,1,0,4,3,2,0,9293,44,0
1100,서울특별시,1116,강서구,,염창동제1투,2810,2024,817,1092,82,2,11,0,1,1,0,2,1,1,2010,14,786
1100,서울특별시,1116,강서구,,염창동제2투,2664,1979,759,1120,64,0,8,1,0,1,2,0,0,1,1956,23,685
1100,서울특별시,1116,강서구,,염창동제3투,2625,1905,837,979,60,0,8,0,0,0,0,1,0,1,1886,19,720
1100,서울특별시,1116,강서구,,염창동제4투,2153,1526,689,770,50,0,6,0,0,0,0,2,0,0,1517,9,627
1100,서울특별시,1116,강서구,,염창동제5투,1987,1245,544,644,33,0,9,0,0,0,2,1,0,0,1233,12,742
1100,서울특별시,1116,강서구,,염창동제6투,2865,2123,944,1064,68,1,10,2,0,1,5,3,0,1,2099,24,742
1100,서울특별시,1116,강서구,,염창동제7투,2152,1680,701,913,44,0,7,0,0,0,1,1,0,0,1667,13,472
1100,서울특별시,1116,강서구,,염창동제8투,2933,2142,878,1138,87,2,7,0,0,0,2,1,0,0,2115,27,791
1100,서울특별시,1116,강서구,등촌제1동,소계,19438,14661,6866,6984,534,8,71,4,3,3,2,10,2,6,14493,168,4777
1100,서울특별시,1116,강서구,,관내사전투표,6264,6264,3342,2638,213,3,13,0,0,3,0,4,2,2,6220,44,0
1100,서울특별시,1116,강서구,,등촌제1동제1투,3111,2167,951,1080,90,2,10,0,1,0,1,1,0,0,2136,31,944
1100,서울특별시,1116,강서구,,등촌제1동제2투,3305,2078,748,1216,58,1,19,0,1,0,1,1,0,1,2046,32,1227
1100,서울특별시,1116,강서구,,등촌제1동제3투,3887,2370,1064,1156,97,0,18,2,0,0,0,1,0,2,2340,30,1517
1100,서울특별시,1116,강서구,,등촌제1동제4투,2871,1782,761,894,76,2,11,2,1,0,0,3,0,1,1751,31,1089
1100,서울특별시,1116,강서구,등촌제2동,소계,16057,12221,5507,6183,335,7,50,4,2,2,15,11,1,2,12119,102,3836
1100,서울특별시,1116,강서구,,관내사전투표,5558,5557,2913,2450,130,2,17,4,1,1,2,5,1,1,5527,30,1
1100,서울특별시,1116,강서구,,등촌제2동제1투,2286,1356,612,668,49,2,5,0,0,0,4,1,0,0,1341,15,930
1100,서울특별시,1116,강서구,,등촌제2동제2투,2916,1725,707,912,61,0,15,0,1,0,0,2,0,0,1698,27,1191
1100,서울특별시,1116,강서구,,등촌제2동제3투,2590,1536,634,823,43,2,10,0,0,0,5,1,0,1,1519,17,1054
1100,서울특별시,1116,강서구,,등촌제2동제4투,2707,2047,641,1330,52,1,3,0,0,1,4,2,0,0,2034,13,660
1100,서울특별시,1116,강서구,등촌제3동,소계,25992,20048,9382,9729,556,14,101,2,3,6,26,20,5,8,19852,196,5944
1100,서울특별시,1116,강서구,,관내사전투표,7690,7690,4246,3187,168,4,24,1,0,1,2,7,1,2,7643,47,0
1100,서울특별시,1116,강서구,,등촌제3동제1투,2234,1411,646,687,32,1,11,0,0,1,2,1,1,1,1383,28,823
1100,서울특별시,1116,강서구,,등촌제3동제2투,2660,2042,827,1093,91,3,8,0,0,0,1,2,0,0,2025,17,618
1100,서울특별시,1116,강서구,,등촌제3동제3투,2586,1898,743,1068,61,0,5,0,1,2,3,3,0,1,1887,11,688
1100,서울특별시,1116,강서구,,등촌제3동제4투,1684,990,420,504,26,0,12,0,0,0,5,0,1,1,969,21,694
1100,서울특별시,1116,강서구,,등촌제3동제5투,1632,1061,468,534,28,1,8,0,1,0,3,4,0,0,1047,14,571
1100,서울특별시,1116,강서구,,등촌제3동제6투,2089,1227,501,647,36,2,12,1,0,1,4,1,0,1,1206,21,862
1100,서울특별시,1116,강서구,,등촌제3동제7투,2080,1449,583,809,39,1,6,0,0,1,2,0,0,0,1441,8,631
1100,서울특별시,1116,강서구,,등촌제3동제8투,1735,1069,475,535,22,2,8,0,1,0,4,1,2,2,1052,17,666
1100,서울특별시,1116,강서구,,등촌제3동제9투,1602,1211,473,665,53,0,7,0,0,0,0,1,0,0,1199,12,391
1100,서울특별시,1116,강서구,화곡본동,소계,25837,17596,9395,7214,541,12,163,9,3,9,13,33,5,3,17400,196,8241
1100,서울특별시,1116,강서구,,관내사전투표,6874,6874,4059,2539,184,3,29,6,1,2,1,13,3,0,6840,34,0
1100,서울특별시,1116,강서구,,화곡본동제1투,3074,1613,825,694,50,0,24,0,0,1,2,0,0,2,1598,15,1461
1100,서울특별시,1116,강서구,,화곡본동제2투,3537,1792,886,773,67,1,20,0,0,2,2,6,1,0,1758,34,1745
1100,서울특별시,1116,강서구,,화곡본동제3투,3244,1848,890,842,53,1,24,0,1,1,4,8,0,0,1824,24,1396
1100,서울특별시,1116,강서구,,화곡본동제4투,2921,1832,894,825,59,1,16,0,0,0,2,3,1,1,1802,30,1089
1100,서울특별시,1116,강서구,,화곡본동제5투,3035,1736,879,724,61,4,30,2,0,0,2,0,0,0,1702,34,1299
1100,서울특별시,1116,강서구,,화곡본동제6투,3152,1901,962,817,67,2,20,1,1,3,0,3,0,0,1876,25,1251
1100,서울특별시,1116,강서구,화곡제1동,소계,39832,26571,13584,11630,754,22,217,10,6,6,22,18,11,8,26288,283,13261
1100,서울특별시,1116,강서구,,관내사전투표,8165,8165,4698,3161,181,5,40,2,2,0,3,6,5,0,8103,62,0
1100,서울특별시,1116,강서구,,화곡제1동제1투,3976,2025,962,931,76,1,15,2,0,2,3,0,0,0,1992,33,1951
1100,서울특별시,1116,강서구,,화곡제1동제2투,3484,1944,927,881,76,0,25,2,1,0,4,2,0,0,1918,26,1540
1100,서울특별시,1116,강서구,,화곡제1동제3투,3970,2086,971,1004,62,5,16,0,0,0,2,1,0,1,2062,24,1884
1100,서울특별시,1116,강서구,,화곡제1동제4투,3451,2009,932,952,55,3,27,1,0,0,2,3,2,1,1978,31,1442
1100,서울특별시,1116,강서구,,화곡제1동제5투,2396,1532,719,733,55,0,12,0,0,0,0,1,0,0,1520,12,864
1100,서울특별시,1116,강서구,,화곡제1동제6투,2572,1427,734,618,48,2,10,1,0,0,0,2,0,1,1416,11,1145
1100,서울특별시,1116,강서구,,화곡제1동제7투,2788,1748,941,710,47,1,18,1,0,2,2,1,0,0,1723,25,1040
1100,서울특별시,1116,강서구,,화곡제1동제8투,2930,1932,948,875,52,1,26,0,0,1,4,1,1,4,1913,19,998
1100,서울특별시,1116,강서구,,화곡제1동제9투,2922,1774,843,841,50,3,12,1,1,1,1,0,1,1,1755,19,1148
1100,서울특별시,1116,강서구,,화곡제1동제10투,3178,1929,909,924,52,1,16,0,2,0,1,1,2,0,1908,21,1249
1100,서울특별시,1116,강서구,화곡제2동,소계,14068,10039,5393,4149,291,8,85,3,2,2,9,10,5,1,9958,81,4029
1100,서울특별시,1116,강서구,,관내사전투표,4864,4863,2846,1838,118,1,25,1,0,0,3,4,2,0,4838,25,1
1100,서울특별시,1116,강서구,,화곡제2동제1투,1581,918,425,437,25,1,13,0,0,0,1,4,0,0,906,12,663
1100,서울특별시,1116,강서구,,화곡제2동제2투,2104,1183,569,553,25,1,14,0,1,1,3,1,0,1,1169,14,921
1100,서울특별시,1116,강서구,,화곡제2동제3투,2790,1603,826,673,74,3,9,2,1,1,1,0,2,0,1592,11,1187
1100,서울특별시,1116,강서구,,화곡제2동제4투,2729,1472,727,648,49,2,24,0,0,0,1,1,1,0,1453,19,1257
1100,서울특별시,1116,강서구,화곡제3동,소계,19669,15626,7284,7651,442,6,89,1,4,2,7,8,2,5,15501,125,4043
1100,서울특별시,1116,강서구,,관내사전투표,6881,6881,3806,2808,188,3,33,0,2,0,2,4,0,0,6846,35,0
1100,서울특별시,1116,강서구,,화곡제3동제1투,2303,1384,630,675,51,0,12,0,0,2,1,3,0,0,1374,10,919
1100,서울특별시,1116,강서구,,화곡제3동제2투,2549,1477,630,757,44,0,14,0,0,0,1,0,0,3,1449,28,1072
1100,서울특별시,1116,강서구,,화곡제3동제3투,2775,1942,831,994,67,0,17,0,0,0,1,1,0,1,1912,30,833
1100,서울특별시,1116,강서구,,화곡제3동제4투,2629,2112,667,1381,46,1,5,1,1,0,1,0,1,0,2104,8,517
1100,서울특별시,1116,강서구,,화곡제3동제5투,2532,1830,720,1036,46,2,8,0,1,0,1,0,1,1,1816,14,702
1100,서울특별시,1116,강서구,화곡제4동,소계,17063,12274,6239,5457,337,9,102,1,0,3,10,5,5,3,12171,103,4789
1100,서울특별시,1116,강서구,,관내사전투표,6096,6096,3456,2415,147,4,30,1,0,1,1,5,2,2,6064,32,0
1100,서울특별시,1116,강서구,,화곡제4동제1투,2171,1202,533,602,32,1,5,0,0,1,5,0,1,1,1181,21,969
1100,서울특별시,1116,강서구,,화곡제4동제2투,2093,1131,513,569,33,1,11,0,0,0,0,0,0,0,1127,4,962
1100,서울특별시,1116,강서구,,화곡제4동제3투,2456,1244,540,622,43,2,17,0,0,0,3,0,1,0,1228,16,1212
1100,서울특별시,1116,강서구,,화곡제4동제4투,1895,1096,492,536,38,1,15,0,0,0,0,0,0,0,1082,14,799
1100,서울특별시,1116,강서구,,화곡제4동제5투,2352,1505,705,713,44,0,24,0,0,1,1,0,1,0,1489,16,847
1100,서울특별시,1116,강서구,화곡제6동,소계,21602,16269,7667,7796,490,9,111,2,3,2,17,12,0,6,16115,154,5333
1100,서울특별시,1116,강서구,,관내사전투표,7574,7574,4184,3069,217,3,39,2,2,0,1,9,0,3,7529,45,0
1100,서울특별시,1116,강서구,,화곡제6동제1투,3563,1972,870,961,88,0,16,0,0,0,5,2,0,1,1943,29,1591
1100,서울특별시,1116,강서구,,화곡제6동제2투,2295,1390,601,710,30,3,18,0,0,0,5,0,0,2,1369,21,905
1100,서울특별시,1116,강서구,,화곡제6동제3투,2276,1406,592,746,36,1,10,0,0,0,2,0,0,0,1387,19,870
1100,서울특별시,1116,강서구,,화곡제6동제4투,3729,2178,912,1133,73,2,24,0,1,2,4,1,0,0,2152,26,1551
1100,서울특별시,1116,강서구,,화곡제6동제5투,2165,1749,508,1177,46,0,4,0,0,0,0,0,0,0,1735,14,416
1100,서울특별시,1116,강서구,화곡제8동,소계,20926,15403,8362,6261,409,20,133,9,2,3,13,10,7,10,15239,164,5523
1100,서울특별시,1116,강서구,,관내사전투표,7600,7593,4553,2738,171,10,43,3,0,1,9,4,4,4,7540,53,7
1100,서울특별시,1116,강서구,,화곡제8동제1투,2888,1537,743,702,50,2,19,2,1,0,0,1,0,1,1521,16,1351
1100,서울특별시,1116,강서구,,화곡제8동제2투,2462,1487,707,689,45,2,18,1,0,0,1,0,0,1,1464,23,975
1100,서울특별시,1116,강서구,,화곡제8동제3투,2706,1559,741,725,51,0,16,1,1,0,2,2,1,2,1542,17,1147
1100,서울특별시,1116,강서구,,화곡제8동제4투,2475,1516,778,638,55,2,17,1,0,0,1,0,0,1,1493,23,959
1100,서울특별시,1116,강서구,,화곡제8동제5투,2795,1711,840,769,37,4,20,1,0,2,0,3,2,1,1679,32,1084
1100,서울특별시,1116,강서구,우장산동,소계,29317,22576,10098,11548,606,12,91,1,3,3,22,12,6,8,22410,166,6741
1100,서울특별시,1116,강서구,,관내사전투표,7262,7262,3722,3329,153,4,19,0,1,1,2,5,0,2,7238,24,0
1100,서울특별시,1116,강서구,,우장산동제1투,2894,1766,791,880,59,0,13,0,0,0,3,3,0,1,1750,16,1128
1100,서울특별시,1116,강서구,,우장산동제2투,2328,1486,700,708,47,2,10,0,0,0,2,1,0,1,1471,15,842
1100,서울특별시,1116,강서구,,우장산동제3투,2197,1431,565,780,52,1,13,0,0,0,3,0,1,0,1415,16,766
1100,서울특별시,1116,강서구,,우장산동제4투,2395,1787,712,1002,52,0,6,1,1,1,3,0,0,0,1778,9,608
1100,서울특별시,1116,강서구,,우장산동제5투,3217,2224,1054,1059,63,3,10,0,0,0,2,2,1,2,2196,28,993
1100,서울특별시,1116,강서구,,우장산동제6투,3118,2278,868,1304,68,0,12,0,1,0,1,0,2,1,2257,21,840
1100,서울특별시,1116,강서구,,우장산동제7투,2916,2062,913,1063,52,1,4,0,0,0,2,1,1,1,2038,24,854
1100,서울특별시,1116,강서구,,우장산동제8투,2990,2280,773,1423,60,1,4,0,0,1,4,0,1,0,2267,13,710
1100,서울특별시,1116,강서구,가양제1동,소계,24579,18296,8058,9331,609,14,84,0,1,3,7,9,1,5,18122,174,6283
1100,서울특별시,1116,강서구,,관내사전투표,6040,6037,3068,2725,170,8,19,0,0,2,0,4,1,2,5999,38,3
1100,서울특별시,1116,강서구,,가양제1동제1투,2376,1626,669,876,59,2,8,0,0,0,1,1,0,0,1616,10,750
1100,서울특별시,1116,강서구,,가양제1동제2투,1417,975,417,521,23,0,5,0,0,0,1,1,0,0,968,7,442
1100,서울특별시,1116,강서구,,가양제1동제3투,1858,1195,368,774,35,0,8,0,1,1,0,0,0,0,1187,8,663
1100,서울특별시,1116,강서구,,가양제1동제4투,1472,943,383,499,36,0,7,0,0,0,1,2,0,0,928,15,529
1100,서울특별시,1116,강서구,,가양제1동제5투,1353,976,349,591,25,1,5,0,0,0,0,0,0,1,972,4,377
1100,서울특별시,1116,강서구,,가양제1동제6투,1743,1344,499,785,46,1,6,0,0,0,0,0,0,0,1337,7,399
1100,서울특별시,1116,강서구,,가양제1동제7투,3129,2121,936,1063,71,1,14,0,0,0,2,0,0,1,2088,33,1008
1100,서울특별시,1116,강서구,,가양제1동제8투,2659,1525,670,740,72,1,7,0,0,0,2,0,0,0,1492,33,1134
1100,서울특별시,1116,강서구,,가양제1동제9투,2532,1554,699,757,72,0,5,0,0,0,0,1,0,1,1535,19,978
1100,서울특별시,1116,강서구,가양제2동,소계,13232,10204,4525,5198,290,1,64,1,3,6,6,7,3,4,10108,96,3028
1100,서울특별시,1116,강서구,,관내사전투표,4731,4731,2351,2196,125,1,17,1,0,1,0,4,2,1,4699,32,0
1100,서울특별시,1116,강서구,,가양제2동제1투,1366,868,218,620,16,0,2,0,0,1,1,0,1,0,859,9,498
1100,서울특별시,1116,강서구,,가양제2동제2투,1691,1240,506,657,56,0,8,0,0,0,1,2,0,1,1231,9,451
1100,서울특별시,1116,강서구,,가양제2동제3투,1841,1029,458,500,34,0,19,0,1,1,3,0,0,2,1018,11,812
1100,서울특별시,1116,강서구,,가양제2동제4투,1466,874,380,456,16,0,5,0,0,1,0,1,0,0,859,15,592
1100,서울특별시,1116,강서구,,가양제2동제5투,2137,1462,612,769,43,0,13,0,2,2,1,0,0,0,1442,20,675
1100,서울특별시,1116,강서구,가양제3동,소계,13394,10503,4927,5121,254,6,52,4,2,1,10,9,1,0,10387,116,2891
1100,서울특별시,1116,강서구,,관내사전투표,5001,5001,2690,2134,107,2,20,0,1,0,1,3,0,0,4958,43,0
1100,서울특별시,1116,강서구,,가양제3동제1투,1865,1277,557,676,20,1,6,1,0,0,4,0,0,0,1265,12,588
1100,서울특별시,1116,강서구,,가양제3동제2투,1838,1063,387,616,31,1,9,1,0,0,0,0,0,0,1045,18,775
1100,서울특별시,1116,강서구,,가양제3동제3투,1737,1206,524,618,39,1,5,0,1,0,1,1,0,0,1190,16,531
1100,서울특별시,1116,강서구,,가양제3동제4투,1321,741,312,385,15,0,8,2,0,1,3,4,1,0,731,10,580
1100,서울특별시,1116,강서구,,가양제3동제5투,1632,1215,457,692,42,1,4,0,0,0,1,1,0,0,1198,17,417
1100,서울특별시,1116,강서구,발산제1동,소계,28821,23090,12125,9930,622,18,107,7,4,13,19,18,3,7,22873,217,5731
1100,서울특별시,1116,강서구,,관내사전투표,9433,9433,5525,3561,222,7,36,1,1,0,2,9,1,1,9366,67,0
1100,서울특별시,1116,강서구,,발산제1동제1투,2256,1484,706,688,53,5,8,1,0,2,4,0,1,1,1469,15,772
1100,서울특별시,1116,강서구,,발산제1동제2투,1971,1195,561,547,50,2,9,1,0,1,3,0,0,0,1174,21,776
1100,서울특별시,1116,강서구,,발산제1동제3투,2401,1580,703,782,54,1,10,1,1,4,3,1,0,0,1560,20,821
1100,서울특별시,1116,강서구,,발산제1동제4투,2678,1947,873,973,54,0,12,1,0,3,3,3,0,0,1922,25,731
1100,서울특별시,1116,강서구,,발산제1동제5투,2951,2028,935,1011,41,1,2,0,0,1,3,2,1,1,1998,30,923
1100,서울특별시,1116,강서구,,발산제1동제6투,2852,2060,1044,921,66,2,13,0,0,1,0,0,0,2,2049,11,792
1100,서울특별시,1116,강서구,,발산제1동제7투,2278,1787,961,759,40,0,8,0,0,0,1,1,0,2,1772,15,491
1100,서울특별시,1116,강서구,,발산제1동제8투,2001,1576,817,688,42,0,9,2,2,1,0,2,0,0,1563,13,425
1100,서울특별시,1116,강서구,공항동,소계,22335,15882,7716,7434,376,4,134,5,4,2,16,11,1,4,15707,175,6453
1100,서울특별시,1116,강서구,,관내사전투표,5209,5212,2873,2139,107,0,38,1,0,2,1,5,0,2,5168,44,-3
1100,서울특별시,1116,강서구,,공항동제1투,4278,2689,1197,1374,61,0,16,0,0,0,6,0,0,0,2654,35,1589
1100,서울특별시,1116,강서구,,공항동제2투,2622,1488,605,795,38,2,17,1,2,0,1,2,0,1,1464,24,1134
1100,서울특별시,1116,강서구,,공항동제3투,2066,1079,465,541,25,2,16,1,0,0,6,1,0,0,1057,22,987
1100,서울특별시,1116,강서구,,공항동제4투,2211,1262,585,599,37,0,19,0,0,0,1,2,0,0,1243,19,949
1100,서울특별시,1116,강서구,,공항동제5투,2067,1236,563,616,31,0,12,0,0,0,1,0,0,0,1223,13,831
1100,서울특별시,1116,강서구,,공항동제6투,3882,2916,1428,1370,77,0,16,2,2,0,0,1,1,1,2898,18,966
1100,서울특별시,1116,강서구,방화제1동,소계,33220,26085,12403,12602,677,14,146,6,1,4,16,22,3,6,25900,185,7135
1100,서울특별시,1116,강서구,,관내사전투표,10334,10330,5686,4341,199,1,41,1,0,0,3,7,0,2,10281,49,4
1100,서울특별시,1116,강서구,,방화제1동제1투,2150,1493,672,746,45,1,13,1,0,0,1,1,0,0,1480,13,657
1100,서울특별시,1116,강서구,,방화제1동제2투,2143,1442,555,821,49,2,7,0,0,0,0,1,0,0,1435,7,701
1100,서울특별시,1116,강서구,,방화제1동제3투,2159,1339,559,705,40,1,16,0,0,1,4,2,1,1,1330,9,820
1100,서울특별시,1116,강서구,,방화제1동제4투,1554,853,327,482,15,1,22,0,0,0,1,0,1,0,849,4,701
1100,서울특별시,1116,강서구,,방화제1동제5투,2195,1517,637,805,44,1,7,1,0,1,2,2,0,0,1500,17,678
1100,서울특별시,1116,강서구,,방화제1동제6투,2646,1737,670,978,59,3,9,0,0,0,1,3,0,0,1723,14,909
1100,서울특별시,1116,강서구,,방화제1동제7투,1977,1304,559,669,45,0,10,0,0,0,2,0,0,1,1286,18,673
1100,서울특별시,1116,강서구,,방화제1동제8투,2399,1751,772,904,46,0,3,0,1,0,1,1,1,1,1730,21,648
1100,서울특별시,1116,강서구,,방화제1동제9투,2352,1827,929,801,60,3,11,2,0,2,1,1,0,0,1810,17,525
1100,서울특별시,1116,강서구,,방화제1동제10투,3311,2492,1037,1350,75,1,7,1,0,0,0,4,0,1,2476,16,819
1100,서울특별시,1116,강서구,방화제2동,소계,18795,13806,6339,6817,372,4,92,3,1,6,18,12,3,6,13673,133,4989
1100,서울특별시,1116,강서구,,관내사전투표,4967,4967,2653,2144,110,1,19,0,0,2,2,8,0,1,4940,27,0
1100,서울특별시,1116,강서구,,방화제2동제1투,2436,1428,573,773,48,1,15,0,0,0,0,0,0,0,1410,18,1008
1100,서울특별시,1116,강서구,,방화제2동제2투,2082,1159,491,594,45,0,8,0,0,1,2,0,0,1,1142,17,923
1100,서울특별시,1116,강서구,,방화제2동제3투,2403,1567,678,799,50,2,10,0,0,0,5,1,0,1,1546,21,836
1100,서울특별시,1116,강서구,,방화제2동제4투,2486,1757,763,901,56,0,12,2,0,0,5,1,0,2,1742,15,729
1100,서울특별시,1116,강서구,,방화제2동제5투,1704,1123,507,563,22,0,10,1,0,1,1,2,2,1,1110,13,581
1100,서울특별시,1116,강서구,,방화제2동제6투,1133,758,243,485,18,0,4,0,0,1,0,0,0,0,751,7,375
1100,서울특별시,1116,강서구,,방화제2동제7투,1584,1047,431,558,23,0,14,0,1,1,3,0,1,0,1032,15,537
1100,서울특별시,1116,강서구,방화제3동,소계,19879,15544,7262,7623,378,6,83,6,2,5,13,9,2,4,15393,151,4335
1100,서울특별시,1116,강서구,,관내사전투표,7154,7154,3817,3114,133,5,23,5,2,2,1,5,2,0,7109,45,0
1100,서울특별시,1116,강서구,,방화제3동제1투,2321,1448,642,715,56,0,10,0,0,0,1,0,0,0,1424,24,873
1100,서울특별시,1116,강서구,,방화제3동제2투,1454,1013,448,506,40,0,7,0,0,0,2,0,0,1,1004,9,441
1100,서울특별시,1116,강서구,,방화제3동제3투,1648,1005,492,465,13,0,9,0,0,1,4,1,0,1,986,19,643
1100,서울특별시,1116,강서구,,방화제3동제4투,2250,1475,549,859,40,0,9,0,0,1,0,1,0,0,1459,16,775
1100,서울특별시,1116,강서구,,방화제3동제5투,1637,1198,413,735,34,0,5,0,0,0,1,0,0,1,1189,9,439
1100,서울특별시,1116,강서구,,방화제3동제6투,1518,1008,423,531,22,0,13,1,0,1,3,2,0,0,996,12,510
1100,서울특별시,1116,강서구,,방화제3동제7투,1897,1243,478,698,40,1,7,0,0,0,1,0,0,1,1226,17,654
1100,서울특별시,1116,강서구,잘못 투입·구분된 투표지,,0,5,5,0,0,0,0,0,0,0,0,0,0,0,5,0,-5
1100,서울특별시,1117,구로구,합계,,348156,272920,133027,127129,7539,159,1713,59,33,75,193,325,54,89,270395,2525,75236
1100,서울특별시,1117,구로구,거소·선상투표,,516,482,183,212,14,1,15,0,0,0,1,0,0,3,429,53,34
1100,서울특별시,1117,구로구,관외사전투표,,33339,33331,17524,14091,1004,22,250,9,4,5,12,84,7,15,33027,304,8
1100,서울특별시,1117,구로구,재외투표,,2279,1702,990,506,50,0,3,0,0,0,0,1,0,0,1550,152,577
1100,서울특별시,1117,구로구,신도림동,소계,27106,22069,9390,11783,613,10,71,7,4,5,15,8,6,8,21920,149,5037
1100,서울특별시,1117,구로구,,관내사전투표,7725,7725,3946,3535,174,3,19,0,3,0,2,2,2,4,7690,35,0
1100,서울특별시,1117,구로구,,신도림동제1투,2644,1743,663,986,62,1,13,0,0,0,0,0,0,0,1725,18,901
1100,서울특별시,1117,구로구,,신도림동제2투,2290,1825,703,1048,50,1,2,0,0,0,1,0,1,3,1809,16,465
1100,서울특별시,1117,구로구,,신도림동제3투,1969,1476,603,796,47,1,8,1,0,0,1,0,2,0,1459,17,493
1100,서울특별시,1117,구로구,,신도림동제4투,2226,1487,583,830,50,0,6,2,0,0,2,1,0,1,1475,12,739
1100,서울특별시,1117,구로구,,신도림동제5투,2526,1953,827,1031,70,0,8,0,0,0,1,2,0,0,1939,14,573
1100,서울특별시,1117,구로구,,신도림동제6투,2428,1877,748,1041,64,1,7,1,0,1,2,3,0,0,1868,9,551
1100,서울특별시,1117,구로구,,신도림동제7투,2781,2026,679,1276,47,0,4,0,0,2,1,0,1,0,2010,16,755
1100,서울특별시,1117,구로구,,신도림동제8투,2517,1957,638,1240,49,3,4,3,1,2,5,0,0,0,1945,12,560
1100,서울특별시,1117,구로구,구로제1동,소계,15849,12856,6296,6009,358,6,58,1,1,2,7,8,3,5,12754,102,2993
1100,서울특별시,1117,구로구,,관내사전투표,6168,6168,3517,2455,148,2,17,0,0,1,1,4,2,0,6147,21,0
1100,서울특별시,1117,구로구,,구로제1동제1투,1937,1314,550,704,31,1,8,0,0,0,4,0,0,3,1301,13,623
1100,서울특별시,1117,구로구,,구로제1동제2투,1756,1276,518,689,47,0,3,1,0,1,1,3,0,0,1263,13,480
1100,서울특별시,1117,구로구,,구로제1동제3투,1751,1228,477,690,36,1,7,0,0,0,0,1,0,0,1212,16,523
1100,서울특별시,1117,구로구,,구로제1동제4투,1887,1291,526,686,40,2,12,0,1,0,0,0,1,0,1268,23,596
1100,서울특별시,1117,구로구,,구로제1동제5투,2350,1579,708,785,56,0,11,0,0,0,1,0,0,2,1563,16,771
1100,서울특별시,1117,구로구,구로제2동,소계,18883,13020,6573,5931,266,7,87,2,1,5,5,19,2,7,12905,115,5863
1100,서울특별시,1117,구로구,,관내사전투표,4869,4869,2855,1871,81,2,16,1,1,3,0,12,1,1,4844,25,0
1100,서울특별시,1117,구로구,,구로제2동제1투,1615,756,372,346,16,0,13,0,0,0,0,0,0,1,748,8,859
1100,서울특별시,1117,구로구,,구로제2동제2투,1157,620,267,321,11,0,6,0,0,0,2,0,0,1,608,12,537
1100,서울특별시,1117,구로구,,구로제2동제3투,1410,722,329,364,8,0,11,1,0,0,0,0,0,1,714,8,688
1100,서울특별시,1117,구로구,,구로제2동제4투,1802,983,451,491,22,2,5,0,0,0,0,0,0,0,971,12,819
1100,서울특별시,1117,구로구,,구로제2동제5투,1508,949,490,413,25,0,8,0,0,0,0,1,1,1,939,10,559
1100,서울특별시,1117,구로구,,구로제2동제6투,2747,1921,862,976,48,2,13,0,0,1,2,1,0,1,1906,15,826
1100,서울특별시,1117,구로구,,구로제2동제7투,1346,701,295,376,15,0,4,0,0,0,0,2,0,1,693,8,645
1100,서울특별시,1117,구로구,,구로제2동제8투,1700,1076,475,548,30,1,7,0,0,0,0,3,0,0,1064,12,624
1100,서울특별시,1117,구로구,,구로제2동제9투,729,423,177,225,10,0,4,0,0,1,1,0,0,0,418,5,306
1100,서울특별시,1117,구로구,구로제3동,소계,19216,14216,7618,5827,448,12,109,2,3,4,13,22,1,7,14066,150,5000
1100,서울특별시,1117,구로구,,관내사전투표,6212,6212,3733,2197,181,8,28,2,0,2,3,13,0,3,6170,42,0
1100,서울특별시,1117,구로구,,구로제3동제1투,1439,765,393,341,16,0,4,0,0,0,0,0,0,0,754,11,674
1100,서울특별시,1117,구로구,,구로제3동제2투,1546,888,450,370,27,1,19,0,0,1,6,0,0,1,875,13,658
1100,서울특별시,1117,구로구,,구로제3동제3투,1901,1283,609,612,33,0,5,0,1,0,2,2,0,1,1265,18,618
1100,서울특별시,1117,구로구,,구로제3동제4투,2052,1339,665,590,50,0,16,0,2,0,1,3,0,0,1327,12,713
1100,서울특별시,1117,구로구,,구로제3동제5투,1700,1107,549,488,37,0,13,0,0,0,0,1,0,0,1088,19,593
1100,서울특별시,1117,구로구,,구로제3동제6투,1662,1222,575,581,44,0,6,0,0,0,1,3,0,0,1210,12,440
1100,서울특별시,1117,구로구,,구로제3동제7투,2704,1400,644,648,60,3,18,0,0,1,0,0,1,2,1377,23,1304
1100,서울특별시,1117,구로구,구로제4동,소계,15451,11026,5731,4760,276,7,90,8,4,5,12,12,5,6,10916,110,4425
1100,서울특별시,1117,구로구,,관내사전투표,3961,3961,2328,1486,65,3,28,5,3,2,2,5,3,1,3931,30,0
1100,서울특별시,1117,구로구,,구로제4동제1투,2064,1234,675,498,26,0,10,0,0,1,1,1,1,1,1214,20,830
1100,서울특별시,1117,구로구,,구로제4동제2투,1687,1077,527,489,31,1,13,1,1,1,2,1,0,1,1068,9,610
1100,서울특별시,1117,구로구,,구로제4동제3투,2156,1431,690,672,39,1,10,0,0,0,3,0,1,1,1417,14,725
1100,서울특별시,1117,구로구,,구로제4동제4투,1459,770,348,386,19,1,6,1,0,0,2,0,0,1,764,6,689
1100,서울특별시,1117,구로구,,구로제4동제5투,2687,1634,783,739,69,1,14,0,0,1,0,2,0,1,1610,24,1053
1100,서울특별시,1117,구로구,,구로제4동제6투,1437,919,380,490,27,0,9,1,0,0,2,3,0,0,912,7,518
1100,서울특별시,1117,구로구,구로제5동,소계,24344,18852,9231,8766,563,5,90,7,4,7,13,20,1,3,18710,142,5492
1100,서울특별시,1117,구로구,,관내사전투표,7540,7538,4292,2961,202,2,23,3,0,3,3,7,1,1,7498,40,2
1100,서울특별시,1117,구로구,,구로제5동제1투,2271,1533,717,742,45,0,7,1,1,0,5,1,0,0,1519,14,738
1100,서울특별시,1117,구로구,,구로제5동제2투,2867,2185,925,1166,63,1,10,1,1,0,0,3,0,0,2170,15,682
1100,서울특별시,1117,구로구,,구로제5동제3투,2626,1503,676,744,49,0,12,0,0,0,2,2,0,0,1485,18,1123
1100,서울특별시,1117,구로구,,구로제5동제4투,2746,1576,736,736,58,0,18,1,2,2,1,2,0,0,1556,20,1170
1100,서울특별시,1117,구로구,,구로제5동제5투,3595,2406,1099,1171,89,2,12,1,0,2,1,2,0,2,2381,25,1189
1100,서울특별시,1117,구로구,,구로제5동제6투,2699,2111,786,1246,57,0,8,0,0,0,1,3,0,0,2101,10,588
1100,서울특별시,1117,구로구,가리봉동,소계,7334,4745,2352,2155,90,2,63,0,0,2,7,3,3,1,4678,67,2589
1100,서울특별시,1117,구로구,,관내사전투표,1932,1932,1098,772,31,0,14,0,0,0,1,2,0,0,1918,14,0
1100,서울특별시,1117,구로구,,가리봉동제1투,1416,661,309,306,14,0,21,0,0,1,2,0,0,0,653,8,755
1100,서울특별시,1117,구로구,,가리봉동제2투,2311,1183,491,613,26,1,18,0,0,0,2,1,2,1,1155,28,1128
1100,서울특별시,1117,구로구,,가리봉동제3투,1675,969,454,464,19,1,10,0,0,1,2,0,1,0,952,17,706
1100,서울특별시,1117,구로구,고척제1동,소계,18492,14463,6721,7155,333,7,79,0,2,1,8,19,2,3,14330,133,4029
1100,서울특별시,1117,구로구,,관내사전투표,6359,6358,3414,2753,127,2,19,0,0,0,1,6,0,1,6323,35,1
1100,서울특별시,1117,구로구,,고척제1동제1투,2413,1615,617,921,44,1,5,0,0,0,0,5,0,0,1593,22,798
1100,서울특별시,1117,구로구,,고척제1동제2투,2454,1618,657,886,33,3,9,0,1,0,2,4,0,2,1597,21,836
1100,서울특별시,1117,구로구,,고척제1동제3투,2956,1984,797,1094,55,0,14,0,0,1,3,1,1,0,1966,18,972
1100,서울특별시,1117,구로구,,고척제1동제4투,1810,1150,453,624,33,1,14,0,0,0,1,0,1,0,1127,23,660
1100,서울특별시,1117,구로구,,고척제1동제5투,2500,1738,783,877,41,0,18,0,1,0,1,3,0,0,1724,14,762
1100,서울특별시,1117,구로구,고척제2동,소계,20421,15142,7276,7218,369,12,97,4,2,8,16,28,2,7,15039,103,5279
1100,서울특별시,1117,구로구,,관내사전투표,5417,5417,3035,2221,101,3,23,2,0,1,4,8,1,2,5401,16,0
1100,서울특별시,1117,구로구,,고척제2동제1투,2281,1359,609,679,36,3,14,0,0,2,0,2,0,1,1346,13,922
1100,서울특별시,1117,구로구,,고척제2동제2투,2265,1568,681,819,36,2,10,0,2,1,0,2,0,1,1554,14,697
1100,서울특별시,1117,구로구,,고척제2동제3투,2312,1429,627,721,39,1,15,0,0,1,3,4,1,1,1413,16,883
1100,서울특별시,1117,구로구,,고척제2동제4투,2048,1213,539,610,33,1,15,0,0,0,0,5,0,0,1203,10,835
1100,서울특별시,1117,구로구,,고척제2동제5투,1943,1163,505,590,26,0,12,1,0,0,7,5,0,0,1146,17,780
1100,서울특별시,1117,구로구,,고척제2동제6투,2533,1889,854,951,59,2,4,1,0,2,1,1,0,2,1877,12,644
1100,서울특별시,1117,구로구,,고척제2동제7투,1622,1104,426,627,39,0,4,0,0,1,1,1,0,0,1099,5,518
1100,서울특별시,1117,구로구,개봉제1동,소계,26450,19781,9380,9535,484,12,123,4,3,5,15,24,6,6,19597,184,6669
1100,서울특별시,1117,구로구,,관내사전투표,6850,6850,3753,2872,134,2,31,3,0,0,3,12,3,3,6816,34,0
1100,서울특별시,1117,구로구,,개봉제1동제1투,2406,1525,690,735,38,3,32,0,0,1,0,2,0,2,1503,22,881
1100,서울특별시,1117,구로구,,개봉제1동제2투,2071,1450,617,777,35,0,8,0,0,0,1,0,1,0,1439,11,621
1100,서울특별시,1117,구로구,,개봉제1동제3투,1863,1057,462,539,27,0,10,0,0,1,1,1,0,1,1042,15,806
1100,서울특별시,1117,구로구,,개봉제1동제4투,1981,1261,566,632,40,1,7,1,0,0,0,1,0,0,1248,13,720
1100,서울특별시,1117,구로구,,개봉제1동제5투,2510,1451,614,773,35,2,11,0,0,0,2,2,0,0,1439,12,1059
1100,서울특별시,1117,구로구,,개봉제1동제6투,2092,1254,520,658,44,1,8,0,0,0,4,0,0,0,1235,19,838
1100,서울특별시,1117,구로구,,개봉제1동제7투,3390,2429,1094,1223,68,2,8,0,0,2,1,2,1,0,2401,28,961
1100,서울특별시,1117,구로구,,개봉제1동제8투,3287,2504,1064,1326,63,1,8,0,3,1,3,4,1,0,2474,30,783
1100,서울특별시,1117,구로구,개봉제2동,소계,24681,19420,9065,9507,536,9,123,3,0,4,17,13,4,5,19286,134,5261
1100,서울특별시,1117,구로구,,관내사전투표,6788,6788,3546,3025,143,3,26,1,0,0,1,5,0,2,6752,36,0
1100,서울특별시,1117,구로구,,개봉제2동제1투,2667,1690,803,806,42,1,18,0,0,0,2,1,0,2,1675,15,977
1100,서울특별시,1117,구로구,,개봉제2동제2투,2360,1532,748,696,45,2,18,1,0,2,0,2,2,1,1517,15,828
1100,서울특별시,1117,구로구,,개봉제2동제3투,2034,1561,581,895,55,1,12,0,0,1,6,0,0,0,1551,10,473
1100,서울특별시,1117,구로구,,개봉제2동제4투,2456,1882,817,987,56,1,7,0,0,0,2,2,1,0,1873,9,574
1100,서울특별시,1117,구로구,,개봉제2동제5투,2049,1557,561,917,59,0,7,0,0,0,2,1,0,0,1547,10,492
1100,서울특별시,1117,구로구,,개봉제2동제6투,1980,1430,570,794,42,0,4,0,0,0,3,1,0,0,1414,16,550
1100,서울특별시,1117,구로구,,개봉제2동제7투,2615,1750,910,740,64,0,20,1,0,1,0,1,1,0,1738,12,865
1100,서울특별시,1117,구로구,,개봉제2동제8투,1732,1230,529,647,30,1,11,0,0,0,1,0,0,0,1219,11,502
1100,서울특별시,1117,구로구,개봉제3동,소계,16511,12332,6251,5572,294,8,71,0,2,2,12,13,2,2,12229,103,4179
1100,서울특별시,1117,구로구,,관내사전투표,5165,5165,2948,2041,111,2,16,0,2,0,3,6,1,0,5130,35,0
1100,서울특별시,1117,구로구,,개봉제3동제1투,2675,1606,758,774,33,1,17,0,0,0,4,2,1,0,1590,16,1069
1100,서울특별시,1117,구로구,,개봉제3동제2투,2366,1422,658,704,33,1,13,0,0,0,1,2,0,1,1413,9,944
1100,서울특별시,1117,구로구,,개봉제3동제3투,2493,1451,671,704,40,1,13,0,0,0,1,1,0,0,1431,20,1042
1100,서울특별시,1117,구로구,,개봉제3동제4투,2230,1675,707,900,42,1,6,0,0,1,1,1,0,0,1659,16,555
1100,서울특별시,1117,구로구,,개봉제3동제5투,1582,1013,509,449,35,2,6,0,0,1,2,1,0,1,1006,7,569
1100,서울특별시,1117,구로구,오류제1동,소계,19653,14797,6986,7010,480,9,119,4,1,4,9,16,2,2,14642,155,4856
1100,서울특별시,1117,구로구,,관내사전투표,6594,6594,3582,2708,200,6,32,3,0,1,1,9,0,0,6542,52,0
1100,서울특별시,1117,구로구,,오류제1동제1투,2723,1408,627,649,73,1,23,1,0,0,1,2,1,0,1378,30,1315
1100,서울특별시,1117,구로구,,오류제1동제2투,2653,1630,679,856,50,1,25,0,1,0,4,1,1,1,1619,11,1023
1100,서울특별시,1117,구로구,,오류제1동제3투,2761,1680,624,974,40,0,14,0,0,0,2,4,0,1,1659,21,1081
1100,서울특별시,1117,구로구,,오류제1동제4투,2377,1769,709,979,55,0,9,0,0,0,0,0,0,0,1752,17,608
1100,서울특별시,1117,구로구,,오류제1동제5투,2545,1716,765,844,62,1,16,0,0,3,1,0,0,0,1692,24,829
1100,서울특별시,1117,구로구,오류제2동,소계,27780,21159,10368,9830,596,15,115,5,1,9,15,18,4,5,20981,178,6621
1100,서울특별시,1117,구로구,,관내사전투표,7613,7612,4344,2980,200,8,23,2,0,1,2,9,2,2,7573,39,1
1100,서울특별시,1117,구로구,,오류제2동제1투,2763,1764,731,955,30,2,24,0,1,1,0,1,0,1,1746,18,999
1100,서울특별시,1117,구로구,,오류제2동제2투,2827,1716,642,999,45,1,8,1,0,1,3,3,0,0,1703,13,1111
1100,서울특별시,1117,구로구,,오류제2동제3투,2788,2007,794,1130,55,1,11,0,0,0,0,0,1,0,1992,15,781
1100,서울특별시,1117,구로구,,오류제2동제4투,2099,1403,619,699,46,1,14,0,0,1,3,2,1,0,1386,17,696
1100,서울특별시,1117,구로구,,오류제2동제5투,1861,1226,562,591,45,0,8,1,0,2,0,0,0,1,1210,16,635
1100,서울특별시,1117,구로구,,오류제2동제6투,2614,1777,847,831,60,1,11,0,0,3,5,0,0,0,1758,19,837
1100,서울특별시,1117,구로구,,오류제2동제7투,3000,2104,1039,963,68,0,8,1,0,0,2,1,0,0,2082,22,896
1100,서울특별시,1117,구로구,,오류제2동제8투,2215,1550,790,682,47,1,8,0,0,0,0,2,0,1,1531,19,665
1100,서울특별시,1117,구로구,수궁동,소계,18369,14083,6167,7298,364,10,94,1,1,6,10,9,2,3,13965,118,4286
1100,서울특별시,1117,구로구,,관내사전투표,5297,5297,2805,2296,124,4,28,1,0,1,1,5,0,1,5266,31,0
1100,서울특별시,1117,구로구,,수궁동제1투,2326,1514,394,1047,43,0,10,0,0,1,2,1,0,0,1498,16,812
1100,서울특별시,1117,구로구,,수궁동제2투,2130,1378,529,782,35,2,14,0,0,1,1,0,1,1,1366,12,752
1100,서울특별시,1117,구로구,,수궁동제3투,2883,1914,761,1058,61,3,11,0,0,2,1,2,0,0,1899,15,969
1100,서울특별시,1117,구로구,,수궁동제4투,2156,1620,666,901,26,0,9,0,1,1,0,1,0,1,1606,14,536
1100,서울특별시,1117,구로구,,수궁동제5투,2517,1627,698,837,48,1,17,0,0,0,1,0,1,0,1603,24,890
1100,서울특별시,1117,구로구,,수궁동제6투,1060,733,314,377,27,0,5,0,0,0,4,0,0,0,727,6,327
1100,서울특별시,1117,구로구,항동,소계,11482,9439,4924,3960,401,5,56,2,0,1,6,8,2,1,9366,73,2043
1100,서울특별시,1117,구로구,,관내사전투표,3849,3849,2313,1355,138,2,12,0,0,0,0,3,0,0,3823,26,0
1100,서울특별시,1117,구로구,,항동제1투,3050,2252,985,1117,104,0,21,1,0,0,3,1,0,1,2233,19,798
1100,서울특별시,1117,구로구,,항동제2투,2360,1730,862,738,98,1,14,0,0,0,0,2,2,0,1717,13,630
1100,서울특별시,1117,구로구,,항동제3투,2223,1608,764,750,61,2,9,1,0,1,3,2,0,0,1593,15,615
1100,서울특별시,1117,구로구,잘못 투입·구분된 투표지,,0,5,1,4,0,0,0,0,0,0,0,0,0,0,5,0,-5
1100,서울특별시,1118,금천구,합계,,208786,157035,80208,69227,4278,106,1161,52,23,38,119,204,48,70,155534,1501,51751
1100,서울특별시,1118,금천구,거소·선상투표,,283,243,96,111,7,0,7,0,0,0,0,0,0,0,221,22,40
1100,서울특별시,1118,금천구,관외사전투표,,19949,19943,10871,7980,638,17,171,7,0,0,5,61,5,10,19765,178,6
1100,서울특별시,1118,금천구,재외투표,,994,712,449,174,27,0,3,0,0,0,0,2,0,0,655,57,282
1100,서울특별시,1118,금천구,가산동,소계,19972,13807,6986,6051,410,8,116,5,2,9,10,8,4,5,13614,193,6165
1100,서울특별시,1118,금천구,,관내사전투표,5069,5069,2915,1877,167,6,30,1,0,5,1,4,1,2,5009,60,0
1100,서울특별시,1118,금천구,,가산동제1투,3273,1807,856,841,59,1,10,1,0,0,2,0,0,0,1770,37,1466
1100,서울특별시,1118,금천구,,가산동제2투,3476,1865,903,835,59,0,23,2,2,2,5,3,1,2,1837,28,1611
1100,서울특별시,1118,금천구,,가산동제3투,2614,1864,798,994,43,0,11,0,0,1,1,1,1,0,1850,14,750
1100,서울특별시,1118,금천구,,가산동제4투,2801,1611,761,746,49,1,23,1,0,0,1,0,1,1,1584,27,1190
1100,서울특별시,1118,금천구,,가산동제5투,898,542,252,269,5,0,11,0,0,0,0,0,0,0,537,5,356
1100,서울특별시,1118,금천구,,가산동제6투,1841,1049,501,489,28,0,8,0,0,1,0,0,0,0,1027,22,792
1100,서울특별시,1118,금천구,독산제1동,소계,34190,25121,12350,11487,788,16,162,11,5,3,19,23,7,9,24880,241,9069
1100,서울특별시,1118,금천구,,관내사전투표,6594,6594,3703,2566,211,7,33,4,1,1,4,10,2,4,6546,48,0
1100,서울특별시,1118,금천구,,독산제1동제1투,3555,1942,943,864,69,1,24,2,1,0,2,2,1,0,1909,33,1613
1100,서울특별시,1118,금천구,,독산제1동제2투,2378,1312,638,575,50,2,18,0,1,0,2,1,0,1,1288,24,1066
1100,서울특별시,1118,금천구,,독산제1동제3투,3173,1878,928,808,88,2,23,0,0,0,2,1,1,0,1853,25,1295
1100,서울특별시,1118,금천구,,독산제1동제4투,3047,2260,1079,1093,52,0,10,0,0,1,3,2,1,2,2243,17,787
1100,서울특별시,1118,금천구,,독산제1동제5투,2464,1659,825,751,46,1,12,2,0,1,5,1,2,0,1646,13,805
1100,서울특별시,1118,금천구,,독산제1동제6투,3094,2191,924,1165,67,2,6,1,0,0,0,2,0,2,2169,22,903
1100,서울특별시,1118,금천구,,독산제1동제7투,3622,2822,1234,1483,68,1,13,0,0,0,0,3,0,0,2802,20,800
1100,서울특별시,1118,금천구,,독산제1동제8투,2722,2121,936,1105,59,0,9,0,1,0,1,1,0,0,2112,9,601
1100,서울특별시,1118,금천구,,독산제1동제9투,3541,2342,1140,1077,78,0,14,2,1,0,0,0,0,0,2312,30,1199
1100,서울특별시,1118,금천구,독산제2동,소계,15643,10710,5642,4596,244,9,93,4,1,5,11,15,2,7,10629,81,4933
1100,서울특별시,1118,금천구,,관내사전투표,4552,4552,2704,1699,92,3,23,1,0,2,2,7,1,4,4538,14,0
1100,서울특별시,1118,금천구,,독산제2동제1투,1911,1087,503,519,29,2,16,0,0,0,2,0,0,0,1071,16,824
1100,서울특별시,1118,금천구,,독산제2동제2투,1895,1024,447,528,24,0,9,0,1,2,2,0,1,1,1015,9,871
1100,서울특별시,1118,금천구,,독산제2동제3투,1583,866,439,384,18,1,11,0,0,0,2,1,0,1,857,9,717
1100,서울특별시,1118,금천구,,독산제2동제4투,1818,1012,505,457,26,0,13,0,0,0,0,3,0,0,1004,8,806
1100,서울특별시,1118,금천구,,독산제2동제5투,1836,964,468,456,18,0,7,2,0,0,2,3,0,0,956,8,872
1100,서울특별시,1118,금천구,,독산제2동제6투,2048,1205,576,553,37,3,14,1,0,1,1,1,0,1,1188,17,843
1100,서울특별시,1118,금천구,독산제3동,소계,20018,14146,7548,5963,345,7,102,3,2,0,16,15,3,5,14009,137,5872
1100,서울특별시,1118,금천구,,관내사전투표,5808,5807,3539,2080,112,3,22,1,0,0,6,4,1,1,5769,38,1
1100,서울특별시,1118,금천구,,독산제3동제1투,2588,1546,717,747,46,2,11,0,1,0,3,2,1,0,1530,16,1042
1100,서울특별시,1118,금천구,,독산제3동제2투,2581,1636,779,764,45,1,19,0,1,0,2,2,0,1,1614,22,945
1100,서울특별시,1118,금천구,,독산제3동제3투,2367,1339,645,614,42,0,15,1,0,0,2,2,0,2,1323,16,1028
1100,서울특별시,1118,금천구,,독산제3동제4투,2219,1060,551,450,29,0,11,0,0,0,2,3,1,1,1048,12,1159
1100,서울특별시,1118,금천구,,독산제3동제5투,2084,1264,597,605,31,0,15,0,0,0,1,0,0,0,1249,15,820
1100,서울특별시,1118,금천구,,독산제3동제6투,2371,1494,720,703,40,1,9,1,0,0,0,2,0,0,1476,18,877
1100,서울특별시,1118,금천구,독산제4동,소계,13236,9554,5062,4057,251,3,65,2,3,2,7,12,2,6,9472,82,3682
1100,서울특별시,1118,금천구,,관내사전투표,4893,4893,2821,1902,113,1,18,1,1,1,0,5,0,3,4866,27,0
1100,서울특별시,1118,금천구,,독산제4동제1투,2100,1079,525,473,35,0,18,0,1,0,4,3,1,1,1061,18,1021
1100,서울특별시,1118,금천구,,독산제4동제2투,2189,1240,560,616,36,1,12,1,1,0,0,0,0,0,1227,13,949
1100,서울특별시,1118,금천구,,독산제4동제3투,1698,954,462,451,21,1,6,0,0,1,1,1,0,1,945,9,744
1100,서울특별시,1118,금천구,,독산제4동제4투,2356,1388,694,615,46,0,11,0,0,0,2,3,1,1,1373,15,968
1100,서울특별시,1118,금천구,시흥제1동,소계,26284,18822,9189,8821,452,13,134,3,2,7,14,16,8,8,18667,155,7462
1100,서울특별시,1118,금천구,,관내사전투표,7342,7342,3935,3178,147,6,26,2,1,1,2,7,1,2,7308,34,0
1100,서울특별시,1118,금천구,,시흥제1동제1투,2210,1420,621,718,54,1,7,0,0,2,0,0,5,0,1408,12,790
1100,서울특별시,1118,금천구,,시흥제1동제2투,3192,2041,952,976,64,1,18,0,0,1,3,2,1,1,2019,22,1151
1100,서울특별시,1118,금천구,,시흥제1동제3투,2206,1612,706,840,35,0,10,0,0,0,1,1,0,2,1595,17,594
1100,서울특별시,1118,금천구,,시흥제1동제4투,1769,860,463,351,29,0,4,0,0,2,1,2,0,0,852,8,909
1100,서울특별시,1118,금천구,,시흥제1동제5투,2052,1112,514,536,20,3,24,0,0,0,1,1,1,1,1101,11,940
1100,서울특별시,1118,금천구,,시흥제1동제6투,1872,1099,538,504,20,0,17,0,0,1,1,1,0,0,1082,17,773
1100,서울특별시,1118,금천구,,시흥제1동제7투,1743,1016,457,509,23,2,12,0,1,0,0,1,0,0,1005,11,727
1100,서울특별시,1118,금천구,,시흥제1동제8투,2270,1111,510,546,27,0,9,0,0,0,4,0,0,2,1098,13,1159
1100,서울특별시,1118,금천구,,시흥제1동제9투,1628,1209,493,663,33,0,7,1,0,0,1,1,0,0,1199,10,419
1100,서울특별시,1118,금천구,시흥제2동,소계,16498,13248,6519,6195,338,11,63,1,4,5,10,13,2,4,13165,83,3250
1100,서울특별시,1118,금천구,,관내사전투표,4958,4957,2775,2027,100,4,19,0,1,0,1,9,1,1,4938,19,1
1100,서울특별시,1118,금천구,,시흥제2동제1투,1679,976,438,491,27,1,5,0,1,1,0,1,0,0,965,11,703
1100,서울특별시,1118,금천구,,시흥제2동제2투,1925,1402,653,678,46,2,6,0,1,1,3,1,0,0,1391,11,523
1100,서울특별시,1118,금천구,,시흥제2동제3투,2092,1622,637,928,32,2,6,0,1,2,2,1,1,0,1612,10,470
1100,서울특별시,1118,금천구,,시흥제2동제4투,2352,1825,768,978,57,1,7,0,0,1,0,1,0,1,1814,11,527
1100,서울특별시,1118,금천구,,시흥제2동제5투,2126,1558,813,665,56,1,8,1,0,0,4,0,0,0,1548,10,568
1100,서울특별시,1118,금천구,,시흥제2동제6투,1366,908,435,428,20,0,12,0,0,0,0,0,0,2,897,11,458
1100,서울특별시,1118,금천구,시흥제3동,소계,9360,7318,3623,3357,191,8,53,5,1,1,3,6,2,4,7254,64,2042
1100,서울특별시,1118,금천구,,관내사전투표,3749,3748,2061,1550,84,3,20,2,0,0,1,3,1,2,3727,21,1
1100,서울특별시,1118,금천구,,시흥제3동제1투,1858,1083,470,550,35,1,11,1,0,1,0,2,0,0,1071,12,775
1100,서울특별시,1118,금천구,,시흥제3동제2투,1408,882,411,420,31,0,3,0,1,0,1,1,1,1,870,12,526
1100,서울특별시,1118,금천구,,시흥제3동제3투,1384,876,352,468,25,3,14,2,0,0,1,0,0,0,865,11,508
1100,서울특별시,1118,금천구,,시흥제3동제4투,961,729,329,369,16,1,5,0,0,0,0,0,0,1,721,8,232
1100,서울특별시,1118,금천구,시흥제4동,소계,16384,11797,5946,5284,298,9,95,3,2,3,15,22,5,7,11689,108,4587
1100,서울특별시,1118,금천구,,관내사전투표,4758,4758,2689,1913,96,2,18,0,0,2,5,9,2,3,4739,19,0
1100,서울특별시,1118,금천구,,시흥제4동제1투,2215,1330,626,633,36,1,13,1,0,0,1,2,0,1,1314,16,885
1100,서울특별시,1118,금천구,,시흥제4동제2투,1700,855,405,398,29,2,13,0,1,0,0,1,0,0,849,6,845
1100,서울특별시,1118,금천구,,시흥제4동제3투,1622,1010,438,517,23,0,13,1,1,0,0,1,0,0,994,16,612
1100,서울특별시,1118,금천구,,시흥제4동제4투,2005,1412,628,705,43,2,10,0,0,1,2,4,0,2,1397,15,593
1100,서울특별시,1118,금천구,,시흥제4동제5투,1983,1151,542,548,33,0,9,1,0,0,2,3,1,0,1139,12,832
1100,서울특별시,1118,금천구,,시흥제4동제6투,2101,1281,618,570,38,2,19,0,0,0,5,2,2,1,1257,24,820
1100,서울특별시,1118,금천구,시흥제5동,소계,15975,11611,5926,5151,289,5,97,8,1,3,8,11,8,5,11512,99,4364
1100,서울특별시,1118,금천구,,관내사전투표,5221,5221,3031,2020,107,3,25,3,0,0,2,2,4,0,5197,24,0
1100,서울특별시,1118,금천구,,시흥제5동제1투,1764,970,434,475,36,0,8,0,0,2,3,1,1,0,960,10,794
1100,서울특별시,1118,금천구,,시흥제5동제2투,2435,1376,655,634,51,1,17,2,0,1,0,1,1,0,1363,13,1059
1100,서울특별시,1118,금천구,,시흥제5동제3투,2500,1594,717,792,38,1,22,0,1,0,1,1,0,3,1576,18,906
1100,서울특별시,1118,금천구,,시흥제5동제4투,2115,1252,570,608,38,0,14,0,0,0,1,4,1,1,1237,15,863
1100,서울특별시,1118,금천구,,시흥제5동제5투,1940,1198,519,622,19,0,11,3,0,0,1,2,1,1,1179,19,742
1100,서울특별시,1118,금천구,잘못 투입·구분된 투표지,,0,3,1,0,0,0,0,0,0,0,1,0,0,0,2,1,-3
1100,서울특별시,1119,영등포구,합계,,334361,263581,116443,134846,7627,134,1324,72,34,58,198,239,39,65,261079,2502,70780
1100,서울특별시,1119,영등포구,거소·선상투표,,438,414,173,175,8,0,7,0,1,0,1,1,0,1,367,47,24
1100,서울특별시,1119,영등포구,관외사전투표,,33494,33487,16119,15705,1081,8,188,12,0,6,13,62,3,6,33203,284,7
1100,서울특별시,1119,영등포구,재외투표,,3069,2308,1169,863,76,1,7,0,0,1,4,0,0,0,2121,187,761
1100,서울특별시,1119,영등포구,영등포본동,소계,17314,13171,6096,6490,358,8,65,4,2,4,14,6,1,3,13051,120,4143
1100,서울특별시,1119,영등포구,,관내사전투표,4750,4750,2560,2015,128,4,12,3,0,0,4,2,1,1,4730,20,0
1100,서울특별시,1119,영등포구,,영등포본동제1투,2067,1387,603,731,27,0,8,0,1,0,0,1,0,0,1371,16,680
1100,서울특별시,1119,영등포구,,영등포본동제2투,2917,1722,735,904,39,2,16,0,0,2,4,1,0,0,1703,19,1195
1100,서울특별시,1119,영등포구,,영등포본동제3투,1707,892,346,489,30,1,5,1,0,1,1,2,0,0,876,16,815
1100,서울특별시,1119,영등포구,,영등포본동제4투,1129,675,262,380,19,0,4,0,0,1,2,0,0,0,668,7,454
1100,서울특별시,1119,영등포구,,영등포본동제5투,2162,1689,710,882,62,1,12,0,0,0,2,0,0,1,1670,19,473
1100,서울특별시,1119,영등포구,,영등포본동제6투,2582,2056,880,1089,53,0,8,0,1,0,1,0,0,1,2033,23,526
1100,서울특별시,1119,영등포구,영등포동,소계,21751,14833,6298,7660,552,10,74,7,4,6,12,12,2,7,14644,189,6918
1100,서울특별시,1119,영등포구,,관내사전투표,4796,4796,2405,2122,192,5,22,3,0,1,1,6,0,1,4758,38,0
1100,서울특별시,1119,영등포구,,영등포동제1투,3498,1883,806,934,83,1,11,2,1,1,1,1,1,1,1843,40,1615
1100,서울특별시,1119,영등포구,,영등포동제2투,3279,1556,689,777,42,0,16,0,1,0,4,1,0,2,1532,24,1723
1100,서울특별시,1119,영등포구,,영등포동제3투,2623,1689,726,858,66,1,10,0,0,0,4,2,1,2,1670,19,934
1100,서울특별시,1119,영등포구,,영등포동제4투,2526,1357,557,700,58,1,6,1,0,1,0,2,0,0,1326,31,1169
1100,서울특별시,1119,영등포구,,영등포동제5투,2642,1686,553,1050,57,0,5,0,2,3,0,0,0,0,1670,16,956
1100,서울특별시,1119,영등포구,,영등포동제6투,2387,1866,562,1219,54,2,4,1,0,0,2,0,0,1,1845,21,521
1100,서울특별시,1119,영등포구,여의동,소계,25254,20059,5099,14372,394,3,60,7,1,9,17,4,1,2,19969,90,5195
1100,서울특별시,1119,영등포구,,관내사전투표,7192,7192,2436,4572,136,0,18,1,0,1,0,3,0,2,7169,23,0
1100,서울특별시,1119,영등포구,,여의동제1투,2237,1622,366,1199,36,1,10,2,0,0,0,0,0,0,1614,8,615
1100,서울특별시,1119,영등포구,,여의동제2투,2386,1501,290,1170,30,0,4,0,1,1,0,0,0,0,1496,5,885
1100,서울특별시,1119,영등포구,,여의동제3투,2214,1612,352,1211,33,1,5,1,0,1,0,0,1,0,1605,7,602
1100,서울특별시,1119,영등포구,,여의동제4투,2062,1426,265,1121,21,1,7,0,0,1,4,0,0,0,1420,6,636
1100,서울특별시,1119,영등포구,,여의동제5투,2153,1608,378,1181,39,0,2,1,0,2,3,0,0,0,1606,2,545
1100,서울특별시,1119,영등포구,,여의동제6투,2449,1828,349,1412,42,0,5,1,0,2,5,1,0,0,1817,11,621
1100,서울특별시,1119,영등포구,,여의동제7투,2836,2061,317,1692,28,0,6,0,0,0,1,0,0,0,2044,17,775
1100,서울특별시,1119,영등포구,,여의동제8투,1725,1209,346,814,29,0,3,1,0,1,4,0,0,0,1198,11,516
1100,서울특별시,1119,영등포구,당산제1동,소계,18728,14733,6656,7378,443,7,70,10,1,1,17,11,3,5,14602,131,3995
1100,서울특별시,1119,영등포구,,관내사전투표,7150,7150,3573,3276,216,3,26,5,0,0,2,4,2,1,7108,42,0
1100,서울특별시,1119,영등포구,,당산제1동제1투,1460,955,418,491,25,1,6,1,0,0,4,0,0,1,947,8,505
1100,서울특별시,1119,영등포구,,당산제1동제2투,2457,1552,693,777,47,0,8,0,0,0,2,3,0,1,1531,21,905
1100,서울특별시,1119,영등포구,,당산제1동제3투,2473,1774,717,960,57,1,11,0,0,0,1,1,0,1,1749,25,699
1100,서울특별시,1119,영등포구,,당산제1동제4투,2996,1851,663,1088,62,1,9,0,0,0,8,2,0,0,1833,18,1145
1100,서울특별시,1119,영등포구,,당산제1동제5투,2192,1451,592,786,36,1,10,4,1,1,0,1,1,1,1434,17,741
1100,서울특별시,1119,영등포구,당산제2동,소계,28312,22410,8971,12363,722,12,84,6,1,5,16,5,1,5,22191,219,5902
1100,서울특별시,1119,영등포구,,관내사전투표,8214,8214,3830,4071,233,5,15,1,0,1,2,2,1,1,8162,52,0
1100,서울특별시,1119,영등포구,,당산제2동제1투,3192,2011,782,1080,94,1,12,0,1,0,2,1,0,4,1977,34,1181
1100,서울특별시,1119,영등포구,,당산제2동제2투,2565,1658,524,1057,44,1,6,1,0,0,0,0,0,0,1633,25,907
1100,서울특별시,1119,영등포구,,당산제2동제3투,3370,2358,890,1338,85,0,14,0,0,1,4,1,0,0,2333,25,1012
1100,서울특별시,1119,영등포구,,당산제2동제4투,1872,1498,544,888,42,3,4,0,0,1,0,0,0,0,1482,16,374
1100,서울특별시,1119,영등포구,,당산제2동제5투,2657,2083,553,1448,50,0,9,3,0,2,2,0,0,0,2067,16,574
1100,서울특별시,1119,영등포구,,당산제2동제6투,2992,2193,830,1253,69,1,9,0,0,0,4,1,0,0,2167,26,799
1100,서울특별시,1119,영등포구,,당산제2동제7투,1859,1296,631,565,73,0,9,1,0,0,0,0,0,0,1279,17,563
1100,서울특별시,1119,영등포구,,당산제2동제8투,1591,1099,387,663,32,1,6,0,0,0,2,0,0,0,1091,8,492
1100,서울특별시,1119,영등포구,도림동,소계,14766,10801,5287,5035,259,9,74,2,3,1,12,8,0,6,10696,105,3965
1100,서울특별시,1119,영등포구,,관내사전투표,4394,4394,2457,1796,97,4,12,1,1,0,3,1,0,1,4373,21,0
1100,서울특별시,1119,영등포구,,도림동제1투,2655,1625,713,832,32,2,15,1,1,0,3,4,0,2,1605,20,1030
1100,서울특별시,1119,영등포구,,도림동제2투,2290,1317,598,630,42,0,20,0,0,1,1,1,0,1,1294,23,973
1100,서울특별시,1119,영등포구,,도림동제3투,2754,1677,754,842,43,2,12,0,0,0,0,2,0,0,1655,22,1077
1100,서울특별시,1119,영등포구,,도림동제4투,2673,1788,765,935,45,1,15,0,1,0,5,0,0,2,1769,19,885
1100,서울특별시,1119,영등포구,문래동,소계,24653,19936,8999,10077,620,6,66,1,4,2,16,10,0,5,19806,130,4717
1100,서울특별시,1119,영등포구,,관내사전투표,6948,6948,3612,3107,161,0,22,0,0,1,3,6,0,0,6912,36,0
1100,서울특별시,1119,영등포구,,문래동제1투,1422,688,288,377,12,0,4,0,0,0,2,0,0,0,683,5,734
1100,서울특별시,1119,영등포구,,문래동제2투,1933,1552,561,930,50,0,1,0,0,1,0,2,0,0,1545,7,381
1100,서울특별시,1119,영등포구,,문래동제3투,2537,1795,743,956,69,1,5,0,0,0,3,0,0,1,1778,17,742
1100,서울특별시,1119,영등포구,,문래동제4투,2191,1738,498,1168,54,2,3,0,3,0,1,0,0,2,1731,7,453
1100,서울특별시,1119,영등포구,,문래동제5투,2976,2121,863,1134,85,1,13,0,1,0,3,0,0,1,2101,20,855
1100,서울특별시,1119,영등포구,,문래동제6투,3591,2769,1367,1258,102,0,13,1,0,0,3,0,0,0,2744,25,822
1100,서울특별시,1119,영등포구,,문래동제7투,3055,2325,1067,1147,87,2,5,0,0,0,1,2,0,1,2312,13,730
1100,서울특별시,1119,영등포구,양평제1동,소계,15220,11850,5643,5604,402,5,64,5,2,1,8,5,2,2,11743,107,3370
1100,서울특별시,1119,영등포구,,관내사전투표,5701,5701,3102,2353,182,2,19,2,0,1,3,4,1,0,5669,32,0
1100,서울특별시,1119,영등포구,,양평제1동제1투,1985,1228,497,658,45,1,10,0,0,0,2,0,1,0,1214,14,757
1100,서울특별시,1119,영등포구,,양평제1동제2투,2776,1966,839,1037,64,1,10,0,0,0,1,0,0,1,1953,13,810
1100,서울특별시,1119,영등포구,,양평제1동제3투,2681,1591,629,841,71,0,17,1,1,0,1,1,0,0,1562,29,1090
1100,서울특별시,1119,영등포구,,양평제1동제4투,2077,1364,576,715,40,1,8,2,1,0,1,0,0,1,1345,19,713
1100,서울특별시,1119,영등포구,양평제2동,소계,16938,13439,6196,6555,483,4,57,1,1,1,7,13,2,1,13321,118,3499
1100,서울특별시,1119,영등포구,,관내사전투표,5541,5541,2888,2413,188,3,14,1,0,0,0,8,0,1,5516,25,0
1100,서울특별시,1119,영등포구,,양평제2동제1투,2226,1618,677,864,46,0,9,0,0,0,0,0,1,0,1597,21,608
1100,서울특별시,1119,영등포구,,양평제2동제2투,2044,1370,524,775,47,0,8,0,0,1,1,1,0,0,1357,13,674
1100,서울특별시,1119,영등포구,,양평제2동제3투,2011,1220,535,603,55,1,2,0,0,0,1,2,0,0,1199,21,791
1100,서울특별시,1119,영등포구,,양평제2동제4투,2367,1864,792,979,61,0,15,0,0,0,4,1,0,0,1852,12,503
1100,서울특별시,1119,영등포구,,양평제2동제5투,2749,1826,780,921,86,0,9,0,1,0,1,1,1,0,1800,26,923
1100,서울특별시,1119,영등포구,신길제1동,소계,14101,10096,4775,4795,310,10,72,3,1,3,6,10,5,2,9992,104,4005
1100,서울특별시,1119,영등포구,,관내사전투표,3969,3969,2184,1620,108,4,17,0,0,0,1,4,0,0,3938,31,0
1100,서울특별시,1119,영등포구,,신길제1동제1투,2600,1615,729,780,66,3,13,1,1,1,2,2,0,0,1598,17,985
1100,서울특별시,1119,영등포구,,신길제1동제2투,2118,1233,531,632,39,0,8,0,0,0,1,0,1,1,1213,20,885
1100,서울특별시,1119,영등포구,,신길제1동제3투,2215,1231,488,665,46,2,9,1,0,1,0,0,1,0,1213,18,984
1100,서울특별시,1119,영등포구,,신길제1동제4투,2266,1444,593,773,32,1,20,1,0,1,2,2,3,1,1429,15,822
1100,서울특별시,1119,영등포구,,신길제1동제5투,933,604,250,325,19,0,5,0,0,0,0,2,0,0,601,3,329
1100,서울특별시,1119,영등포구,신길제3동,소계,12568,9339,4260,4646,241,6,65,1,0,6,8,7,1,1,9242,97,3229
1100,서울특별시,1119,영등포구,,관내사전투표,3256,3256,1777,1378,58,0,17,0,0,0,1,2,1,0,3234,22,0
1100,서울특별시,1119,영등포구,,신길제3동제1투,1702,1008,451,503,26,0,12,0,0,0,2,1,0,0,995,13,694
1100,서울특별시,1119,영등포구,,신길제3동제2투,1811,1015,405,553,29,1,11,0,0,1,2,0,0,0,1002,13,796
1100,서울특별시,1119,영등포구,,신길제3동제3투,1925,1442,576,784,47,1,10,0,0,1,1,1,0,0,1421,21,483
1100,서울특별시,1119,영등포구,,신길제3동제4투,2066,1368,542,751,46,3,8,0,0,4,1,1,0,0,1356,12,698
1100,서울특별시,1119,영등포구,,신길제3동제5투,1808,1250,509,677,35,1,7,1,0,0,1,2,0,1,1234,16,558
1100,서울특별시,1119,영등포구,신길제4동,소계,10222,8014,3701,3974,223,7,28,2,0,2,6,6,2,1,7952,62,2208
1100,서울특별시,1119,영등포구,,관내사전투표,3569,3569,1860,1574,95,0,11,2,0,1,1,2,1,0,3547,22,0
1100,서울특별시,1119,영등포구,,신길제4동제1투,1505,812,368,411,18,1,4,0,0,0,1,1,0,0,804,8,693
1100,서울특별시,1119,영등포구,,신길제4동제2투,1445,805,347,421,20,1,5,0,0,0,0,2,0,0,796,9,640
1100,서울특별시,1119,영등포구,,신길제4동제3투,1645,1194,468,669,36,1,1,0,0,1,3,0,1,0,1180,14,451
1100,서울특별시,1119,영등포구,,신길제4동제4투,2058,1634,658,899,54,4,7,0,0,0,1,1,0,1,1625,9,424
1100,서울특별시,1119,영등포구,신길제5동,소계,9468,7474,3558,3603,200,4,33,1,1,1,2,9,0,2,7414,60,1994
1100,서울특별시,1119,영등포구,,관내사전투표,3911,3911,2125,1646,100,2,5,0,0,1,0,7,0,1,3887,24,0
1100,서울특별시,1119,영등포구,,신길제5동제1투,1069,571,236,299,25,0,2,0,0,0,0,1,0,0,563,8,498
1100,서울특별시,1119,영등포구,,신길제5동제2투,1700,1281,455,776,29,2,6,1,0,0,0,0,0,0,1269,12,419
1100,서울특별시,1119,영등포구,,신길제5동제3투,1602,995,442,501,28,0,9,0,1,0,1,1,0,0,983,12,607
1100,서울특별시,1119,영등포구,,신길제5동제4투,1186,716,300,381,18,0,11,0,0,0,1,0,0,1,712,4,470
1100,서울특별시,1119,영등포구,신길제6동,소계,14630,11062,4885,5660,300,9,59,4,6,3,9,17,5,2,10959,103,3568
1100,서울특별시,1119,영등포구,,관내사전투표,4629,4629,2379,2077,116,3,16,3,0,3,4,3,2,1,4607,22,0
1100,서울특별시,1119,영등포구,,신길제6동제1투,1880,1107,423,622,35,1,7,0,1,0,1,1,2,0,1093,14,773
1100,서울특별시,1119,영등포구,,신길제6동제2투,2092,1545,572,906,38,1,9,0,2,0,2,3,0,0,1533,12,547
1100,서울특별시,1119,영등포구,,신길제6동제3투,2074,1446,565,807,40,2,6,0,1,0,0,3,1,1,1426,20,628
1100,서울특별시,1119,영등포구,,신길제6동제4투,2157,1234,499,665,42,1,4,0,2,0,1,4,0,0,1218,16,923
1100,서울특별시,1119,영등포구,,신길제6동제5투,1798,1101,447,583,29,1,17,1,0,0,1,3,0,0,1082,19,697
1100,서울특별시,1119,영등포구,신길제7동,소계,13761,10831,4270,6104,285,6,43,2,0,1,9,10,2,4,10736,95,2930
1100,서울특별시,1119,영등포구,,관내사전투표,3743,3742,1751,1858,87,2,10,2,0,0,2,1,1,2,3716,26,1
1100,서울특별시,1119,영등포구,,신길제7동제1투,2644,2050,756,1211,49,2,8,0,0,0,1,3,1,1,2032,18,594
1100,서울특별시,1119,영등포구,,신길제7동제2투,2958,2117,792,1228,62,0,7,0,0,0,1,3,0,0,2093,24,841
1100,서울특별시,1119,영등포구,,신길제7동제3투,2234,1333,452,800,41,1,15,0,0,1,3,2,0,1,1316,17,901
1100,서울특별시,1119,영등포구,,신길제7동제4투,2182,1589,519,1007,46,1,3,0,0,0,2,1,0,0,1579,10,593
1100,서울특별시,1119,영등포구,대림제1동,소계,12225,9212,4487,4359,187,7,58,1,2,3,6,20,5,0,9135,77,3013
1100,서울특별시,1119,영등포구,,관내사전투표,4592,4592,2569,1884,82,2,16,1,1,1,2,12,1,0,4571,21,0
1100,서울특별시,1119,영등포구,,대림제1동제1투,1528,813,336,419,21,1,14,0,0,0,0,1,1,0,793,20,715
1100,서울특별시,1119,영등포구,,대림제1동제2투,1585,916,357,529,16,0,4,0,0,0,2,1,0,0,909,7,669
1100,서울특별시,1119,영등포구,,대림제1동제3투,1708,1242,527,667,27,0,7,0,0,2,0,2,0,0,1232,10,466
1100,서울특별시,1119,영등포구,,대림제1동제4투,1674,1033,439,542,25,2,10,0,1,0,0,2,2,0,1023,10,641
1100,서울특별시,1119,영등포구,,대림제1동제5투,1138,616,259,318,16,2,7,0,0,0,2,2,1,0,607,9,522
1100,서울특별시,1119,영등포구,대림제2동,소계,10425,7575,3820,3433,165,7,51,2,2,0,6,7,0,0,7493,82,2850
1100,서울특별시,1119,영등포구,,관내사전투표,3354,3354,1969,1288,58,4,12,0,2,0,1,3,0,0,3337,17,0
1100,서울특별시,1119,영등포구,,대림제2동제1투,798,377,158,200,8,0,4,0,0,0,0,0,0,0,370,7,421
1100,서울특별시,1119,영등포구,,대림제2동제2투,904,513,230,258,12,0,5,0,0,0,0,0,0,0,505,8,391
1100,서울특별시,1119,영등포구,,대림제2동제3투,2001,1246,532,645,31,2,8,1,0,0,4,3,0,0,1226,20,755
1100,서울특별시,1119,영등포구,,대림제2동제4투,2260,1479,663,735,47,0,14,1,0,0,1,1,0,0,1462,17,781
1100,서울특별시,1119,영등포구,,대림제2동제5투,1108,606,268,307,9,1,8,0,0,0,0,0,0,0,593,13,502
1100,서울특별시,1119,영등포구,대림제3동,소계,17024,12535,5981,5994,317,5,99,1,2,2,9,16,4,10,12440,95,4489
1100,서울특별시,1119,영등포구,,관내사전투표,4658,4658,2548,1949,103,2,23,0,0,1,2,8,3,1,4640,18,0
1100,서울특별시,1119,영등포구,,대림제3동제1투,2036,1270,587,611,42,0,11,0,0,0,0,2,0,2,1255,15,766
1100,서울특별시,1119,영등포구,,대림제3동제2투,1859,1163,554,547,35,0,12,1,1,0,0,2,0,1,1153,10,696
1100,서울특별시,1119,영등포구,,대림제3동제3투,1644,1046,481,526,20,0,5,0,0,0,1,0,0,1,1034,12,598
1100,서울특별시,1119,영등포구,,대림제3동제4투,1291,742,354,346,16,0,10,0,0,0,1,1,0,1,729,13,549
1100,서울특별시,1119,영등포구,,대림제3동제5투,1817,1080,462,560,28,0,18,0,1,0,1,0,0,2,1072,8,737
1100,서울특별시,1119,영등포구,,대림제3동제6투,1539,1022,464,503,32,1,12,0,0,0,1,1,0,0,1014,8,517
1100,서울특별시,1119,영등포구,,대림제3동제7투,2180,1554,531,952,41,2,8,0,0,1,3,2,1,2,1543,11,626
1100,서울특별시,1119,영등포구,잘못 투입·구분된 투표지,,0,2,0,1,1,0,0,0,0,0,0,0,0,0,2,0,-2
1100,서울특별시,1120,동작구,합계,,342248,271510,122914,135733,7866,161,1380,56,35,85,140,221,51,66,268708,2802,70738
1100,서울특별시,1120,동작구,거소·선상투표,,478,453,181,197,8,3,7,0,0,0,0,0,0,1,397,56,25
1100,서울특별시,1120,동작구,관외사전투표,,39413,39408,19054,18324,1294,23,220,6,3,18,17,53,2,7,39021,387,5
1100,서울특별시,1120,동작구,재외투표,,3306,2390,1214,871,79,0,5,0,1,0,1,3,0,0,2174,216,916
1100,서울특별시,1120,동작구,노량진제1동,소계,23411,17417,7341,9334,427,6,104,4,4,7,10,12,2,4,17255,162,5994
1100,서울특별시,1120,동작구,,관내사전투표,5322,5322,2710,2462,102,4,8,2,0,1,0,4,1,2,5296,26,0
1100,서울특별시,1120,동작구,,노량진제1동제1투,2453,1788,703,1024,38,0,7,0,0,1,3,1,0,0,1777,11,665
1100,서울특별시,1120,동작구,,노량진제1동제2투,2710,1748,709,939,54,2,15,0,1,0,4,1,0,1,1726,22,962
1100,서울특별시,1120,동작구,,노량진제1동제3투,1862,1327,450,820,40,0,9,0,0,1,0,0,0,0,1320,7,535
1100,서울특별시,1120,동작구,,노량진제1동제4투,2892,1400,564,726,42,0,24,0,0,0,1,3,0,0,1360,40,1492
1100,서울특별시,1120,동작구,,노량진제1동제5투,1613,1079,416,608,24,0,15,0,0,1,1,1,0,0,1066,13,534
1100,서울특별시,1120,동작구,,노량진제1동제6투,2527,1731,733,896,56,0,13,2,1,2,1,1,0,1,1706,25,796
1100,서울특별시,1120,동작구,,노량진제1동제7투,1470,1173,363,774,24,0,0,0,2,0,0,1,0,0,1164,9,297
1100,서울특별시,1120,동작구,,노량진제1동제8투,2562,1849,693,1085,47,0,13,0,0,1,0,0,1,0,1840,9,713
1100,서울특별시,1120,동작구,노량진제2동,소계,11822,9113,4259,4383,236,11,58,0,1,3,7,24,2,2,8986,127,2709
1100,서울특별시,1120,동작구,,관내사전투표,5664,5664,2938,2479,139,6,27,0,0,0,1,18,0,1,5609,55,0
1100,서울특별시,1120,동작구,,노량진제2동제1투,1142,692,291,364,21,0,3,0,0,0,0,2,0,1,682,10,450
1100,서울특별시,1120,동작구,,노량진제2동제2투,1232,630,233,356,15,0,10,0,0,0,1,2,0,0,617,13,602
1100,서울특별시,1120,동작구,,노량진제2동제3투,1444,789,295,450,23,1,5,0,1,3,1,0,1,0,780,9,655
1100,서울특별시,1120,동작구,,노량진제2동제4투,2340,1338,502,734,38,4,13,0,0,0,4,2,1,0,1298,40,1002
1100,서울특별시,1120,동작구,상도제1동,소계,32877,25319,10705,13431,760,15,89,7,4,7,11,11,4,6,25050,269,7558
1100,서울특별시,1120,동작구,,관내사전투표,10241,10241,4945,4930,254,9,21,2,1,2,0,4,0,3,10171,70,0
1100,서울특별시,1120,동작구,,상도제1동제1투,3434,2244,969,1151,77,0,11,0,0,0,1,2,2,0,2213,31,1190
1100,서울특별시,1120,동작구,,상도제1동제2투,3275,2085,832,1131,73,0,11,0,0,0,3,0,0,1,2051,34,1190
1100,서울특별시,1120,동작구,,상도제1동제3투,2708,1806,730,986,53,4,6,0,1,2,2,1,1,0,1786,20,902
1100,서울특별시,1120,동작구,,상도제1동제4투,2487,1649,618,936,59,0,10,1,0,0,2,1,0,0,1627,22,838
1100,서울특별시,1120,동작구,,상도제1동제5투,2624,1561,466,1015,48,0,7,2,2,2,1,0,0,0,1543,18,1063
1100,서울특별시,1120,동작구,,상도제1동제6투,2460,1685,588,1003,55,0,7,0,0,1,0,1,0,1,1656,29,775
1100,서울특별시,1120,동작구,,상도제1동제7투,2428,1574,643,821,64,1,12,1,0,0,2,1,1,0,1546,28,854
1100,서울특별시,1120,동작구,,상도제1동제8투,3220,2474,914,1458,77,1,4,1,0,0,0,1,0,1,2457,17,746
1100,서울특별시,1120,동작구,상도제2동,소계,21021,16161,6901,8600,419,6,64,1,1,6,8,3,4,4,16017,144,4860
1100,서울특별시,1120,동작구,,관내사전투표,7261,7261,3630,3392,165,2,21,0,0,1,1,3,1,3,7219,42,0
1100,서울특별시,1120,동작구,,상도제2동제1투,3212,2117,818,1202,55,0,13,0,1,0,2,0,1,0,2092,25,1095
1100,서울특별시,1120,동작구,,상도제2동제2투,3254,2001,684,1233,49,1,9,0,0,1,1,0,0,1,1979,22,1253
1100,서울특별시,1120,동작구,,상도제2동제3투,2521,1609,615,910,52,0,9,1,0,0,2,0,2,0,1591,18,912
1100,서울특별시,1120,동작구,,상도제2동제4투,3630,2544,881,1549,76,1,5,0,0,3,2,0,0,0,2517,27,1086
1100,서울특별시,1120,동작구,,상도제2동제5투,1143,629,273,314,22,2,7,0,0,1,0,0,0,0,619,10,514
1100,서울특별시,1120,동작구,상도제3동,소계,23080,17907,9400,7617,551,9,116,3,3,1,9,16,3,4,17732,175,5173
1100,서울특별시,1120,동작구,,관내사전투표,9846,9846,5643,3768,311,1,50,3,1,1,1,8,1,2,9790,56,0
1100,서울특별시,1120,동작구,,상도제3동제1투,3321,2119,957,1055,57,3,15,0,1,0,2,2,0,0,2092,27,1202
1100,서울특별시,1120,동작구,,상도제3동제2투,2446,1323,591,649,42,3,9,0,0,0,2,0,0,1,1297,26,1123
1100,서울특별시,1120,동작구,,상도제3동제3투,2134,1223,555,585,42,2,17,0,0,0,2,2,0,0,1205,18,911
1100,서울특별시,1120,동작구,,상도제3동제4투,2004,1288,641,582,32,0,11,0,0,0,0,1,2,1,1270,18,716
1100,서울특별시,1120,동작구,,상도제3동제5투,3329,2108,1013,978,67,0,14,0,1,0,2,3,0,0,2078,30,1221
1100,서울특별시,1120,동작구,상도제4동,소계,20967,14781,7410,6655,414,11,95,5,0,6,15,11,5,7,14634,147,6186
1100,서울특별시,1120,동작구,,관내사전투표,6165,6165,3417,2530,144,4,15,0,0,2,5,3,3,4,6127,38,0
1100,서울특별시,1120,동작구,,상도제4동제1투,1995,1126,567,500,26,0,13,0,0,0,1,0,0,0,1107,19,869
1100,서울특별시,1120,동작구,,상도제4동제2투,2476,1397,623,692,33,1,16,3,0,2,1,1,1,2,1375,22,1079
1100,서울특별시,1120,동작구,,상도제4동제3투,1897,1066,491,513,26,3,11,1,0,0,4,1,0,1,1051,15,831
1100,서울특별시,1120,동작구,,상도제4동제4투,2552,1434,684,659,58,2,10,1,0,0,2,0,0,0,1416,18,1118
1100,서울특별시,1120,동작구,,상도제4동제5투,3107,1941,828,1012,57,1,22,0,0,1,1,1,0,0,1923,18,1166
1100,서울특별시,1120,동작구,,상도제4동제6투,2775,1652,800,749,70,0,8,0,0,1,1,5,1,0,1635,17,1123
1100,서울특별시,1120,동작구,흑석동,소계,24223,18761,6931,11061,480,9,75,3,3,3,5,14,3,6,18593,168,5462
1100,서울특별시,1120,동작구,,관내사전투표,8251,8251,3609,4371,183,3,28,0,1,0,1,9,0,4,8209,42,0
1100,서울특별시,1120,동작구,,흑석동제1투,2189,1481,289,1140,40,0,5,0,1,1,0,0,1,0,1477,4,708
1100,서울특별시,1120,동작구,,흑석동제2투,1790,866,318,501,22,0,7,1,1,0,2,1,1,0,854,12,924
1100,서울특별시,1120,동작구,,흑석동제3투,2266,1516,523,940,31,2,3,0,0,0,0,1,1,0,1501,15,750
1100,서울특별시,1120,동작구,,흑석동제4투,2146,1460,395,996,41,0,9,1,0,0,0,2,0,0,1444,16,686
1100,서울특별시,1120,동작구,,흑석동제5투,2461,1649,516,1036,52,0,8,0,0,1,0,0,0,1,1614,35,812
1100,서울특별시,1120,동작구,,흑석동제6투,2622,1689,601,990,53,2,10,1,0,0,2,1,0,1,1661,28,933
1100,서울특별시,1120,동작구,,흑석동제7투,2498,1849,680,1087,58,2,5,0,0,1,0,0,0,0,1833,16,649
1100,서울특별시,1120,동작구,사당제1동,소계,18046,13532,6438,6313,493,11,90,7,2,2,12,7,6,2,13383,149,4514
1100,서울특별시,1120,동작구,,관내사전투표,5477,5477,2985,2252,170,3,19,3,1,0,5,4,2,0,5444,33,0
1100,서울특별시,1120,동작구,,사당제1동제1투,3480,2358,1042,1172,88,3,20,1,1,1,4,0,1,0,2333,25,1122
1100,서울특별시,1120,동작구,,사당제1동제2투,2529,1699,754,839,67,1,12,0,0,1,1,0,2,1,1678,21,830
1100,서울특별시,1120,동작구,,사당제1동제3투,2107,1308,526,674,65,3,14,1,0,0,2,1,0,1,1287,21,799
1100,서울특별시,1120,동작구,,사당제1동제4투,1969,1219,557,584,46,1,8,0,0,0,0,1,1,0,1198,21,750
1100,서울특별시,1120,동작구,,사당제1동제5투,2484,1471,574,792,57,0,17,2,0,0,0,1,0,0,1443,28,1013
1100,서울특별시,1120,동작구,사당제2동,소계,22337,17962,7267,9938,482,4,84,1,4,2,11,9,1,4,17807,155,4375
1100,서울특별시,1120,동작구,,관내사전투표,8619,8619,4127,4205,201,3,26,0,2,0,3,4,1,4,8576,43,0
1100,서울특별시,1120,동작구,,사당제2동제1투,2598,1965,624,1267,44,0,7,1,1,1,3,1,0,0,1949,16,633
1100,서울특별시,1120,동작구,,사당제2동제2투,2249,1412,515,817,50,0,6,0,0,0,0,1,0,0,1389,23,837
1100,서울특별시,1120,동작구,,사당제2동제3투,1766,1176,536,571,44,0,12,0,0,0,0,0,0,0,1163,13,590
1100,서울특별시,1120,동작구,,사당제2동제4투,2073,1227,368,793,32,0,6,0,0,1,1,2,0,0,1203,24,846
1100,서울특별시,1120,동작구,,사당제2동제5투,1506,970,362,558,31,0,10,0,0,0,1,0,0,0,962,8,536
1100,서울특별시,1120,동작구,,사당제2동제6투,1789,1291,371,854,38,1,10,0,1,0,2,0,0,0,1277,14,498
1100,서울특별시,1120,동작구,,사당제2동제7투,1737,1302,364,873,42,0,7,0,0,0,1,1,0,0,1288,14,435
1100,서울특별시,1120,동작구,사당제3동,소계,16772,12812,5205,7111,335,5,39,3,3,4,4,12,3,1,12725,87,3960
1100,서울특별시,1120,동작구,,관내사전투표,4314,4314,2055,2130,82,2,6,1,2,1,1,8,1,0,4289,25,0
1100,서울특별시,1120,동작구,,사당제3동제1투,2484,1615,653,886,46,1,7,2,0,1,1,1,1,0,1599,16,869
1100,서울특별시,1120,동작구,,사당제3동제2투,1046,681,276,377,17,0,5,0,0,0,0,1,0,0,676,5,365
1100,서울특별시,1120,동작구,,사당제3동제3투,1765,1048,320,677,36,0,7,0,1,1,0,1,0,0,1043,5,717
1100,서울특별시,1120,동작구,,사당제3동제4투,2954,1934,709,1132,74,1,4,0,0,0,1,1,1,0,1923,11,1020
1100,서울특별시,1120,동작구,,사당제3동제5투,2082,1549,626,866,39,1,6,0,0,1,0,0,0,0,1539,10,533
1100,서울특별시,1120,동작구,,사당제3동제6투,2127,1671,566,1043,41,0,4,0,0,0,1,0,0,1,1656,15,456
1100,서울특별시,1120,동작구,사당제4동,소계,12047,9328,4745,4132,263,11,69,3,2,6,10,4,4,2,9251,77,2719
1100,서울특별시,1120,동작구,,관내사전투표,4870,4870,2819,1862,128,8,23,3,0,1,2,2,2,1,4851,19,0
1100,서울특별시,1120,동작구,,사당제4동제1투,1840,1168,527,562,40,1,11,0,1,2,1,0,0,0,1145,23,672
1100,서울특별시,1120,동작구,,사당제4동제2투,1672,1074,430,584,37,2,8,0,1,2,0,0,1,0,1065,9,598
1100,서울특별시,1120,동작구,,사당제4동제3투,2038,1226,549,608,34,0,17,0,0,1,4,0,1,1,1215,11,812
1100,서울특별시,1120,동작구,,사당제4동제4투,1627,990,420,516,24,0,10,0,0,0,3,2,0,0,975,15,637
1100,서울특별시,1120,동작구,사당제5동,소계,12032,9613,4596,4623,256,8,31,0,2,5,1,5,1,2,9530,83,2419
1100,서울특별시,1120,동작구,,관내사전투표,4986,4987,2754,2060,127,5,9,0,1,2,0,3,1,1,4963,24,-1
1100,서울특별시,1120,동작구,,사당제5동제1투,1847,1305,466,791,29,0,6,0,1,0,0,0,0,0,1293,12,542
1100,서울특별시,1120,동작구,,사당제5동제2투,1806,1194,473,677,28,1,3,0,0,0,0,1,0,0,1183,11,612
1100,서울특별시,1120,동작구,,사당제5동제3투,1818,1077,436,563,41,1,11,0,0,2,1,1,0,1,1057,20,741
1100,서울특별시,1120,동작구,,사당제5동제4투,1575,1050,467,532,31,1,2,0,0,1,0,0,0,0,1034,16,525
1100,서울특별시,1120,동작구,대방동,소계,26377,20003,9184,9898,555,21,101,8,1,7,8,21,8,7,19819,184,6374
1100,서울특별시,1120,동작구,,관내사전투표,7484,7484,3949,3293,162,8,27,1,1,1,0,8,4,0,7454,30,0
1100,서울특별시,1120,동작구,,대방동제1투,2161,1397,584,719,48,0,15,0,0,2,1,1,1,2,1373,24,764
1100,서울특별시,1120,동작구,,대방동제2투,2248,1588,639,879,48,3,6,1,0,1,1,2,0,0,1580,8,660
1100,서울특별시,1120,동작구,,대방동제3투,2860,2006,800,1099,72,1,13,2,0,0,0,3,0,2,1992,14,854
1100,서울특별시,1120,동작구,,대방동제4투,2208,1366,626,676,31,0,10,1,0,0,0,2,1,0,1347,19,842
1100,서울특별시,1120,동작구,,대방동제5투,2130,1514,542,906,36,3,8,0,0,1,2,0,1,0,1499,15,616
1100,서울특별시,1120,동작구,,대방동제6투,1862,1225,512,641,39,1,5,1,0,0,0,3,0,1,1203,22,637
1100,서울특별시,1120,동작구,,대방동제7투,2804,1804,776,908,71,0,11,2,0,1,3,1,0,0,1773,31,1000
1100,서울특별시,1120,동작구,,대방동제8투,2620,1619,756,777,48,5,6,0,0,1,1,1,1,2,1598,21,1001
1100,서울특별시,1120,동작구,신대방제1동,소계,17069,13275,5855,6854,360,5,73,2,1,5,7,10,0,3,13175,100,3794
1100,서울특별시,1120,동작구,,관내사전투표,5213,5214,2631,2398,128,4,19,1,0,0,2,3,0,1,5187,27,-1
1100,서울특별시,1120,동작구,,신대방제1동제1투,1458,917,363,492,24,1,17,0,0,0,0,1,0,2,900,17,541
1100,서울특별시,1120,동작구,,신대방제1동제2투,1748,999,398,550,29,0,9,0,0,3,2,0,0,0,991,8,749
1100,서울특별시,1120,동작구,,신대방제1동제3투,2831,2089,928,1072,74,0,7,0,0,0,0,0,0,0,2081,8,742
1100,서울특별시,1120,동작구,,신대방제1동제4투,2993,1890,761,1030,57,0,16,0,1,1,0,2,0,0,1868,22,1103
1100,서울특별시,1120,동작구,,신대방제1동제5투,2826,2166,774,1312,48,0,5,1,0,1,3,4,0,0,2148,18,660
1100,서울특별시,1120,동작구,신대방제2동,소계,16970,13274,6227,6391,454,3,60,3,0,3,4,6,3,4,13158,116,3696
1100,서울특별시,1120,동작구,,관내사전투표,5919,5916,3277,2376,199,0,13,2,0,2,2,5,0,2,5878,38,3
1100,서울특별시,1120,동작구,,신대방제2동제1투,2406,1649,676,899,44,0,12,1,0,1,1,0,1,0,1635,14,757
1100,서울특별시,1120,동작구,,신대방제2동제2투,2715,1721,758,859,71,1,12,0,0,0,0,1,0,2,1704,17,994
1100,서울특별시,1120,동작구,,신대방제2동제3투,3071,1985,868,987,92,0,9,0,0,0,1,0,1,0,1958,27,1086
1100,서울특별시,1120,동작구,,신대방제2동제4투,2859,2003,648,1270,48,2,14,0,0,0,0,0,1,0,1983,20,856
1100,서울특별시,1120,동작구,잘못 투입·구분된 투표지,,0,1,1,0,0,0,0,0,0,0,0,0,0,0,1,0,-1
1100,서울특별시,1121,관악구,합계,,446161,340773,169284,151944,11245,309,2594,110,35,103,246,310,98,116,336394,4379,105388
1100,서울특별시,1121,관악구,거소·선상투표,,574,529,250,200,9,2,10,1,0,0,0,0,2,1,475,54,45
1100,서울특별시,1121,관악구,관외사전투표,,45300,45292,23432,19112,1638,39,376,15,6,12,19,71,10,16,44746,546,8
1100,서울특별시,1121,관악구,재외투표,,3004,2193,1308,614,72,0,5,1,1,2,0,0,0,0,2003,190,811
1100,서울특별시,1121,관악구,보라매동,소계,19753,14476,7325,6341,469,9,123,3,1,6,7,7,6,4,14301,175,5277
1100,서울특별시,1121,관악구,,관내사전투표,5676,5676,3305,2105,167,5,31,0,0,2,4,2,2,1,5624,52,0
1100,서울특별시,1121,관악구,,보라매동제1투,2606,1809,720,997,60,0,11,1,0,1,3,0,0,0,1793,16,797
1100,서울특별시,1121,관악구,,보라매동제2투,2530,1639,789,758,49,0,11,0,0,1,0,2,0,1,1611,28,891
1100,서울특별시,1121,관악구,,보라매동제3투,3223,2037,909,998,64,0,24,0,0,1,0,2,3,1,2002,35,1186
1100,서울특별시,1121,관악구,,보라매동제4투,2773,1534,738,696,55,3,19,1,1,0,0,1,1,0,1515,19,1239
1100,서울특별시,1121,관악구,,보라매동제5투,2945,1781,864,787,74,1,27,1,0,1,0,0,0,1,1756,25,1164
1100,서울특별시,1121,관악구,은천동,소계,25731,19248,9855,8449,548,16,132,3,2,4,14,15,7,10,19055,193,6483
1100,서울특별시,1121,관악구,,관내사전투표,8032,8032,4678,3035,207,7,35,3,0,2,5,6,4,3,7985,47,0
1100,서울특별시,1121,관악구,,은천동제1투,2609,1529,639,795,56,0,13,0,0,0,0,2,1,1,1507,22,1080
1100,서울특별시,1121,관악구,,은천동제2투,2589,1567,680,784,51,1,17,0,1,0,1,1,0,3,1539,28,1022
1100,서울특별시,1121,관악구,,은천동제3투,2185,1382,571,728,50,1,11,0,0,0,0,0,0,0,1361,21,803
1100,서울특별시,1121,관악구,,은천동제4투,2442,1856,856,906,59,0,5,0,0,1,3,4,0,1,1835,21,586
1100,서울특별시,1121,관악구,,은천동제5투,2518,1788,859,845,46,3,16,0,0,1,3,0,1,1,1775,13,730
1100,서울특별시,1121,관악구,,은천동제6투,2604,1542,792,666,45,1,16,0,0,0,1,1,1,1,1524,18,1062
1100,서울특별시,1121,관악구,,은천동제7투,2752,1552,780,690,34,3,19,0,1,0,1,1,0,0,1529,23,1200
1100,서울특별시,1121,관악구,성현동,소계,22089,17247,8607,7834,473,12,103,9,0,7,10,10,5,6,17076,171,4842
1100,서울특별시,1121,관악구,,관내사전투표,6279,6280,3571,2479,158,4,25,7,0,1,0,5,2,2,6254,26,-1
1100,서울특별시,1121,관악구,,성현동제1투,2488,1711,867,766,46,0,13,0,0,1,0,1,1,0,1695,16,777
1100,서울특별시,1121,관악구,,성현동제2투,3189,2140,1014,1016,62,1,13,2,0,0,0,3,0,1,2112,28,1049
1100,서울특별시,1121,관악구,,성현동제3투,2242,1786,811,889,43,1,12,0,0,1,1,0,0,0,1758,28,456
1100,서울특별시,1121,관악구,,성현동제4투,2275,1701,682,912,65,3,8,0,0,0,1,0,0,0,1671,30,574
1100,서울특별시,1121,관악구,,성현동제5투,2144,1456,609,761,53,0,11,0,0,1,2,0,1,1,1439,17,688
1100,서울특별시,1121,관악구,,성현동제6투,1167,651,328,293,16,1,3,0,0,0,2,0,0,1,644,7,516
1100,서울특별시,1121,관악구,,성현동제7투,2305,1522,725,718,30,2,18,0,0,3,4,1,1,1,1503,19,783
1100,서울특별시,1121,관악구,중앙동,소계,13034,9683,4850,4194,408,7,73,2,0,2,5,10,3,3,9557,126,3351
1100,서울특별시,1121,관악구,,관내사전투표,4774,4774,2651,1827,204,3,26,0,0,0,1,8,1,1,4722,52,0
1100,서울특별시,1121,관악구,,중앙동제1투,2548,1471,652,698,71,2,20,0,0,2,1,0,0,0,1446,25,1077
1100,서울특별시,1121,관악구,,중앙동제2투,2578,1669,790,762,66,1,16,2,0,0,2,2,2,1,1644,25,909
1100,서울특별시,1121,관악구,,중앙동제3투,3134,1769,757,907,67,1,11,0,0,0,1,0,0,1,1745,24,1365
1100,서울특별시,1121,관악구,청림동,소계,12110,9800,4701,4691,265,2,43,1,0,1,10,8,1,1,9724,76,2310
1100,서울특별시,1121,관악구,,관내사전투표,4303,4303,2327,1852,93,2,9,0,0,1,1,3,0,0,4288,15,0
1100,서울특별시,1121,관악구,,청림동제1투,2191,1589,570,937,53,0,6,0,0,0,3,1,0,0,1570,19,602
1100,서울특별시,1121,관악구,,청림동제2투,2529,1519,693,744,38,0,16,0,0,0,1,3,1,0,1496,23,1010
1100,서울특별시,1121,관악구,,청림동제3투,3087,2389,1111,1158,81,0,12,1,0,0,5,1,0,1,2370,19,698
1100,서울특별시,1121,관악구,행운동,소계,24117,18383,8888,8313,720,22,122,8,0,4,16,12,3,5,18113,270,5734
1100,서울특별시,1121,관악구,,관내사전투표,7624,7624,4256,2940,285,4,40,3,0,1,1,5,3,3,7541,83,0
1100,서울특별시,1121,관악구,,행운동제1투,2644,1756,744,884,69,1,15,0,0,1,2,0,0,0,1716,40,888
1100,서울특별시,1121,관악구,,행운동제2투,3011,2020,815,1046,89,6,15,1,0,0,6,5,0,0,1983,37,991
1100,서울특별시,1121,관악구,,행운동제3투,3160,2051,933,977,89,3,12,0,0,1,1,0,0,1,2017,34,1109
1100,서울특별시,1121,관악구,,행운동제4투,2880,1664,714,796,86,3,22,2,0,0,0,0,0,0,1623,41,1216
1100,서울특별시,1121,관악구,,행운동제5투,1942,1166,511,580,44,4,9,1,0,0,0,2,0,0,1151,15,776
1100,서울특별시,1121,관악구,,행운동제6투,2856,2102,915,1090,58,1,9,1,0,1,6,0,0,1,2082,20,754
1100,서울특별시,1121,관악구,청룡동,소계,28656,21507,10233,9913,796,23,136,5,3,5,15,18,9,5,21161,346,7149
1100,서울특별시,1121,관악구,,관내사전투표,8702,8701,4798,3492,261,10,37,2,0,0,2,8,3,3,8616,85,1
1100,서울특별시,1121,관악구,,청룡동제1투,3288,1855,816,898,80,2,22,0,0,0,3,2,0,0,1823,32,1433
1100,서울특별시,1121,관악구,,청룡동제2투,3342,2116,971,987,94,1,16,0,1,1,3,0,1,0,2075,41,1226
1100,서울특별시,1121,관악구,,청룡동제3투,3289,2194,895,1104,109,4,12,1,1,0,1,3,0,2,2132,62,1095
1100,서울특별시,1121,관악구,,청룡동제4투,3277,2243,1044,1053,70,4,20,0,1,2,4,1,0,0,2199,44,1034
1100,서울특별시,1121,관악구,,청룡동제5투,3829,2565,983,1379,119,1,21,0,0,2,1,3,1,0,2510,55,1264
1100,서울특별시,1121,관악구,,청룡동제6투,2929,1833,726,1000,63,1,8,2,0,0,1,1,4,0,1806,27,1096
1100,서울특별시,1121,관악구,낙성대동,소계,13626,10179,4797,4780,385,5,60,5,1,4,3,5,1,6,10052,127,3447
1100,서울특별시,1121,관악구,,관내사전투표,4603,4603,2463,1897,174,2,15,3,1,1,0,1,0,3,4560,43,0
1100,서울특별시,1121,관악구,,낙성대동제1투,3434,2149,892,1115,81,0,16,1,0,1,1,4,0,1,2112,37,1285
1100,서울특별시,1121,관악구,,낙성대동제2투,2763,1614,702,813,55,2,13,0,0,1,0,0,1,1,1588,26,1149
1100,서울특별시,1121,관악구,,낙성대동제3투,2826,1813,740,955,75,1,16,1,0,1,2,0,0,1,1792,21,1013
1100,서울특별시,1121,관악구,인헌동,소계,22643,17548,8768,7740,628,14,118,8,3,2,13,10,7,4,17315,233,5095
1100,서울특별시,1121,관악구,,관내사전투표,8994,8994,5046,3487,315,7,45,5,0,0,5,6,1,2,8919,75,0
1100,서울특별시,1121,관악구,,인헌동제1투,2346,1288,544,646,50,3,14,0,0,0,1,0,0,0,1258,30,1058
1100,서울특별시,1121,관악구,,인헌동제2투,3038,1798,712,947,82,0,11,1,0,0,4,0,1,1,1759,39,1240
1100,서울특별시,1121,관악구,,인헌동제3투,2767,1783,779,882,57,2,22,0,0,1,2,0,0,0,1745,38,984
1100,서울특별시,1121,관악구,,인헌동제4투,2656,1646,737,812,51,1,11,1,0,1,0,2,2,0,1618,28,1010
1100,서울특별시,1121,관악구,,인헌동제5투,2842,2039,950,966,73,1,15,1,3,0,1,2,3,1,2016,23,803
1100,서울특별시,1121,관악구,남현동,소계,14402,11003,5062,5367,370,12,50,3,3,4,12,7,1,3,10894,109,3399
1100,서울특별시,1121,관악구,,관내사전투표,4853,4855,2613,2039,143,4,19,2,0,1,4,2,1,1,4829,26,-2
1100,서울특별시,1121,관악구,,남현동제1투,2475,1679,705,882,59,2,7,0,0,0,1,1,0,2,1659,20,796
1100,서울특별시,1121,관악구,,남현동제2투,2296,1569,641,839,55,1,6,0,2,1,3,1,0,0,1549,20,727
1100,서울특별시,1121,관악구,,남현동제3투,2492,1470,573,791,65,3,7,1,1,1,2,1,0,0,1445,25,1022
1100,서울특별시,1121,관악구,,남현동제4투,2286,1430,530,816,48,2,11,0,0,1,2,2,0,0,1412,18,856
1100,서울특별시,1121,관악구,신림동,소계,19991,13366,6454,5910,547,26,160,4,3,4,10,7,5,7,13137,229,6625
1100,서울특별시,1121,관악구,,관내사전투표,6242,6244,3344,2505,244,14,51,0,0,1,1,6,2,3,6171,73,-2
1100,서울특별시,1121,관악구,,신림동제1투,4139,2176,949,1027,95,3,46,1,2,1,4,0,1,0,2129,47,1963
1100,서울특별시,1121,관악구,,신림동제2투,4147,2003,887,935,91,4,23,2,0,1,2,0,1,3,1949,54,2144
1100,서울특별시,1121,관악구,,신림동제3투,2883,1420,629,672,59,0,21,0,1,0,1,0,1,1,1385,35,1463
1100,서울특별시,1121,관악구,,신림동제4투,2580,1523,645,771,58,5,19,1,0,1,2,1,0,0,1503,20,1057
1100,서울특별시,1121,관악구,신사동,소계,18630,13038,6560,5710,408,13,108,3,1,4,7,15,5,5,12839,199,5592
1100,서울특별시,1121,관악구,,관내사전투표,5852,5852,3304,2254,183,7,33,3,0,0,1,9,2,4,5800,52,0
1100,서울특별시,1121,관악구,,신사동제1투,2346,1453,699,668,41,1,13,0,0,3,4,0,0,0,1429,24,893
1100,서울특별시,1121,관악구,,신사동제2투,2699,1485,667,705,58,2,9,0,0,0,2,1,1,1,1446,39,1214
1100,서울특별시,1121,관악구,,신사동제3투,2417,1347,591,662,53,1,12,0,1,1,0,2,2,0,1325,22,1070
1100,서울특별시,1121,관악구,,신사동제4투,2485,1255,552,613,40,1,21,0,0,0,0,1,0,0,1228,27,1230
1100,서울특별시,1121,관악구,,신사동제5투,2831,1646,747,808,33,1,20,0,0,0,0,2,0,0,1611,35,1185
1100,서울특별시,1121,관악구,조원동,소계,14833,10739,5240,4889,365,13,85,2,0,3,13,7,1,2,10620,119,4094
1100,서울특별시,1121,관악구,,관내사전투표,5260,5260,2878,2150,160,6,24,1,0,0,1,3,0,1,5224,36,0
1100,서울특별시,1121,관악구,,조원동제1투,2820,1521,676,730,68,3,17,0,0,1,3,1,0,0,1499,22,1299
1100,서울특별시,1121,관악구,,조원동제2투,2684,1486,639,749,46,1,21,1,0,0,3,1,0,1,1462,24,1198
1100,서울특별시,1121,관악구,,조원동제3투,2506,1478,642,734,56,3,15,0,0,1,0,2,1,0,1454,24,1028
1100,서울특별시,1121,관악구,,조원동제4투,1563,994,405,526,35,0,8,0,0,1,6,0,0,0,981,13,569
1100,서울특별시,1121,관악구,미성동,소계,24589,18216,8883,8518,489,9,124,5,1,5,12,22,5,6,18079,137,6373
1100,서울특별시,1121,관악구,,관내사전투표,6985,6985,3894,2827,173,4,43,1,1,2,1,9,2,3,6960,25,0
1100,서울특별시,1121,관악구,,미성동제1투,2841,1571,706,751,68,2,12,1,0,0,1,2,0,1,1544,27,1270
1100,서울특별시,1121,관악구,,미성동제2투,2567,1658,752,837,40,0,12,1,0,0,1,0,1,0,1644,14,909
1100,서울특별시,1121,관악구,,미성동제3투,2628,2075,746,1252,53,1,5,1,0,0,0,2,0,0,2060,15,553
1100,서울특별시,1121,관악구,,미성동제4투,2452,1459,737,656,34,0,20,1,0,0,1,4,1,0,1454,5,993
1100,서울특별시,1121,관악구,,미성동제5투,2349,1427,646,703,39,0,12,0,0,2,1,4,0,1,1408,19,922
1100,서울특별시,1121,관악구,,미성동제6투,2411,1402,621,710,37,0,13,0,0,1,3,0,1,0,1386,16,1009
1100,서울특별시,1121,관악구,,미성동제7투,2356,1639,781,782,45,2,7,0,0,0,4,1,0,1,1623,16,717
1100,서울특별시,1121,관악구,난곡동,소계,21373,15064,7901,6359,431,13,146,3,1,6,20,17,5,7,14909,155,6309
1100,서울특별시,1121,관악구,,관내사전투표,5953,5953,3507,2217,138,4,36,2,1,0,2,4,2,4,5917,36,0
1100,서울특별시,1121,관악구,,난곡동제1투,2648,1369,692,581,56,1,13,0,0,0,1,1,1,0,1346,23,1279
1100,서울특별시,1121,관악구,,난곡동제2투,2941,1772,869,796,54,0,24,0,0,1,3,1,1,0,1749,23,1169
1100,서울특별시,1121,관악구,,난곡동제3투,3009,1980,998,844,68,3,30,1,0,3,1,1,1,2,1952,28,1029
1100,서울특별시,1121,관악구,,난곡동제4투,2284,1327,575,678,42,1,12,0,0,0,0,2,0,0,1310,17,957
1100,서울특별시,1121,관악구,,난곡동제5투,2125,1330,630,635,35,2,9,0,0,0,9,1,0,0,1321,9,795
1100,서울특별시,1121,관악구,,난곡동제6투,2413,1333,630,608,38,2,22,0,0,2,4,7,0,1,1314,19,1080
1100,서울특별시,1121,관악구,난향동,소계,12021,9237,4797,4066,219,6,62,2,1,1,10,7,4,2,9177,60,2784
1100,서울특별시,1121,관악구,,관내사전투표,4444,4444,2608,1698,90,2,19,1,0,0,1,6,1,2,4428,16,0
1100,서울특별시,1121,관악구,,난향동제1투,2200,1346,607,678,33,1,11,0,0,1,4,0,0,0,1335,11,854
1100,서울특별시,1121,관악구,,난향동제2투,2800,1961,854,1022,51,2,9,1,1,0,1,0,1,0,1942,19,839
1100,서울특별시,1121,관악구,,난향동제3투,2577,1486,728,668,45,1,23,0,0,0,4,1,2,0,1472,14,1091
1100,서울특별시,1121,관악구,서원동,소계,18886,13035,6413,5775,467,18,124,3,2,4,7,11,2,5,12831,204,5851
1100,서울특별시,1121,관악구,,관내사전투표,5436,5435,3037,2132,162,4,38,2,1,0,2,4,2,4,5388,47,1
1100,서울특별시,1121,관악구,,서원동제1투,3060,1930,854,931,74,3,22,0,1,0,1,3,0,0,1889,41,1130
1100,서울특별시,1121,관악구,,서원동제2투,2498,1343,565,681,49,5,13,1,0,3,1,2,0,0,1320,23,1155
1100,서울특별시,1121,관악구,,서원동제3투,3003,1502,646,721,68,2,22,0,0,0,2,1,0,1,1463,39,1501
1100,서울특별시,1121,관악구,,서원동제4투,2244,1243,570,580,57,2,10,0,0,1,0,1,0,0,1221,22,1001
1100,서울특별시,1121,관악구,,서원동제5투,2645,1582,741,730,57,2,19,0,0,0,1,0,0,0,1550,32,1063
1100,서울특별시,1121,관악구,신원동,소계,15558,11073,5466,4950,355,11,104,4,0,2,14,11,3,7,10927,146,4485
1100,서울특별시,1121,관악구,,관내사전투표,5498,5497,3011,2248,142,4,32,1,0,2,3,5,2,3,5453,44,1
1100,서울특별시,1121,관악구,,신원동제1투,3042,1676,701,859,53,1,24,0,0,0,1,3,0,2,1644,32,1366
1100,서울특별시,1121,관악구,,신원동제2투,2203,1245,514,617,58,1,17,0,0,0,0,2,1,0,1210,35,958
1100,서울특별시,1121,관악구,,신원동제3투,2324,1287,599,582,64,3,15,0,0,0,6,1,0,0,1270,17,1037
1100,서울특별시,1121,관악구,,신원동제4투,2491,1368,641,644,38,2,16,3,0,0,4,0,0,2,1350,18,1123
1100,서울특별시,1121,관악구,서림동,소계,17480,12109,5739,5599,428,13,102,3,4,3,5,15,2,1,11914,195,5371
1100,서울특별시,1121,관악구,,관내사전투표,3829,3829,2188,1478,116,6,11,1,2,0,0,7,0,0,3809,20,0
1100,서울특별시,1121,관악구,,서림동제1투,2944,1675,768,791,53,3,16,1,0,0,1,2,0,0,1635,40,1269
1100,서울특별시,1121,관악구,,서림동제2투,2500,1970,725,1140,66,0,7,0,0,3,1,2,0,0,1944,26,530
1100,서울특별시,1121,관악구,,서림동제3투,2398,1276,488,671,54,1,21,0,1,0,2,0,1,0,1239,37,1122
1100,서울특별시,1121,관악구,,서림동제4투,3151,1668,732,778,78,1,32,0,1,0,1,2,1,1,1627,41,1483
1100,서울특별시,1121,관악구,,서림동제5투,2658,1691,838,741,61,2,15,1,0,0,0,2,0,0,1660,31,967
1100,서울특별시,1121,관악구,삼성동,소계,18187,13930,7153,6145,331,14,101,4,1,6,14,13,7,5,13794,136,4257
1100,서울특별시,1121,관악구,,관내사전투표,6008,6008,3457,2330,139,3,27,2,0,1,3,2,4,2,5970,38,0
1100,서울특별시,1121,관악구,,삼성동제1투,1848,950,413,481,21,2,11,2,0,1,0,0,1,0,932,18,898
1100,서울특별시,1121,관악구,,삼성동제2투,2335,1501,700,707,42,3,19,0,0,1,5,2,0,1,1480,21,834
1100,서울특별시,1121,관악구,,삼성동제3투,2179,1388,617,690,43,1,12,0,0,0,1,2,0,1,1367,21,791
1100,서울특별시,1121,관악구,,삼성동제4투,1103,733,340,357,17,2,6,0,0,0,1,0,0,0,723,10,370
1100,서울특별시,1121,관악구,,삼성동제5투,2085,1401,772,565,25,1,13,0,1,1,2,2,1,1,1384,17,684
1100,서울특별시,1121,관악구,,삼성동제6투,2629,1949,854,1015,44,2,13,0,0,2,2,5,1,0,1938,11,680
1100,서울특별시,1121,관악구,대학동,소계,19574,13874,6601,6474,424,10,127,13,1,12,10,12,4,5,13693,181,5700
1100,서울특별시,1121,관악구,,관내사전투표,6836,6836,3688,2837,180,2,49,6,0,6,2,7,0,1,6778,58,0
1100,서울특별시,1121,관악구,,대학동제1투,3642,1788,679,964,66,1,24,2,0,1,2,1,0,0,1740,48,1854
1100,서울특별시,1121,관악구,,대학동제2투,2545,1720,648,966,61,2,15,2,1,1,1,1,2,1,1701,19,825
1100,서울특별시,1121,관악구,,대학동제3투,3386,1922,922,879,68,3,18,2,0,2,2,0,1,2,1899,23,1464
1100,서울특별시,1121,관악구,,대학동제4투,3165,1608,664,828,49,2,21,1,0,2,3,3,1,1,1575,33,1557
1100,서울특별시,1121,관악구,잘못 투입·구분된 투표지,,0,4,1,1,0,0,0,0,0,0,0,0,0,0,2,2,-4
1100,서울특별시,1122,서초구,합계,,344756,277878,88686,179472,5864,105,894,52,18,98,186,99,35,49,275558,2320,66878
1100,서울특별시,1122,서초구,거소·선상투표,,410,366,107,217,3,0,1,0,0,0,1,0,0,0,329,37,44
1100,서울특별시,1122,서초구,관외사전투표,,34561,34553,13740,19516,832,13,136,17,1,5,18,21,4,10,34313,240,8
1100,서울특별시,1122,서초구,재외투표,,5640,4174,1528,2179,103,0,9,0,0,2,2,0,0,0,3823,351,1466
1100,서울특별시,1122,서초구,서초1동,소계,16946,13348,4212,8691,276,2,46,2,2,5,9,9,1,3,13258,90,3598
1100,서울특별시,1122,서초구,,관내사전투표,6140,6140,2339,3627,122,1,14,1,0,1,1,4,1,1,6112,28,0
1100,서울특별시,1122,서초구,,서초1동제1투,3316,2268,604,1586,49,0,11,1,0,3,1,3,0,0,2258,10,1048
1100,서울특별시,1122,서초구,,서초1동제2투,2624,1799,492,1231,37,0,13,0,0,1,2,1,0,1,1778,21,825
1100,서울특별시,1122,서초구,,서초1동제3투,2612,1657,362,1239,28,1,3,0,1,0,1,0,0,1,1636,21,955
1100,서울특별시,1122,서초구,,서초1동제4투,2254,1484,415,1008,40,0,5,0,1,0,4,1,0,0,1474,10,770
1100,서울특별시,1122,서초구,서초2동,소계,20005,15815,4352,10986,330,5,32,2,0,7,7,1,2,4,15728,87,4190
1100,서울특별시,1122,서초구,,관내사전투표,6598,6598,2180,4250,133,0,10,0,0,1,0,0,0,1,6575,23,0
1100,서울특별시,1122,서초구,,서초2동제1투,3158,2335,479,1789,41,1,6,0,0,1,3,0,1,1,2322,13,823
1100,서울특별시,1122,서초구,,서초2동제2투,2267,1315,400,856,35,0,6,0,0,1,0,0,1,0,1299,16,952
1100,서울특별시,1122,서초구,,서초2동제3투,2848,1963,556,1327,53,2,2,1,0,2,1,0,0,1,1945,18,885
1100,서울특별시,1122,서초구,,서초2동제4투,2671,1749,334,1375,30,2,2,0,0,0,1,0,0,0,1744,5,922
1100,서울특별시,1122,서초구,,서초2동제5투,2463,1855,403,1389,38,0,6,1,0,2,2,1,0,1,1843,12,608
1100,서울특별시,1122,서초구,서초3동,소계,24856,19138,5863,12589,407,11,66,2,2,6,19,7,3,5,18980,158,5718
1100,서울특별시,1122,서초구,,관내사전투표,7011,7009,2717,4104,126,5,14,1,0,3,2,2,1,2,6977,32,2
1100,서울특별시,1122,서초구,,서초3동제1투,3208,2008,416,1518,45,2,5,0,0,0,1,1,0,0,1988,20,1200
1100,서울특별시,1122,서초구,,서초3동제2투,2237,1564,497,1000,32,0,12,0,0,1,2,0,0,0,1544,20,673
1100,서울특별시,1122,서초구,,서초3동제3투,2247,1554,389,1093,37,3,5,1,0,0,3,0,0,2,1533,21,693
1100,서울특별시,1122,서초구,,서초3동제4투,2375,1647,459,1121,36,1,8,0,1,1,3,0,0,1,1631,16,728
1100,서울특별시,1122,서초구,,서초3동제5투,2534,1703,500,1139,34,0,9,0,1,1,5,0,1,0,1690,13,831
1100,서울특별시,1122,서초구,,서초3동제6투,3226,2143,567,1484,54,0,10,0,0,0,1,3,0,0,2119,24,1083
1100,서울특별시,1122,서초구,,서초3동제7투,2018,1510,318,1130,43,0,3,0,0,0,2,1,1,0,1498,12,508
1100,서울특별시,1122,서초구,서초4동,소계,20971,16648,3525,12691,272,7,25,3,2,5,15,4,3,0,16552,96,4323
1100,서울특별시,1122,서초구,,관내사전투표,5033,5033,1576,3334,80,3,7,0,0,1,0,3,1,0,5005,28,0
1100,서울특별시,1122,서초구,,서초4동제1투,3052,1737,328,1341,38,1,6,1,1,0,5,1,0,0,1722,15,1315
1100,서울특별시,1122,서초구,,서초4동제2투,2816,2133,368,1713,31,1,3,1,0,1,3,0,0,0,2121,12,683
1100,서울특별시,1122,서초구,,서초4동제3투,2491,1914,263,1619,21,0,0,1,0,0,2,0,0,0,1906,8,577
1100,서울특별시,1122,서초구,,서초4동제4투,2257,1749,245,1455,29,2,3,0,1,0,2,0,0,0,1737,12,508
1100,서울특별시,1122,서초구,,서초4동제5투,2841,2073,368,1641,36,0,5,0,0,3,1,0,2,0,2056,17,768
1100,서울특별시,1122,서초구,,서초4동제6투,2481,2009,377,1588,37,0,1,0,0,0,2,0,0,0,2005,4,472
1100,서울특별시,1122,서초구,잠원동,소계,19301,15168,3836,10887,305,3,26,3,1,7,7,3,0,0,15078,90,4133
1100,서울특별시,1122,서초구,,관내사전투표,5546,5546,1746,3680,94,1,6,0,0,0,1,1,0,0,5529,17,0
1100,서울특별시,1122,서초구,,잠원동제1투,2608,1584,336,1188,40,0,0,1,0,3,1,0,0,0,1569,15,1024
1100,서울특별시,1122,서초구,,잠원동제2투,2065,1438,237,1158,23,0,3,0,0,0,2,1,0,0,1424,14,627
1100,서울특별시,1122,서초구,,잠원동제3투,2127,1580,354,1173,39,0,3,1,0,1,1,1,0,0,1573,7,547
1100,서울특별시,1122,서초구,,잠원동제4투,2448,1816,332,1428,43,0,3,0,1,0,1,0,0,0,1808,8,632
1100,서울특별시,1122,서초구,,잠원동제5투,2191,1419,443,900,46,1,8,1,0,1,1,0,0,0,1401,18,772
1100,서울특별시,1122,서초구,,잠원동제6투,2316,1785,388,1360,20,1,3,0,0,2,0,0,0,0,1774,11,531
1100,서울특별시,1122,서초구,반포본동,소계,1316,933,292,613,19,0,2,0,0,0,2,0,0,3,931,2,383
1100,서울특별시,1122,서초구,,관내사전투표,656,656,231,408,13,0,0,0,0,0,1,0,0,3,656,0,0
1100,서울특별시,1122,서초구,,반포본동투표소,660,277,61,205,6,0,2,0,0,0,1,0,0,0,275,2,383
1100,서울특별시,1122,서초구,반포1동,소계,25382,18995,5068,13375,337,7,67,2,0,13,10,5,1,2,18887,108,6387
1100,서울특별시,1122,서초구,,관내사전투표,6741,6741,2100,4507,90,4,9,1,0,2,1,1,0,1,6716,25,0
1100,서울특별시,1122,서초구,,반포1동제1투,3214,2465,426,1993,26,0,5,0,0,2,3,1,0,0,2456,9,749
1100,서울특별시,1122,서초구,,반포1동제2투,2849,2148,488,1594,45,0,7,0,0,2,0,0,1,1,2138,10,701
1100,서울특별시,1122,서초구,,반포1동제3투,2595,1492,531,869,51,1,15,0,0,1,2,0,0,0,1470,22,1103
1100,서울특별시,1122,서초구,,반포1동제4투,2406,1323,517,739,31,0,16,1,0,1,0,1,0,0,1306,17,1083
1100,서울특별시,1122,서초구,,반포1동제5투,2145,962,355,557,26,0,8,0,0,2,1,1,0,0,950,12,1183
1100,서울특별시,1122,서초구,,반포1동제6투,2900,1878,267,1561,35,1,2,0,0,0,3,1,0,0,1870,8,1022
1100,서울특별시,1122,서초구,,반포1동제7투,2532,1986,384,1555,33,1,5,0,0,3,0,0,0,0,1981,5,546
1100,서울특별시,1122,서초구,반포2동,소계,10669,8894,1620,7083,124,0,17,1,0,6,3,2,1,1,8858,36,1775
1100,서울특별시,1122,서초구,,관내사전투표,3066,3066,721,2291,32,0,4,0,0,1,1,1,1,0,3052,14,0
1100,서울특별시,1122,서초구,,반포2동제1투,2731,1948,272,1636,25,0,4,0,0,3,1,0,0,0,1941,7,783
1100,서울특별시,1122,서초구,,반포2동제2투,2409,1886,342,1496,33,0,2,0,0,1,0,1,0,0,1875,11,523
1100,서울특별시,1122,서초구,,반포2동제3투,2463,1994,285,1660,34,0,7,1,0,1,1,0,0,1,1990,4,469
1100,서울특별시,1122,서초구,반포3동,소계,16270,13281,2875,10098,178,4,19,0,1,5,4,4,0,1,13189,92,2989
1100,서울특별시,1122,서초구,,관내사전투표,5212,5212,1350,3775,49,1,4,0,0,0,0,2,0,1,5182,30,0
1100,서울특별시,1122,서초구,,반포3동제1투,2681,1726,312,1358,40,0,1,0,1,3,0,0,0,0,1715,11,955
1100,서울특별시,1122,서초구,,반포3동제2투,1695,1233,234,959,24,0,3,0,0,1,2,1,0,0,1224,9,462
1100,서울특별시,1122,서초구,,반포3동제3투,1930,1561,302,1217,17,1,3,0,0,1,0,1,0,0,1542,19,369
1100,서울특별시,1122,서초구,,반포3동제4투,2037,1480,266,1179,15,1,2,0,0,0,1,0,0,0,1464,16,557
1100,서울특별시,1122,서초구,,반포3동제5투,2715,2069,411,1610,33,1,6,0,0,0,1,0,0,0,2062,7,646
1100,서울특별시,1122,서초구,반포4동,소계,13632,10782,2855,7593,224,3,23,1,3,2,3,4,2,1,10714,68,2850
1100,서울특별시,1122,서초구,,관내사전투표,3948,3948,1345,2505,73,1,5,0,1,0,0,1,0,0,3931,17,0
1100,서울특별시,1122,서초구,,반포4동제1투,1957,1275,295,926,30,2,6,0,2,1,2,1,0,1,1266,9,682
1100,서울특별시,1122,서초구,,반포4동제2투,2183,1342,309,997,20,0,3,0,0,1,0,1,0,0,1331,11,841
1100,서울특별시,1122,서초구,,반포4동제3투,2303,1914,407,1444,48,0,1,1,0,0,0,0,1,0,1902,12,389
1100,서울특별시,1122,서초구,,반포4동제4투,1620,1226,277,909,25,0,5,0,0,0,0,0,1,0,1217,9,394
1100,서울특별시,1122,서초구,,반포4동제5투,1621,1077,222,812,28,0,3,0,0,0,1,1,0,0,1067,10,544
1100,서울특별시,1122,서초구,방배본동,소계,15614,12507,3908,8231,233,2,28,2,1,8,4,1,0,1,12419,88,3107
1100,서울특별시,1122,서초구,,관내사전투표,5133,5133,1903,3119,73,2,10,2,0,0,2,0,0,1,5112,21,0
1100,서울특별시,1122,서초구,,방배본동제1투,2381,1608,403,1146,37,0,3,0,1,1,0,0,0,0,1591,17,773
1100,서울특별시,1122,서초구,,방배본동제2투,2460,1721,298,1388,25,0,2,0,0,2,0,1,0,0,1716,5,739
1100,서울특별시,1122,서초구,,방배본동제3투,3072,2205,619,1502,49,0,6,0,0,4,0,0,0,0,2180,25,867
1100,서울특별시,1122,서초구,,방배본동제4투,2568,1840,685,1076,49,0,7,0,0,1,2,0,0,0,1820,20,728
1100,서울특별시,1122,서초구,방배1동,소계,13085,10288,3618,6263,260,2,40,1,0,0,8,3,1,1,10197,91,2797
1100,서울특별시,1122,서초구,,관내사전투표,4460,4460,1904,2407,114,1,10,0,0,0,3,1,0,1,4441,19,0
1100,서울특별시,1122,서초구,,방배1동제1투,2012,1188,408,717,39,0,7,0,0,0,2,2,1,0,1176,12,824
1100,서울특별시,1122,서초구,,방배1동제2투,2608,1792,616,1082,51,0,12,0,0,0,1,0,0,0,1762,30,816
1100,서울특별시,1122,서초구,,방배1동제3투,1966,1335,399,885,28,1,4,0,0,0,1,0,0,0,1318,17,631
1100,서울특별시,1122,서초구,,방배1동제4투,2039,1513,291,1172,28,0,7,1,0,0,1,0,0,0,1500,13,526
1100,서울특별시,1122,서초구,방배2동,소계,14797,11713,4506,6761,266,6,50,0,1,2,4,7,2,3,11608,105,3084
1100,서울특별시,1122,서초구,,관내사전투표,4453,4453,2127,2190,91,4,13,0,1,0,0,2,0,1,4429,24,0
1100,서울특별시,1122,서초구,,방배2동제1투,1935,1140,381,715,21,1,9,0,0,0,1,1,0,0,1129,11,795
1100,서울특별시,1122,서초구,,방배2동제2투,1016,682,222,413,21,0,9,0,0,0,2,2,0,0,669,13,334
1100,서울특별시,1122,서초구,,방배2동제3투,773,481,171,296,10,0,1,0,0,0,0,0,0,0,478,3,292
1100,서울특별시,1122,서초구,,방배2동제4투,2264,1747,560,1124,44,0,3,0,0,0,1,1,0,0,1733,14,517
1100,서울특별시,1122,서초구,,방배2동제5투,1706,1121,384,675,32,0,6,0,0,1,0,1,1,2,1102,19,585
1100,서울특별시,1122,서초구,,방배2동제6투,1615,1328,397,884,26,1,6,0,0,1,0,0,0,0,1315,13,287
1100,서울특별시,1122,서초구,,방배2동제7투,1035,761,264,464,21,0,3,0,0,0,0,0,1,0,753,8,274
1100,서울특별시,1122,서초구,방배3동,소계,13738,11053,3069,7679,198,7,19,2,2,6,5,1,2,1,10991,62,2685
1100,서울특별시,1122,서초구,,관내사전투표,4465,4465,1446,2917,73,5,4,0,0,1,2,0,2,1,4451,14,0
1100,서울특별시,1122,서초구,,방배3동제1투,2031,1474,292,1140,18,2,4,0,0,2,0,1,0,0,1459,15,557
1100,서울특별시,1122,서초구,,방배3동제2투,2159,1611,378,1195,23,0,5,0,0,1,0,0,0,0,1602,9,548
1100,서울특별시,1122,서초구,,방배3동제3투,1853,1254,253,955,32,0,2,0,0,2,2,0,0,0,1246,8,599
1100,서울특별시,1122,서초구,,방배3동제4투,2241,1542,512,981,31,0,2,2,2,0,1,0,0,0,1531,11,699
1100,서울특별시,1122,서초구,,방배3동제5투,989,707,188,491,21,0,2,0,0,0,0,0,0,0,702,5,282
1100,서울특별시,1122,서초구,방배4동,소계,17352,13603,4730,8317,337,11,53,3,0,4,10,6,2,4,13477,126,3749
1100,서울특별시,1122,서초구,,관내사전투표,5526,5525,2331,3017,119,2,9,2,0,2,1,4,2,1,5490,35,1
1100,서울특별시,1122,서초구,,방배4동제1투,2224,1464,286,1126,28,2,5,0,0,0,1,0,0,0,1448,16,760
1100,서울특별시,1122,서초구,,방배4동제2투,1966,1301,323,908,37,0,16,0,0,1,1,0,0,0,1286,15,665
1100,서울특별시,1122,서초구,,방배4동제3투,1814,1077,369,663,23,1,2,0,0,0,1,1,0,0,1060,17,737
1100,서울특별시,1122,서초구,,방배4동제4투,2401,1682,663,920,59,4,11,1,0,0,2,0,0,0,1660,22,719
1100,서울특별시,1122,서초구,,방배4동제5투,995,650,232,373,28,0,5,0,0,0,0,0,0,3,641,9,345
1100,서울특별시,1122,서초구,,방배4동제6투,2426,1904,526,1310,43,2,5,0,0,1,4,1,0,0,1892,12,522
1100,서울특별시,1122,서초구,양재1동,소계,29405,22516,8782,12870,531,10,96,5,2,7,26,9,4,6,22348,168,6889
1100,서울특별시,1122,서초구,,관내사전투표,5593,5593,2657,2788,100,2,14,0,0,2,4,1,0,2,5570,23,0
1100,서울특별시,1122,서초구,,양재1동제1투,2036,1396,491,834,45,1,8,0,0,1,0,1,0,0,1381,15,640
1100,서울특별시,1122,서초구,,양재1동제2투,2370,1695,643,971,49,3,8,0,0,0,1,0,1,2,1678,17,675
1100,서울특별시,1122,서초구,,양재1동제3투,2014,1324,411,858,24,0,8,0,0,1,4,2,1,0,1309,15,690
1100,서울특별시,1122,서초구,,양재1동제4투,2328,1749,543,1144,40,0,5,0,0,0,1,0,0,1,1734,15,579
1100,서울특별시,1122,서초구,,양재1동제5투,2823,1992,779,1132,45,1,15,1,0,2,5,1,0,0,1981,11,831
1100,서울특별시,1122,서초구,,양재1동제6투,2149,1330,448,818,29,0,12,1,1,0,2,0,1,1,1313,17,819
1100,서울특별시,1122,서초구,,양재1동제7투,2121,1411,332,1034,30,1,5,0,0,0,0,0,1,0,1403,8,710
1100,서울특별시,1122,서초구,,양재1동제8투,2590,1946,848,1012,52,0,11,0,1,0,6,0,0,0,1930,16,644
1100,서울특별시,1122,서초구,,양재1동제9투,2983,2268,767,1413,58,1,4,2,0,0,3,0,0,0,2248,20,715
1100,서울특별시,1122,서초구,,양재1동제10투,2398,1812,863,866,59,1,6,1,0,1,0,4,0,0,1801,11,586
1100,서울특별시,1122,서초구,양재2동,소계,17725,13598,6231,6710,380,8,97,3,0,4,13,7,4,2,13459,139,4127
1100,서울특별시,1122,서초구,,관내사전투표,6397,6398,3328,2811,166,3,31,3,0,2,1,4,2,1,6352,46,-1
1100,서울특별시,1122,서초구,,양재2동제1투,2195,1244,508,672,36,2,6,0,0,0,3,0,1,0,1228,16,951
1100,서울특별시,1122,서초구,,양재2동제2투,1997,1316,525,699,50,0,14,0,0,0,3,0,0,0,1291,25,681
1100,서울특별시,1122,서초구,,양재2동제3투,2485,1641,624,951,37,3,11,0,0,1,2,0,0,0,1629,12,844
1100,서울특별시,1122,서초구,,양재2동제4투,2468,1630,687,838,64,0,17,0,0,1,2,1,0,0,1610,20,838
1100,서울특별시,1122,서초구,,양재2동제5투,2183,1369,559,739,27,0,18,0,0,0,2,2,1,1,1349,20,814
1100,서울특별시,1122,서초구,내곡동,소계,13081,10498,3967,6118,249,4,42,3,0,4,16,5,3,1,10412,86,2583
1100,서울특별시,1122,서초구,,관내사전투표,4990,4986,2165,2684,102,1,13,3,0,1,2,1,2,1,4975,11,4
1100,서울특별시,1122,서초구,,내곡동제1투,1173,709,211,450,18,1,6,0,0,0,1,1,0,0,688,21,464
1100,서울특별시,1122,서초구,,내곡동제2투,1995,1453,437,952,36,0,4,0,0,2,5,2,0,0,1438,15,542
1100,서울특별시,1122,서초구,,내곡동제3투,2476,1720,610,1041,43,1,9,0,0,1,1,0,1,0,1707,13,756
1100,서울특별시,1122,서초구,,내곡동제4투,2447,1630,544,991,50,1,10,0,0,0,7,1,0,0,1604,26,817
1100,서울특별시,1122,서초구,잘못 투입·구분된 투표지,,0,7,2,5,0,0,0,0,0,0,0,0,0,0,7,0,-7
1100,서울특별시,1123,강남구,합계,,451970,354778,106865,235897,7020,130,1383,47,39,109,258,134,46,95,352023,2755,97192
1100,서울특별시,1123,강남구,거소·선상투표,,585,549,211,286,7,0,4,0,0,0,1,0,1,1,511,38,36
1100,서울특별시,1123,강남구,관외사전투표,,41538,41532,15433,24650,848,20,209,9,6,9,20,22,2,17,41245,287,6
1100,서울특별시,1123,강남구,재외투표,,7157,5257,1888,2817,127,1,8,1,0,0,3,1,0,0,4846,411,1900
1100,서울특별시,1123,강남구,신사동,소계,12872,9799,2285,7226,166,5,35,2,3,3,2,2,1,0,9730,69,3073
1100,서울특별시,1123,강남구,,관내사전투표,3623,3622,1122,2409,63,1,10,1,0,0,0,1,0,0,3607,15,1
1100,서울특별시,1123,강남구,,신사동제1투,1779,1054,245,774,16,1,6,0,1,1,0,0,0,0,1044,10,725
1100,서울특별시,1123,강남구,,신사동제2투,1365,787,244,503,19,0,10,0,1,1,0,0,0,0,778,9,578
1100,서울특별시,1123,강남구,,신사동제3투,1447,928,324,543,36,1,6,0,0,0,0,0,0,0,910,18,519
1100,서울특별시,1123,강남구,,신사동제4투,2521,1762,162,1574,15,1,0,0,0,0,1,1,0,0,1754,8,759
1100,서울특별시,1123,강남구,,신사동제5투,2137,1646,188,1423,17,1,3,1,1,1,1,0,1,0,1637,9,491
1100,서울특별시,1123,강남구,논현1동,소계,18465,11485,4302,6712,272,4,84,1,2,3,7,3,3,3,11396,89,6980
1100,서울특별시,1123,강남구,,관내사전투표,4006,4007,1827,2064,82,0,10,1,1,0,3,1,1,1,3991,16,-1
1100,서울특별시,1123,강남구,,논현1동제1투,3043,1300,442,792,34,1,18,0,0,0,1,1,1,0,1290,10,1743
1100,서울특별시,1123,강남구,,논현1동제2투,2712,1475,484,908,44,2,16,0,0,0,2,0,0,0,1456,19,1237
1100,서울특별시,1123,강남구,,논현1동제3투,2950,1749,502,1180,39,0,13,0,0,2,0,1,1,1,1739,10,1201
1100,서울특별시,1123,강남구,,논현1동제4투,3017,1499,518,920,34,1,15,0,1,0,1,0,0,0,1490,9,1518
1100,서울특별시,1123,강남구,,논현1동제5투,2737,1455,529,848,39,0,12,0,0,1,0,0,0,1,1430,25,1282
1100,서울특별시,1123,강남구,논현2동,소계,17087,11864,3531,7916,232,1,50,1,0,2,16,6,1,5,11761,103,5223
1100,서울특별시,1123,강남구,,관내사전투표,4238,4237,1548,2593,63,0,8,1,0,0,0,1,0,1,4215,22,1
1100,서울특별시,1123,강남구,,논현2동제1투,3042,1548,333,1158,23,0,10,0,0,0,5,1,0,1,1531,17,1494
1100,서울특별시,1123,강남구,,논현2동제2투,1914,1236,244,932,32,0,5,0,0,0,5,0,0,0,1218,18,678
1100,서울특별시,1123,강남구,,논현2동제3투,1558,959,288,630,17,0,6,0,0,0,1,0,0,0,942,17,599
1100,서울특별시,1123,강남구,,논현2동제4투,3272,2150,584,1485,49,0,9,0,0,1,2,2,1,1,2134,16,1122
1100,서울특별시,1123,강남구,,논현2동제5투,3063,1734,534,1118,48,1,12,0,0,1,3,2,0,2,1721,13,1329
1100,서울특별시,1123,강남구,압구정동,소계,19599,15337,2115,12906,189,3,38,1,1,7,14,0,2,2,15278,59,4262
1100,서울특별시,1123,강남구,,관내사전투표,5163,5163,907,4185,43,1,10,0,0,1,0,0,0,1,5148,15,0
1100,서울특별시,1123,강남구,,압구정동제1투,2564,1640,129,1478,18,1,2,0,0,0,4,0,0,0,1632,8,924
1100,서울특별시,1123,강남구,,압구정동제2투,1771,1311,150,1134,15,0,2,0,0,0,4,0,0,0,1305,6,460
1100,서울특별시,1123,강남구,,압구정동제3투,1997,1487,109,1352,17,0,1,0,1,1,2,0,0,0,1483,4,510
1100,서울특별시,1123,강남구,,압구정동제4투,1919,1285,265,973,26,0,11,0,0,1,0,0,1,0,1277,8,634
1100,서울특별시,1123,강남구,,압구정동제5투,2637,1977,233,1697,31,0,1,0,0,4,1,0,0,1,1968,9,660
1100,서울특별시,1123,강남구,,압구정동제6투,2465,1759,177,1538,29,1,3,1,0,0,3,0,0,0,1752,7,706
1100,서울특별시,1123,강남구,,압구정동제7투,1083,715,145,549,10,0,8,0,0,0,0,0,1,0,713,2,368
1100,서울특별시,1123,강남구,청담동,소계,19710,14597,3293,10930,223,4,41,1,1,6,11,1,3,2,14516,81,5113
1100,서울특별시,1123,강남구,,관내사전투표,4830,4828,1391,3345,58,2,9,0,0,1,0,1,2,1,4810,18,2
1100,서울특별시,1123,강남구,,청담동제1투,2682,1588,270,1274,27,0,5,0,1,0,1,0,0,0,1578,10,1094
1100,서울특별시,1123,강남구,,청담동제2투,2065,1340,183,1131,10,1,6,1,0,0,2,0,0,1,1335,5,725
1100,서울특별시,1123,강남구,,청담동제3투,1959,1408,235,1132,26,0,0,0,0,1,3,0,0,0,1397,11,551
1100,서울특별시,1123,강남구,,청담동제4투,1528,988,153,810,13,0,7,0,0,0,0,0,0,0,983,5,540
1100,서울특별시,1123,강남구,,청담동제5투,2519,1761,407,1293,35,1,9,0,0,3,0,0,0,0,1748,13,758
1100,서울특별시,1123,강남구,,청담동제6투,2641,1819,467,1298,33,0,5,0,0,1,3,0,0,0,1807,12,822
1100,서울특별시,1123,강남구,,청담동제7투,1486,865,187,647,21,0,0,0,0,0,2,0,1,0,858,7,621
1100,서울특별시,1123,강남구,삼성1동,소계,10296,8012,2021,5751,126,2,38,1,2,4,12,2,1,0,7960,52,2284
1100,서울특별시,1123,강남구,,관내사전투표,3350,3351,1086,2195,42,1,12,0,0,0,0,2,0,0,3338,13,-1
1100,서울특별시,1123,강남구,,삼성1동제1투,2505,1646,368,1205,36,1,13,0,2,3,7,0,1,0,1636,10,859
1100,서울특별시,1123,강남구,,삼성1동제2투,1959,1366,210,1119,21,0,4,0,0,1,0,0,0,0,1355,11,593
1100,서울특별시,1123,강남구,,삼성1동제3투,2482,1649,357,1232,27,0,9,1,0,0,5,0,0,0,1631,18,833
1100,서울특별시,1123,강남구,삼성2동,소계,23596,18023,5333,12113,367,7,73,2,4,8,5,7,3,3,17925,98,5573
1100,서울특별시,1123,강남구,,관내사전투표,6599,6599,2513,3904,124,2,18,2,2,0,1,3,2,1,6572,27,0
1100,서울특별시,1123,강남구,,삼성2동제1투,3301,1837,578,1183,36,0,21,0,1,0,0,2,1,0,1822,15,1464
1100,서울특별시,1123,강남구,,삼성2동제2투,3332,2415,526,1822,38,2,7,0,0,3,1,0,0,0,2399,16,917
1100,서울특별시,1123,강남구,,삼성2동제3투,3865,2611,666,1863,54,1,10,0,1,3,1,1,0,0,2600,11,1254
1100,서울특별시,1123,강남구,,삼성2동제4투,2842,1754,515,1154,52,1,10,0,0,1,1,0,0,2,1736,18,1088
1100,서울특별시,1123,강남구,,삼성2동제5투,3657,2807,535,2187,63,1,7,0,0,1,1,1,0,0,2796,11,850
1100,서울특별시,1123,강남구,대치1동,소계,17255,14639,2497,11802,228,3,23,1,0,3,7,6,2,2,14574,65,2616
1100,서울특별시,1123,강남구,,관내사전투표,5540,5540,1226,4204,80,2,3,1,0,2,3,2,0,0,5523,17,0
1100,서울특별시,1123,강남구,,대치1동제1투,2893,2289,281,1966,26,0,5,0,0,0,1,1,0,1,2281,8,604
1100,서울특별시,1123,강남구,,대치1동제2투,2165,1652,316,1276,42,0,2,0,0,1,0,0,1,0,1638,14,513
1100,서울특별시,1123,강남구,,대치1동제3투,1811,1445,181,1229,28,0,2,0,0,0,0,0,0,0,1440,5,366
1100,서울특별시,1123,강남구,,대치1동제4투,1918,1508,170,1299,22,0,1,0,0,0,2,0,0,1,1495,13,410
1100,서울특별시,1123,강남구,,대치1동제5투,2928,2205,323,1828,30,1,10,0,0,0,1,3,1,0,2197,8,723
1100,서울특별시,1123,강남구,대치2동,소계,24636,19902,4347,15035,325,4,46,3,2,7,14,6,3,1,19793,109,4734
1100,서울특별시,1123,강남구,,관내사전투표,6111,6111,1695,4289,91,0,6,1,1,1,2,2,2,0,6090,21,0
1100,서울특별시,1123,강남구,,대치2동제1투,2661,2001,445,1511,25,1,3,0,0,0,1,0,0,0,1986,15,660
1100,서울특별시,1123,강남구,,대치2동제2투,2219,1688,358,1276,31,1,6,0,1,0,0,0,0,1,1674,14,531
1100,서울특별시,1123,강남구,,대치2동제3투,2294,1766,357,1354,38,1,3,0,0,0,2,0,0,0,1755,11,528
1100,서울특별시,1123,강남구,,대치2동제4투,2088,1650,181,1435,20,0,3,1,0,2,2,0,0,0,1644,6,438
1100,서울특별시,1123,강남구,,대치2동제5투,2203,1743,213,1492,21,1,6,1,0,1,0,1,0,0,1736,7,460
1100,서울특별시,1123,강남구,,대치2동제6투,2314,1848,325,1468,39,0,2,0,0,1,1,1,1,0,1838,10,466
1100,서울특별시,1123,강남구,,대치2동제7투,2646,1776,343,1379,33,0,5,0,0,0,3,0,0,0,1763,13,870
1100,서울특별시,1123,강남구,,대치2동제8투,2100,1319,430,831,27,0,12,0,0,2,3,2,0,0,1307,12,781
1100,서울특별시,1123,강남구,대치4동,소계,15916,11473,4260,6789,227,4,62,1,1,3,6,10,3,7,11373,100,4443
1100,서울특별시,1123,강남구,,관내사전투표,5097,5096,2173,2761,103,0,21,0,0,2,1,3,2,3,5069,27,1
1100,서울특별시,1123,강남구,,대치4동제1투,2549,1491,532,881,36,1,13,0,1,0,2,0,1,0,1467,24,1058
1100,서울특별시,1123,강남구,,대치4동제2투,2893,1914,688,1149,32,0,10,1,0,1,2,4,0,2,1889,25,979
1100,서울특별시,1123,강남구,,대치4동제3투,2624,1509,369,1078,33,1,9,0,0,0,0,2,0,2,1494,15,1115
1100,서울특별시,1123,강남구,,대치4동제4투,2753,1463,498,920,23,2,9,0,0,0,1,1,0,0,1454,9,1290
1100,서울특별시,1123,강남구,역삼1동,소계,28166,17690,6592,10279,461,5,113,1,0,7,16,10,2,1,17487,203,10476
1100,서울특별시,1123,강남구,,관내사전투표,5445,5445,2498,2736,150,1,22,0,0,0,4,0,0,1,5412,33,0
1100,서울특별시,1123,강남구,,역삼1동제1투,3108,1646,584,993,33,0,8,0,0,0,3,2,1,0,1624,22,1462
1100,서울특별시,1123,강남구,,역삼1동제2투,2481,1341,466,804,32,0,15,0,0,1,1,3,1,0,1323,18,1140
1100,서울특별시,1123,강남구,,역삼1동제3투,3087,1653,611,960,38,0,17,0,0,1,1,0,0,0,1628,25,1434
1100,서울특별시,1123,강남구,,역삼1동제4투,3380,1867,613,1159,52,3,12,0,0,4,1,2,0,0,1846,21,1513
1100,서울특별시,1123,강남구,,역삼1동제5투,3796,1681,571,1014,49,0,19,0,0,0,1,2,0,0,1656,25,2115
1100,서울특별시,1123,강남구,,역삼1동제6투,2661,1494,490,931,39,0,9,1,0,0,2,1,0,0,1473,21,1167
1100,서울특별시,1123,강남구,,역삼1동제7투,2453,1599,480,1050,38,1,5,0,0,1,2,0,0,0,1577,22,854
1100,서울특별시,1123,강남구,,역삼1동제8투,1755,964,279,632,30,0,6,0,0,0,1,0,0,0,948,16,791
1100,서울특별시,1123,강남구,역삼2동,소계,27224,20723,6245,13858,399,8,62,4,6,5,11,4,3,4,20609,114,6501
1100,서울특별시,1123,강남구,,관내사전투표,8404,8404,3024,5207,127,2,12,1,1,1,2,0,0,2,8379,25,0
1100,서울특별시,1123,강남구,,역삼2동제1투,3155,2012,431,1519,44,1,2,0,0,0,2,1,0,0,2000,12,1143
1100,서울특별시,1123,강남구,,역삼2동제2투,3183,2304,468,1769,40,1,11,0,0,0,3,0,0,0,2292,12,879
1100,서울특별시,1123,강남구,,역삼2동제3투,3617,1958,686,1178,54,2,16,2,2,1,1,0,0,0,1942,16,1659
1100,서울특별시,1123,강남구,,역삼2동제4투,3029,1808,688,1039,46,1,11,0,2,0,0,2,2,0,1791,17,1221
1100,서울특별시,1123,강남구,,역삼2동제5투,2689,1885,533,1275,50,0,8,0,0,1,0,0,1,2,1870,15,804
1100,서울특별시,1123,강남구,,역삼2동제6투,3147,2352,415,1871,38,1,2,1,1,2,3,1,0,0,2335,17,795
1100,서울특별시,1123,강남구,도곡1동,소계,15710,12630,3579,8611,303,4,23,3,1,2,5,1,0,2,12534,96,3080
1100,서울특별시,1123,강남구,,관내사전투표,5190,5190,1853,3208,98,1,5,0,0,0,2,1,0,1,5169,21,0
1100,서울특별시,1123,강남구,,도곡1동제1투,1242,960,164,768,19,0,2,0,0,0,0,0,0,0,953,7,282
1100,서울특별시,1123,강남구,,도곡1동제2투,2575,1761,365,1332,36,0,5,0,0,0,1,0,0,0,1739,22,814
1100,서울특별시,1123,강남구,,도곡1동제3투,2381,1760,446,1245,52,1,2,1,1,0,1,0,0,0,1749,11,621
1100,서울특별시,1123,강남구,,도곡1동제4투,2773,1818,551,1162,69,2,7,0,0,0,1,0,0,1,1793,25,955
1100,서울특별시,1123,강남구,,도곡1동제5투,1549,1141,200,896,29,0,2,2,0,2,0,0,0,0,1131,10,408
1100,서울특별시,1123,강남구,도곡2동,소계,22806,18193,3136,14645,267,7,23,2,1,2,16,2,1,2,18104,89,4613
1100,서울특별시,1123,강남구,,관내사전투표,4446,4445,1186,3159,64,2,10,0,0,0,1,0,0,0,4422,23,1
1100,서울특별시,1123,강남구,,도곡2동제1투,1663,946,245,668,17,1,1,0,0,0,4,0,0,0,936,10,717
1100,서울특별시,1123,강남구,,도곡2동제2투,2175,1559,219,1295,27,0,2,0,0,1,1,0,0,0,1545,14,616
1100,서울특별시,1123,강남구,,도곡2동제3투,2357,1812,161,1628,18,0,0,0,0,0,0,0,0,0,1807,5,545
1100,서울특별시,1123,강남구,,도곡2동제4투,3167,2448,198,2203,24,3,4,0,0,1,4,0,0,2,2439,9,719
1100,서울특별시,1123,강남구,,도곡2동제5투,2895,2180,336,1784,46,0,2,0,0,0,4,1,0,0,2173,7,715
1100,서울특별시,1123,강남구,,도곡2동제6투,3169,2497,393,2051,36,1,2,0,0,0,2,0,0,0,2485,12,672
1100,서울특별시,1123,강남구,,도곡2동제7투,2934,2306,398,1857,35,0,2,2,1,0,0,1,1,0,2297,9,628
1100,서울특별시,1123,강남구,개포1동,소계,5903,4851,1148,3572,76,2,21,0,0,3,4,0,0,1,4827,24,1052
1100,서울특별시,1123,강남구,,관내사전투표,2384,2384,638,1701,35,2,5,0,0,0,0,0,0,1,2382,2,0
1100,서울특별시,1123,강남구,,개포1동제1투,1729,1150,155,960,17,0,4,0,0,3,2,0,0,0,1141,9,579
1100,서울특별시,1123,강남구,,개포1동제2투,1113,850,107,712,19,0,3,0,0,0,1,0,0,0,842,8,263
1100,서울특별시,1123,강남구,,개포1동제3투,677,467,248,199,5,0,9,0,0,0,1,0,0,0,462,5,210
1100,서울특별시,1123,강남구,개포2동,소계,19148,15895,3931,11501,311,5,32,0,0,2,10,7,2,2,15803,92,3253
1100,서울특별시,1123,강남구,,관내사전투표,5239,5239,1639,3471,95,1,9,0,0,0,1,2,0,1,5219,20,0
1100,서울특별시,1123,강남구,,개포2동제1투,2248,1531,314,1163,39,0,3,0,0,0,2,1,0,0,1522,9,717
1100,서울특별시,1123,강남구,,개포2동제2투,1923,1489,307,1123,33,0,3,0,0,0,2,1,0,0,1469,20,434
1100,서울특별시,1123,강남구,,개포2동제3투,2122,1739,345,1354,21,1,3,0,0,1,0,0,0,1,1726,13,383
1100,서울특별시,1123,강남구,,개포2동제4투,3131,2557,486,2007,44,1,5,0,0,0,0,2,1,0,2546,11,574
1100,서울특별시,1123,강남구,,개포2동제5투,1762,1240,283,920,22,1,4,0,0,0,4,0,1,0,1235,5,522
1100,서울특별시,1123,강남구,,개포2동제6투,2723,2100,557,1463,57,1,5,0,0,1,1,1,0,0,2086,14,623
1100,서울특별시,1123,강남구,개포4동,소계,17669,13764,4826,8426,301,7,75,2,0,6,11,6,2,11,13673,91,3905
1100,서울특별시,1123,강남구,,관내사전투표,5293,5294,2310,2830,97,5,18,0,0,2,1,3,0,6,5272,22,-1
1100,서울특별시,1123,강남구,,개포4동제1투,2932,1708,669,951,50,0,11,0,0,1,5,1,0,3,1691,17,1224
1100,서울특별시,1123,강남구,,개포4동제2투,3221,2444,388,1995,45,0,3,1,0,0,0,0,1,1,2434,10,777
1100,서울특별시,1123,강남구,,개포4동제3투,3220,2287,690,1506,46,1,18,0,0,2,1,0,1,0,2265,22,933
1100,서울특별시,1123,강남구,,개포4동제4투,3003,2031,769,1144,63,1,25,1,0,1,4,2,0,1,2011,20,972
1100,서울특별시,1123,강남구,일원본동,소계,16811,13760,4285,8990,337,5,33,2,2,4,10,9,2,5,13684,76,3051
1100,서울특별시,1123,강남구,,관내사전투표,6347,6347,2368,3814,121,3,9,1,0,1,4,4,1,1,6327,20,0
1100,서울특별시,1123,강남구,,일원본동제1투,2920,1880,409,1397,52,0,5,1,0,1,0,0,0,3,1868,12,1040
1100,서울특별시,1123,강남구,,일원본동제2투,2294,1710,464,1174,54,1,2,0,0,0,4,2,0,0,1701,9,584
1100,서울특별시,1123,강남구,,일원본동제3투,2969,2246,544,1611,57,0,9,0,0,1,0,2,1,1,2226,20,723
1100,서울특별시,1123,강남구,,일원본동제4투,2281,1577,500,994,53,1,8,0,2,1,2,1,0,0,1562,15,704
1100,서울특별시,1123,강남구,일원1동,소계,12336,9401,3853,5110,234,6,72,2,2,11,9,8,2,2,9311,90,2935
1100,서울특별시,1123,강남구,,관내사전투표,4467,4467,2116,2192,103,2,20,1,1,1,0,3,1,1,4441,26,0
1100,서울특별시,1123,강남구,,일원1동제1투,1699,900,322,531,20,1,8,1,0,2,0,1,0,1,887,13,799
1100,서울특별시,1123,강남구,,일원1동제2투,1582,1081,373,644,29,1,8,0,1,3,2,2,1,0,1064,17,501
1100,서울특별시,1123,강남구,,일원1동제3투,1498,986,336,593,25,0,13,0,0,4,0,0,0,0,971,15,512
1100,서울특별시,1123,강남구,,일원1동제4투,1605,1071,350,656,40,0,7,0,0,1,4,1,0,0,1059,12,534
1100,서울특별시,1123,강남구,,일원1동제5투,1485,896,356,494,17,2,16,0,0,0,3,1,0,0,889,7,589
1100,서울특별시,1123,강남구,일원2동,소계,14690,12025,4128,7477,251,6,51,2,1,3,10,7,2,8,11946,79,2665
1100,서울특별시,1123,강남구,,관내사전투표,5865,5865,2474,3227,98,5,19,1,0,2,3,4,0,3,5836,29,0
1100,서울특별시,1123,강남구,,일원2동제1투,1499,799,322,431,17,1,11,0,0,0,1,0,2,1,786,13,700
1100,서울특별시,1123,강남구,,일원2동제2투,1828,1271,379,833,39,0,5,0,1,0,0,2,0,1,1260,11,557
1100,서울특별시,1123,강남구,,일원2동제3투,1958,1382,377,951,27,0,11,1,0,0,1,0,0,2,1370,12,576
1100,서울특별시,1123,강남구,,일원2동제4투,1368,1015,199,772,34,0,1,0,0,0,1,1,0,0,1008,7,353
1100,서울특별시,1123,강남구,,일원2동제5투,2172,1693,377,1263,36,0,4,0,0,1,4,0,0,1,1686,7,479
1100,서울특별시,1123,강남구,수서동,소계,12656,9857,3708,5764,183,6,76,1,0,2,11,7,4,8,9770,87,2799
1100,서울특별시,1123,강남구,,관내사전투표,4455,4455,1914,2388,80,3,21,1,0,0,3,5,1,4,4420,35,0
1100,서울특별시,1123,강남구,,수서동제1투,1702,1125,247,850,15,0,3,0,0,1,0,0,0,0,1116,9,577
1100,서울특별시,1123,강남구,,수서동제2투,1272,853,372,433,16,1,19,0,0,1,3,0,1,0,846,7,419
1100,서울특별시,1123,강남구,,수서동제3투,1422,830,344,443,9,1,14,0,0,0,2,2,1,3,819,11,592
1100,서울특별시,1123,강남구,,수서동제4투,1381,828,352,432,17,1,10,0,0,0,3,0,1,0,816,12,553
1100,서울특별시,1123,강남구,,수서동제5투,2424,1766,479,1218,46,0,9,0,0,0,0,0,0,1,1753,13,658
1100,서울특별시,1123,강남구,세곡동,소계,30139,23516,9916,12729,560,11,91,4,4,7,27,7,1,6,23363,153,6623
1100,서울특별시,1123,강남구,,관내사전투표,7461,7461,3761,3511,133,2,23,4,0,1,4,1,0,1,7441,20,0
1100,서울특별시,1123,강남구,,세곡동제1투,2160,1282,462,762,33,2,5,0,0,0,2,0,0,0,1266,16,878
1100,서울특별시,1123,강남구,,세곡동제2투,2162,1481,574,852,39,1,6,0,0,0,2,1,0,0,1475,6,681
1100,서울특별시,1123,강남구,,세곡동제3투,2665,1925,794,1052,48,3,8,0,0,0,3,0,0,2,1910,15,740
1100,서울특별시,1123,강남구,,세곡동제4투,2920,2089,737,1263,62,2,4,0,0,1,3,1,0,2,2075,14,831
1100,서울특별시,1123,강남구,,세곡동제5투,2307,1787,710,1017,39,0,7,0,1,0,3,1,0,0,1778,9,520
1100,서울특별시,1123,강남구,,세곡동제6투,2645,1876,815,968,56,0,10,0,3,1,3,1,0,0,1857,19,769
1100,서울특별시,1123,강남구,,세곡동제7투,2487,1732,616,1049,38,0,9,0,0,0,1,0,1,1,1715,17,755
1100,서울특별시,1123,강남구,,세곡동제8투,2650,1879,855,928,47,1,13,0,0,4,5,2,0,0,1855,24,771
1100,서울특별시,1123,강남구,,세곡동제9투,2682,2004,592,1327,65,0,6,0,0,0,1,0,0,0,1991,13,678
1100,서울특별시,1123,강남구,잘못 투입·구분된 투표지,,0,4,2,2,0,0,0,0,0,0,0,0,0,0,4,0,-4
1100,서울특별시,1124,송파구,합계,,565840,453536,180490,255166,10652,196,2050,56,66,136,290,239,69,100,449510,4026,112304
1100,서울특별시,1124,송파구,거소·선상투표,,682,638,222,327,7,1,5,0,0,0,0,1,0,1,564,74,44
1100,서울특별시,1124,송파구,관외사전투표,,49509,49503,21722,25744,1250,18,290,11,7,7,25,29,10,18,49131,372,6
1100,서울특별시,1124,송파구,재외투표,,5919,4400,1886,1999,130,1,7,1,2,0,0,0,0,1,4027,373,1519
1100,서울특별시,1124,송파구,풍납1동,소계,10682,8144,3741,4081,180,5,49,0,5,8,9,5,4,4,8091,53,2538
1100,서울특별시,1124,송파구,,관내사전투표,3946,3946,2075,1740,75,2,18,0,2,4,4,1,2,2,3925,21,0
1100,서울특별시,1124,송파구,,풍납1동제1투,2529,1460,578,811,40,2,15,0,0,2,2,1,0,1,1452,8,1069
1100,서울특별시,1124,송파구,,풍납1동제2투,1996,1201,503,643,27,1,10,0,0,0,0,0,1,1,1186,15,795
1100,서울특별시,1124,송파구,,풍납1동제3투,2211,1537,585,887,38,0,6,0,3,2,3,3,1,0,1528,9,674
1100,서울특별시,1124,송파구,풍납2동,소계,18768,14533,6064,7886,370,9,60,2,2,2,10,6,4,4,14419,114,4235
1100,서울특별시,1124,송파구,,관내사전투표,6769,6768,3213,3330,161,5,19,1,1,2,1,0,3,2,6738,30,1
1100,서울특별시,1124,송파구,,풍납2동제1투,1991,1214,460,690,39,0,3,0,0,0,1,0,0,0,1193,21,777
1100,서울특별시,1124,송파구,,풍납2동제2투,2361,1516,500,943,42,1,11,0,0,0,3,1,0,1,1502,14,845
1100,서울특별시,1124,송파구,,풍납2동제3투,2063,1426,509,854,31,1,5,0,0,0,3,2,1,0,1406,20,637
1100,서울특별시,1124,송파구,,풍납2동제4투,2050,1328,548,730,33,1,6,0,0,0,1,1,0,0,1320,8,722
1100,서울특별시,1124,송파구,,풍납2동제5투,1551,1028,395,594,23,0,6,1,0,0,0,1,0,1,1021,7,523
1100,서울특별시,1124,송파구,,풍납2동제6투,1983,1253,439,745,41,1,10,0,1,0,1,1,0,0,1239,14,730
1100,서울특별시,1124,송파구,거여1동,소계,10579,8170,3810,4020,191,2,49,0,1,3,10,5,2,1,8094,76,2409
1100,서울특별시,1124,송파구,,관내사전투표,3875,3875,2094,1653,77,1,21,0,1,1,2,2,1,0,3853,22,0
1100,서울특별시,1124,송파구,,거여1동제1투,2458,1476,604,794,35,1,10,0,0,1,4,1,0,1,1451,25,982
1100,서울특별시,1124,송파구,,거여1동제2투,2062,1271,552,653,37,0,11,0,0,0,2,1,0,0,1256,15,791
1100,서울특별시,1124,송파구,,거여1동제3투,2184,1548,560,920,42,0,7,0,0,1,2,1,1,0,1534,14,636
1100,서울특별시,1124,송파구,거여2동,소계,16376,13033,5877,6514,340,10,87,1,2,6,9,14,7,4,12871,162,3343
1100,서울특별시,1124,송파구,,관내사전투표,6294,6293,3324,2754,136,4,31,1,0,3,3,6,2,0,6264,29,1
1100,서울특별시,1124,송파구,,거여2동제1투,2672,1714,578,1057,38,1,13,0,0,0,3,0,1,0,1691,23,958
1100,서울특별시,1124,송파구,,거여2동제2투,2608,1611,621,822,57,5,25,0,1,2,3,0,4,3,1543,68,997
1100,서울특별시,1124,송파구,,거여2동제3투,2590,1852,704,1040,66,0,14,0,1,1,0,3,0,1,1830,22,738
1100,서울특별시,1124,송파구,,거여2동제4투,2212,1563,650,841,43,0,4,0,0,0,0,5,0,0,1543,20,649
1100,서울특별시,1124,송파구,마천1동,소계,15054,10912,5279,5172,236,9,90,2,1,1,13,11,2,4,10820,92,4142
1100,서울특별시,1124,송파구,,관내사전투표,4472,4472,2408,1933,78,3,20,0,0,0,1,4,1,1,4449,23,0
1100,서울특별시,1124,송파구,,마천1동제1투,1772,957,399,500,31,0,13,0,1,1,0,3,0,0,948,9,815
1100,서울특별시,1124,송파구,,마천1동제2투,2021,1178,516,607,24,2,12,0,0,0,3,1,0,1,1166,12,843
1100,서울특별시,1124,송파구,,마천1동제3투,2177,1299,582,644,40,1,15,2,0,0,1,1,1,2,1289,10,878
1100,서울특별시,1124,송파구,,마천1동제4투,1794,1007,415,532,22,1,16,0,0,0,2,1,0,0,989,18,787
1100,서울특별시,1124,송파구,,마천1동제5투,2818,1999,959,956,41,2,14,0,0,0,6,1,0,0,1979,20,819
1100,서울특별시,1124,송파구,마천2동,소계,15986,11831,5933,5424,250,9,104,1,0,6,6,14,1,4,11752,79,4155
1100,서울특별시,1124,송파구,,관내사전투표,5505,5504,3087,2261,97,2,25,0,0,1,0,7,0,2,5482,22,1
1100,서울특별시,1124,송파구,,마천2동제1투,2394,1247,528,653,30,3,20,0,0,0,2,1,1,0,1238,9,1147
1100,서울특별시,1124,송파구,,마천2동제2투,2464,1413,591,743,41,1,13,0,0,1,1,3,0,0,1394,19,1051
1100,서울특별시,1124,송파구,,마천2동제3투,3176,2102,993,1001,53,1,30,1,0,3,2,0,0,1,2085,17,1074
1100,서울특별시,1124,송파구,,마천2동제4투,2447,1565,734,766,29,2,16,0,0,1,1,3,0,1,1553,12,882
1100,서울특별시,1124,송파구,방이1동,소계,13248,10714,4563,5742,263,8,35,1,1,5,4,8,0,3,10633,81,2534
1100,서울특별시,1124,송파구,,관내사전투표,5152,5152,2478,2516,117,2,12,0,0,0,0,4,0,0,5129,23,0
1100,서울특별시,1124,송파구,,방이1동제1투,2685,1808,638,1077,56,1,10,0,0,3,3,0,0,1,1789,19,877
1100,서울특별시,1124,송파구,,방이1동제2투,2975,1922,865,972,47,2,11,1,1,0,0,3,0,1,1903,19,1053
1100,서울특별시,1124,송파구,,방이1동제3투,2436,1832,582,1177,43,3,2,0,0,2,1,1,0,1,1812,20,604
1100,서울특별시,1124,송파구,방이2동,소계,21133,15198,6660,7805,428,5,79,3,2,5,9,12,2,3,15013,185,5935
1100,서울특별시,1124,송파구,,관내사전투표,5868,5864,2912,2697,168,1,20,1,1,0,0,4,0,1,5805,59,4
1100,서울특별시,1124,송파구,,방이2동제1투,2582,1476,518,870,46,1,11,1,0,1,1,1,0,0,1450,26,1106
1100,서울특별시,1124,송파구,,방이2동제2투,2472,1363,506,784,45,0,7,0,0,1,0,0,0,0,1343,20,1109
1100,서울특별시,1124,송파구,,방이2동제3투,2470,1440,575,787,46,2,9,0,0,0,3,2,0,0,1424,16,1030
1100,서울특별시,1124,송파구,,방이2동제4투,2951,2029,849,1089,49,0,10,0,0,1,0,2,0,2,2002,27,922
1100,서울특별시,1124,송파구,,방이2동제5투,2598,1637,734,830,35,0,12,1,1,2,2,1,1,0,1619,18,961
1100,서울특별시,1124,송파구,,방이2동제6투,2192,1389,566,748,39,1,10,0,0,0,3,2,1,0,1370,19,803
1100,서울특별시,1124,송파구,오륜동,소계,13729,11701,3006,8354,213,3,31,0,4,5,10,4,1,0,11631,70,2028
1100,서울특별시,1124,송파구,,관내사전투표,5600,5600,1812,3667,81,2,12,0,0,0,4,2,0,0,5580,20,0
1100,서울특별시,1124,송파구,,오륜동제1투,1640,1183,241,904,24,0,3,0,0,1,2,0,0,0,1175,8,457
1100,서울특별시,1124,송파구,,오륜동제2투,2309,1776,351,1359,43,0,6,0,0,1,1,0,0,0,1761,15,533
1100,서울특별시,1124,송파구,,오륜동제3투,2173,1669,371,1234,33,1,7,0,2,2,3,1,1,0,1655,14,504
1100,서울특별시,1124,송파구,,오륜동제4투,2007,1473,231,1190,32,0,3,0,2,1,0,1,0,0,1460,13,534
1100,서울특별시,1124,송파구,오금동,소계,28963,22229,9019,12395,506,9,105,1,1,8,11,11,1,4,22071,158,6734
1100,서울특별시,1124,송파구,,관내사전투표,7430,7431,3452,3761,151,3,23,0,0,3,1,3,0,2,7399,32,-1
1100,서울특별시,1124,송파구,,오금동제1투,2626,1704,350,1301,37,0,3,0,0,0,1,0,0,0,1692,12,922
1100,서울특별시,1124,송파구,,오금동제2투,2826,2019,612,1328,50,0,7,0,0,0,3,0,1,1,2002,17,807
1100,서울특별시,1124,송파구,,오금동제3투,2443,1645,677,899,40,1,11,0,0,0,2,1,0,1,1632,13,798
1100,서울특별시,1124,송파구,,오금동제4투,3230,2182,927,1154,59,2,16,0,0,2,1,2,0,0,2163,19,1048
1100,서울특별시,1124,송파구,,오금동제5투,2557,1710,748,884,39,3,11,0,0,1,0,1,0,0,1687,23,847
1100,서울특별시,1124,송파구,,오금동제6투,2326,1758,565,1132,37,0,8,0,0,0,2,1,0,0,1745,13,568
1100,서울특별시,1124,송파구,,오금동제7투,3039,2004,887,1024,51,0,15,0,1,1,0,1,0,0,1980,24,1035
1100,서울특별시,1124,송파구,,오금동제8투,2486,1776,801,912,42,0,11,1,0,1,1,2,0,0,1771,5,710
1100,서울특별시,1124,송파구,송파1동,소계,20153,15598,7033,7822,463,12,72,2,3,2,11,13,4,1,15438,160,4555
1100,서울특별시,1124,송파구,,관내사전투표,7275,7275,3790,3174,224,3,24,0,0,1,2,6,1,1,7226,49,0
1100,서울특별시,1124,송파구,,송파1동제1투,2446,1442,595,759,44,1,10,1,0,0,2,1,1,0,1414,28,1004
1100,서울특별시,1124,송파구,,송파1동제2투,2029,1437,508,869,29,0,8,1,2,1,1,2,0,0,1421,16,592
1100,서울특별시,1124,송파구,,송파1동제3투,1698,1067,420,585,31,0,7,0,0,0,1,1,0,0,1045,22,631
1100,서울특별시,1124,송파구,,송파1동제4투,1940,1240,511,667,41,3,4,0,0,0,0,0,1,0,1227,13,700
1100,서울특별시,1124,송파구,,송파1동제5투,2462,1603,700,812,54,3,10,0,1,0,2,1,1,0,1584,19,859
1100,서울특별시,1124,송파구,,송파1동제6투,2303,1534,509,956,40,2,9,0,0,0,3,2,0,0,1521,13,769
1100,서울특별시,1124,송파구,송파2동,소계,15332,12542,4624,7467,282,5,39,1,0,3,10,9,2,1,12443,99,2790
1100,서울특별시,1124,송파구,,관내사전투표,5873,5873,2610,3101,117,3,12,0,0,0,3,4,0,0,5850,23,0
1100,서울특별시,1124,송파구,,송파2동제1투,2120,1412,389,951,38,0,11,0,0,0,4,2,1,1,1397,15,708
1100,서울특별시,1124,송파구,,송파2동제2투,1871,1206,494,647,33,1,5,0,0,1,1,2,1,0,1185,21,665
1100,서울특별시,1124,송파구,,송파2동제3투,2577,1933,549,1325,37,0,1,0,0,0,0,1,0,0,1913,20,644
1100,서울특별시,1124,송파구,,송파2동제4투,2891,2118,582,1443,57,1,10,1,0,2,2,0,0,0,2098,20,773
1100,서울특별시,1124,송파구,석촌동,소계,25334,18421,8763,8827,472,8,130,3,2,3,13,4,3,5,18233,188,6913
1100,서울특별시,1124,송파구,,관내사전투표,7831,7831,4295,3274,170,4,37,3,0,1,2,0,1,2,7789,42,0
1100,서울특별시,1124,송파구,,석촌동제1투,2512,1516,590,851,38,0,12,0,0,1,0,1,0,0,1493,23,996
1100,서울특별시,1124,송파구,,석촌동제2투,2287,1345,604,666,42,1,9,0,0,0,0,1,1,0,1324,21,942
1100,서울특별시,1124,송파구,,석촌동제3투,2748,1615,674,842,61,1,14,0,0,0,3,0,0,0,1595,20,1133
1100,서울특별시,1124,송파구,,석촌동제4투,2702,1695,736,875,41,0,16,0,1,1,2,1,0,2,1675,20,1007
1100,서울특별시,1124,송파구,,석촌동제5투,2613,1483,631,781,35,1,12,0,0,0,3,1,0,1,1465,18,1130
1100,서울특별시,1124,송파구,,석촌동제6투,2460,1525,665,783,36,0,19,0,0,0,2,0,1,0,1506,19,935
1100,서울특별시,1124,송파구,,석촌동제7투,2181,1411,568,755,49,1,11,0,1,0,1,0,0,0,1386,25,770
1100,서울특별시,1124,송파구,삼전동,소계,24753,18020,8634,8543,486,10,117,5,5,2,12,6,9,5,17834,186,6733
1100,서울특별시,1124,송파구,,관내사전투표,7344,7341,3997,3092,166,6,26,1,0,0,4,1,5,1,7299,42,3
1100,서울특별시,1124,송파구,,삼전동제1투,2279,1197,511,607,40,0,8,1,1,1,3,1,1,0,1174,23,1082
1100,서울특별시,1124,송파구,,삼전동제2투,2439,1470,609,776,44,0,17,1,0,0,0,1,1,1,1450,20,969
1100,서울특별시,1124,송파구,,삼전동제3투,2548,1679,745,844,48,2,20,0,0,0,0,2,1,0,1662,17,869
1100,서울특별시,1124,송파구,,삼전동제4투,2420,1492,622,782,55,0,6,0,1,0,2,0,0,1,1469,23,928
1100,서울특별시,1124,송파구,,삼전동제5투,2902,1923,862,957,57,1,12,2,1,0,2,1,0,1,1896,27,979
1100,서울특별시,1124,송파구,,삼전동제6투,2535,1532,667,794,35,0,13,0,1,0,1,0,1,0,1512,20,1003
1100,서울특별시,1124,송파구,,삼전동제7투,2286,1386,621,691,41,1,15,0,1,1,0,0,0,1,1372,14,900
1100,서울특별시,1124,송파구,가락본동,소계,20148,15230,6103,8456,370,11,98,0,3,6,20,8,2,1,15078,152,4918
1100,서울특별시,1124,송파구,,관내사전투표,6329,6331,2978,3136,142,4,25,0,1,1,2,5,2,1,6297,34,-2
1100,서울특별시,1124,송파구,,가락본동제1투,2295,1187,411,721,27,1,11,0,0,0,0,1,0,0,1172,15,1108
1100,서울특별시,1124,송파구,,가락본동제2투,2764,1892,709,1091,43,3,11,0,0,1,3,0,0,0,1861,31,872
1100,서울특별시,1124,송파구,,가락본동제3투,2670,1637,609,927,49,2,14,0,1,2,5,0,0,0,1609,28,1033
1100,서울특별시,1124,송파구,,가락본동제4투,1697,1175,368,755,29,0,9,0,0,1,3,0,0,0,1165,10,522
1100,서울특별시,1124,송파구,,가락본동제5투,2303,1569,632,853,39,1,18,0,0,0,5,2,0,0,1550,19,734
1100,서울특별시,1124,송파구,,가락본동제6투,2090,1439,396,973,41,0,10,0,1,1,2,0,0,0,1424,15,651
1100,서울특별시,1124,송파구,가락1동,소계,20076,16881,5097,11272,331,3,34,0,0,5,13,3,1,2,16761,120,3195
1100,서울특별시,1124,송파구,,관내사전투표,7812,7813,2796,4850,127,1,10,0,0,1,3,0,1,1,7790,23,-1
1100,서울특별시,1124,송파구,,가락1동제1투,2694,1897,475,1353,46,0,1,0,0,0,1,2,0,0,1878,19,797
1100,서울특별시,1124,송파구,,가락1동제2투,2603,1903,463,1363,45,1,7,0,0,0,2,0,0,1,1882,21,700
1100,서울특별시,1124,송파구,,가락1동제3투,2124,1629,386,1186,32,0,4,0,0,2,3,1,0,0,1614,15,495
1100,서울특별시,1124,송파구,,가락1동제4투,2525,1919,518,1328,44,1,6,0,0,1,1,0,0,0,1899,20,606
1100,서울특별시,1124,송파구,,가락1동제5투,2318,1720,459,1192,37,0,6,0,0,1,3,0,0,0,1698,22,598
1100,서울특별시,1124,송파구,가락2동,소계,23681,18739,7507,10497,482,5,67,2,2,10,6,13,1,4,18596,143,4942
1100,서울특별시,1124,송파구,,관내사전투표,6660,6659,3262,3183,151,0,18,0,0,3,1,10,0,1,6629,30,1
1100,서울특별시,1124,송파구,,가락2동제1투,2434,1466,583,820,40,0,5,0,0,2,0,0,0,0,1450,16,968
1100,서울특별시,1124,송파구,,가락2동제2투,2239,1412,513,830,44,0,7,0,0,1,1,1,0,0,1397,15,827
1100,서울특별시,1124,송파구,,가락2동제3투,2832,2283,821,1372,66,1,3,0,1,2,1,1,0,0,2268,15,549
1100,서울특별시,1124,송파구,,가락2동제4투,2109,1538,463,1007,38,1,8,0,0,0,1,0,0,3,1521,17,571
1100,서울특별시,1124,송파구,,가락2동제5투,2410,1673,533,1072,41,0,8,0,1,1,0,1,0,0,1657,16,737
1100,서울특별시,1124,송파구,,가락2동제6투,2521,1819,633,1115,43,1,5,2,0,1,0,0,1,0,1801,18,702
1100,서울특별시,1124,송파구,,가락2동제7투,2476,1889,699,1098,59,2,13,0,0,0,2,0,0,0,1873,16,587
1100,서울특별시,1124,송파구,문정1동,소계,17298,13906,5779,7599,307,5,69,1,1,3,10,5,0,3,13782,124,3392
1100,서울특별시,1124,송파구,,관내사전투표,6437,6437,3204,3007,149,4,22,0,1,1,2,3,0,2,6395,42,0
1100,서울특별시,1124,송파구,,문정1동제1투,2930,1788,731,969,41,0,18,0,0,1,0,0,0,0,1760,28,1142
1100,서울특별시,1124,송파구,,문정1동제2투,2242,1622,537,1015,38,0,8,0,0,1,3,1,0,1,1604,18,620
1100,서울특별시,1124,송파구,,문정1동제3투,2677,1703,731,890,45,0,15,0,0,0,1,0,0,0,1682,21,974
1100,서울특별시,1124,송파구,,문정1동제4투,3012,2356,576,1718,34,1,6,1,0,0,4,1,0,0,2341,15,656
1100,서울특별시,1124,송파구,문정2동,소계,21662,17130,5185,11335,389,6,48,2,3,2,10,5,2,1,16988,142,4532
1100,서울특별시,1124,송파구,,관내사전투표,4983,4983,1660,3220,74,4,8,1,0,1,0,1,0,0,4969,14,0
1100,서울특별시,1124,송파구,,문정2동제1투,1884,1437,224,1165,28,0,3,1,1,0,0,1,1,0,1424,13,447
1100,서울특별시,1124,송파구,,문정2동제2투,2638,2036,397,1593,31,0,5,0,0,0,3,0,0,0,2029,7,602
1100,서울특별시,1124,송파구,,문정2동제3투,2423,1726,307,1364,31,0,5,0,1,1,4,0,0,1,1714,12,697
1100,서울특별시,1124,송파구,,문정2동제4투,3171,2184,895,1181,71,0,4,0,0,0,2,2,0,0,2155,29,987
1100,서울특별시,1124,송파구,,문정2동제5투,3127,2207,809,1275,79,1,9,0,0,0,1,0,0,0,2174,33,920
1100,서울특별시,1124,송파구,,문정2동제6투,3436,2557,893,1537,75,1,14,0,1,0,0,1,1,0,2523,34,879
1100,서울특별시,1124,송파구,장지동,소계,24026,19075,8726,9602,462,11,78,3,3,10,16,10,5,3,18929,146,4951
1100,서울특별시,1124,송파구,,관내사전투표,8312,8312,4359,3707,176,5,27,0,0,1,4,4,1,2,8286,26,0
1100,서울특별시,1124,송파구,,장지동제1투,1422,798,325,427,25,1,5,0,0,1,0,1,1,1,787,11,624
1100,서울특별시,1124,송파구,,장지동제2투,1883,1296,473,760,33,0,10,0,0,2,2,0,0,0,1280,16,587
1100,서울특별시,1124,송파구,,장지동제3투,2688,1773,756,916,53,2,10,1,0,2,4,0,2,0,1746,27,915
1100,서울특별시,1124,송파구,,장지동제4투,1620,1137,435,654,37,0,2,0,0,0,0,2,0,0,1130,7,483
1100,서울특별시,1124,송파구,,장지동제5투,2939,1998,844,1077,37,0,12,0,1,1,4,1,1,0,1978,20,941
1100,서울특별시,1124,송파구,,장지동제6투,2757,2013,852,1066,58,2,8,1,0,3,2,1,0,0,1993,20,744
1100,서울특별시,1124,송파구,,장지동제7투,2405,1748,682,995,43,1,4,1,2,0,0,1,0,0,1729,19,657
1100,서울특별시,1124,송파구,잠실본동,소계,22307,16068,7071,8298,408,7,105,1,3,1,10,7,2,2,15915,153,6239
1100,서울특별시,1124,송파구,,관내사전투표,7109,7109,3616,3252,169,1,28,0,1,0,1,2,1,0,7071,38,0
1100,서울특별시,1124,송파구,,잠실본동제1투,2836,1535,627,836,36,0,8,1,0,0,0,3,0,1,1512,23,1301
1100,서울특별시,1124,송파구,,잠실본동제2투,2502,1455,518,846,46,2,16,0,0,0,5,0,0,0,1433,22,1047
1100,서울특별시,1124,송파구,,잠실본동제3투,2416,1422,584,770,38,0,11,0,0,0,0,0,1,0,1404,18,994
1100,서울특별시,1124,송파구,,잠실본동제4투,2431,1482,559,857,37,0,16,0,0,0,1,0,0,0,1470,12,949
1100,서울특별시,1124,송파구,,잠실본동제5투,2394,1505,539,891,41,1,11,0,2,1,1,1,0,0,1488,17,889
1100,서울특별시,1124,송파구,,잠실본동제6투,2619,1560,628,846,41,3,15,0,0,0,2,1,0,1,1537,23,1059
1100,서울특별시,1124,송파구,잠실2동,소계,25386,21135,6214,14333,405,7,29,3,1,11,9,3,1,7,21023,112,4251
1100,서울특별시,1124,송파구,,관내사전투표,8029,8028,2949,4912,132,4,4,0,0,2,0,1,0,4,8008,20,1
1100,서울특별시,1124,송파구,,잠실2동제1투,1812,1353,332,964,36,0,5,0,0,0,1,0,1,0,1339,14,459
1100,서울특별시,1124,송파구,,잠실2동제2투,2735,2113,533,1520,42,0,1,0,0,1,1,0,0,1,2099,14,622
1100,서울특별시,1124,송파구,,잠실2동제3투,2688,1785,410,1317,35,1,4,1,1,0,0,1,0,0,1770,15,903
1100,서울특별시,1124,송파구,,잠실2동제4투,2385,1803,387,1358,36,0,5,0,0,3,0,0,0,0,1789,14,582
1100,서울특별시,1124,송파구,,잠실2동제5투,2637,2044,508,1464,46,2,6,2,0,1,0,0,0,2,2031,13,593
1100,서울특별시,1124,송파구,,잠실2동제6투,2400,1904,527,1314,46,0,3,0,0,1,2,0,0,0,1893,11,496
1100,서울특별시,1124,송파구,,잠실2동제7투,2700,2105,568,1484,32,0,1,0,0,3,5,1,0,0,2094,11,595
1100,서울특별시,1124,송파구,잠실3동,소계,23603,19321,4720,14062,357,6,38,1,2,12,14,5,0,2,19219,102,4282
1100,서울특별시,1124,송파구,,관내사전투표,5698,5698,1744,3827,92,2,6,0,0,1,0,3,0,0,5675,23,0
1100,서울특별시,1124,송파구,,잠실3동제1투,1716,1284,279,962,30,1,1,0,0,3,1,1,0,0,1278,6,432
1100,서울특별시,1124,송파구,,잠실3동제2투,2292,1513,296,1169,30,0,6,0,0,1,4,0,0,0,1506,7,779
1100,서울특별시,1124,송파구,,잠실3동제3투,1800,1426,329,1051,23,0,6,0,0,2,1,0,0,0,1412,14,374
1100,서울특별시,1124,송파구,,잠실3동제4투,1691,1332,205,1104,14,0,1,0,0,1,1,0,0,0,1326,6,359
1100,서울특별시,1124,송파구,,잠실3동제5투,2652,2039,438,1538,46,2,4,0,0,2,0,0,0,0,2030,9,613
1100,서울특별시,1124,송파구,,잠실3동제6투,2044,1593,346,1195,39,0,4,1,0,0,2,0,0,0,1587,6,451
1100,서울특별시,1124,송파구,,잠실3동제7투,2794,2207,510,1620,45,1,5,0,1,0,1,1,0,2,2186,21,587
1100,서울특별시,1124,송파구,,잠실3동제8투,2916,2229,573,1596,38,0,5,0,1,2,4,0,0,0,2219,10,687
1100,서울특별시,1124,송파구,잠실4동,소계,15170,12658,3753,8549,243,2,26,1,3,2,6,1,1,0,12587,71,2512
1100,서울특별시,1124,송파구,,관내사전투표,5747,5747,2061,3562,90,0,7,1,2,1,2,0,0,0,5726,21,0
1100,서울특별시,1124,송파구,,잠실4동제1투,1923,1293,303,952,28,0,2,0,0,0,0,0,0,0,1285,8,630
1100,서울특별시,1124,송파구,,잠실4동제2투,2389,1815,444,1307,42,0,7,0,0,1,2,0,0,0,1803,12,574
1100,서울특별시,1124,송파구,,잠실4동제3투,2464,1830,431,1338,31,1,5,0,0,0,2,1,1,0,1810,20,634
1100,서울특별시,1124,송파구,,잠실4동제4투,2647,1973,514,1390,52,1,5,0,1,0,0,0,0,0,1963,10,674
1100,서울특별시,1124,송파구,잠실6동,소계,13260,10834,2980,7563,197,1,15,0,3,0,3,1,1,3,10767,67,2426
1100,서울특별시,1124,송파구,,관내사전투표,5290,5289,1754,3407,103,0,8,0,1,0,1,1,1,1,5277,12,1
1100,서울특별시,1124,송파구,,잠실6동제1투,2841,1917,425,1435,33,0,1,0,0,0,0,0,0,1,1895,22,924
1100,서울특별시,1124,송파구,,잠실6동제2투,2639,1840,386,1404,25,1,1,0,2,0,2,0,0,0,1821,19,799
1100,서울특별시,1124,송파구,,잠실6동제3투,2490,1788,415,1317,36,0,5,0,0,0,0,0,0,1,1774,14,702
1100,서울특별시,1124,송파구,잠실7동,소계,8389,7109,1633,5295,123,0,9,1,1,3,1,3,1,1,7071,38,1280
1100,서울특별시,1124,송파구,,관내사전투표,3546,3546,1049,2416,63,0,4,0,0,1,0,2,1,0,3536,10,0
1100,서울특별시,1124,송파구,,잠실7동제1투,2507,1769,214,1507,26,0,0,1,1,2,1,1,0,0,1753,16,738
1100,서울특별시,1124,송파구,,잠실7동제2투,2336,1794,370,1372,34,0,5,0,0,0,0,0,0,1,1782,12,542
1100,서울특별시,1124,송파구,위례동,소계,24634,19856,8883,10179,511,8,85,7,3,5,10,23,0,8,19722,134,4778
1100,서울특별시,1124,송파구,,관내사전투표,7378,7379,3698,3476,145,3,16,1,2,0,0,7,0,4,7352,27,-1
1100,서울특별시,1124,송파구,,위례동제1투,2435,1755,447,1229,60,0,5,0,0,1,0,1,0,1,1744,11,680
1100,서울특별시,1124,송파구,,위례동제2투,2857,2102,832,1173,51,1,14,1,0,0,2,4,0,1,2079,23,755
1100,서울특별시,1124,송파구,,위례동제3투,2715,1826,692,1048,60,0,10,2,0,1,1,0,0,2,1816,10,889
1100,서울특별시,1124,송파구,,위례동제4투,1777,1141,333,750,33,2,8,1,0,0,0,1,0,0,1128,13,636
1100,서울특별시,1124,송파구,,위례동제5투,2928,2188,1138,950,54,0,16,1,1,3,4,5,0,0,2172,16,740
1100,서울특별시,1124,송파구,,위례동제6투,3570,2735,1375,1230,79,1,16,1,0,0,2,3,0,0,2707,28,835
1100,서울특별시,1124,송파구,,위례동제7투,974,730,368,323,29,1,0,0,0,0,1,2,0,0,724,6,244
1100,서울특별시,1124,송파구,잘못 투입·구분된 투표지,,0,7,3,4,0,0,0,0,0,0,0,0,0,0,7,0,-7
1100,서울특별시,1125,강동구,합계,,397634,313203,139172,160593,8029,182,1793,56,32,84,242,253,63,85,310584,2619,84431
1100,서울특별시,1125,강동구,거소·선상투표,,778,736,271,300,26,3,15,1,1,1,0,1,3,4,626,110,42
1100,서울특별시,1125,강동구,관외사전투표,,35353,35350,17033,16615,1013,32,270,9,3,4,11,58,7,19,35074,276,3
1100,서울특별시,1125,강동구,재외투표,,2940,2101,1110,751,56,0,5,1,0,4,0,2,1,0,1930,171,839
1100,서울특별시,1125,강동구,강일동,소계,23947,18758,9643,8386,425,11,96,3,3,4,24,15,6,4,18620,138,5189
1100,서울특별시,1125,강동구,,관내사전투표,7285,7285,4208,2864,132,7,22,2,1,1,7,4,3,3,7254,31,0
1100,서울특별시,1125,강동구,,강일동제1투,2484,1550,689,783,45,0,8,0,0,1,4,1,0,0,1531,19,934
1100,서울특별시,1125,강동구,,강일동제2투,2267,1568,716,777,41,1,11,0,0,0,2,3,1,0,1552,16,699
1100,서울특별시,1125,강동구,,강일동제3투,2212,1554,675,820,37,1,8,0,0,1,2,1,0,0,1545,9,658
1100,서울특별시,1125,강동구,,강일동제4투,2355,1615,752,774,52,1,13,1,1,0,3,1,0,0,1598,17,740
1100,서울특별시,1125,강동구,,강일동제5투,2209,1664,849,743,44,0,7,0,1,0,0,3,0,0,1647,17,545
1100,서울특별시,1125,강동구,,강일동제6투,2527,1811,876,865,33,0,14,0,0,0,3,2,2,1,1796,15,716
1100,서울특별시,1125,강동구,,강일동제7투,2608,1711,878,760,41,1,13,0,0,1,3,0,0,0,1697,14,897
1100,서울특별시,1125,강동구,명일제1동,소계,20850,16627,6726,9239,413,10,75,2,0,5,9,8,3,8,16498,129,4223
1100,서울특별시,1125,강동구,,관내사전투표,7739,7739,3660,3833,162,2,20,1,0,3,1,5,2,3,7692,47,0
1100,서울특별시,1125,강동구,,명일제1동제1투,2154,1380,478,834,36,1,6,0,0,1,2,0,1,1,1360,20,774
1100,서울특별시,1125,강동구,,명일제1동제2투,2881,1988,712,1182,54,2,12,1,0,0,5,2,0,2,1972,16,893
1100,서울특별시,1125,강동구,,명일제1동제3투,2240,1683,483,1139,49,0,2,0,0,1,0,0,0,0,1674,9,557
1100,서울특별시,1125,강동구,,명일제1동제4투,2748,1980,624,1251,64,2,17,0,0,0,1,0,0,1,1960,20,768
1100,서울특별시,1125,강동구,,명일제1동제5투,3088,1857,769,1000,48,3,18,0,0,0,0,1,0,1,1840,17,1231
1100,서울특별시,1125,강동구,명일제2동,소계,13894,11641,4424,6829,247,1,32,2,3,3,14,6,1,1,11563,78,2253
1100,서울특별시,1125,강동구,,관내사전투표,5014,5014,2248,2656,83,1,5,2,1,0,2,2,0,0,5000,14,0
1100,서울특별시,1125,강동구,,명일제2동제1투,1942,1559,494,1004,39,0,2,0,0,0,2,0,0,0,1541,18,383
1100,서울특별시,1125,강동구,,명일제2동제2투,1991,1325,473,787,31,0,11,0,2,0,3,3,1,1,1312,13,666
1100,서울특별시,1125,강동구,,명일제2동제3투,2768,2062,738,1234,56,0,10,0,0,2,2,1,0,0,2043,19,706
1100,서울특별시,1125,강동구,,명일제2동제4투,2179,1681,471,1148,38,0,4,0,0,1,5,0,0,0,1667,14,498
1100,서울특별시,1125,강동구,고덕제1동,소계,16884,13846,5666,7697,329,3,56,3,1,2,9,8,3,0,13777,69,3038
1100,서울특별시,1125,강동구,,관내사전투표,6582,6582,3076,3330,137,1,14,0,1,0,1,2,0,0,6562,20,0
1100,서울특별시,1125,강동구,,고덕제1동제1투,1390,1019,398,572,34,0,6,0,0,0,0,1,0,0,1011,8,371
1100,서울특별시,1125,강동구,,고덕제1동제2투,1090,772,257,470,30,0,6,0,0,0,2,1,0,0,766,6,318
1100,서울특별시,1125,강동구,,고덕제1동제3투,1462,988,335,599,37,0,3,1,0,0,3,0,1,0,979,9,474
1100,서울특별시,1125,강동구,,고덕제1동제4투,1559,928,343,539,19,0,13,1,0,1,3,1,0,0,920,8,631
1100,서울특별시,1125,강동구,,고덕제1동제5투,2406,1871,660,1153,32,1,9,1,0,1,0,2,1,0,1860,11,535
1100,서울특별시,1125,강동구,,고덕제1동제6투,2395,1686,597,1034,40,1,5,0,0,0,0,1,1,0,1679,7,709
1100,서울특별시,1125,강동구,고덕제2동,소계,16115,12976,4789,7702,283,9,72,2,0,1,6,7,3,4,12878,98,3139
1100,서울특별시,1125,강동구,,관내사전투표,5143,5143,2261,2751,80,1,21,1,0,0,0,3,1,2,5121,22,0
1100,서울특별시,1125,강동구,,고덕제2동제1투,1819,994,374,558,28,1,14,0,0,1,3,2,2,0,983,11,825
1100,서울특별시,1125,강동구,,고덕제2동제2투,2377,1556,569,906,44,5,17,0,0,0,0,1,0,2,1544,12,821
1100,서울특별시,1125,강동구,,고덕제2동제3투,2791,2161,652,1431,53,2,6,0,0,0,0,1,0,0,2145,16,630
1100,서울특별시,1125,강동구,,고덕제2동제4투,1763,1410,449,899,36,0,6,1,0,0,0,0,0,0,1391,19,353
1100,서울특별시,1125,강동구,,고덕제2동제5투,2222,1712,484,1157,42,0,8,0,0,0,3,0,0,0,1694,18,510
1100,서울특별시,1125,강동구,암사제1동,소계,25791,18302,8590,8904,450,7,149,3,1,5,17,19,4,4,18153,149,7489
1100,서울특별시,1125,강동구,,관내사전투표,6721,6718,3689,2831,120,3,37,1,1,1,2,8,1,2,6696,22,3
1100,서울특별시,1125,강동구,,암사제1동제1투,2845,1496,682,729,49,1,10,1,0,0,2,0,0,0,1474,22,1349
1100,서울특별시,1125,강동구,,암사제1동제2투,2548,1444,662,710,41,0,16,0,0,0,0,2,1,0,1432,12,1104
1100,서울특별시,1125,강동구,,암사제1동제3투,2465,1465,625,761,40,0,20,0,0,0,2,1,0,0,1449,16,1000
1100,서울특별시,1125,강동구,,암사제1동제4투,2360,1431,615,730,48,1,12,1,0,0,2,1,1,1,1412,19,929
1100,서울특별시,1125,강동구,,암사제1동제5투,2025,1186,504,600,40,0,19,0,0,1,2,1,0,1,1168,18,839
1100,서울특별시,1125,강동구,,암사제1동제6투,2268,1353,590,697,23,1,21,0,0,2,0,3,0,0,1337,16,915
1100,서울특별시,1125,강동구,,암사제1동제7투,2165,1374,591,716,40,0,10,0,0,1,3,2,1,0,1364,10,791
1100,서울특별시,1125,강동구,,암사제1동제8투,2394,1835,632,1130,49,1,4,0,0,0,4,1,0,0,1821,14,559
1100,서울특별시,1125,강동구,암사제2동,소계,13975,11627,5190,5936,339,8,52,1,2,5,6,11,0,2,11552,75,2348
1100,서울특별시,1125,강동구,,관내사전투표,6956,6956,3491,3217,174,4,23,1,0,1,0,9,0,2,6922,34,0
1100,서울특별시,1125,강동구,,암사제2동제1투,1673,1103,368,676,38,1,9,0,0,2,2,1,0,0,1097,6,570
1100,서울특별시,1125,강동구,,암사제2동제2투,3032,1914,778,1024,68,2,18,0,1,0,0,1,0,0,1892,22,1118
1100,서울특별시,1125,강동구,,암사제2동제3투,2314,1654,553,1019,59,1,2,0,1,2,4,0,0,0,1641,13,660
1100,서울특별시,1125,강동구,암사제3동,소계,14215,11831,4703,6727,277,5,31,1,1,1,16,4,2,1,11769,62,2384
1100,서울특별시,1125,강동구,,관내사전투표,5455,5455,2505,2810,102,1,12,0,0,0,3,1,0,1,5435,20,0
1100,서울특별시,1125,강동구,,암사제3동제1투,2408,1691,527,1103,43,1,1,0,0,0,4,1,1,0,1681,10,717
1100,서울특별시,1125,강동구,,암사제3동제2투,2215,1702,521,1103,50,1,9,0,1,1,6,1,1,0,1694,8,513
1100,서울특별시,1125,강동구,,암사제3동제3투,2174,1542,572,901,45,0,6,1,0,0,1,1,0,0,1527,15,632
1100,서울특별시,1125,강동구,,암사제3동제4투,1963,1441,578,810,37,2,3,0,0,0,2,0,0,0,1432,9,522
1100,서울특별시,1125,강동구,천호제1동,소계,22067,16005,7536,7799,379,15,100,1,2,10,13,17,3,7,15882,123,6062
1100,서울특별시,1125,강동구,,관내사전투표,6343,6343,3400,2714,144,8,28,0,0,3,2,9,1,1,6310,33,0
1100,서울특별시,1125,강동구,,천호제1동제1투,2834,1520,702,739,44,1,14,0,0,0,2,1,0,2,1505,15,1314
1100,서울특별시,1125,강동구,,천호제1동제2투,2808,1811,704,1043,36,1,11,0,0,0,1,1,0,0,1797,14,997
1100,서울특별시,1125,강동구,,천호제1동제3투,2632,1533,712,728,48,2,14,0,1,5,3,2,1,1,1517,16,1099
1100,서울특별시,1125,강동구,,천호제1동제4투,2844,1822,780,968,40,1,11,1,0,1,2,1,0,0,1805,17,1022
1100,서울특별시,1125,강동구,,천호제1동제5투,2360,1537,593,880,33,2,11,0,0,0,0,0,1,2,1522,15,823
1100,서울특별시,1125,강동구,,천호제1동제6투,2246,1439,645,727,34,0,11,0,1,1,3,3,0,1,1426,13,807
1100,서울특별시,1125,강동구,천호제2동,소계,26475,18744,8807,9106,456,7,148,4,2,4,19,21,3,3,18580,164,7731
1100,서울특별시,1125,강동구,,관내사전투표,6426,6427,3466,2752,133,2,26,2,0,0,5,12,2,2,6402,25,-1
1100,서울특별시,1125,강동구,,천호제2동제1투,2144,1350,619,675,29,0,12,0,0,0,3,0,0,0,1338,12,794
1100,서울특별시,1125,강동구,,천호제2동제2투,2481,1673,678,921,34,0,25,1,0,0,0,0,0,0,1659,14,808
1100,서울특별시,1125,강동구,,천호제2동제3투,1978,1208,532,614,40,0,9,0,0,0,0,0,0,0,1195,13,770
1100,서울특별시,1125,강동구,,천호제2동제4투,2705,1626,628,917,54,0,6,0,0,1,3,1,0,1,1611,15,1079
1100,서울특별시,1125,강동구,,천호제2동제5투,3054,1854,829,919,50,1,21,0,0,1,1,6,0,0,1828,26,1200
1100,서울특별시,1125,강동구,,천호제2동제6투,2994,1836,841,901,46,1,23,1,0,1,0,0,1,0,1815,21,1158
1100,서울특별시,1125,강동구,,천호제2동제7투,3111,1828,795,929,50,3,15,0,1,1,6,1,0,0,1801,27,1283
1100,서울특별시,1125,강동구,,천호제2동제8투,1582,942,419,478,20,0,11,0,1,0,1,1,0,0,931,11,640
1100,서울특별시,1125,강동구,천호제3동,소계,22232,16236,7235,8219,480,7,107,1,1,9,12,7,3,6,16087,149,5996
1100,서울특별시,1125,강동구,,관내사전투표,6930,6928,3467,3174,210,2,30,1,0,0,2,3,1,1,6891,37,2
1100,서울특별시,1125,강동구,,천호제3동제1투,2481,1528,594,824,61,1,10,0,0,3,4,0,1,0,1498,30,953
1100,서울특별시,1125,강동구,,천호제3동제2투,2508,1530,500,976,27,1,6,0,0,3,1,1,1,1,1517,13,978
1100,서울특별시,1125,강동구,,천호제3동제3투,2698,1708,673,953,44,3,15,0,0,2,1,0,0,1,1692,16,990
1100,서울특별시,1125,강동구,,천호제3동제4투,2491,1410,588,749,38,0,12,0,1,0,0,2,0,2,1392,18,1081
1100,서울특별시,1125,강동구,,천호제3동제5투,2729,1593,721,783,45,0,20,0,0,1,2,0,0,1,1573,20,1136
1100,서울특별시,1125,강동구,,천호제3동제6투,2395,1539,692,760,55,0,14,0,0,0,2,1,0,0,1524,15,856
1100,서울특별시,1125,강동구,성내제1동,소계,15730,12374,5653,6198,350,9,59,1,2,0,5,7,2,2,12288,86,3356
1100,서울특별시,1125,강동구,,관내사전투표,5853,5853,3024,2608,149,5,29,0,0,0,3,3,1,1,5823,30,0
1100,서울특별시,1125,강동구,,성내제1동제1투,2286,1349,525,754,46,3,10,0,0,0,0,0,0,0,1338,11,937
1100,서울특별시,1125,강동구,,성내제1동제2투,2704,1851,747,1021,62,0,4,1,2,0,1,1,0,0,1839,12,853
1100,서울특별시,1125,강동구,,성내제1동제3투,2357,1540,703,740,59,0,13,0,0,0,1,3,0,1,1520,20,817
1100,서울특별시,1125,강동구,,성내제1동제4투,2530,1781,654,1075,34,1,3,0,0,0,0,0,1,0,1768,13,749
1100,서울특별시,1125,강동구,성내제2동,소계,19146,13955,6391,6946,372,12,88,2,2,3,15,10,4,2,13847,108,5191
1100,서울특별시,1125,강동구,,관내사전투표,6302,6302,3220,2884,133,3,23,0,0,1,2,4,2,1,6273,29,0
1100,서울특별시,1125,강동구,,성내제2동제1투,2624,1382,568,732,53,0,11,0,0,1,2,1,1,0,1369,13,1242
1100,서울특별시,1125,강동구,,성내제2동제2투,2585,1597,669,838,48,3,14,2,0,0,1,0,0,1,1576,21,988
1100,서울특별시,1125,강동구,,성내제2동제3투,2755,1703,740,867,50,2,20,0,2,0,4,1,1,0,1687,16,1052
1100,서울특별시,1125,강동구,,성내제2동제4투,2356,1384,566,748,40,4,9,0,0,0,3,3,0,0,1373,11,972
1100,서울특별시,1125,강동구,,성내제2동제5투,2524,1587,628,877,48,0,11,0,0,1,3,1,0,0,1569,18,937
1100,서울특별시,1125,강동구,성내제3동,소계,18972,14466,6640,7180,390,6,112,2,1,2,10,8,0,3,14354,112,4506
1100,서울특별시,1125,강동구,,관내사전투표,6874,6874,3522,3123,148,4,40,0,0,1,0,4,0,2,6844,30,0
1100,서울특별시,1125,강동구,,성내제3동제1투,2420,1379,546,758,39,1,16,1,0,1,2,0,0,0,1364,15,1041
1100,서울특별시,1125,강동구,,성내제3동제2투,2675,1673,659,926,47,0,24,0,1,0,1,0,0,1,1659,14,1002
1100,서울특별시,1125,강동구,,성내제3동제3투,3504,2313,911,1267,77,0,14,0,0,0,3,1,0,0,2273,40,1191
1100,서울특별시,1125,강동구,,성내제3동제4투,3499,2227,1002,1106,79,1,18,1,0,0,4,3,0,0,2214,13,1272
1100,서울특별시,1125,강동구,길동,소계,35223,25470,11214,13184,602,16,166,5,2,8,25,22,6,7,25257,213,9753
1100,서울특별시,1125,강동구,,관내사전투표,8649,8648,4510,3894,156,1,32,3,1,2,3,8,0,3,8613,35,1
1100,서울특별시,1125,강동구,,길동제1투,3148,1689,688,914,44,3,14,0,0,1,3,1,0,0,1668,21,1459
1100,서울특별시,1125,강동구,,길동제2투,2388,1535,560,910,31,2,11,1,0,0,2,1,1,0,1519,16,853
1100,서울특별시,1125,강동구,,길동제3투,2904,1933,798,1036,48,3,24,0,0,0,2,3,2,2,1918,15,971
1100,서울특별시,1125,강동구,,길동제4투,3244,1764,712,953,55,0,14,0,0,0,1,5,0,1,1741,23,1480
1100,서울특별시,1125,강동구,,길동제5투,2677,1799,801,922,35,1,15,0,0,2,3,0,0,0,1779,20,878
1100,서울특별시,1125,강동구,,길동제6투,2646,1587,602,890,54,1,13,0,1,0,2,1,1,0,1565,22,1059
1100,서울특별시,1125,강동구,,길동제7투,2738,1814,641,1081,59,2,10,0,0,1,3,1,0,1,1799,15,924
1100,서울특별시,1125,강동구,,길동제8투,1682,1252,506,687,37,0,6,0,0,1,0,2,0,0,1239,13,430
1100,서울특별시,1125,강동구,,길동제9투,2400,1602,595,937,41,1,6,0,0,1,3,0,0,0,1584,18,798
1100,서울특별시,1125,강동구,,길동제10투,2747,1847,801,960,42,2,21,1,0,0,3,0,2,0,1832,15,900
1100,서울특별시,1125,강동구,둔촌제2동,소계,19042,14551,6139,7795,391,10,58,3,2,4,12,9,4,1,14428,123,4491
1100,서울특별시,1125,강동구,,관내사전투표,5372,5372,2650,2538,130,2,15,1,2,0,1,3,0,1,5343,29,0
1100,서울특별시,1125,강동구,,둔촌제2동제1투,3097,1894,795,1010,52,1,8,0,0,1,1,0,1,0,1869,25,1203
1100,서울특별시,1125,강동구,,둔촌제2동제2투,2727,1788,716,978,51,0,13,0,0,2,4,2,0,0,1766,22,939
1100,서울특별시,1125,강동구,,둔촌제2동제3투·둔촌제1동투,3317,2333,894,1330,70,3,7,0,0,0,3,1,1,0,2309,24,984
1100,서울특별시,1125,강동구,,둔촌제2동제4투,1771,1158,429,671,37,2,5,1,0,1,1,2,0,0,1149,9,613
1100,서울특별시,1125,강동구,,둔촌제2동제5투,2758,2006,655,1268,51,2,10,1,0,0,2,1,2,0,1992,14,752
1100,서울특별시,1125,강동구,상일제1동,소계,26247,21348,8207,12333,563,9,68,7,2,7,16,8,2,4,21226,122,4899
1100,서울특별시,1125,강동구,,관내사전투표,7442,7434,3433,3801,149,1,19,3,0,0,3,2,0,1,7412,22,8
1100,서울특별시,1125,강동구,,상일제1동제1투,1413,1014,379,584,34,0,4,0,1,0,3,1,0,0,1006,8,399
1100,서울특별시,1125,강동구,,상일제1동제2투,1642,1041,374,612,25,1,12,1,0,3,1,0,0,0,1029,12,601
1100,서울특별시,1125,강동구,,상일제1동제3투,1916,1322,402,862,35,0,5,0,0,0,1,2,1,1,1309,13,594
1100,서울특별시,1125,강동구,,상일제1동제4투,2575,1789,608,1101,56,2,5,1,0,1,3,0,0,0,1777,12,786
1100,서울특별시,1125,강동구,,상일제1동제5투,2732,2154,726,1348,51,3,7,0,1,1,2,0,0,0,2139,15,578
1100,서울특별시,1125,강동구,,상일제1동제6투,3069,2355,800,1456,77,1,5,1,0,1,1,0,1,1,2344,11,714
1100,서울특별시,1125,강동구,,상일제1동제7투,2833,2182,724,1359,77,0,4,1,0,0,1,0,0,1,2167,15,651
1100,서울특별시,1125,강동구,,상일제1동제8투,2625,2057,761,1210,59,1,7,0,0,1,1,3,0,0,2043,14,568
1100,서울특별시,1125,강동구,상일제2동,소계,7758,6258,3205,2746,188,2,34,2,1,2,3,5,3,3,6194,64,1500
1100,서울특별시,1125,강동구,,관내사전투표,2815,2815,1606,1100,82,0,9,0,1,0,0,0,2,1,2801,14,0
1100,서울특별시,1125,강동구,,상일제2동제1투,1622,1088,501,517,33,1,10,1,0,1,3,2,1,2,1072,16,534
1100,서울특별시,1125,강동구,,상일제2동제2투,1814,1267,577,629,32,0,9,1,0,1,0,1,0,0,1250,17,547
1100,서울특별시,1125,강동구,,상일제2동제3투,1507,1088,521,500,41,1,6,0,0,0,0,2,0,0,1071,17,419
1100,서울특별시,1125,강동구,잘못 투입·구분된 투표지,,0,1,0,1,0,0,0,0,0,0,0,0,0,0,1,0,-12600,부산광역시,2601,중구,합계,,38032,27408,9929,16153,600,9,349,7,5,6,24,21,13,10,27126,282,10624
2600,부산광역시,2601,중구,거소·선상투표,,105,96,29,55,0,0,3,0,0,0,0,1,0,0,88,8,9
2600,부산광역시,2601,중구,관외사전투표,,3639,3638,1571,1866,118,0,44,2,0,0,0,2,0,1,3604,34,1
2600,부산광역시,2601,중구,재외투표,,220,147,80,48,8,0,1,0,0,0,0,0,0,0,137,10,73
2600,부산광역시,2601,중구,중앙동,소계,2498,1621,633,873,63,1,17,1,0,0,3,0,2,1,1594,27,877
2600,부산광역시,2601,중구,,관내사전투표,753,753,329,368,33,1,7,0,0,0,1,0,0,1,740,13,0
2600,부산광역시,2601,중구,,중앙동제1투,848,414,141,250,11,0,3,0,0,0,0,0,1,0,406,8,434
2600,부산광역시,2601,중구,,중앙동제2투,897,454,163,255,19,0,7,1,0,0,2,0,1,0,448,6,443
2600,부산광역시,2601,중구,동광동,소계,2484,1735,639,1001,31,0,28,0,3,0,5,3,1,2,1713,22,749
2600,부산광역시,2601,중구,,관내사전투표,955,955,398,519,17,0,9,0,1,0,0,1,0,1,946,9,0
2600,부산광역시,2601,중구,,동광동제1투,764,367,109,224,8,0,11,0,2,0,4,0,1,1,360,7,397
2600,부산광역시,2601,중구,,동광동제2투,765,413,132,258,6,0,8,0,0,0,1,2,0,0,407,6,352
2600,부산광역시,2601,중구,대청동,소계,5058,3459,1288,1997,79,2,46,2,0,0,2,4,2,1,3423,36,1599
2600,부산광역시,2601,중구,,관내사전투표,1434,1434,613,769,31,0,10,0,0,0,1,1,0,1,1426,8,0
2600,부산광역시,2601,중구,,대청동제1투,1449,817,231,534,21,1,11,1,0,0,1,2,2,0,804,13,632
2600,부산광역시,2601,중구,,대청동제2투,1133,588,198,348,16,1,12,0,0,0,0,1,0,0,576,12,545
2600,부산광역시,2601,중구,,대청동제3투,1042,620,246,346,11,0,13,1,0,0,0,0,0,0,617,3,422
2600,부산광역시,2601,중구,보수동,소계,8427,5803,2003,3528,125,1,87,1,1,0,8,3,3,1,5761,42,2624
2600,부산광역시,2601,중구,,관내사전투표,2339,2339,902,1360,35,0,26,1,1,0,1,1,1,0,2328,11,0
2600,부산광역시,2601,중구,,보수동제1투,1347,792,260,491,21,0,16,0,0,0,0,0,1,0,789,3,555
2600,부산광역시,2601,중구,,보수동제2투,1397,743,239,445,19,1,24,0,0,0,3,1,1,0,733,10,654
2600,부산광역시,2601,중구,,보수동제3투,892,481,151,307,14,0,4,0,0,0,1,0,0,0,477,4,411
2600,부산광역시,2601,중구,,보수동제4투,2452,1448,451,925,36,0,17,0,0,0,3,1,0,1,1434,14,1004
2600,부산광역시,2601,중구,부평동,소계,4273,3082,919,2066,32,0,29,0,0,4,4,3,1,0,3058,24,1191
2600,부산광역시,2601,중구,,관내사전투표,1684,1684,582,1069,14,0,11,0,0,0,0,2,0,0,1678,6,0
2600,부산광역시,2601,중구,,부평동제1투,1071,586,141,416,6,0,11,0,0,2,3,1,0,0,580,6,485
2600,부산광역시,2601,중구,,부평동제2투,1518,812,196,581,12,0,7,0,0,2,1,0,1,0,800,12,706
2600,부산광역시,2601,중구,광복동,소계,1079,838,260,551,6,0,10,0,0,0,1,0,0,0,828,10,241
2600,부산광역시,2601,중구,,관내사전투표,571,571,198,358,5,0,2,0,0,0,1,0,0,0,564,7,0
2600,부산광역시,2601,중구,,광복동투표소,508,267,62,193,1,0,8,0,0,0,0,0,0,0,264,3,241
2600,부산광역시,2601,중구,남포동,소계,844,579,148,406,13,1,8,0,0,0,0,0,0,0,576,3,265
2600,부산광역시,2601,중구,,관내사전투표,300,300,87,201,6,1,4,0,0,0,0,0,0,0,299,1,0
2600,부산광역시,2601,중구,,남포동투표소,544,279,61,205,7,0,4,0,0,0,0,0,0,0,277,2,265
2600,부산광역시,2601,중구,영주제1동,소계,3678,2322,876,1319,52,2,32,1,0,2,1,3,1,3,2292,30,1356
2600,부산광역시,2601,중구,,관내사전투표,918,919,364,518,17,0,7,0,0,1,1,2,0,0,910,9,-1
2600,부산광역시,2601,중구,,영주제1동제1투,945,471,176,259,19,0,9,0,0,0,0,0,0,1,464,7,474
2600,부산광역시,2601,중구,,영주제1동제2투,791,423,156,246,5,2,5,1,0,0,0,0,0,2,417,6,368
2600,부산광역시,2601,중구,,영주제1동제3투,1024,509,180,296,11,0,11,0,0,1,0,1,1,0,501,8,515
2600,부산광역시,2601,중구,영주제2동,소계,5727,4088,1483,2443,73,2,44,0,1,0,0,2,3,1,4052,36,1639
2600,부산광역시,2601,중구,,관내사전투표,1447,1447,609,802,18,1,5,0,0,0,0,1,2,1,1439,8,0
2600,부산광역시,2601,중구,,영주제2동제1투,929,451,133,286,15,0,12,0,0,0,0,0,1,0,447,4,478
2600,부산광역시,2601,중구,,영주제2동제2투,987,532,177,327,6,0,12,0,1,0,0,1,0,0,524,8,455
2600,부산광역시,2601,중구,,영주제2동제3투,1597,1116,395,676,26,0,7,0,0,0,0,0,0,0,1104,12,481
2600,부산광역시,2601,중구,,영주제2동제4투,767,542,169,352,8,1,8,0,0,0,0,0,0,0,538,4,225
2600,부산광역시,2601,중구,잘못 투입·구분된 투표지,,0,0,0,0,0,0,0,0,0,0,0,0,0,0,0,0,0
2600,부산광역시,2602,서구,합계,,94117,69786,25154,41470,1508,40,713,22,13,18,52,72,19,31,69112,674,24331
2600,부산광역시,2602,서구,거소·선상투표,,290,269,84,129,4,0,5,1,0,0,2,2,2,1,230,39,21
2600,부산광역시,2602,서구,관외사전투표,,8850,8846,3679,4719,215,5,115,3,2,2,2,9,2,5,8758,88,4
2600,부산광역시,2602,서구,재외투표,,480,319,173,109,9,0,3,0,0,2,0,0,0,0,296,23,161
2600,부산광역시,2602,서구,동대신제1동,소계,4658,3529,1185,2174,83,1,45,1,0,3,3,3,2,3,3503,26,1129
2600,부산광역시,2602,서구,,관내사전투표,1506,1505,586,864,32,1,10,1,0,0,0,2,0,1,1497,8,1
2600,부산광역시,2602,서구,,동대신제1동제1투,1478,909,215,642,22,0,19,0,0,1,0,1,0,1,901,8,569
2600,부산광역시,2602,서구,,동대신제1동제2투,1674,1115,384,668,29,0,16,0,0,2,3,0,2,1,1105,10,559
2600,부산광역시,2602,서구,동대신제2동,소계,5503,3852,1251,2433,72,5,48,3,0,2,2,6,2,0,3824,28,1651
2600,부산광역시,2602,서구,,관내사전투표,1390,1390,547,792,18,3,17,1,0,0,0,5,0,0,1383,7,0
2600,부산광역시,2602,서구,,동대신제2동제1투,1354,916,201,666,28,0,10,1,0,0,1,0,0,0,907,9,438
2600,부산광역시,2602,서구,,동대신제2동제2투,1433,786,257,498,13,2,10,1,0,0,0,0,0,0,781,5,647
2600,부산광역시,2602,서구,,동대신제2동제3투,1326,760,246,477,13,0,11,0,0,2,1,1,2,0,753,7,566
2600,부산광역시,2602,서구,동대신제3동,소계,6662,5026,1798,3012,111,4,45,1,1,2,4,3,1,0,4982,44,1636
2600,부산광역시,2602,서구,,관내사전투표,2542,2542,1009,1457,45,2,18,0,0,1,1,1,0,0,2534,8,0
2600,부산광역시,2602,서구,,동대신제3동제1투,2287,1361,449,838,39,2,10,0,1,1,0,1,1,0,1342,19,926
2600,부산광역시,2602,서구,,동대신제3동제2투,1833,1123,340,717,27,0,17,1,0,0,3,1,0,0,1106,17,710
2600,부산광역시,2602,서구,서대신제1동,소계,10496,7872,2912,4655,172,2,61,0,1,0,5,8,0,2,7818,54,2624
2600,부산광역시,2602,서구,,관내사전투표,3340,3340,1428,1803,63,1,20,0,0,0,3,2,0,2,3322,18,0
2600,부산광역시,2602,서구,,서대신제1동제1투,2406,1620,548,998,45,0,11,0,1,0,1,1,0,0,1605,15,786
2600,부산광역시,2602,서구,,서대신제1동제2투,1027,559,163,365,7,0,11,0,0,0,0,4,0,0,550,9,468
2600,부산광역시,2602,서구,,서대신제1동제3투,2099,1229,384,792,36,1,11,0,0,0,1,0,0,0,1225,4,870
2600,부산광역시,2602,서구,,서대신제1동제4투,1624,1124,389,697,21,0,8,0,0,0,0,1,0,0,1116,8,500
2600,부산광역시,2602,서구,서대신제3동,소계,5844,4365,1607,2586,94,4,31,2,0,2,5,5,0,1,4337,28,1479
2600,부산광역시,2602,서구,,관내사전투표,2094,2094,892,1152,35,1,4,1,0,0,2,2,0,0,2089,5,0
2600,부산광역시,2602,서구,,서대신제3동제1투,2286,1415,437,916,28,1,15,1,0,1,2,2,0,0,1403,12,871
2600,부산광역시,2602,서구,,서대신제3동제2투,1464,856,278,518,31,2,12,0,0,1,1,1,0,1,845,11,608
2600,부산광역시,2602,서구,서대신제4동,소계,5966,4606,1765,2653,104,1,27,2,1,0,2,5,1,2,4563,43,1360
2600,부산광역시,2602,서구,,관내사전투표,2174,2174,958,1143,47,1,9,1,0,0,0,1,1,0,2161,13,0
2600,부산광역시,2602,서구,,서대신제4동제1투,1244,813,262,509,20,0,3,0,0,0,0,1,0,2,797,16,431
2600,부산광역시,2602,서구,,서대신제4동제2투,2010,1282,442,782,33,0,10,1,1,0,2,1,0,0,1272,10,728
2600,부산광역시,2602,서구,,서대신제4동제3투,538,337,103,219,4,0,5,0,0,0,0,2,0,0,333,4,201
2600,부산광역시,2602,서구,부민동,소계,6115,4490,1669,2584,141,1,43,3,0,0,1,5,0,4,4451,39,1625
2600,부산광역시,2602,서구,,관내사전투표,2112,2112,907,1110,72,0,13,1,0,0,0,1,0,2,2106,6,0
2600,부산광역시,2602,서구,,부민동제1투,2198,1298,418,806,34,1,19,2,0,0,0,2,0,2,1284,14,900
2600,부산광역시,2602,서구,,부민동제2투,1805,1080,344,668,35,0,11,0,0,0,1,2,0,0,1061,19,725
2600,부산광역시,2602,서구,아미동,소계,5541,3498,1157,2167,69,2,48,1,0,1,8,2,0,1,3456,42,2043
2600,부산광역시,2602,서구,,관내사전투표,1164,1164,460,658,15,1,15,0,0,0,2,0,0,1,1152,12,0
2600,부산광역시,2602,서구,,아미동제1투,1191,596,161,395,17,0,13,0,0,1,4,1,0,0,592,4,595
2600,부산광역시,2602,서구,,아미동제2투,1127,587,179,379,17,1,4,0,0,0,0,1,0,0,581,6,540
2600,부산광역시,2602,서구,,아미동제3투,1039,469,135,302,12,0,6,1,0,0,1,0,0,0,457,12,570
2600,부산광역시,2602,서구,,아미동제4투,1020,682,222,433,8,0,10,0,0,0,1,0,0,0,674,8,338
2600,부산광역시,2602,서구,초장동,소계,3518,2303,737,1454,44,1,37,0,0,1,1,4,1,2,2282,21,1215
2600,부산광역시,2602,서구,,관내사전투표,1055,1055,350,662,16,0,13,0,0,0,0,3,1,1,1046,9,0
2600,부산광역시,2602,서구,,초장동제1투,1392,722,221,468,16,0,6,0,0,1,1,0,0,0,713,9,670
2600,부산광역시,2602,서구,,초장동제2투,1071,526,166,324,12,1,18,0,0,0,0,1,0,1,523,3,545
2600,부산광역시,2602,서구,충무동,소계,8495,6002,1953,3813,131,2,43,0,3,0,3,3,1,2,5954,48,2493
2600,부산광역시,2602,서구,,관내사전투표,2979,2979,1083,1795,68,0,11,0,2,0,1,1,0,0,2961,18,0
2600,부산광역시,2602,서구,,충무동제1투,3114,1732,515,1138,40,2,14,0,1,0,0,2,1,2,1715,17,1382
2600,부산광역시,2602,서구,,충무동제2투,2402,1291,355,880,23,0,18,0,0,0,2,0,0,0,1278,13,1111
2600,부산광역시,2602,서구,남부민제1동,소계,4240,2910,917,1871,53,0,27,1,0,1,4,4,2,1,2881,29,1330
2600,부산광역시,2602,서구,,관내사전투표,1271,1271,467,760,16,0,12,1,0,0,2,1,0,1,1260,11,0
2600,부산광역시,2602,서구,,남부민제1동제1투,1847,1043,297,697,24,0,9,0,0,1,2,3,1,0,1034,9,804
2600,부산광역시,2602,서구,,남부민제1동제2투,1122,596,153,414,13,0,6,0,0,0,0,0,1,0,587,9,526
2600,부산광역시,2602,서구,남부민제2동,소계,7419,4981,1757,2986,93,4,67,1,3,0,6,3,2,4,4926,55,2438
2600,부산광역시,2602,서구,,관내사전투표,1814,1814,761,988,30,1,18,0,1,0,1,1,1,0,1802,12,0
2600,부산광역시,2602,서구,,남부민제2동제1투,1958,1071,369,635,29,1,19,1,0,0,1,0,0,3,1058,13,887
2600,부산광역시,2602,서구,,남부민제2동제2투,1152,622,184,401,13,2,10,0,0,0,2,2,0,0,614,8,530
2600,부산광역시,2602,서구,,남부민제2동제3투,1237,756,221,497,13,0,11,0,1,0,2,0,0,0,745,11,481
2600,부산광역시,2602,서구,,남부민제2동제4투,1258,718,222,465,8,0,9,0,1,0,0,0,1,1,707,11,540
2600,부산광역시,2602,서구,암남동,소계,10040,6916,2509,4124,113,8,68,3,2,2,4,10,3,3,6849,67,3124
2600,부산광역시,2602,서구,,관내사전투표,2634,2634,1045,1507,30,3,17,1,0,0,2,7,0,2,2614,20,0
2600,부산광역시,2602,서구,,암남동제1투,1357,692,197,457,18,1,5,0,1,1,1,0,1,0,682,10,665
2600,부산광역시,2602,서구,,암남동제2투,1094,710,286,382,16,2,9,2,0,0,0,1,1,1,700,10,384
2600,부산광역시,2602,서구,,암남동제3투,1106,657,252,374,14,0,9,0,1,0,0,1,0,0,651,6,449
2600,부산광역시,2602,서구,,암남동제4투,2112,1227,414,762,20,0,12,0,0,0,1,0,1,0,1210,17,885
2600,부산광역시,2602,서구,,암남동제5투,1737,996,315,642,15,2,16,0,0,1,0,1,0,0,992,4,741
2600,부산광역시,2602,서구,잘못 투입·구분된 투표지,,0,2,1,1,0,0,0,0,0,0,0,0,0,0,2,0,-2
2600,부산광역시,2603,동구,합계,,80399,59326,21558,35081,1190,28,665,19,8,24,56,64,23,34,58750,576,21073
2600,부산광역시,2603,동구,거소·선상투표,,243,224,74,106,8,0,3,0,0,0,1,0,0,0,192,32,19
2600,부산광역시,2603,동구,관외사전투표,,7096,7095,2989,3727,183,5,101,5,2,2,5,8,1,4,7032,63,1
2600,부산광역시,2603,동구,재외투표,,386,250,137,76,9,0,0,1,0,0,0,1,0,0,224,26,136
2600,부산광역시,2603,동구,초량제1동,소계,3914,2656,1031,1497,59,2,35,0,0,1,5,4,1,0,2635,21,1258
2600,부산광역시,2603,동구,,관내사전투표,1291,1291,549,700,23,1,11,0,0,0,0,2,1,0,1287,4,0
2600,부산광역시,2603,동구,,초량제1동제1투,1731,869,312,494,28,1,17,0,0,0,4,1,0,0,857,12,862
2600,부산광역시,2603,동구,,초량제1동제2투,892,496,170,303,8,0,7,0,0,1,1,1,0,0,491,5,396
2600,부산광역시,2603,동구,초량제2동,소계,4923,3343,1101,2084,69,1,41,1,1,1,3,4,1,1,3308,35,1580
2600,부산광역시,2603,동구,,관내사전투표,1650,1650,576,1003,36,1,14,1,1,0,0,3,0,0,1635,15,0
2600,부산광역시,2603,동구,,초량제2동제1투,1925,956,284,615,22,0,17,0,0,1,2,1,1,0,943,13,969
2600,부산광역시,2603,동구,,초량제2동제2투,1348,737,241,466,11,0,10,0,0,0,1,0,0,1,730,7,611
2600,부산광역시,2603,동구,초량제3동,소계,9862,7115,2826,3982,145,3,75,2,1,4,1,5,1,1,7046,69,2747
2600,부산광역시,2603,동구,,관내사전투표,3209,3209,1430,1678,54,1,21,1,0,2,1,3,1,1,3193,16,0
2600,부산광역시,2603,동구,,초량제3동제1투,2617,1525,570,862,46,0,21,1,1,0,0,2,0,0,1503,22,1092
2600,부산광역시,2603,동구,,초량제3동제2투,1736,1102,405,637,27,2,14,0,0,1,0,0,0,0,1086,16,634
2600,부산광역시,2603,동구,,초량제3동제3투,2300,1279,421,805,18,0,19,0,0,1,0,0,0,0,1264,15,1021
2600,부산광역시,2603,동구,초량제6동,소계,5028,3511,1165,2188,68,1,38,0,0,2,2,4,3,4,3475,36,1517
2600,부산광역시,2603,동구,,관내사전투표,1641,1641,589,993,35,1,8,0,0,1,0,0,1,2,1630,11,0
2600,부산광역시,2603,동구,,초량제6동제1투,1661,895,265,581,14,0,17,0,0,0,2,1,2,1,883,12,766
2600,부산광역시,2603,동구,,초량제6동제2투,1726,975,311,614,19,0,13,0,0,1,0,3,0,1,962,13,751
2600,부산광역시,2603,동구,수정제1동,소계,3783,2821,997,1699,53,3,42,0,0,1,2,3,1,3,2804,17,962
2600,부산광역시,2603,동구,,관내사전투표,1654,1654,626,968,33,2,15,0,0,1,1,2,0,0,1648,6,0
2600,부산광역시,2603,동구,,수정제1동제1투,946,480,154,301,6,0,10,0,0,0,1,0,0,3,475,5,466
2600,부산광역시,2603,동구,,수정제1동제2투,1183,687,217,430,14,1,17,0,0,0,0,1,1,0,681,6,496
2600,부산광역시,2603,동구,수정제2동,소계,8619,6307,2242,3782,142,7,61,1,1,0,4,6,5,6,6257,50,2312
2600,부산광역시,2603,동구,,관내사전투표,3164,3163,1252,1792,75,1,22,0,0,0,0,1,2,2,3147,16,1
2600,부산광역시,2603,동구,,수정제2동제1투,2263,1331,408,866,29,1,14,1,1,0,1,0,1,1,1323,8,932
2600,부산광역시,2603,동구,,수정제2동제2투,1495,773,246,485,10,1,12,0,0,0,2,3,1,1,761,12,722
2600,부산광역시,2603,동구,,수정제2동제3투,1697,1040,336,639,28,4,13,0,0,0,1,2,1,2,1026,14,657
2600,부산광역시,2603,동구,수정제4동,소계,3194,2292,715,1487,35,0,20,2,1,1,5,5,0,1,2272,20,902
2600,부산광역시,2603,동구,,관내사전투표,1126,1126,390,701,17,0,4,0,0,0,2,4,0,1,1119,7,0
2600,부산광역시,2603,동구,,수정제4동제1투,953,486,142,314,10,0,11,2,0,0,0,1,0,0,480,6,467
2600,부산광역시,2603,동구,,수정제4동제2투,1115,680,183,472,8,0,5,0,1,1,3,0,0,0,673,7,435
2600,부산광역시,2603,동구,수정제5동,소계,4489,3250,1140,1970,70,0,33,2,0,0,4,4,1,3,3227,23,1239
2600,부산광역시,2603,동구,,관내사전투표,1717,1717,634,1016,38,0,13,0,0,0,1,0,1,2,1705,12,0
2600,부산광역시,2603,동구,,수정제5동제1투,1274,715,262,425,14,0,6,1,0,0,1,2,0,1,712,3,559
2600,부산광역시,2603,동구,,수정제5동제2투,1498,818,244,529,18,0,14,1,0,0,2,2,0,0,810,8,680
2600,부산광역시,2603,동구,좌천동,소계,9236,6607,2417,3897,132,1,72,1,2,3,4,10,3,2,6544,63,2629
2600,부산광역시,2603,동구,,관내사전투표,2930,2930,1182,1663,43,1,20,0,0,1,1,4,2,0,2917,13,0
2600,부산광역시,2603,동구,,좌천동제1투,2190,1285,440,775,27,0,21,0,1,1,1,3,0,0,1269,16,905
2600,부산광역시,2603,동구,,좌천동제2투,1934,1133,381,693,25,0,14,1,0,1,1,1,1,2,1120,13,801
2600,부산광역시,2603,동구,,좌천동제3투,2182,1259,414,766,37,0,17,0,1,0,1,2,0,0,1238,21,923
2600,부산광역시,2603,동구,범일제1동,소계,9452,6393,2112,4018,96,4,66,4,0,8,8,8,4,5,6333,60,3059
2600,부산광역시,2603,동구,,관내사전투표,2333,2333,834,1433,23,2,15,2,0,2,1,3,2,2,2319,14,0
2600,부산광역시,2603,동구,,범일제1동제1투,3223,2016,679,1245,30,1,25,1,0,3,2,1,0,2,1989,27,1207
2600,부산광역시,2603,동구,,범일제1동제2투,1768,1003,296,653,25,0,12,1,0,0,4,2,1,0,994,9,765
2600,부산광역시,2603,동구,,범일제1동제3투,2128,1041,303,687,18,1,14,0,0,3,1,2,1,1,1031,10,1087
2600,부산광역시,2603,동구,범일제2동,소계,6958,5091,1819,3084,70,0,53,0,0,1,10,1,1,3,5042,49,1867
2600,부산광역시,2603,동구,,관내사전투표,2114,2114,842,1216,28,0,14,0,0,0,2,1,0,1,2104,10,0
2600,부산광역시,2603,동구,,범일제2동제1투,1403,738,222,472,10,0,15,0,0,0,5,0,1,0,725,13,665
2600,부산광역시,2603,동구,,범일제2동제2투,1931,1181,410,717,17,0,15,0,0,1,2,0,0,2,1164,17,750
2600,부산광역시,2603,동구,,범일제2동제3투,1510,1058,345,679,15,0,9,0,0,0,1,0,0,0,1049,9,452
2600,부산광역시,2603,동구,범일제5동,소계,3216,2370,793,1483,51,1,25,0,0,0,2,1,1,1,2358,12,846
2600,부산광역시,2603,동구,,관내사전투표,812,812,315,476,10,1,6,0,0,0,0,0,1,1,810,2,0
2600,부산광역시,2603,동구,,범일제5동제1투,1268,860,253,567,22,0,13,0,0,0,0,0,0,0,855,5,408
2600,부산광역시,2603,동구,,범일제5동제2투,1136,698,225,440,19,0,6,0,0,0,2,1,0,0,693,5,438
2600,부산광역시,2603,동구,잘못 투입·구분된 투표지,,0,1,0,1,0,0,0,0,0,0,0,0,0,0,1,0,-1
2600,부산광역시,2604,영도구,합계,,100073,71696,29565,39058,1368,41,712,26,18,13,55,125,29,36,71046,650,28377
2600,부산광역시,2604,영도구,거소·선상투표,,342,312,106,141,4,5,8,0,1,0,2,0,1,1,269,43,30
2600,부산광역시,2604,영도구,관외사전투표,,7403,7402,3402,3625,166,7,111,3,2,1,2,11,3,6,7339,63,1
2600,부산광역시,2604,영도구,재외투표,,489,341,208,100,13,0,2,0,0,0,1,0,0,0,324,17,148
2600,부산광역시,2604,영도구,남항동,소계,9294,6358,2333,3838,75,4,45,2,2,1,2,8,1,3,6314,44,2936
2600,부산광역시,2604,영도구,,관내사전투표,2895,2895,1173,1655,30,0,15,2,0,0,1,6,0,0,2882,13,0
2600,부산광역시,2604,영도구,,남항동제1투,2056,1160,373,750,12,1,11,0,1,0,0,0,0,0,1148,12,896
2600,부산광역시,2604,영도구,,남항동제2투,1716,976,343,603,12,3,7,0,0,0,0,0,1,1,970,6,740
2600,부산광역시,2604,영도구,,남항동제3투,2627,1327,444,830,21,0,12,0,1,1,1,2,0,2,1314,13,1300
2600,부산광역시,2604,영도구,영선제1동,소계,3347,2337,951,1310,29,3,16,1,1,1,3,4,2,1,2322,15,1010
2600,부산광역시,2604,영도구,,관내사전투표,1299,1299,566,697,13,3,9,0,1,1,1,3,0,0,1294,5,0
2600,부산광역시,2604,영도구,,영선제1동제1투,973,493,188,279,8,0,5,0,0,0,2,1,1,1,485,8,480
2600,부산광역시,2604,영도구,,영선제1동제2투,1075,545,197,334,8,0,2,1,0,0,0,0,1,0,543,2,530
2600,부산광역시,2604,영도구,영선제2동,소계,8228,6248,2473,3573,101,4,38,3,0,1,3,9,1,0,6206,42,1980
2600,부산광역시,2604,영도구,,관내사전투표,3563,3563,1517,1963,44,4,10,1,0,1,1,4,0,0,3545,18,0
2600,부산광역시,2604,영도구,,영선제2동제1투,2082,1193,446,691,25,0,11,0,0,0,0,2,0,0,1175,18,889
2600,부산광역시,2604,영도구,,영선제2동제2투,1685,987,347,604,22,0,10,1,0,0,1,0,0,0,985,2,698
2600,부산광역시,2604,영도구,,영선제2동제3투,898,505,163,315,10,0,7,1,0,0,1,3,1,0,501,4,393
2600,부산광역시,2604,영도구,신선동,소계,6493,4005,1606,2219,73,1,44,0,1,1,9,7,2,3,3966,39,2488
2600,부산광역시,2604,영도구,,관내사전투표,1670,1670,759,864,25,0,10,0,0,0,1,4,0,2,1665,5,0
2600,부산광역시,2604,영도구,,신선동제1투,1330,626,219,368,13,0,9,0,1,0,1,0,1,1,613,13,704
2600,부산광역시,2604,영도구,,신선동제2투,1517,789,287,461,14,0,10,0,0,1,2,2,0,0,777,12,728
2600,부산광역시,2604,영도구,,신선동제3투,1015,535,208,300,8,1,10,0,0,0,2,0,1,0,530,5,480
2600,부산광역시,2604,영도구,,신선동제4투,961,385,133,226,13,0,5,0,0,0,3,1,0,0,381,4,576
2600,부산광역시,2604,영도구,봉래제1동,소계,6042,4424,1705,2563,84,0,31,1,2,0,2,6,2,1,4397,27,1618
2600,부산광역시,2604,영도구,,관내사전투표,2564,2564,1008,1480,38,0,17,1,2,0,1,5,2,1,2555,9,0
2600,부산광역시,2604,영도구,,봉래제1동제1투,1766,1018,380,600,22,0,5,0,0,0,1,0,0,0,1008,10,748
2600,부산광역시,2604,영도구,,봉래제1동제2투,1712,842,317,483,24,0,9,0,0,0,0,1,0,0,834,8,870
2600,부산광역시,2604,영도구,봉래제2동,소계,6188,4330,1849,2278,100,5,45,1,0,0,0,13,0,2,4293,37,1858
2600,부산광역시,2604,영도구,,관내사전투표,1466,1466,687,721,28,2,7,1,0,0,0,10,0,0,1456,10,0
2600,부산광역시,2604,영도구,,봉래제2동제1투,2728,1726,732,904,53,2,17,0,0,0,0,0,0,1,1709,17,1002
2600,부산광역시,2604,영도구,,봉래제2동제2투,1994,1138,430,653,19,1,21,0,0,0,0,3,0,1,1128,10,856
2600,부산광역시,2604,영도구,청학제1동,소계,5104,3433,1434,1847,59,1,44,3,0,0,2,5,3,0,3398,35,1671
2600,부산광역시,2604,영도구,,관내사전투표,1643,1643,772,815,20,1,11,2,0,0,0,5,2,0,1628,15,0
2600,부산광역시,2604,영도구,,청학제1동제1투,2007,1024,381,587,25,0,19,1,0,0,2,0,0,0,1015,9,983
2600,부산광역시,2604,영도구,,청학제1동제2투,1454,766,281,445,14,0,14,0,0,0,0,0,1,0,755,11,688
2600,부산광역시,2604,영도구,청학제2동,소계,13381,9021,3730,4892,186,4,90,3,0,1,7,23,5,4,8945,76,4360
2600,부산광역시,2604,영도구,,관내사전투표,3078,3078,1450,1507,70,1,18,2,0,0,1,9,1,2,3061,17,0
2600,부산광역시,2604,영도구,,청학제2동제1투,2022,1248,494,712,14,0,14,1,0,0,0,2,0,0,1237,11,774
2600,부산광역시,2604,영도구,,청학제2동제2투,1746,1000,350,603,18,0,14,0,0,0,0,1,2,1,989,11,746
2600,부산광역시,2604,영도구,,청학제2동제3투,1959,1014,401,566,26,2,8,0,0,0,2,3,0,0,1008,6,945
2600,부산광역시,2604,영도구,,청학제2동제4투,2392,1395,545,770,35,1,22,0,0,0,3,2,1,1,1380,15,997
2600,부산광역시,2604,영도구,,청학제2동제5투,2184,1286,490,734,23,0,14,0,0,1,1,6,1,0,1270,16,898
2600,부산광역시,2604,영도구,동삼제1동,소계,21770,15116,6440,8037,318,5,140,5,6,2,13,26,4,8,15004,112,6654
2600,부산광역시,2604,영도구,,관내사전투표,6750,6750,3223,3351,96,2,36,2,1,0,1,12,0,1,6725,25,0
2600,부산광역시,2604,영도구,,동삼제1동제1투,1762,977,389,552,13,0,14,0,0,0,0,2,0,0,970,7,785
2600,부산광역시,2604,영도구,,동삼제1동제2투,2034,1042,405,570,35,1,15,2,1,0,2,1,0,0,1032,10,992
2600,부산광역시,2604,영도구,,동삼제1동제3투,2255,1315,493,763,33,0,12,0,0,1,1,0,2,1,1306,9,940
2600,부산광역시,2604,영도구,,동삼제1동제4투,2180,1305,513,722,36,0,12,0,1,0,3,2,1,1,1291,14,875
2600,부산광역시,2604,영도구,,동삼제1동제5투,1841,1020,415,541,35,0,9,1,0,0,1,2,0,1,1005,15,821
2600,부산광역시,2604,영도구,,동삼제1동제6투,1781,1094,418,619,29,0,14,0,0,0,2,1,1,0,1084,10,687
2600,부산광역시,2604,영도구,,동삼제1동제7투,1416,618,201,363,19,0,13,0,2,1,1,4,0,2,606,12,798
2600,부산광역시,2604,영도구,,동삼제1동제8투,1751,995,383,556,22,2,15,0,1,0,2,2,0,2,985,10,756
2600,부산광역시,2604,영도구,동삼제2동,소계,3021,2164,838,1224,43,0,21,1,0,0,2,2,1,1,2133,31,857
2600,부산광역시,2604,영도구,,관내사전투표,1104,1104,471,587,23,0,6,0,0,0,1,1,0,1,1090,14,0
2600,부산광역시,2604,영도구,,동삼제2동투표소,1917,1060,367,637,20,0,15,1,0,0,1,1,1,0,1043,17,857
2600,부산광역시,2604,영도구,동삼제3동,소계,8971,6205,2490,3411,117,2,77,3,3,5,7,11,4,6,6136,69,2766
2600,부산광역시,2604,영도구,,관내사전투표,3122,3122,1426,1577,56,0,25,1,2,2,2,4,1,1,3097,25,0
2600,부산광역시,2604,영도구,,동삼제3동제1투,1371,739,263,428,22,1,11,0,0,1,0,2,1,0,729,10,632
2600,부산광역시,2604,영도구,,동삼제3동제2투,1461,768,266,461,9,1,12,0,0,0,2,1,1,2,755,13,693
2600,부산광역시,2604,영도구,,동삼제3동제3투,1548,715,210,451,15,0,12,1,1,1,2,4,1,2,700,15,833
2600,부산광역시,2604,영도구,,동삼제3동제4투,1469,861,325,494,15,0,17,1,0,1,1,0,0,1,855,6,608
2600,부산광역시,2604,영도구,잘못 투입·구분된 투표지,,0,0,0,0,0,0,0,0,0,0,0,0,0,0,0,0,0
2600,부산광역시,2605,부산진구,합계,,313739,233474,89233,133285,5214,137,2423,59,30,52,216,350,68,97,231164,2310,80265
2600,부산광역시,2605,부산진구,거소·선상투표,,796,723,242,337,16,4,9,1,1,1,1,2,3,1,618,105,73
2600,부산광역시,2605,부산진구,관외사전투표,,26424,26420,11335,13633,728,14,332,7,4,1,16,44,6,13,26133,287,4
2600,부산광역시,2605,부산진구,재외투표,,1114,795,482,205,31,0,5,0,0,0,0,0,0,0,723,72,319
2600,부산광역시,2605,부산진구,부전제1동,소계,14743,10178,3514,6156,244,7,121,2,1,2,10,2,2,5,10066,112,4565
2600,부산광역시,2605,부산진구,,관내사전투표,4746,4746,1822,2747,113,2,28,1,1,1,1,1,1,3,4721,25,0
2600,부산광역시,2605,부산진구,,부전제1동제1투,2434,1106,324,710,30,3,22,1,0,1,0,1,0,1,1093,13,1328
2600,부산광역시,2605,부산진구,,부전제1동제2투,3509,1812,619,1048,50,2,35,0,0,0,5,0,1,0,1760,52,1697
2600,부산광역시,2605,부산진구,,부전제1동제3투,2296,1224,318,838,23,0,29,0,0,0,2,0,0,1,1211,13,1072
2600,부산광역시,2605,부산진구,,부전제1동제4투,1758,1290,431,813,28,0,7,0,0,0,2,0,0,0,1281,9,468
2600,부산광역시,2605,부산진구,부전제2동,소계,8930,6165,2180,3698,121,2,72,4,0,0,8,2,0,3,6090,75,2765
2600,부산광역시,2605,부산진구,,관내사전투표,2366,2366,1024,1219,58,2,27,1,0,0,1,1,0,0,2333,33,0
2600,부산광역시,2605,부산진구,,부전제2동제1투,2603,1387,471,833,28,0,21,1,0,0,1,1,0,3,1359,28,1216
2600,부산광역시,2605,부산진구,,부전제2동제2투,1534,573,185,349,15,0,9,1,0,0,4,0,0,0,563,10,961
2600,부산광역시,2605,부산진구,,부전제2동제3투,2427,1839,500,1297,20,0,15,1,0,0,2,0,0,0,1835,4,588
2600,부산광역시,2605,부산진구,연지동,소계,16003,12249,4437,7354,233,6,92,0,2,6,8,13,5,9,12165,84,3754
2600,부산광역시,2605,부산진구,,관내사전투표,4546,4546,1924,2495,79,2,18,0,0,3,0,5,1,1,4528,18,0
2600,부산광역시,2605,부산진구,,연지동제1투,2467,1844,657,1104,45,1,13,0,0,0,2,1,1,4,1828,16,623
2600,부산광역시,2605,부산진구,,연지동제2투,2553,1677,510,1096,22,1,22,0,1,1,3,1,0,2,1659,18,876
2600,부산광역시,2605,부산진구,,연지동제3투,1511,864,242,586,15,0,9,0,0,2,0,0,1,1,856,8,647
2600,부산광역시,2605,부산진구,,연지동제4투,2399,1592,501,1030,25,2,16,0,1,0,2,1,2,1,1581,11,807
2600,부산광역시,2605,부산진구,,연지동제5투,2527,1726,603,1043,47,0,14,0,0,0,1,5,0,0,1713,13,801
2600,부산광역시,2605,부산진구,초읍동,소계,17835,13249,4507,8256,235,6,123,1,2,3,11,25,6,4,13179,70,4586
2600,부산광역시,2605,부산진구,,관내사전투표,5223,5223,2026,3046,88,2,24,0,1,1,2,5,1,0,5196,27,0
2600,부산광역시,2605,부산진구,,초읍동제1투,2837,1956,675,1195,45,0,25,1,0,0,2,3,1,0,1947,9,881
2600,부산광역시,2605,부산진구,,초읍동제2투,2092,1346,366,922,23,1,20,0,0,1,1,5,0,1,1340,6,746
2600,부산광역시,2605,부산진구,,초읍동제3투,1575,908,240,635,15,0,10,0,0,1,1,2,1,0,905,3,667
2600,부산광역시,2605,부산진구,,초읍동제4투,1863,1174,363,752,26,0,20,0,1,0,1,1,1,1,1166,8,689
2600,부산광역시,2605,부산진구,,초읍동제5투,2403,1451,476,915,26,1,11,0,0,0,1,7,1,1,1439,12,952
2600,부산광역시,2605,부산진구,,초읍동제6투,1842,1191,361,791,12,2,13,0,0,0,3,2,1,1,1186,5,651
2600,부산광역시,2605,부산진구,양정제1동,소계,16664,12649,4719,7404,269,1,111,1,0,5,14,18,1,4,12547,102,4015
2600,부산광역시,2605,부산진구,,관내사전투표,4909,4901,2142,2590,103,0,25,0,0,3,2,9,0,1,4875,26,8
2600,부산광역시,2605,부산진구,,양정제1동제1투,1746,1000,325,626,19,0,16,0,0,0,0,0,0,1,987,13,746
2600,부산광역시,2605,부산진구,,양정제1동제2투,2459,1818,570,1181,36,0,12,0,0,2,4,4,0,1,1810,8,641
2600,부산광역시,2605,부산진구,,양정제1동제3투,2831,2137,727,1317,54,1,14,0,0,0,4,2,0,0,2119,18,694
2600,부산광역시,2605,부산진구,,양정제1동제4투,3011,1819,634,1085,37,0,36,1,0,0,2,3,0,0,1798,21,1192
2600,부산광역시,2605,부산진구,,양정제1동제5투,1708,974,321,605,20,0,8,0,0,0,2,0,1,1,958,16,734
2600,부산광역시,2605,부산진구,양정제2동,소계,8728,5424,1996,3119,133,2,73,2,1,3,9,11,3,3,5355,69,3304
2600,부산광역시,2605,부산진구,,관내사전투표,1481,1480,620,810,29,0,6,0,0,1,0,2,1,1,1470,10,1
2600,부산광역시,2605,부산진구,,양정제2동제1투,2697,1434,524,794,51,2,29,0,0,0,4,5,0,1,1410,24,1263
2600,부산광역시,2605,부산진구,,양정제2동제2투,3206,1829,651,1073,38,0,29,2,1,2,4,4,0,1,1805,24,1377
2600,부산광역시,2605,부산진구,,양정제2동제3투,1344,681,201,442,15,0,9,0,0,0,1,0,2,0,670,11,663
2600,부산광역시,2605,부산진구,전포제1동,소계,17565,12014,4474,6836,350,9,162,5,0,4,14,15,2,2,11873,141,5551
2600,부산광역시,2605,부산진구,,관내사전투표,4841,4841,2077,2528,132,4,38,2,0,0,6,6,2,0,4795,46,0
2600,부산광역시,2605,부산진구,,전포제1동제1투,2700,1272,414,759,40,2,26,1,0,0,3,4,0,0,1249,23,1428
2600,부산광역시,2605,부산진구,,전포제1동제2투,2372,1302,420,804,27,0,30,1,0,0,3,2,0,1,1288,14,1070
2600,부산광역시,2605,부산진구,,전포제1동제3투,2782,1425,512,788,60,2,31,0,0,1,0,1,0,1,1396,29,1357
2600,부산광역시,2605,부산진구,,전포제1동제4투,2262,1296,400,823,33,1,22,0,0,2,2,1,0,0,1284,12,966
2600,부산광역시,2605,부산진구,,전포제1동제5투,2608,1878,651,1134,58,0,15,1,0,1,0,1,0,0,1861,17,730
2600,부산광역시,2605,부산진구,전포제2동,소계,16196,11133,3998,6594,228,8,144,5,5,2,17,13,3,7,11024,109,5063
2600,부산광역시,2605,부산진구,,관내사전투표,3738,3738,1588,2029,58,1,31,0,1,2,3,3,2,3,3721,17,0
2600,부산광역시,2605,부산진구,,전포제2동제1투,2121,1144,354,729,26,2,16,1,1,0,1,0,0,0,1130,14,977
2600,부산광역시,2605,부산진구,,전포제2동제2투,2198,1246,431,742,26,0,27,0,0,0,3,1,0,0,1230,16,952
2600,부산광역시,2605,부산진구,,전포제2동제3투,2526,1709,557,1069,31,1,23,1,3,0,3,6,0,2,1696,13,817
2600,부산광역시,2605,부산진구,,전포제2동제4투,2167,1355,393,877,34,2,18,2,0,0,5,3,0,2,1336,19,812
2600,부산광역시,2605,부산진구,,전포제2동제5투,3446,1941,675,1148,53,2,29,1,0,0,2,0,1,0,1911,30,1505
2600,부산광역시,2605,부산진구,부암제1동,소계,17094,12192,4821,6908,232,3,103,2,0,0,3,12,1,2,12087,105,4902
2600,부산광역시,2605,부산진구,,관내사전투표,4569,4569,2053,2400,70,0,18,1,0,0,0,4,1,0,4547,22,0
2600,부산광역시,2605,부산진구,,부암제1동제1투,1318,681,204,436,10,0,18,0,0,0,0,1,0,0,669,12,637
2600,부산광역시,2605,부산진구,,부암제1동제2투,2394,1640,687,887,35,0,19,1,0,0,0,1,0,0,1630,10,754
2600,부산광역시,2605,부산진구,,부암제1동제3투,1978,1070,381,637,24,1,3,0,0,0,2,1,0,2,1051,19,908
2600,부산광역시,2605,부산진구,,부암제1동제4투,3305,2059,722,1239,51,0,23,0,0,0,0,4,0,0,2039,20,1246
2600,부산광역시,2605,부산진구,,부암제1동제5투,3530,2173,774,1309,42,2,22,0,0,0,1,1,0,0,2151,22,1357
2600,부산광역시,2605,부산진구,부암제3동,소계,14084,10638,4489,5753,179,5,87,4,1,0,9,30,6,3,10566,72,3446
2600,부산광역시,2605,부산진구,,관내사전투표,4706,4706,2205,2367,65,1,26,3,0,0,2,11,3,1,4684,22,0
2600,부산광역시,2605,부산진구,,부암제3동제1투,1900,983,321,602,17,1,18,0,0,0,3,5,1,0,968,15,917
2600,부산광역시,2605,부산진구,,부암제3동제2투,2620,1827,678,1083,29,1,20,0,1,0,0,3,0,0,1815,12,793
2600,부산광역시,2605,부산진구,,부암제3동제3투,1739,1068,337,692,12,0,14,0,0,0,0,7,1,0,1063,5,671
2600,부산광역시,2605,부산진구,,부암제3동제4투,3119,2054,948,1009,56,2,9,1,0,0,4,4,1,2,2036,18,1065
2600,부산광역시,2605,부산진구,당감제1동,소계,18618,13613,5507,7565,257,7,104,3,3,10,13,22,5,6,13502,111,5005
2600,부산광역시,2605,부산진구,,관내사전투표,4924,4924,2233,2551,69,2,25,1,0,1,2,11,1,1,4897,27,0
2600,부산광역시,2605,부산진구,,당감제1동제1투,1964,1155,378,722,20,1,14,0,0,1,1,2,2,1,1142,13,809
2600,부산광역시,2605,부산진구,,당감제1동제2투,2173,1324,411,846,31,1,14,1,0,0,1,3,1,1,1310,14,849
2600,부산광역시,2605,부산진구,,당감제1동제3투,1806,974,317,612,19,0,7,0,0,2,2,1,1,0,961,13,832
2600,부산광역시,2605,부산진구,,당감제1동제4투,3239,1944,771,1080,45,1,17,1,1,1,4,2,0,0,1923,21,1295
2600,부산광역시,2605,부산진구,,당감제1동제5투,2098,1544,653,835,23,2,12,0,0,1,3,1,0,2,1532,12,554
2600,부산광역시,2605,부산진구,,당감제1동제6투,2414,1748,744,919,50,0,15,0,2,4,0,2,0,1,1737,11,666
2600,부산광역시,2605,부산진구,당감제2동,소계,8995,7216,2778,4113,182,3,59,2,1,0,7,13,2,5,7165,51,1779
2600,부산광역시,2605,부산진구,,관내사전투표,3245,3245,1397,1719,81,1,20,1,0,0,2,4,2,4,3231,14,0
2600,부산광역시,2605,부산진구,,당감제2동제1투,2494,1470,478,901,50,0,17,0,1,0,2,3,0,0,1452,18,1024
2600,부산광역시,2605,부산진구,,당감제2동제2투,1450,1119,420,658,19,1,8,0,0,0,0,1,0,0,1107,12,331
2600,부산광역시,2605,부산진구,,당감제2동제3투,1806,1382,483,835,32,1,14,1,0,0,3,5,0,1,1375,7,424
2600,부산광역시,2605,부산진구,당감제4동,소계,9469,6964,3051,3611,145,4,64,1,2,2,8,20,1,1,6910,54,2505
2600,부산광역시,2605,부산진구,,관내사전투표,3388,3388,1625,1662,62,2,15,0,0,1,0,7,0,0,3374,14,0
2600,부산광역시,2605,부산진구,,당감제4동제1투,1178,648,215,398,15,1,8,0,0,0,3,1,0,0,641,7,530
2600,부산광역시,2605,부산진구,,당감제4동제2투,1825,988,364,570,23,0,11,0,0,0,2,3,0,1,974,14,837
2600,부산광역시,2605,부산진구,,당감제4동제3투,3078,1940,847,981,45,1,30,1,2,1,3,9,1,0,1921,19,1138
2600,부산광역시,2605,부산진구,가야제1동,소계,15917,10954,3988,6406,253,8,120,4,0,1,10,16,3,11,10820,134,4963
2600,부산광역시,2605,부산진구,,관내사전투표,4525,4525,1852,2516,79,2,34,0,0,0,2,6,0,6,4497,28,0
2600,부산광역시,2605,부산진구,,가야제1동제1투,2149,1323,426,803,47,2,18,1,0,1,4,2,2,1,1307,16,826
2600,부산광역시,2605,부산진구,,가야제1동제2투,2230,1234,429,732,24,2,15,0,0,0,1,4,0,1,1208,26,996
2600,부산광역시,2605,부산진구,,가야제1동제3투,2088,1198,412,709,40,0,8,1,0,0,0,1,1,0,1172,26,890
2600,부산광역시,2605,부산진구,,가야제1동제4투,1718,977,325,607,14,1,15,1,0,0,2,1,0,1,967,10,741
2600,부산광역시,2605,부산진구,,가야제1동제5투,1726,944,316,569,22,0,18,1,0,0,1,2,0,0,929,15,782
2600,부산광역시,2605,부산진구,,가야제1동제6투,1481,753,228,470,27,1,12,0,0,0,0,0,0,2,740,13,728
2600,부산광역시,2605,부산진구,가야제2동,소계,13285,9893,3490,6003,198,9,90,1,1,2,6,12,3,3,9818,75,3392
2600,부산광역시,2605,부산진구,,관내사전투표,4165,4165,1688,2361,64,0,25,0,1,1,1,8,1,0,4150,15,0
2600,부산광역시,2605,부산진구,,가야제2동제1투,2324,1415,494,852,36,4,16,0,0,0,0,0,0,1,1403,12,909
2600,부산광역시,2605,부산진구,,가야제2동제2투,2224,1368,403,905,28,0,12,0,0,0,2,1,1,1,1353,15,856
2600,부산광역시,2605,부산진구,,가야제2동제3투,1995,1218,368,785,23,3,16,0,0,0,2,2,1,1,1201,17,777
2600,부산광역시,2605,부산진구,,가야제2동제4투,2577,1727,537,1100,47,2,21,1,0,1,1,1,0,0,1711,16,850
2600,부산광역시,2605,부산진구,개금제1동,소계,13753,9731,3686,5500,275,4,117,6,3,0,8,16,4,5,9624,107,4022
2600,부산광역시,2605,부산진구,,관내사전투표,4229,4227,1805,2243,98,2,27,3,2,0,1,5,4,3,4193,34,2
2600,부산광역시,2605,부산진구,,개금제1동제1투,3602,2101,776,1191,68,1,30,1,0,0,3,3,0,1,2074,27,1501
2600,부산광역시,2605,부산진구,,개금제1동제2투,3308,1891,622,1139,68,0,28,1,0,0,3,5,0,0,1866,25,1417
2600,부산광역시,2605,부산진구,,개금제1동제3투,2614,1512,483,927,41,1,32,1,1,0,1,3,0,1,1491,21,1102
2600,부산광역시,2605,부산진구,개금제2동,소계,9121,6777,2507,3954,157,6,65,1,0,3,6,10,5,0,6714,63,2344
2600,부산광역시,2605,부산진구,,관내사전투표,3165,3165,1302,1741,65,3,24,0,0,1,1,2,2,0,3141,24,0
2600,부산광역시,2605,부산진구,,개금제2동제1투,1899,1048,375,606,31,1,16,1,0,2,3,3,2,0,1040,8,851
2600,부산광역시,2605,부산진구,,개금제2동제2투,1757,983,297,629,23,1,15,0,0,0,1,4,1,0,971,12,774
2600,부산광역시,2605,부산진구,,개금제2동제3투,2300,1581,533,978,38,1,10,0,0,0,1,1,0,0,1562,19,719
2600,부산광역시,2605,부산진구,개금제3동,소계,22476,16787,6468,9574,362,14,154,4,2,4,19,34,1,4,16640,147,5689
2600,부산광역시,2605,부산진구,,관내사전투표,5352,5352,2345,2843,84,4,29,1,0,0,3,8,1,0,5318,34,0
2600,부산광역시,2605,부산진구,,개금제3동제1투,1731,1000,338,598,24,3,19,0,0,0,4,2,0,0,988,12,731
2600,부산광역시,2605,부산진구,,개금제3동제2투,2202,1342,480,794,34,0,14,0,0,0,1,1,0,2,1326,16,860
2600,부산광역시,2605,부산진구,,개금제3동제3투,2523,1673,647,934,43,2,13,1,0,1,3,8,0,0,1652,21,850
2600,부산광역시,2605,부산진구,,개금제3동제4투,2516,1878,687,1112,49,1,17,2,0,2,1,0,0,0,1871,7,638
2600,부산광역시,2605,부산진구,,개금제3동제5투,1808,1114,411,636,24,0,12,0,1,0,4,6,0,1,1095,19,694
2600,부산광역시,2605,부산진구,,개금제3동제6투,2110,1352,482,803,28,4,21,0,0,0,1,2,0,1,1342,10,758
2600,부산광역시,2605,부산진구,,개금제3동제7투,2178,1561,530,961,37,0,14,0,0,0,0,3,0,0,1545,16,617
2600,부산광역시,2605,부산진구,,개금제3동제8투,2056,1515,548,893,39,0,15,0,1,1,2,4,0,0,1503,12,541
2600,부산광역시,2605,부산진구,범천제1동,소계,10175,6728,2466,3942,152,5,75,1,1,2,5,10,2,1,6662,66,3447
2600,부산광역시,2605,부산진구,,관내사전투표,3037,3037,1315,1616,57,3,18,1,1,1,2,4,1,0,3019,18,0
2600,부산광역시,2605,부산진구,,범천제1동제1투,3245,1807,552,1165,43,1,27,0,0,0,2,1,0,1,1792,15,1438
2600,부산광역시,2605,부산진구,,범천제1동제2투,3893,1884,599,1161,52,1,30,0,0,1,1,5,1,0,1851,33,2009
2600,부산광역시,2605,부산진구,범천제2동,소계,15754,10972,4092,6360,234,10,141,2,0,1,14,10,4,5,10873,99,4782
2600,부산광역시,2605,부산진구,,관내사전투표,4092,4092,1701,2259,65,6,38,1,0,0,1,2,2,3,4078,14,0
2600,부산광역시,2605,부산진구,,범천제2동제1투,2704,1527,584,850,41,1,21,1,0,1,1,1,1,0,1502,25,1177
2600,부산광역시,2605,부산진구,,범천제2동제2투,2330,1265,491,691,39,0,28,0,0,0,1,2,0,1,1253,12,1065
2600,부산광역시,2605,부산진구,,범천제2동제3투,1274,677,180,460,12,1,9,0,0,0,4,0,1,0,667,10,597
2600,부산광역시,2605,부산진구,,범천제2동제4투,1644,941,291,596,22,0,15,0,0,0,4,1,0,0,929,12,703
2600,부산광역시,2605,부산진구,,범천제2동제5투,1230,787,242,518,12,1,10,0,0,0,1,0,0,0,784,3,443
2600,부산광역시,2605,부산진구,,범천제2동제6투,2480,1683,603,986,43,1,20,0,0,0,2,4,0,1,1660,23,797
2600,부산광역시,2605,부산진구,잘못 투입·구분된 투표지,,0,10,6,4,0,0,0,0,0,0,0,0,0,0,10,0,-10
2600,부산광역시,2606,동래구,합계,,232079,179768,65261,106515,4035,73,1683,41,28,47,147,245,31,68,178174,1594,52311
2600,부산광역시,2606,동래구,거소·선상투표,,639,594,203,296,9,1,16,0,1,0,1,0,0,1,528,66,45
2600,부산광역시,2606,동래구,관외사전투표,,22286,22283,9320,11869,562,8,248,7,2,4,11,31,2,8,22072,211,3
2600,부산광역시,2606,동래구,재외투표,,1105,819,424,299,17,1,2,2,0,0,0,0,0,0,745,74,286
2600,부산광역시,2606,동래구,수민동,소계,23627,17719,6400,10529,416,8,166,4,2,5,23,25,4,10,17592,127,5908
2600,부산광역시,2606,동래구,,관내사전투표,5869,5869,2498,3176,114,3,38,1,1,2,1,8,1,3,5846,23,0
2600,부산광역시,2606,동래구,,수민동제1투,2039,1198,374,766,29,0,18,0,0,1,2,1,0,0,1191,7,841
2600,부산광역시,2606,동래구,,수민동제2투,3498,2338,789,1424,65,1,28,1,0,0,4,5,0,1,2318,20,1160
2600,부산광역시,2606,동래구,,수민동제3투,2652,1645,512,1053,35,4,25,1,0,0,4,1,0,1,1636,9,1007
2600,부산광역시,2606,동래구,,수민동제4투,3000,2046,725,1220,59,0,15,0,1,1,0,1,2,1,2025,21,954
2600,부산광역시,2606,동래구,,수민동제5투,1677,1198,321,807,29,0,14,0,0,0,6,5,1,2,1185,13,479
2600,부산광역시,2606,동래구,,수민동제6투,2638,1829,661,1079,42,0,17,0,0,0,3,3,0,1,1806,23,809
2600,부산광역시,2606,동래구,,수민동제7투,2254,1596,520,1004,43,0,11,1,0,1,3,1,0,1,1585,11,658
2600,부산광역시,2606,동래구,복산동,소계,8661,6610,2038,4313,128,6,58,2,0,0,7,4,4,3,6563,47,2051
2600,부산광역시,2606,동래구,,관내사전투표,3362,3362,1179,2069,65,3,18,1,0,0,1,3,2,0,3341,21,0
2600,부산광역시,2606,동래구,,복산동제1투,2849,1797,424,1294,41,0,20,0,0,0,1,1,1,1,1783,14,1052
2600,부산광역시,2606,동래구,,복산동제2투,2450,1451,435,950,22,3,20,1,0,0,5,0,1,2,1439,12,999
2600,부산광역시,2606,동래구,명륜동,소계,17880,13971,5076,8369,291,2,96,1,3,3,7,16,2,1,13867,104,3909
2600,부산광역시,2606,동래구,,관내사전투표,5845,5845,2460,3201,116,1,27,0,0,1,0,10,1,1,5818,27,0
2600,부산광역시,2606,동래구,,명륜동제1투,2997,1711,510,1110,41,0,25,0,0,1,2,0,0,0,1689,22,1286
2600,부산광역시,2606,동래구,,명륜동제2투,1885,1278,412,812,30,0,8,0,1,0,1,2,0,0,1266,12,607
2600,부산광역시,2606,동래구,,명륜동제3투,1942,1279,339,895,25,1,9,0,0,0,0,1,0,0,1270,9,663
2600,부산광역시,2606,동래구,,명륜동제4투,2029,1383,441,886,22,0,18,0,1,0,3,1,1,0,1373,10,646
2600,부산광역시,2606,동래구,,명륜동제5투,3182,2475,914,1465,57,0,9,1,1,1,1,2,0,0,2451,24,707
2600,부산광역시,2606,동래구,온천제1동,소계,16981,11807,4056,7182,287,4,127,0,1,2,8,16,1,1,11685,122,5174
2600,부산광역시,2606,동래구,,관내사전투표,4262,4262,1692,2427,79,3,30,0,0,0,1,7,0,1,4240,22,0
2600,부산광역시,2606,동래구,,온천제1동제1투,3029,1874,515,1269,38,0,26,0,0,0,2,4,0,0,1854,20,1155
2600,부산광역시,2606,동래구,,온천제1동제2투,2334,1238,361,821,34,0,8,0,0,1,0,0,0,0,1225,13,1096
2600,부산광역시,2606,동래구,,온천제1동제3투,2689,1527,508,929,39,1,27,0,0,0,1,1,0,0,1506,21,1162
2600,부산광역시,2606,동래구,,온천제1동제4투,3061,1897,640,1132,64,0,21,0,1,0,4,3,1,0,1866,31,1164
2600,부산광역시,2606,동래구,,온천제1동제5투,1606,1009,340,604,33,0,15,0,0,1,0,1,0,0,994,15,597
2600,부산광역시,2606,동래구,온천제2동,소계,16123,12690,4087,8109,276,6,94,1,2,6,6,16,0,5,12608,82,3433
2600,부산광역시,2606,동래구,,관내사전투표,5053,5053,1907,2993,98,3,17,1,0,3,2,6,0,3,5033,20,0
2600,부산광역시,2606,동래구,,온천제2동제1투,1788,1110,372,687,22,1,14,0,1,0,0,5,0,1,1103,7,678
2600,부산광역시,2606,동래구,,온천제2동제2투,2539,1744,496,1179,32,0,16,0,0,1,1,1,0,0,1726,18,795
2600,부산광역시,2606,동래구,,온천제2동제3투,2498,1817,379,1376,32,1,9,0,1,2,0,0,0,0,1800,17,681
2600,부산광역시,2606,동래구,,온천제2동제4투,1420,1094,366,666,46,0,7,0,0,0,0,0,0,1,1086,8,326
2600,부산광역시,2606,동래구,,온천제2동제5투,1660,1054,306,704,18,1,18,0,0,0,0,2,0,0,1049,5,606
2600,부산광역시,2606,동래구,,온천제2동제6투,1165,818,261,504,28,0,13,0,0,0,3,2,0,0,811,7,347
2600,부산광역시,2606,동래구,온천제3동,소계,26928,18481,6510,11109,409,5,201,4,5,6,15,36,0,7,18307,174,8447
2600,부산광역시,2606,동래구,,관내사전투표,4194,4195,1720,2330,86,0,27,0,0,0,1,6,0,3,4173,22,-1
2600,부산광역시,2606,동래구,,온천제3동제1투,3368,2051,750,1194,54,1,24,0,0,0,4,8,0,0,2035,16,1317
2600,부산광역시,2606,동래구,,온천제3동제2투,3115,1998,663,1235,41,0,31,0,1,3,1,2,0,2,1979,19,1117
2600,부산광역시,2606,동래구,,온천제3동제3투,3735,2182,701,1390,39,1,21,1,1,0,0,4,0,1,2159,23,1553
2600,부산광역시,2606,동래구,,온천제3동제4투,3161,2017,693,1214,47,1,30,0,1,1,3,1,0,1,1992,25,1144
2600,부산광역시,2606,동래구,,온천제3동제5투,2895,1750,572,1062,46,1,27,3,0,1,4,6,0,0,1722,28,1145
2600,부산광역시,2606,동래구,,온천제3동제6투,2832,1887,575,1204,55,0,21,0,2,1,0,6,0,0,1864,23,945
2600,부산광역시,2606,동래구,,온천제3동제7투,3628,2401,836,1480,41,1,20,0,0,0,2,3,0,0,2383,18,1227
2600,부산광역시,2606,동래구,사직제1동,소계,9046,7052,2461,4264,169,1,76,2,1,1,3,3,1,2,6984,68,1994
2600,부산광역시,2606,동래구,,관내사전투표,3676,3676,1434,2114,75,1,26,0,0,0,0,2,1,1,3654,22,0
2600,부산광역시,2606,동래구,,사직제1동제1투,2799,1684,462,1113,49,0,30,0,0,1,1,1,0,0,1657,27,1115
2600,부산광역시,2606,동래구,,사직제1동제2투,2571,1692,565,1037,45,0,20,2,1,0,2,0,0,1,1673,19,879
2600,부산광역시,2606,동래구,사직제2동,소계,19045,15058,6173,8320,338,7,96,3,0,1,9,17,0,7,14971,87,3987
2600,부산광역시,2606,동래구,,관내사전투표,5952,5952,2822,2965,107,4,20,2,0,0,2,8,0,1,5931,21,0
2600,부산광역시,2606,동래구,,사직제2동제1투,1822,1345,504,779,31,0,10,0,0,0,0,1,0,2,1327,18,477
2600,부산광역시,2606,동래구,,사직제2동제2투,2599,1643,633,930,49,1,20,0,0,0,2,2,0,1,1638,5,956
2600,부산광역시,2606,동래구,,사직제2동제3투,2011,1415,505,858,35,0,5,0,0,0,1,1,0,1,1406,9,596
2600,부산광역시,2606,동래구,,사직제2동제4투,2162,1522,553,908,31,1,13,0,0,1,1,1,0,1,1510,12,640
2600,부산광역시,2606,동래구,,사직제2동제5투,2112,1404,483,848,34,1,16,0,0,0,2,4,0,1,1389,15,708
2600,부산광역시,2606,동래구,,사직제2동제6투,2387,1777,673,1032,51,0,12,1,0,0,1,0,0,0,1770,7,610
2600,부산광역시,2606,동래구,사직제3동,소계,13652,10355,3783,6114,235,2,95,3,2,2,9,14,5,4,10268,87,3297
2600,부산광역시,2606,동래구,,관내사전투표,4432,4431,1859,2419,92,2,26,2,0,1,3,5,1,1,4411,20,1
2600,부산광역시,2606,동래구,,사직제3동제1투,1915,1074,356,655,24,0,22,0,0,0,1,1,3,1,1063,11,841
2600,부산광역시,2606,동래구,,사직제3동제2투,3080,2087,715,1264,64,0,14,0,1,0,0,5,0,1,2064,23,993
2600,부산광역시,2606,동래구,,사직제3동제3투,1982,1315,389,855,27,0,20,0,1,0,4,1,0,0,1297,18,667
2600,부산광역시,2606,동래구,,사직제3동제4투,2243,1448,464,921,28,0,13,1,0,1,1,2,1,1,1433,15,795
2600,부산광역시,2606,동래구,안락제1동,소계,12609,9496,3217,5881,187,7,98,2,1,5,11,14,4,6,9433,63,3113
2600,부산광역시,2606,동래구,,관내사전투표,3804,3804,1556,2114,61,2,30,1,1,0,4,6,2,2,3779,25,0
2600,부산광역시,2606,동래구,,안락제1동제1투,2443,1725,439,1216,37,2,20,0,0,0,0,2,0,0,1716,9,718
2600,부산광역시,2606,동래구,,안락제1동제2투,2124,1481,514,898,42,0,9,1,0,3,4,2,0,2,1475,6,643
2600,부산광역시,2606,동래구,,안락제1동제3투,2155,1246,357,820,23,2,25,0,0,2,1,2,1,1,1234,12,909
2600,부산광역시,2606,동래구,,안락제1동제4투,2083,1240,351,833,24,1,14,0,0,0,2,2,1,1,1229,11,843
2600,부산광역시,2606,동래구,안락제2동,소계,20360,15601,5618,9246,400,6,134,4,4,7,19,20,3,4,15465,136,4759
2600,부산광역시,2606,동래구,,관내사전투표,4737,4737,1963,2607,93,3,24,4,0,0,8,7,0,3,4712,25,0
2600,부산광역시,2606,동래구,,안락제2동제1투,1845,1107,349,714,25,0,7,0,0,0,2,0,0,0,1097,10,738
2600,부산광역시,2606,동래구,,안락제2동제2투,1484,906,273,580,22,0,12,0,0,1,2,2,1,0,893,13,578
2600,부산광역시,2606,동래구,,안락제2동제3투,2954,2203,642,1464,50,1,19,0,0,0,3,4,0,0,2183,20,751
2600,부산광역시,2606,동래구,,안락제2동제4투,1944,1503,528,885,57,0,11,0,0,2,1,2,1,0,1487,16,441
2600,부산광역시,2606,동래구,,안락제2동제5투,1959,1284,387,822,31,1,16,0,0,3,3,2,0,0,1265,19,675
2600,부산광역시,2606,동래구,,안락제2동제6투,2557,1681,580,1005,49,1,21,0,2,1,0,1,1,0,1661,20,876
2600,부산광역시,2606,동래구,,안락제2동제7투,2880,2180,896,1169,73,0,24,0,2,0,0,2,0,1,2167,13,700
2600,부산광역시,2606,동래구,명장제1동,소계,11482,8744,2987,5374,169,5,93,1,2,2,11,16,3,4,8667,77,2738
2600,부산광역시,2606,동래구,,관내사전투표,3704,3703,1431,2166,48,2,17,1,0,0,2,7,1,2,3677,26,1
2600,부산광역시,2606,동래구,,명장제1동제1투,1896,1079,298,709,29,0,18,0,0,1,1,3,1,0,1060,19,817
2600,부산광역시,2606,동래구,,명장제1동제2투,1834,1168,344,771,22,2,12,0,0,0,1,2,1,2,1157,11,666
2600,부산광역시,2606,동래구,,명장제1동제3투,1515,1047,285,705,21,1,13,0,2,1,7,2,0,0,1037,10,468
2600,부산광역시,2606,동래구,,명장제1동제4투,2533,1747,629,1023,49,0,33,0,0,0,0,2,0,0,1736,11,786
2600,부산광역시,2606,동래구,명장제2동,소계,11655,8483,2906,5238,142,4,83,5,2,3,7,17,2,5,8414,69,3172
2600,부산광역시,2606,동래구,,관내사전투표,3353,3353,1311,1942,47,4,17,2,2,1,0,7,1,0,3334,19,0
2600,부산광역시,2606,동래구,,명장제2동제1투,2440,1531,481,973,26,0,24,0,0,0,5,3,1,2,1515,16,909
2600,부산광역시,2606,동래구,,명장제2동제2투,1730,1045,312,685,18,0,9,1,0,2,1,6,0,1,1035,10,685
2600,부산광역시,2606,동래구,,명장제2동제3투,1828,1130,329,749,17,0,18,2,0,0,1,0,0,1,1117,13,698
2600,부산광역시,2606,동래구,,명장제2동제4투,2304,1424,473,889,34,0,15,0,0,0,0,1,0,1,1413,11,880
2600,부산광역시,2606,동래구,잘못 투입·구분된 투표지,,0,5,2,3,0,0,0,0,0,0,0,0,0,0,5,0,-5
2600,부산광역시,2607,남구,합계,,227098,173557,64361,101749,3652,64,1515,43,23,43,156,251,46,53,171956,1601,53541
2600,부산광역시,2607,남구,거소·선상투표,,682,632,199,314,15,1,16,1,0,0,2,0,1,0,549,83,50
2600,부산광역시,2607,남구,관외사전투표,,19321,19318,8083,10239,488,12,243,4,5,1,8,25,4,6,19118,200,3
2600,부산광역시,2607,남구,재외투표,,1104,784,444,247,17,0,3,0,0,0,0,1,0,0,712,72,320
2600,부산광역시,2607,남구,대연제1동,소계,13558,9343,3366,5528,206,4,88,2,1,3,18,5,5,7,9233,110,4215
2600,부산광역시,2607,남구,,관내사전투표,4242,4241,1682,2405,87,0,25,0,0,0,5,2,3,0,4209,32,1
2600,부산광역시,2607,남구,,대연제1동제1투,2928,1579,509,965,51,2,19,1,1,1,3,1,1,1,1555,24,1349
2600,부산광역시,2607,남구,,대연제1동제2투,3138,1718,598,1029,34,1,18,0,0,1,3,1,0,4,1689,29,1420
2600,부산광역시,2607,남구,,대연제1동제3투,3250,1805,577,1129,34,1,26,1,0,1,7,1,1,2,1780,25,1445
2600,부산광역시,2607,남구,대연제3동,소계,23510,17257,6634,9872,427,15,91,3,1,5,10,18,1,5,17082,175,6253
2600,부산광역시,2607,남구,,관내사전투표,5716,5716,2522,3001,122,9,17,1,0,0,1,5,1,3,5682,34,0
2600,부산광역시,2607,남구,,대연제3동제1투,2023,1201,367,744,43,1,13,1,0,0,4,1,0,0,1174,27,822
2600,부산광역시,2607,남구,,대연제3동제2투,2784,1919,708,1126,48,0,15,0,0,2,1,2,0,0,1902,17,865
2600,부산광역시,2607,남구,,대연제3동제3투,2800,1551,515,937,41,2,19,0,0,1,1,1,0,0,1517,34,1249
2600,부산광역시,2607,남구,,대연제3동제4투,2796,1809,624,1100,41,2,10,0,0,1,1,6,0,1,1786,23,987
2600,부산광역시,2607,남구,,대연제3동제5투,2683,1892,734,1099,31,0,10,0,0,1,1,1,0,0,1877,15,791
2600,부산광역시,2607,남구,,대연제3동제6투,2397,1660,667,921,48,0,2,1,0,0,1,2,0,1,1643,17,737
2600,부산광역시,2607,남구,,대연제3동제7투,2311,1509,497,944,53,1,5,0,1,0,0,0,0,0,1501,8,802
2600,부산광역시,2607,남구,대연제4동,소계,9958,7553,2812,4424,157,4,67,2,1,0,9,12,1,2,7491,62,2405
2600,부산광역시,2607,남구,,관내사전투표,3221,3221,1319,1805,52,3,15,1,1,0,2,6,0,1,3205,16,0
2600,부산광역시,2607,남구,,대연제4동제1투,1494,967,302,627,19,1,7,0,0,0,4,1,0,0,961,6,527
2600,부산광역시,2607,남구,,대연제4동제2투,1492,782,238,493,23,0,15,0,0,0,1,0,1,1,772,10,710
2600,부산광역시,2607,남구,,대연제4동제3투,1740,1099,360,669,23,0,22,1,0,0,1,3,0,0,1079,20,641
2600,부산광역시,2607,남구,,대연제4동제4투,2011,1484,593,830,40,0,8,0,0,0,1,2,0,0,1474,10,527
2600,부산광역시,2607,남구,대연제5동,소계,13463,9889,3662,5759,241,6,76,4,0,3,9,13,1,3,9777,112,3574
2600,부산광역시,2607,남구,,관내사전투표,4145,4145,1768,2225,85,2,17,1,0,1,2,4,1,2,4108,37,0
2600,부산광역시,2607,남구,,대연제5동제1투,2416,1496,478,919,47,1,18,1,0,0,3,2,0,0,1469,27,920
2600,부산광역시,2607,남구,,대연제5동제2투,2562,1419,441,898,37,1,12,2,0,1,2,3,0,1,1398,21,1143
2600,부산광역시,2607,남구,,대연제5동제3투,2195,1308,465,778,24,1,20,0,0,1,1,1,0,0,1291,17,887
2600,부산광역시,2607,남구,,대연제5동제4투,2145,1521,510,939,48,1,9,0,0,0,1,3,0,0,1511,10,624
2600,부산광역시,2607,남구,대연제6동,소계,12534,10090,3789,5932,217,3,55,0,1,2,11,9,0,2,10021,69,2444
2600,부산광역시,2607,남구,,관내사전투표,4942,4942,2042,2750,96,2,19,0,1,1,1,5,0,1,4918,24,0
2600,부산광역시,2607,남구,,대연제6동제1투,1883,1122,341,727,29,0,8,0,0,1,1,2,0,0,1109,13,761
2600,부산광역시,2607,남구,,대연제6동제2투,1717,1106,392,655,28,0,18,0,0,0,1,0,0,1,1095,11,611
2600,부산광역시,2607,남구,,대연제6동제3투,2255,1653,591,1000,40,1,7,0,0,0,3,2,0,0,1644,9,602
2600,부산광역시,2607,남구,,대연제6동제4투,1737,1267,423,800,24,0,3,0,0,0,5,0,0,0,1255,12,470
2600,부산광역시,2607,남구,용호제1동,소계,29227,21710,6796,14144,403,1,139,3,5,7,15,22,8,5,21548,162,7517
2600,부산광역시,2607,남구,,관내사전투표,4349,4349,1753,2473,56,1,29,0,1,1,1,8,5,2,4330,19,0
2600,부산광역시,2607,남구,,용호제1동제1투,1970,1024,291,677,27,0,15,0,0,0,2,3,0,0,1015,9,946
2600,부산광역시,2607,남구,,용호제1동제2투,2063,1202,349,795,22,0,18,0,0,0,2,1,1,0,1188,14,861
2600,부산광역시,2607,남구,,용호제1동제3투,2106,1213,358,787,25,0,17,0,0,1,0,3,1,1,1193,20,893
2600,부산광역시,2607,남구,,용호제1동제4투,2898,2090,847,1123,66,0,18,2,2,0,3,2,0,1,2064,26,808
2600,부산광역시,2607,남구,,용호제1동제5투,3010,2129,677,1364,49,0,12,0,1,2,2,3,0,0,2110,19,881
2600,부산광역시,2607,남구,,용호제1동제6투,2941,2112,587,1465,38,0,8,0,0,1,1,0,0,0,2100,12,829
2600,부산광역시,2607,남구,,용호제1동제7투,3064,2264,600,1596,42,0,9,1,0,1,0,2,0,1,2252,12,800
2600,부산광역시,2607,남구,,용호제1동제8투,2146,1552,519,975,32,0,6,0,1,0,0,0,1,0,1534,18,594
2600,부산광역시,2607,남구,,용호제1동제9투,2114,1714,396,1285,19,0,4,0,0,1,3,0,0,0,1708,6,400
2600,부산광역시,2607,남구,,용호제1동제10투,2566,2061,419,1604,27,0,3,0,0,0,1,0,0,0,2054,7,505
2600,부산광역시,2607,남구,용호제2동,소계,12432,9407,3319,5751,165,5,82,2,1,3,7,13,2,3,9353,54,3025
2600,부산광역시,2607,남구,,관내사전투표,3156,3156,1277,1773,50,3,25,1,0,0,2,6,0,2,3139,17,0
2600,부산광역시,2607,남구,,용호제2동제1투,1392,822,237,541,19,0,10,1,1,0,1,0,0,0,810,12,570
2600,부산광역시,2607,남구,,용호제2동제2투,1120,617,160,437,7,1,10,0,0,0,0,1,0,0,616,1,503
2600,부산광역시,2607,남구,,용호제2동제3투,1995,1245,451,747,22,1,8,0,0,2,3,1,1,1,1237,8,750
2600,부산광역시,2607,남구,,용호제2동제4투,2014,1509,525,923,37,0,13,0,0,0,0,4,0,0,1502,7,505
2600,부산광역시,2607,남구,,용호제2동제5투,2755,2058,669,1330,30,0,16,0,0,1,1,1,1,0,2049,9,697
2600,부산광역시,2607,남구,용호제3동,소계,13793,10902,4018,6529,177,0,74,3,0,3,5,13,4,5,10831,71,2891
2600,부산광역시,2607,남구,,관내사전투표,6504,6503,2612,3746,88,0,19,1,0,1,2,10,1,1,6481,22,1
2600,부산광역시,2607,남구,,용호제3동제1투,1850,1135,375,716,21,0,6,0,0,1,1,1,0,1,1122,13,715
2600,부산광역시,2607,남구,,용호제3동제2투,1585,948,293,610,21,0,8,1,0,0,1,1,2,2,939,9,637
2600,부산광역시,2607,남구,,용호제3동제3투,1746,985,273,652,25,0,21,0,0,1,0,1,0,1,974,11,761
2600,부산광역시,2607,남구,,용호제3동제4투,2108,1331,465,805,22,0,20,1,0,0,1,0,1,0,1315,16,777
2600,부산광역시,2607,남구,용호제4동,소계,7749,5913,2413,3260,116,2,64,1,3,1,11,6,0,0,5877,36,1836
2600,부산광역시,2607,남구,,관내사전투표,3320,3320,1471,1756,59,0,22,1,1,0,0,1,0,0,3311,9,0
2600,부산광역시,2607,남구,,용호제4동제1투,2401,1447,553,798,38,2,28,0,1,1,8,2,0,0,1431,16,954
2600,부산광역시,2607,남구,,용호제4동제2투,2028,1146,389,706,19,0,14,0,1,0,3,3,0,0,1135,11,882
2600,부산광역시,2607,남구,용당동,소계,6250,4706,1858,2670,87,1,34,2,0,2,6,15,1,0,4676,30,1544
2600,부산광역시,2607,남구,,관내사전투표,1836,1836,852,921,37,0,14,0,0,0,2,4,0,0,1830,6,0
2600,부산광역시,2607,남구,,용당동제1투,812,438,128,288,6,1,7,0,0,0,1,3,0,0,434,4,374
2600,부산광역시,2607,남구,,용당동제2투,1470,926,336,550,23,0,7,0,0,2,1,1,0,0,920,6,544
2600,부산광역시,2607,남구,,용당동제3투,2132,1506,542,911,21,0,6,2,0,0,2,7,1,0,1492,14,626
2600,부산광역시,2607,남구,감만제1동,소계,10533,7472,2856,4249,181,1,88,3,0,3,6,21,3,3,7414,58,3061
2600,부산광역시,2607,남구,,관내사전투표,3096,3096,1352,1617,68,1,26,3,0,1,0,10,2,1,3081,15,0
2600,부산광역시,2607,남구,,감만제1동제1투,1160,524,175,325,9,0,6,0,0,0,1,3,0,0,519,5,636
2600,부산광역시,2607,남구,,감만제1동제2투,1591,930,319,540,32,0,19,0,0,0,1,2,1,1,915,15,661
2600,부산광역시,2607,남구,,감만제1동제3투,1042,560,164,366,8,0,15,0,0,1,2,0,0,0,556,4,482
2600,부산광역시,2607,남구,,감만제1동제4투,1471,841,272,530,16,0,7,0,0,1,1,4,0,0,831,10,630
2600,부산광역시,2607,남구,,감만제1동제5투,2173,1521,574,871,48,0,15,0,0,0,1,2,0,1,1512,9,652
2600,부산광역시,2607,남구,감만제2동,소계,6128,4516,1701,2612,84,2,50,2,1,3,2,17,2,1,4477,39,1612
2600,부산광역시,2607,남구,,관내사전투표,2443,2443,1035,1321,46,2,12,1,0,0,0,12,1,1,2431,12,0
2600,부산광역시,2607,남구,,감만제2동제1투,1806,996,333,600,22,0,19,1,1,3,1,2,1,0,983,13,810
2600,부산광역시,2607,남구,,감만제2동제2투,1879,1077,333,691,16,0,19,0,0,0,1,3,0,0,1063,14,802
2600,부산광역시,2607,남구,문현제1동,소계,11101,8105,3050,4712,153,0,88,2,2,3,8,17,1,2,8038,67,2996
2600,부산광역시,2607,남구,,관내사전투표,3881,3881,1663,2089,79,0,21,1,0,0,3,5,0,1,3862,19,0
2600,부산광역시,2607,남구,,문현제1동제1투,2167,1250,388,795,24,0,23,0,0,1,1,5,1,1,1239,11,917
2600,부산광역시,2607,남구,,문현제1동제2투,1559,985,337,613,15,0,7,0,0,0,1,3,0,0,976,9,574
2600,부산광역시,2607,남구,,문현제1동제3투,2154,1263,422,771,23,0,24,1,2,0,2,0,0,0,1245,18,891
2600,부산광역시,2607,남구,,문현제1동제4투,1340,726,240,444,12,0,13,0,0,2,1,4,0,0,716,10,614
2600,부산광역시,2607,남구,문현제2동,소계,6845,4618,1637,2750,113,2,53,2,0,2,1,4,1,1,4566,52,2227
2600,부산광역시,2607,남구,,관내사전투표,1902,1902,736,1091,43,1,14,0,0,1,0,2,0,1,1889,13,0
2600,부산광역시,2607,남구,,문현제2동제1투,1628,907,299,554,22,0,14,1,0,0,0,2,0,0,892,15,721
2600,부산광역시,2607,남구,,문현제2동제2투,1134,564,195,337,16,1,8,0,0,0,0,0,0,0,557,7,570
2600,부산광역시,2607,남구,,문현제2동제3투,2181,1245,407,768,32,0,17,1,0,1,1,0,1,0,1228,17,936
2600,부산광역시,2607,남구,문현제3동,소계,11800,8844,3279,5202,196,3,78,5,1,2,8,9,2,3,8788,56,2956
2600,부산광역시,2607,남구,,관내사전투표,3611,3611,1543,1956,68,0,21,2,0,0,0,3,1,0,3594,17,0
2600,부산광역시,2607,남구,,문현제3동제1투,1030,618,171,420,8,1,10,0,0,1,0,2,0,0,613,5,412
2600,부산광역시,2607,남구,,문현제3동제2투,2231,1299,424,795,36,0,17,1,1,0,5,1,1,1,1282,17,932
2600,부산광역시,2607,남구,,문현제3동제3투,2784,1896,642,1169,55,2,10,2,0,1,2,1,0,2,1886,10,888
2600,부산광역시,2607,남구,,문현제3동제4투,2144,1420,499,862,29,0,20,0,0,0,1,2,0,0,1413,7,724
2600,부산광역시,2607,남구,문현제4동,소계,7158,5237,1832,3218,84,0,49,0,1,0,4,12,0,2,5202,35,1921
2600,부산광역시,2607,남구,,관내사전투표,2351,2351,952,1334,36,0,12,0,0,0,1,6,0,0,2341,10,0
2600,부산광역시,2607,남구,,문현제4동제1투,1318,861,265,564,12,0,7,0,1,0,1,1,0,1,852,9,457
2600,부산광역시,2607,남구,,문현제4동제2투,2237,1345,413,878,20,0,16,0,0,0,1,3,0,1,1332,13,892
2600,부산광역시,2607,남구,,문현제4동제3투,1252,680,202,442,16,0,14,0,0,0,1,2,0,0,677,3,572
2600,부산광역시,2607,남구,우암동,소계,9952,7258,2611,4337,125,2,77,2,0,0,16,19,9,3,7201,57,2694
2600,부산광역시,2607,남구,,관내사전투표,1881,1881,787,1041,18,1,13,0,0,0,1,9,3,0,1873,8,0
2600,부산광역시,2607,남구,,우암동제1투,1311,924,343,546,17,0,6,1,0,0,1,3,1,1,919,5,387
2600,부산광역시,2607,남구,,우암동제2투,2505,1730,613,1023,41,0,27,0,0,0,6,1,2,1,1714,16,775
2600,부산광역시,2607,남구,,우암동제3투,2279,1591,527,981,33,1,18,1,0,0,7,4,0,1,1573,18,688
2600,부산광역시,2607,남구,,우암동제4투,1976,1132,341,746,16,0,13,0,0,0,1,2,3,0,1122,10,844
2600,부산광역시,2607,남구,잘못 투입·구분된 투표지,,0,3,2,0,0,0,0,0,0,0,0,0,0,0,2,1,-3
2600,부산광역시,2608,북구,합계,,246904,189125,74650,105576,4262,90,2065,63,37,47,198,204,51,114,187357,1768,57779
2600,부산광역시,2608,북구,거소·선상투표,,584,542,165,255,8,3,17,1,3,0,2,2,0,1,457,85,42
2600,부산광역시,2608,북구,관외사전투표,,19101,19099,8264,9783,504,13,269,8,4,3,14,26,7,11,18906,193,2
2600,부산광역시,2608,북구,재외투표,,745,533,267,190,12,0,2,0,0,0,0,0,0,0,471,62,212
2600,부산광역시,2608,북구,구포제1동,소계,14140,10209,3720,5991,202,8,135,4,3,2,5,13,6,13,10102,107,3931
2600,부산광역시,2608,북구,,관내사전투표,4248,4249,1677,2421,68,3,29,1,2,1,3,5,2,2,4214,35,-1
2600,부산광역시,2608,북구,,구포제1동제1투,1690,909,314,538,22,1,17,0,0,0,0,1,0,1,894,15,781
2600,부산광역시,2608,북구,,구포제1동제2투,2277,1373,466,829,34,0,24,1,1,0,1,3,1,1,1361,12,904
2600,부산광역시,2608,북구,,구포제1동제3투,1868,1068,322,689,16,1,16,1,0,1,0,1,0,2,1049,19,800
2600,부산광역시,2608,북구,,구포제1동제4투,1977,1167,445,641,28,2,28,1,0,0,0,1,1,5,1152,15,810
2600,부산광역시,2608,북구,,구포제1동제5투,2080,1443,496,873,34,1,21,0,0,0,1,2,2,2,1432,11,637
2600,부산광역시,2608,북구,구포제2동,소계,20189,14264,5441,8154,294,8,178,6,7,4,15,13,4,12,14136,128,5925
2600,부산광역시,2608,북구,,관내사전투표,4561,4561,2022,2382,84,4,35,3,0,1,4,2,1,2,4540,21,0
2600,부산광역시,2608,북구,,구포제2동제1투,1920,1050,329,658,20,0,23,0,1,1,3,2,1,2,1040,10,870
2600,부산광역시,2608,북구,,구포제2동제2투,2080,1004,343,608,17,1,13,0,3,0,3,2,0,0,990,14,1076
2600,부산광역시,2608,북구,,구포제2동제3투,2958,1905,656,1142,50,0,27,0,1,1,1,2,2,1,1883,22,1053
2600,부산광역시,2608,북구,,구포제2동제4투,2606,1573,533,947,30,1,32,2,1,0,1,1,0,3,1551,22,1033
2600,부산광역시,2608,북구,,구포제2동제5투,2903,2097,756,1248,40,1,26,0,1,1,2,1,0,2,2078,19,806
2600,부산광역시,2608,북구,,구포제2동제6투,1111,613,191,395,11,0,9,0,0,0,1,0,0,1,608,5,498
2600,부산광역시,2608,북구,,구포제2동제7투,2050,1461,611,774,42,1,13,1,0,0,0,3,0,1,1446,15,589
2600,부산광역시,2608,북구,구포제3동,소계,16071,10675,4243,5885,228,8,167,2,2,3,11,15,1,5,10570,105,5396
2600,부산광역시,2608,북구,,관내사전투표,4487,4486,1980,2323,88,4,53,1,2,1,3,4,1,4,4464,22,1
2600,부산광역시,2608,북구,,구포제3동제1투,1927,1025,355,615,15,0,20,0,0,2,1,5,0,1,1014,11,902
2600,부산광역시,2608,북구,,구포제3동제2투,1838,968,366,542,20,2,23,0,0,0,1,0,0,0,954,14,870
2600,부산광역시,2608,북구,,구포제3동제3투,2076,1078,376,630,27,1,20,0,0,0,0,2,0,0,1056,22,998
2600,부산광역시,2608,북구,,구포제3동제4투,2021,1195,439,693,31,0,16,0,0,0,3,1,0,0,1183,12,826
2600,부산광역시,2608,북구,,구포제3동제5투,1618,821,326,449,18,0,18,1,0,0,1,1,0,0,814,7,797
2600,부산광역시,2608,북구,,구포제3동제6투,2104,1102,401,633,29,1,17,0,0,0,2,2,0,0,1085,17,1002
2600,부산광역시,2608,북구,덕천제1동,소계,9611,6815,2417,4065,156,0,75,6,0,5,10,8,6,5,6753,62,2796
2600,부산광역시,2608,북구,,관내사전투표,2450,2450,964,1403,44,0,20,0,0,1,1,3,2,1,2439,11,0
2600,부산광역시,2608,북구,,덕천제1동제1투,2241,1540,532,936,42,0,13,2,0,1,0,2,1,2,1531,9,701
2600,부산광역시,2608,북구,,덕천제1동제2투,1002,539,144,364,14,0,8,0,0,0,0,1,0,0,531,8,463
2600,부산광역시,2608,북구,,덕천제1동제3투,1489,845,301,493,17,0,15,2,0,0,1,2,1,1,833,12,644
2600,부산광역시,2608,북구,,덕천제1동제4투,2429,1441,476,869,39,0,19,2,0,3,8,0,2,1,1419,22,988
2600,부산광역시,2608,북구,덕천제2동,소계,10939,7827,2838,4580,166,5,112,2,1,0,5,14,4,8,7735,92,3112
2600,부산광역시,2608,북구,,관내사전투표,3478,3478,1441,1894,69,0,34,1,0,0,0,6,1,2,3448,30,0
2600,부산광역시,2608,북구,,덕천제2동제1투,2050,1125,331,717,31,1,22,0,0,0,0,1,2,0,1105,20,925
2600,부산광역시,2608,북구,,덕천제2동제2투,1628,933,270,611,13,1,16,0,0,0,2,1,0,3,917,16,695
2600,부산광역시,2608,북구,,덕천제2동제3투,2031,1266,458,733,30,3,18,1,1,0,1,5,0,2,1252,14,765
2600,부산광역시,2608,북구,,덕천제2동제4투,1752,1025,338,625,23,0,22,0,0,0,2,1,1,1,1013,12,727
2600,부산광역시,2608,북구,덕천제3동,소계,9175,6395,2363,3719,143,1,76,4,2,0,11,11,3,2,6335,60,2780
2600,부산광역시,2608,북구,,관내사전투표,2742,2742,1104,1541,51,0,21,0,1,0,3,3,1,0,2725,17,0
2600,부산광역시,2608,북구,,덕천제3동제1투,1269,755,299,420,24,0,5,0,0,0,1,1,1,0,751,4,514
2600,부산광역시,2608,북구,,덕천제3동제2투,1858,1016,340,615,24,0,19,0,1,0,2,0,0,2,1003,13,842
2600,부산광역시,2608,북구,,덕천제3동제3투,1849,1098,358,673,26,1,20,4,0,0,2,2,0,0,1086,12,751
2600,부산광역시,2608,북구,,덕천제3동제4투,1457,784,262,470,18,0,11,0,0,0,3,5,1,0,770,14,673
2600,부산광역시,2608,북구,만덕제1동,소계,13181,10256,4110,5702,219,8,105,3,1,1,14,4,3,3,10173,83,2925
2600,부산광역시,2608,북구,,관내사전투표,4139,4139,1763,2244,67,3,38,0,0,0,1,2,1,1,4120,19,0
2600,부산광역시,2608,북구,,만덕제1동제1투,1894,1172,434,680,24,3,12,2,1,0,4,0,2,0,1162,10,722
2600,부산광역시,2608,북구,,만덕제1동제2투,2414,1735,748,896,46,0,16,1,0,0,4,1,0,0,1712,23,679
2600,부산광역시,2608,북구,,만덕제1동제3투,2539,1646,563,998,42,1,23,0,0,0,2,0,0,1,1630,16,893
2600,부산광역시,2608,북구,,만덕제1동제4투,2195,1564,602,884,40,1,16,0,0,1,3,1,0,1,1549,15,631
2600,부산광역시,2608,북구,만덕제2동,소계,20377,15204,6163,8403,320,3,158,5,0,8,17,14,2,3,15096,108,5173
2600,부산광역시,2608,북구,,관내사전투표,5791,5789,2504,3124,97,1,33,3,0,0,5,6,1,0,5774,15,2
2600,부산광역시,2608,북구,,만덕제2동제1투,1395,776,237,496,17,0,10,0,0,2,1,0,0,0,763,13,619
2600,부산광역시,2608,북구,,만덕제2동제2투,1039,593,207,353,9,0,13,0,0,1,1,0,0,0,584,9,446
2600,부산광역시,2608,북구,,만덕제2동제3투,1987,1217,384,766,27,0,18,0,0,0,3,3,0,1,1202,15,770
2600,부산광역시,2608,북구,,만덕제2동제4투,1610,1012,318,649,16,0,13,2,0,0,0,1,1,0,1000,12,598
2600,부산광역시,2608,북구,,만덕제2동제5투,1551,1142,554,517,38,0,17,0,0,3,2,1,0,0,1132,10,409
2600,부산광역시,2608,북구,,만덕제2동제6투,2107,1338,521,760,36,0,13,0,0,1,1,0,0,0,1332,6,769
2600,부산광역시,2608,북구,,만덕제2동제7투,2879,1951,927,938,47,2,22,0,0,0,3,1,0,0,1940,11,928
2600,부산광역시,2608,북구,,만덕제2동제8투,2018,1386,511,800,33,0,19,0,0,1,1,2,0,2,1369,17,632
2600,부산광역시,2608,북구,만덕제3동,소계,15068,11494,4370,6652,235,3,111,5,0,5,9,8,3,5,11406,88,3574
2600,부산광역시,2608,북구,,관내사전투표,4702,4702,2021,2555,65,2,30,1,0,3,0,3,3,2,4685,17,0
2600,부산광역시,2608,북구,,만덕제3동제1투,1729,1114,384,675,27,0,16,3,0,0,2,0,0,0,1107,7,615
2600,부산광역시,2608,북구,,만덕제3동제2투,2319,1608,526,1001,36,0,17,0,0,2,1,2,0,2,1587,21,711
2600,부산광역시,2608,북구,,만덕제3동제3투,1641,980,346,575,23,0,15,0,0,0,2,3,0,0,964,16,661
2600,부산광역시,2608,북구,,만덕제3동제4투,2591,1780,663,1036,48,1,17,0,0,0,1,0,0,0,1766,14,811
2600,부산광역시,2608,북구,,만덕제3동제5투,2086,1310,430,810,36,0,16,1,0,0,3,0,0,1,1297,13,776
2600,부산광역시,2608,북구,금곡동,소계,30647,22881,9223,12567,505,7,257,7,5,9,30,25,6,21,22662,219,7766
2600,부산광역시,2608,북구,,관내사전투표,6029,6029,2775,3031,137,4,35,1,0,2,4,2,2,8,6001,28,0
2600,부산광역시,2608,북구,,금곡동제1투,2068,1477,556,838,27,1,23,0,1,1,4,3,0,0,1454,23,591
2600,부산광역시,2608,북구,,금곡동제2투,2004,1359,506,769,37,0,22,0,0,0,4,1,0,1,1340,19,645
2600,부산광역시,2608,북구,,금곡동제3투,2046,1447,516,871,25,1,13,1,1,2,0,0,0,0,1430,17,599
2600,부산광역시,2608,북구,,금곡동제4투,2208,1680,607,976,51,0,26,1,1,0,3,4,0,0,1669,11,528
2600,부산광역시,2608,북구,,금곡동제5투,1426,935,289,612,10,0,10,0,0,1,0,0,0,2,924,11,491
2600,부산광역시,2608,북구,,금곡동제6투,1567,1051,401,582,22,1,21,1,0,0,1,3,0,2,1034,17,516
2600,부산광역시,2608,북구,,금곡동제7투,2096,1407,553,793,25,0,13,0,0,0,5,1,0,3,1393,14,689
2600,부산광역시,2608,북구,,금곡동제8투,1682,1037,322,662,6,0,15,1,1,1,1,2,2,2,1015,22,645
2600,부산광역시,2608,북구,,금곡동제9투,1598,1133,437,651,24,0,11,0,1,0,2,1,0,0,1127,6,465
2600,부산광역시,2608,북구,,금곡동제10투,2206,1297,482,742,36,0,22,0,0,0,2,1,0,1,1286,11,909
2600,부산광역시,2608,북구,,금곡동제11투,2862,1982,879,1005,45,0,26,2,0,0,4,3,1,1,1966,16,880
2600,부산광역시,2608,북구,,금곡동제12투,2855,2047,900,1035,60,0,20,0,0,2,0,4,1,1,2023,24,808
2600,부산광역시,2608,북구,화명제1동,소계,30243,23820,9211,13649,558,6,178,3,3,4,23,15,0,10,23660,160,6423
2600,부산광역시,2608,북구,,관내사전투표,6925,6925,3064,3654,142,2,30,1,0,0,7,3,0,2,6905,20,0
2600,부산광역시,2608,북구,,화명제1동제1투,2162,1387,538,769,37,1,23,1,1,1,1,1,0,1,1374,13,775
2600,부산광역시,2608,북구,,화명제1동제2투,2832,1943,721,1105,60,2,20,0,1,1,1,1,0,2,1914,29,889
2600,부산광역시,2608,북구,,화명제1동제3투,1850,1345,542,748,31,0,12,0,0,0,3,1,0,0,1337,8,505
2600,부산광역시,2608,북구,,화명제1동제4투,1881,1319,554,701,41,0,10,0,0,0,1,1,0,2,1310,9,562
2600,부산광역시,2608,북구,,화명제1동제5투,3181,2375,918,1347,71,1,20,0,0,0,2,2,0,1,2362,13,806
2600,부산광역시,2608,북구,,화명제1동제6투,2832,2190,650,1483,30,0,13,0,0,0,3,0,0,1,2180,10,642
2600,부산광역시,2608,북구,,화명제1동제7투,2865,2211,786,1337,53,0,13,0,0,1,1,1,0,1,2193,18,654
2600,부산광역시,2608,북구,,화명제1동제8투,2873,2090,678,1339,39,0,12,1,1,0,1,0,0,0,2071,19,783
2600,부산광역시,2608,북구,,화명제1동제9투,1687,1165,424,676,33,0,14,0,0,1,3,3,0,0,1154,11,522
2600,부산광역시,2608,북구,,화명제1동제10투,1155,870,336,490,21,0,11,0,0,0,0,2,0,0,860,10,285
2600,부산광역시,2608,북구,화명제2동,소계,13474,10103,4085,5537,233,5,106,4,2,2,12,17,3,4,10010,93,3371
2600,부산광역시,2608,북구,,관내사전투표,3818,3818,1774,1908,73,3,23,1,1,1,2,11,1,2,3800,18,0
2600,부산광역시,2608,북구,,화명제2동제1투,2589,1720,599,1021,46,0,27,1,1,1,2,0,1,2,1701,19,869
2600,부산광역시,2608,북구,,화명제2동제2투,1815,1103,399,641,35,1,10,2,0,0,2,2,0,0,1092,11,712
2600,부산광역시,2608,북구,,화명제2동제3투,1948,1197,451,670,34,0,22,0,0,0,4,2,0,0,1183,14,751
2600,부산광역시,2608,북구,,화명제2동제4투,1429,867,310,518,20,0,8,0,0,0,1,1,0,0,858,9,562
2600,부산광역시,2608,북구,,화명제2동제5투,1875,1398,552,779,25,1,16,0,0,0,1,1,1,0,1376,22,477
2600,부산광역시,2608,북구,화명제3동,소계,23359,19005,7769,10442,479,12,119,3,4,1,20,19,3,11,18882,123,4354
2600,부산광역시,2608,북구,,관내사전투표,7415,7414,3441,3746,147,4,28,1,3,1,3,7,1,4,7386,28,1
2600,부산광역시,2608,북구,,화명제3동제1투,3208,2349,857,1390,64,3,11,0,1,0,2,1,0,2,2331,18,859
2600,부산광역시,2608,북구,,화명제3동제2투,1791,1367,575,712,42,1,14,0,0,0,2,3,0,1,1350,17,424
2600,부산광역시,2608,북구,,화명제3동제3투,2215,1375,477,833,38,0,10,0,0,0,1,3,0,2,1364,11,840
2600,부산광역시,2608,북구,,화명제3동제4투,1886,1356,484,785,50,1,18,0,0,0,0,0,0,1,1339,17,530
2600,부산광역시,2608,북구,,화명제3동제5투,1099,821,302,488,16,0,5,1,0,0,0,0,0,0,812,9,278
2600,부산광역시,2608,북구,,화명제3동제6투,2832,2116,810,1187,64,1,24,1,0,0,10,4,2,0,2103,13,716
2600,부산광역시,2608,북구,,화명제3동제7투,2913,2207,823,1301,58,2,9,0,0,0,2,1,0,1,2197,10,706
2600,부산광역시,2608,북구,잘못 투입·구분된 투표지,,0,3,1,2,0,0,0,0,0,0,0,0,0,0,3,0,-3
2600,부산광역시,2609,해운대구,합계,,339847,259616,92631,156792,5068,118,2157,60,35,61,212,291,48,94,257567,2049,80231
2600,부산광역시,2609,해운대구,거소·선상투표,,835,771,235,397,12,1,14,1,0,1,0,0,1,1,663,108,64
2600,부산광역시,2609,해운대구,관외사전투표,,27763,27760,10754,15749,607,11,311,5,7,6,10,44,3,12,27519,241,3
2600,부산광역시,2609,해운대구,재외투표,,1953,1415,661,575,42,2,4,0,3,0,0,0,0,0,1287,128,538
2600,부산광역시,2609,해운대구,우제1동,소계,16933,12003,3722,7824,194,6,140,3,0,4,5,13,3,3,11917,86,4930
2600,부산광역시,2609,해운대구,,관내사전투표,4259,4259,1603,2539,62,3,26,1,0,0,0,1,1,2,4238,21,0
2600,부산광역시,2609,해운대구,,우제1동제1투,2056,1179,336,782,21,0,23,0,0,0,3,2,0,0,1167,12,877
2600,부산광역시,2609,해운대구,,우제1동제2투,2641,1766,589,1086,31,2,38,0,0,0,0,5,0,0,1751,15,875
2600,부산광역시,2609,해운대구,,우제1동제3투,2252,1298,297,944,23,0,18,0,0,0,0,1,0,1,1284,14,954
2600,부산광역시,2609,해운대구,,우제1동제4투,3349,1724,478,1173,27,1,22,1,0,2,0,2,2,0,1708,16,1625
2600,부산광역시,2609,해운대구,,우제1동제5투,2376,1777,419,1300,30,0,13,1,0,2,2,2,0,0,1769,8,599
2600,부산광역시,2609,해운대구,우제2동,소계,22550,17594,5462,11613,283,5,85,2,0,3,20,11,2,2,17488,106,4956
2600,부산광역시,2609,해운대구,,관내사전투표,6682,6682,2518,4013,91,2,26,0,0,2,3,6,0,1,6662,20,0
2600,부산광역시,2609,해운대구,,우제2동제1투,3205,2292,666,1548,40,1,11,0,0,0,0,1,1,0,2268,24,913
2600,부산광역시,2609,해운대구,,우제2동제2투,2838,1908,582,1275,32,1,0,1,0,0,2,1,0,0,1894,14,930
2600,부산광역시,2609,해운대구,,우제2동제3투,2242,1393,404,929,24,0,15,1,0,0,2,3,1,1,1380,13,849
2600,부산광역시,2609,해운대구,,우제2동제4투,2471,1688,458,1151,42,0,13,0,0,0,5,0,0,0,1669,19,783
2600,부산광역시,2609,해운대구,,우제2동제5투,2794,2000,527,1416,26,1,13,0,0,1,4,0,0,0,1988,12,794
2600,부산광역시,2609,해운대구,,우제2동제6투,2318,1631,307,1281,28,0,7,0,0,0,4,0,0,0,1627,4,687
2600,부산광역시,2609,해운대구,중제1동,소계,20562,15117,4806,9764,288,5,115,3,5,3,12,7,0,4,15012,105,5445
2600,부산광역시,2609,해운대구,,관내사전투표,5843,5844,2135,3541,108,0,27,0,0,0,3,4,0,2,5820,24,-1
2600,부산광역시,2609,해운대구,,중제1동제1투,3383,2045,421,1561,30,0,10,0,1,3,1,0,0,0,2027,18,1338
2600,부산광역시,2609,해운대구,,중제1동제2투,3328,2125,583,1437,51,2,20,2,2,0,4,1,0,1,2103,22,1203
2600,부산광역시,2609,해운대구,,중제1동제3투,2696,1717,572,1069,37,2,15,1,1,0,1,0,0,1,1699,18,979
2600,부산광역시,2609,해운대구,,중제1동제4투,2750,1713,591,1060,29,0,18,0,1,0,3,1,0,0,1703,10,1037
2600,부산광역시,2609,해운대구,,중제1동제5투,2562,1673,504,1096,33,1,25,0,0,0,0,1,0,0,1660,13,889
2600,부산광역시,2609,해운대구,중제2동,소계,12788,9397,3185,5893,178,4,60,1,1,1,7,6,2,4,9342,55,3391
2600,부산광역시,2609,해운대구,,관내사전투표,4135,4135,1612,2419,68,0,12,1,0,0,2,3,0,2,4119,16,0
2600,부산광역시,2609,해운대구,,중제2동제1투,940,488,145,316,12,0,10,0,0,0,0,0,1,0,484,4,452
2600,부산광역시,2609,해운대구,,중제2동제2투,2387,1327,474,788,28,2,16,0,0,1,2,3,1,1,1316,11,1060
2600,부산광역시,2609,해운대구,,중제2동제3투,2480,1552,420,1069,34,1,11,0,1,0,3,0,0,0,1539,13,928
2600,부산광역시,2609,해운대구,,중제2동제4투,2846,1895,534,1301,36,1,11,0,0,0,0,0,0,1,1884,11,951
2600,부산광역시,2609,해운대구,좌제1동,소계,15220,11824,4469,6890,274,3,78,4,1,2,2,15,0,0,11738,86,3396
2600,부산광역시,2609,해운대구,,관내사전투표,5439,5439,2402,2841,124,2,28,1,0,1,0,7,0,0,5406,33,0
2600,부산광역시,2609,해운대구,,좌제1동제1투,2540,1342,436,852,32,0,10,0,0,0,0,2,0,0,1332,10,1198
2600,부산광역시,2609,해운대구,,좌제1동제2투,2104,1433,419,945,34,0,23,2,0,0,0,2,0,0,1425,8,671
2600,부산광역시,2609,해운대구,,좌제1동제3투,2349,1587,563,959,38,1,11,0,1,0,1,0,0,0,1574,13,762
2600,부산광역시,2609,해운대구,,좌제1동제4투,2788,2023,649,1293,46,0,6,1,0,1,1,4,0,0,2001,22,765
2600,부산광역시,2609,해운대구,좌제2동,소계,24701,18294,6854,10742,385,9,132,4,2,7,5,16,6,3,18165,129,6407
2600,부산광역시,2609,해운대구,,관내사전투표,7023,7023,3036,3786,116,6,29,2,1,2,1,6,2,1,6988,35,0
2600,부산광역시,2609,해운대구,,좌제2동제1투,2719,1486,471,935,42,1,18,1,0,3,0,2,1,1,1475,11,1233
2600,부산광역시,2609,해운대구,,좌제2동제2투,3422,1915,635,1173,59,1,20,1,0,1,1,1,2,0,1894,21,1507
2600,부산광역시,2609,해운대구,,좌제2동제3투,2412,1539,541,948,27,0,11,0,0,1,0,0,0,1,1529,10,873
2600,부산광역시,2609,해운대구,,좌제2동제4투,2289,1533,567,890,37,0,18,0,1,0,0,1,0,0,1514,19,756
2600,부산광역시,2609,해운대구,,좌제2동제5투,2650,1935,638,1230,37,0,15,0,0,0,1,2,1,0,1924,11,715
2600,부산광역시,2609,해운대구,,좌제2동제6투,2105,1423,505,860,32,1,15,0,0,0,0,0,0,0,1413,10,682
2600,부산광역시,2609,해운대구,,좌제2동제7투,2081,1440,461,920,35,0,6,0,0,0,2,4,0,0,1428,12,641
2600,부산광역시,2609,해운대구,좌제3동,소계,12990,10099,3835,5895,219,3,67,2,0,6,10,9,0,3,10049,50,2891
2600,부산광역시,2609,해운대구,,관내사전투표,4888,4888,2045,2699,92,1,21,2,0,2,0,3,0,2,4867,21,0
2600,부산광역시,2609,해운대구,,좌제3동제1투,2300,1429,498,872,36,0,10,0,0,3,3,1,0,0,1423,6,871
2600,부산광역시,2609,해운대구,,좌제3동제2투,1789,1183,434,698,23,0,11,0,0,1,4,4,0,0,1175,8,606
2600,부산광역시,2609,해운대구,,좌제3동제3투,1981,1263,447,762,27,2,11,0,0,0,1,1,0,1,1252,11,718
2600,부산광역시,2609,해운대구,,좌제3동제4투,2032,1336,411,864,41,0,14,0,0,0,2,0,0,0,1332,4,696
2600,부산광역시,2609,해운대구,좌제4동,소계,18226,14535,5668,8356,317,5,79,4,2,2,5,10,2,3,14453,82,3691
2600,부산광역시,2609,해운대구,,관내사전투표,5629,5629,2565,2905,93,1,30,3,0,0,1,7,1,2,5608,21,0
2600,부산광역시,2609,해운대구,,좌제4동제1투,2079,1400,486,860,40,0,5,1,1,0,0,1,0,0,1394,6,679
2600,부산광역시,2609,해운대구,,좌제4동제2투,1286,907,340,530,23,0,7,0,0,0,0,0,1,0,901,6,379
2600,부산광역시,2609,해운대구,,좌제4동제3투,2259,1513,543,914,41,1,3,0,1,1,1,0,0,1,1506,7,746
2600,부산광역시,2609,해운대구,,좌제4동제4투,2417,1666,587,1015,35,1,10,0,0,0,3,1,0,0,1652,14,751
2600,부산광역시,2609,해운대구,,좌제4동제5투,2275,1712,583,1063,36,2,14,0,0,1,0,1,0,0,1700,12,563
2600,부산광역시,2609,해운대구,,좌제4동제6투,2281,1708,564,1069,49,0,10,0,0,0,0,0,0,0,1692,16,573
2600,부산광역시,2609,해운대구,송정동,소계,8500,6060,2148,3653,124,1,65,0,2,1,10,6,2,4,6016,44,2440
2600,부산광역시,2609,해운대구,,관내사전투표,2623,2623,1038,1491,59,1,18,0,0,0,2,3,0,0,2612,11,0
2600,부산광역시,2609,해운대구,,송정동제1투,2040,1049,316,677,21,0,18,0,1,1,3,0,0,2,1039,10,991
2600,부산광역시,2609,해운대구,,송정동제2투,2366,1485,492,930,20,0,22,0,0,0,3,0,2,2,1471,14,881
2600,부산광역시,2609,해운대구,,송정동제3투,1471,903,302,555,24,0,7,0,1,0,2,3,0,0,894,9,568
2600,부산광역시,2609,해운대구,반여제1동,소계,26142,20135,7940,11446,402,11,142,3,1,2,20,13,4,14,19998,137,6007
2600,부산광역시,2609,해운대구,,관내사전투표,6174,6173,2804,3231,92,3,17,0,0,0,3,5,1,3,6159,14,1
2600,부산광역시,2609,해운대구,,반여제1동제1투,1740,1108,350,695,20,0,26,0,1,0,1,0,2,1,1096,12,632
2600,부산광역시,2609,해운대구,,반여제1동제2투,2500,1572,516,989,29,1,11,0,0,1,3,1,1,1,1553,19,928
2600,부산광역시,2609,해운대구,,반여제1동제3투,2485,1688,586,1018,47,1,15,0,0,0,5,1,0,0,1673,15,797
2600,부산광역시,2609,해운대구,,반여제1동제4투,2146,1398,435,880,39,1,15,1,0,0,2,1,0,3,1377,21,748
2600,부산광역시,2609,해운대구,,반여제1동제5투,2150,1593,591,940,43,1,8,0,0,0,2,0,0,2,1587,6,557
2600,부산광역시,2609,해운대구,,반여제1동제6투,2025,1512,657,803,20,0,12,1,0,0,3,1,0,1,1498,14,513
2600,부산광역시,2609,해운대구,,반여제1동제7투,1913,1355,569,735,21,1,15,1,0,1,1,2,0,0,1346,9,558
2600,부산광역시,2609,해운대구,,반여제1동제8투,2219,1623,591,961,49,1,10,0,0,0,0,0,0,2,1614,9,596
2600,부산광역시,2609,해운대구,,반여제1동제9투,2790,2113,841,1194,42,2,13,0,0,0,0,2,0,1,2095,18,677
2600,부산광역시,2609,해운대구,반여제2동,소계,11120,7519,2783,4403,141,8,88,4,1,3,10,10,5,3,7459,60,3601
2600,부산광역시,2609,해운대구,,관내사전투표,3452,3454,1367,1966,56,4,33,0,0,1,2,4,2,1,3436,18,-2
2600,부산광역시,2609,해운대구,,반여제2동제1투,1984,1091,367,683,25,0,6,0,0,0,3,0,1,0,1085,6,893
2600,부산광역시,2609,해운대구,,반여제2동제2투,1665,903,331,516,21,1,13,1,0,1,0,3,0,0,887,16,762
2600,부산광역시,2609,해운대구,,반여제2동제3투,1327,625,204,390,6,1,8,2,1,0,2,2,1,1,618,7,702
2600,부산광역시,2609,해운대구,,반여제2동제4투,1577,910,326,533,22,1,19,0,0,0,3,0,0,0,904,6,667
2600,부산광역시,2609,해운대구,,반여제2동제5투,1115,536,188,315,11,1,9,1,0,1,0,1,1,1,529,7,579
2600,부산광역시,2609,해운대구,반여제3동,소계,7543,5072,1871,2946,118,6,65,0,0,0,7,12,1,0,5026,46,2471
2600,부산광역시,2609,해운대구,,관내사전투표,2488,2488,1019,1371,53,3,20,0,0,0,2,4,1,0,2473,15,0
2600,부산광역시,2609,해운대구,,반여제3동제1투,1763,877,303,529,13,1,13,0,0,0,2,3,0,0,864,13,886
2600,부산광역시,2609,해운대구,,반여제3동제2투,1494,806,247,507,29,0,11,0,0,0,2,2,0,0,798,8,688
2600,부산광역시,2609,해운대구,,반여제3동제3투,1798,901,302,539,23,2,21,0,0,0,1,3,0,0,891,10,897
2600,부산광역시,2609,해운대구,반여제4동,소계,12366,9381,3708,5286,211,2,78,3,0,1,8,12,2,5,9316,65,2985
2600,부산광역시,2609,해운대구,,관내사전투표,3480,3480,1482,1888,53,2,30,2,0,1,0,7,0,1,3466,14,0
2600,부산광역시,2609,해운대구,,반여제4동제1투,1960,1152,396,692,33,0,12,0,0,0,1,1,1,2,1138,14,808
2600,부산광역시,2609,해운대구,,반여제4동제2투,1950,1127,363,713,24,0,13,0,0,0,3,2,0,1,1119,8,823
2600,부산광역시,2609,해운대구,,반여제4동제3투,2479,1858,763,1020,42,0,15,1,0,0,1,1,0,1,1844,14,621
2600,부산광역시,2609,해운대구,,반여제4동제4투,2497,1764,704,973,59,0,8,0,0,0,3,1,1,0,1749,15,733
2600,부산광역시,2609,해운대구,반송제1동,소계,12270,8275,3041,4800,140,8,125,5,1,3,19,24,6,8,8180,95,3995
2600,부산광역시,2609,해운대구,,관내사전투표,4050,4050,1628,2268,54,5,32,5,0,2,6,10,3,4,4017,33,0
2600,부산광역시,2609,해운대구,,반송제1동제1투,1384,711,261,385,19,1,23,0,0,0,4,3,1,0,697,14,673
2600,부산광역시,2609,해운대구,,반송제1동제2투,1246,673,228,416,10,0,8,0,0,0,0,6,0,0,668,5,573
2600,부산광역시,2609,해운대구,,반송제1동제3투,1218,676,225,404,16,1,9,0,0,0,4,1,2,1,663,13,542
2600,부산광역시,2609,해운대구,,반송제1동제4투,1184,634,200,392,13,0,16,0,0,1,1,1,0,3,627,7,550
2600,부산광역시,2609,해운대구,,반송제1동제5투,1520,650,224,372,16,0,19,0,1,0,2,1,0,0,635,15,870
2600,부산광역시,2609,해운대구,,반송제1동제6투,1429,722,238,443,12,1,16,0,0,0,2,2,0,0,714,8,707
2600,부산광역시,2609,해운대구,,반송제1동제7투,239,159,37,120,0,0,2,0,0,0,0,0,0,0,159,0,80
2600,부산광역시,2609,해운대구,반송제2동,소계,19690,13884,5133,8066,260,7,185,5,2,4,19,50,3,9,13743,141,5806
2600,부산광역시,2609,해운대구,,관내사전투표,6022,6021,2437,3369,97,5,45,3,1,2,6,17,0,2,5984,37,1
2600,부산광역시,2609,해운대구,,반송제2동제1투,1807,1150,332,748,31,1,20,0,0,2,3,2,1,0,1140,10,657
2600,부산광역시,2609,해운대구,,반송제2동제2투,2232,1216,451,681,25,0,22,0,0,0,3,15,0,1,1198,18,1016
2600,부산광역시,2609,해운대구,,반송제2동제3투,1278,647,207,399,13,0,14,0,0,0,0,3,0,1,637,10,631
2600,부산광역시,2609,해운대구,,반송제2동제4투,1035,656,214,409,9,1,13,1,0,0,0,0,0,0,647,9,379
2600,부산광역시,2609,해운대구,,반송제2동제5투,2283,1359,482,799,31,0,23,0,0,0,4,3,0,4,1346,13,924
2600,부산광역시,2609,해운대구,,반송제2동제6투,1585,889,313,521,15,0,21,0,0,0,2,3,0,0,875,14,696
2600,부산광역시,2609,해운대구,,반송제2동제7투,1457,833,251,537,10,0,13,1,0,0,0,0,2,0,814,19,624
2600,부산광역시,2609,해운대구,,반송제2동제8투,1991,1113,446,603,29,0,14,0,1,0,1,7,0,1,1102,11,878
2600,부산광역시,2609,해운대구,재송제1동,소계,26802,20205,7211,12287,402,12,124,5,3,3,18,14,4,6,20089,116,6597
2600,부산광역시,2609,해운대구,,관내사전투표,7032,7029,2881,3947,125,7,29,1,0,0,1,7,1,2,7001,28,3
2600,부산광역시,2609,해운대구,,재송제1동제1투,2895,1545,522,955,25,2,16,0,0,0,1,3,1,0,1525,20,1350
2600,부산광역시,2609,해운대구,,재송제1동제2투,2701,1540,501,963,39,1,19,0,0,0,2,0,1,1,1527,13,1161
2600,부산광역시,2609,해운대구,,재송제1동제3투,2352,1371,480,821,31,0,18,0,1,1,4,0,1,0,1357,14,981
2600,부산광역시,2609,해운대구,,재송제1동제4투,3016,2209,883,1237,58,0,14,1,0,0,6,2,0,1,2202,7,807
2600,부산광역시,2609,해운대구,,재송제1동제5투,3471,2533,691,1774,48,1,7,1,1,0,1,0,0,0,2524,9,938
2600,부산광역시,2609,해운대구,,재송제1동제6투,3094,2243,594,1592,36,0,8,2,1,0,0,0,0,1,2234,9,851
2600,부산광역시,2609,해운대구,,재송제1동제7투,2241,1735,659,998,40,1,13,0,0,2,3,2,0,1,1719,16,506
2600,부산광역시,2609,해운대구,재송제2동,소계,19446,13283,5187,7549,258,8,142,5,2,5,13,13,1,7,13190,93,6163
2600,부산광역시,2609,해운대구,,관내사전투표,4785,4785,2081,2580,67,2,30,2,1,1,1,6,0,0,4771,14,0
2600,부산광역시,2609,해운대구,,재송제2동제1투,1704,904,307,553,18,0,12,0,0,0,0,2,0,0,892,12,800
2600,부산광역시,2609,해운대구,,재송제2동제2투,1651,948,327,567,28,0,15,1,0,1,2,0,0,1,942,6,703
2600,부산광역시,2609,해운대구,,재송제2동제3투,2140,1174,453,646,34,1,14,1,0,0,2,3,0,2,1156,18,966
2600,부산광역시,2609,해운대구,,재송제2동제4투,1947,1197,408,733,31,1,14,0,0,1,0,0,0,0,1188,9,750
2600,부산광역시,2609,해운대구,,재송제2동제5투,1288,727,279,411,15,1,8,1,0,0,1,1,0,2,719,8,561
2600,부산광역시,2609,해운대구,,재송제2동제6투,1564,846,291,508,16,0,16,0,1,0,1,0,1,1,835,11,718
2600,부산광역시,2609,해운대구,,재송제2동제7투,2191,1298,476,769,27,3,16,0,0,0,1,1,0,1,1294,4,893
2600,부산광역시,2609,해운대구,,재송제2동제8투,2176,1404,565,782,22,0,17,0,0,2,5,0,0,0,1393,11,772
2600,부산광역시,2609,해운대구,우제3동,소계,21447,16991,3957,12658,212,1,58,1,2,4,12,6,1,3,16915,76,4456
2600,부산광역시,2609,해운대구,,관내사전투표,6929,6929,1985,4812,91,1,15,0,0,0,5,2,0,2,6913,16,0
2600,부산광역시,2609,해운대구,,우제3동제1투,2411,1606,384,1175,22,0,10,0,1,1,0,1,0,0,1594,12,805
2600,부산광역시,2609,해운대구,,우제3동제2투,2451,1738,428,1259,21,0,8,0,0,1,4,2,1,0,1724,14,713
2600,부산광역시,2609,해운대구,,우제3동제3투,1920,1324,195,1095,14,0,9,0,0,0,1,1,0,0,1315,9,596
2600,부산광역시,2609,해운대구,,우제3동제4투,2890,1826,332,1444,26,0,7,0,0,0,0,0,0,1,1810,16,1064
2600,부산광역시,2609,해운대구,,우제3동제5투,2586,1875,307,1538,17,0,4,0,1,2,1,0,0,0,1870,5,711
2600,부산광역시,2609,해운대구,,우제3동제6투,2260,1693,326,1335,21,0,5,1,0,0,1,0,0,0,1689,4,567
2600,부산광역시,2609,해운대구,잘못 투입·구분된 투표지,,0,2,1,0,1,0,0,0,0,0,0,0,0,0,2,0,-2
2600,부산광역시,2610,기장군,합계,,144027,106148,42955,58497,2253,54,1212,28,13,23,78,131,21,40,105305,843,37879
2600,부산광역시,2610,기장군,거소·선상투표,,473,447,120,252,6,1,13,2,1,0,0,0,0,0,395,52,26
2600,부산광역시,2610,기장군,관외사전투표,,13656,13653,5734,7264,313,14,173,5,2,4,5,18,4,6,13542,111,3
2600,부산광역시,2610,기장군,재외투표,,570,416,215,147,13,0,2,0,0,0,0,0,1,0,378,38,154
2600,부산광역시,2610,기장군,기장읍,소계,41832,28328,9820,17278,560,10,334,12,5,6,37,34,6,4,28106,222,13504
2600,부산광역시,2610,기장군,,관내사전투표,8569,8568,3488,4814,139,3,63,3,1,2,8,10,3,1,8535,33,1
2600,부산광역시,2610,기장군,,기장읍제1투,2728,1539,505,936,45,0,23,1,1,0,4,2,0,1,1518,21,1189
2600,부산광역시,2610,기장군,,기장읍제2투,3308,1954,668,1188,48,0,31,0,1,1,4,2,1,0,1944,10,1354
2600,부산광역시,2610,기장군,,기장읍제3투,3019,2070,793,1169,60,1,21,0,0,0,2,1,0,0,2047,23,949
2600,부산광역시,2610,기장군,,기장읍제4투,3911,2210,750,1356,46,4,30,0,0,1,2,3,0,0,2192,18,1701
2600,부산광역시,2610,기장군,,기장읍제5투,2639,1555,531,939,33,2,26,0,0,1,2,0,0,0,1534,21,1084
2600,부산광역시,2610,기장군,,기장읍제6투,3600,1907,614,1167,56,0,36,2,0,0,3,6,0,1,1885,22,1693
2600,부산광역시,2610,기장군,,기장읍제7투,3341,2179,699,1416,24,0,20,0,1,0,5,3,1,0,2169,10,1162
2600,부산광역시,2610,기장군,,기장읍제8투,1948,994,339,599,23,0,21,0,0,0,0,2,0,0,984,10,954
2600,부산광역시,2610,기장군,,기장읍제9투,1444,873,220,627,7,0,3,1,0,0,1,1,0,0,860,13,571
2600,부산광역시,2610,기장군,,기장읍제10투,2136,1381,472,843,31,0,14,1,1,0,2,2,0,0,1366,15,755
2600,부산광역시,2610,기장군,,기장읍제11투,522,338,69,262,2,0,3,0,0,0,0,0,0,0,336,2,184
2600,부산광역시,2610,기장군,,기장읍제12투,654,600,8,588,0,0,1,1,0,0,1,0,0,0,599,1,54
2600,부산광역시,2610,기장군,,기장읍제13투,2240,957,253,644,18,0,29,0,0,0,2,1,0,1,948,9,1283
2600,부산광역시,2610,기장군,,기장읍제14투,1773,1203,411,730,28,0,13,3,0,1,1,1,1,0,1189,14,570
2600,부산광역시,2610,기장군,장안읍,소계,7647,5804,1748,3811,109,3,72,1,0,1,6,13,3,1,5768,36,1843
2600,부산광역시,2610,기장군,,관내사전투표,2395,2395,911,1394,44,0,23,1,0,0,1,3,2,1,2380,15,0
2600,부산광역시,2610,기장군,,장안읍제1투,975,586,131,427,14,0,9,0,0,0,1,2,0,0,584,2,389
2600,부산광역시,2610,기장군,,장안읍제2투,752,488,102,370,4,0,7,0,0,0,1,0,0,0,484,4,264
2600,부산광역시,2610,기장군,,장안읍제3투,597,342,74,251,8,2,3,0,0,1,1,0,0,0,340,2,255
2600,부산광역시,2610,기장군,,장안읍제4투,1000,615,168,421,5,0,10,0,0,0,0,7,1,0,612,3,385
2600,부산광역시,2610,기장군,,장안읍제5투,1140,754,190,527,14,1,15,0,0,0,2,1,0,0,750,4,386
2600,부산광역시,2610,기장군,,장안읍제6투,788,624,172,421,20,0,5,0,0,0,0,0,0,0,618,6,164
2600,부산광역시,2610,기장군,일광면,소계,18904,13964,5175,8256,284,7,129,0,3,2,5,13,1,5,13880,84,4940
2600,부산광역시,2610,기장군,,관내사전투표,4930,4929,2088,2708,84,0,27,0,0,0,2,2,0,0,4911,18,1
2600,부산광역시,2610,기장군,,일광면제1투,1116,648,138,485,9,0,9,0,0,0,0,0,0,1,642,6,468
2600,부산광역시,2610,기장군,,일광면제2투,1300,837,188,620,6,2,9,0,0,0,2,1,0,0,828,9,463
2600,부산광역시,2610,기장군,,일광면제3투,375,253,43,194,4,0,7,0,0,0,0,1,0,1,250,3,122
2600,부산광역시,2610,기장군,,일광면제4투,503,343,63,268,3,1,5,0,2,0,0,0,0,1,343,0,160
2600,부산광역시,2610,기장군,,일광면제5투,2726,1615,465,1068,44,0,20,0,0,1,0,2,1,0,1601,14,1111
2600,부산광역시,2610,기장군,,일광면제6투,2300,1636,736,821,39,1,19,0,1,0,0,6,0,2,1625,11,664
2600,부산광역시,2610,기장군,,일광면제7투,3112,2042,816,1138,59,0,16,0,0,0,0,1,0,0,2030,12,1070
2600,부산광역시,2610,기장군,,일광면제8투,2542,1661,638,954,36,3,17,0,0,1,1,0,0,0,1650,11,881
2600,부산광역시,2610,기장군,정관읍,소계,54393,38545,18380,18460,872,16,437,8,2,9,21,44,3,19,38271,274,15848
2600,부산광역시,2610,기장군,,관내사전투표,9997,9997,5297,4413,172,1,50,2,0,3,0,9,0,3,9950,47,0
2600,부산광역시,2610,기장군,,정관읍제1투,3423,1836,828,899,55,1,31,1,0,0,2,2,0,2,1821,15,1587
2600,부산광역시,2610,기장군,,정관읍제2투,2668,1675,710,884,41,1,10,0,0,1,1,4,0,1,1653,22,993
2600,부산광역시,2610,기장군,,정관읍제3투,541,390,70,308,4,0,3,0,0,0,0,1,0,1,387,3,151
2600,부산광역시,2610,기장군,,정관읍제4투,3047,2063,959,1014,51,1,19,0,0,0,1,3,0,1,2049,14,984
2600,부산광역시,2610,기장군,,정관읍제5투,4072,2822,1424,1266,76,1,33,0,0,0,3,1,0,1,2805,17,1250
2600,부산광역시,2610,기장군,,정관읍제6투,3510,2173,933,1112,49,2,42,0,0,1,3,6,0,0,2148,25,1337
2600,부산광역시,2610,기장군,,정관읍제7투,3329,2143,1025,1003,63,2,29,1,0,0,1,0,0,0,2124,19,1186
2600,부산광역시,2610,기장군,,정관읍제8투,4099,2741,1371,1257,63,1,20,1,0,1,3,1,1,1,2720,21,1358
2600,부산광역시,2610,기장군,,정관읍제9투,2781,1730,773,884,27,1,28,1,0,0,2,3,0,1,1720,10,1051
2600,부산광역시,2610,기장군,,정관읍제10투,3341,2380,1171,1099,59,0,26,1,0,0,1,5,2,0,2364,16,961
2600,부산광역시,2610,기장군,,정관읍제11투,2036,1337,581,685,30,0,28,0,0,0,0,3,0,1,1328,9,699
2600,부산광역시,2610,기장군,,정관읍제12투,2346,1384,643,670,41,2,16,0,2,0,2,0,0,0,1376,8,962
2600,부산광역시,2610,기장군,,정관읍제13투,1989,1238,533,640,39,0,13,1,0,1,1,2,0,0,1230,8,751
2600,부산광역시,2610,기장군,,정관읍제14투,2226,1336,658,605,37,1,23,0,0,0,0,1,0,1,1326,10,890
2600,부산광역시,2610,기장군,,정관읍제15투,2013,1329,520,733,29,2,29,0,0,0,0,1,0,3,1317,12,684
2600,부산광역시,2610,기장군,,정관읍제16투,2975,1971,884,988,36,0,37,0,0,2,1,2,0,3,1953,18,1004
2600,부산광역시,2610,기장군,철마면,소계,6552,4991,1763,3029,96,3,52,0,0,1,4,9,3,5,4965,26,1561
2600,부산광역시,2610,기장군,,관내사전투표,1598,1598,745,814,23,0,8,0,0,0,0,3,0,1,1594,4,0
2600,부산광역시,2610,기장군,,철마면제1투,1047,685,154,498,16,2,6,0,0,0,0,1,0,1,678,7,362
2600,부산광역시,2610,기장군,,철마면제2투,724,505,130,358,5,0,9,0,0,0,0,1,0,1,504,1,219
2600,부산광역시,2610,기장군,,철마면제3투,3183,2203,734,1359,52,1,29,0,0,1,4,4,3,2,2189,14,980
2600,부산광역시,2610,기장군,잘못 투입·구분된 투표지,,0,0,0,0,0,0,0,0,0,0,0,0,0,0,0,0,0
2600,부산광역시,2611,사하구,합계,,268754,196600,78332,108983,4277,91,2304,49,34,45,156,254,62,102,194689,1911,72154
2600,부산광역시,2611,사하구,거소·선상투표,,748,626,201,304,13,1,12,1,0,1,2,0,1,2,538,88,122
2600,부산광역시,2611,사하구,관외사전투표,,19976,19976,8611,10212,485,12,330,10,5,5,10,32,6,21,19739,237,0
2600,부산광역시,2611,사하구,재외투표,,999,733,434,195,25,0,1,0,0,0,2,0,0,0,657,76,266
2600,부산광역시,2611,사하구,괴정제1동,소계,16237,11877,4349,7046,228,6,88,2,3,3,13,19,4,4,11765,112,4360
2600,부산광역시,2611,사하구,,관내사전투표,5172,5172,2147,2879,85,2,18,1,0,0,2,8,0,3,5145,27,0
2600,부산광역시,2611,사하구,,괴정제1동제1투,1946,1179,409,706,19,0,18,1,1,2,2,4,2,1,1165,14,767
2600,부산광역시,2611,사하구,,괴정제1동제2투,2263,1333,390,871,36,2,16,0,1,0,5,3,1,0,1325,8,930
2600,부산광역시,2611,사하구,,괴정제1동제3투,2523,1532,510,946,35,0,13,0,0,0,1,2,0,0,1507,25,991
2600,부산광역시,2611,사하구,,괴정제1동제4투,1889,1185,396,732,21,1,14,0,1,1,2,1,1,0,1170,15,704
2600,부산광역시,2611,사하구,,괴정제1동제5투,2444,1476,497,912,32,1,9,0,0,0,1,1,0,0,1453,23,968
2600,부산광역시,2611,사하구,괴정제2동,소계,10700,7386,2739,4337,151,4,83,3,0,2,5,8,2,2,7336,50,3314
2600,부산광역시,2611,사하구,,관내사전투표,2702,2702,1169,1446,51,1,17,1,0,1,0,6,1,0,2693,9,0
2600,부산광역시,2611,사하구,,괴정제2동제1투,1825,1041,342,655,16,0,14,1,0,0,3,1,0,0,1032,9,784
2600,부산광역시,2611,사하구,,괴정제2동제2투,2084,1316,485,758,38,2,19,0,0,1,2,0,1,1,1307,9,768
2600,부산광역시,2611,사하구,,괴정제2동제3투,2292,1253,409,783,32,1,19,0,0,0,0,0,0,0,1244,9,1039
2600,부산광역시,2611,사하구,,괴정제2동제4투,1797,1074,334,695,14,0,14,1,0,0,0,1,0,1,1060,14,723
2600,부산광역시,2611,사하구,괴정제3동,소계,11201,8193,3071,4799,156,1,75,1,0,2,7,13,5,4,8134,59,3008
2600,부산광역시,2611,사하구,,관내사전투표,3830,3830,1621,2088,76,0,20,0,0,1,1,7,0,0,3814,16,0
2600,부산광역시,2611,사하구,,괴정제3동제1투,2150,1195,432,695,28,1,15,0,0,0,4,3,3,0,1181,14,955
2600,부산광역시,2611,사하구,,괴정제3동제2투,2581,1571,510,990,23,0,24,0,0,1,1,1,2,3,1555,16,1010
2600,부산광역시,2611,사하구,,괴정제3동제3투,2640,1597,508,1026,29,0,16,1,0,0,1,2,0,1,1584,13,1043
2600,부산광역시,2611,사하구,괴정제4동,소계,9834,7151,2652,4177,147,6,81,0,2,2,7,11,2,4,7091,60,2683
2600,부산광역시,2611,사하구,,관내사전투표,3154,3154,1345,1705,54,2,26,0,0,2,1,5,0,1,3141,13,0
2600,부산광역시,2611,사하구,,괴정제4동제1투,2382,1489,519,894,30,1,20,0,1,0,2,4,2,2,1475,14,893
2600,부산광역시,2611,사하구,,괴정제4동제2투,2268,1344,433,839,36,2,13,0,0,0,3,1,0,1,1328,16,924
2600,부산광역시,2611,사하구,,괴정제4동제3투,1055,600,178,381,16,1,13,0,0,0,1,0,0,0,590,10,455
2600,부산광역시,2611,사하구,,괴정제4동제4투,975,564,177,358,11,0,9,0,1,0,0,1,0,0,557,7,411
2600,부산광역시,2611,사하구,당리동,소계,20972,15377,5852,8872,317,6,164,1,5,4,15,16,4,2,15258,119,5595
2600,부산광역시,2611,사하구,,관내사전투표,6004,6004,2610,3194,116,2,38,1,1,0,2,8,1,1,5974,30,0
2600,부산광역시,2611,사하구,,당리동제1투,2973,2016,791,1130,56,2,24,0,0,0,0,1,0,0,2004,12,957
2600,부산광역시,2611,사하구,,당리동제2투,2140,1272,423,794,24,0,20,0,1,1,0,0,0,0,1263,9,868
2600,부산광역시,2611,사하구,,당리동제3투,1926,1179,362,759,23,0,16,0,0,0,3,1,1,0,1165,14,747
2600,부산광역시,2611,사하구,,당리동제4투,2077,1185,390,739,27,1,16,0,0,0,2,0,0,1,1176,9,892
2600,부산광역시,2611,사하구,,당리동제5투,1964,1131,393,692,21,0,10,0,0,2,1,2,1,0,1122,9,833
2600,부산광역시,2611,사하구,,당리동제6투,1955,1325,465,779,28,0,19,0,0,1,5,1,1,0,1299,26,630
2600,부산광역시,2611,사하구,,당리동제7투,1933,1265,418,785,22,1,21,0,3,0,2,3,0,0,1255,10,668
2600,부산광역시,2611,사하구,하단제1동,소계,17947,13090,5101,7402,271,8,146,3,4,5,4,16,6,6,12972,118,4857
2600,부산광역시,2611,사하구,,관내사전투표,4987,4987,2202,2566,109,4,41,1,0,0,0,8,4,2,4937,50,0
2600,부산광역시,2611,사하구,,하단제1동제1투,2020,1261,395,805,24,0,17,0,1,0,0,3,1,1,1247,14,759
2600,부산광역시,2611,사하구,,하단제1동제2투,2817,1401,510,811,25,1,31,1,0,0,1,0,1,1,1382,19,1416
2600,부산광역시,2611,사하구,,하단제1동제3투,2866,1565,550,927,40,1,25,1,1,3,1,0,0,1,1550,15,1301
2600,부산광역시,2611,사하구,,하단제1동제4투,2897,2115,781,1255,43,2,17,0,1,2,1,3,0,0,2105,10,782
2600,부산광역시,2611,사하구,,하단제1동제5투,2360,1761,663,1038,30,0,15,0,1,0,1,2,0,1,1751,10,599
2600,부산광역시,2611,사하구,하단제2동,소계,19418,13398,5073,7692,305,6,140,4,3,3,6,19,3,5,13259,139,6020
2600,부산광역시,2611,사하구,,관내사전투표,4555,4554,2067,2322,90,2,26,3,0,0,1,9,2,1,4523,31,1
2600,부산광역시,2611,사하구,,하단제2동제1투,2621,1634,529,1029,40,0,16,0,0,0,1,2,0,1,1618,16,987
2600,부산광역시,2611,사하구,,하단제2동제2투,3336,1975,637,1216,48,4,33,0,0,0,0,4,1,1,1944,31,1361
2600,부산광역시,2611,사하구,,하단제2동제3투,3020,1504,533,901,31,0,21,0,0,0,2,0,0,0,1488,16,1516
2600,부산광역시,2611,사하구,,하단제2동제4투,3282,2077,678,1285,51,0,27,0,1,1,1,1,0,2,2047,30,1205
2600,부산광역시,2611,사하구,,하단제2동제5투,2604,1654,629,939,45,0,17,1,2,2,1,3,0,0,1639,15,950
2600,부산광역시,2611,사하구,신평제1동,소계,14284,9863,3982,5408,211,3,120,3,1,1,12,11,6,5,9763,100,4421
2600,부산광역시,2611,사하구,,관내사전투표,4432,4432,1954,2321,91,0,29,0,0,0,1,5,2,2,4405,27,0
2600,부산광역시,2611,사하구,,신평제1동제1투,3337,2001,794,1102,47,0,26,0,0,1,9,2,2,1,1984,17,1336
2600,부산광역시,2611,사하구,,신평제1동제2투,2168,1123,406,638,29,1,25,2,0,0,0,2,0,0,1103,20,1045
2600,부산광역시,2611,사하구,,신평제1동제3투,2139,1039,363,623,16,1,17,0,0,0,2,0,2,0,1024,15,1100
2600,부산광역시,2611,사하구,,신평제1동제4투,2208,1268,465,724,28,1,23,1,1,0,0,2,0,2,1247,21,940
2600,부산광역시,2611,사하구,신평제2동,소계,13903,10214,4268,5445,262,5,123,2,1,3,7,8,1,1,10126,88,3689
2600,부산광역시,2611,사하구,,관내사전투표,4607,4607,2173,2242,109,2,43,2,1,1,0,3,1,1,4578,29,0
2600,부산광역시,2611,사하구,,신평제2동제1투,2081,951,318,566,22,1,21,0,0,0,4,1,0,0,933,18,1130
2600,부산광역시,2611,사하구,,신평제2동제2투,2755,1839,716,1047,43,0,17,0,0,2,0,2,0,0,1827,12,916
2600,부산광역시,2611,사하구,,신평제2동제3투,2050,1270,472,719,36,2,23,0,0,0,2,0,0,0,1254,16,780
2600,부산광역시,2611,사하구,,신평제2동제4투,2410,1547,589,871,52,0,19,0,0,0,1,2,0,0,1534,13,863
2600,부산광역시,2611,사하구,장림제1동,소계,9370,6559,2939,3320,144,4,75,2,0,1,5,6,0,7,6503,56,2811
2600,부산광역시,2611,사하구,,관내사전투표,2973,2973,1437,1432,53,1,26,0,0,0,1,5,0,3,2958,15,0
2600,부산광역시,2611,사하구,,장림제1동제1투,1289,640,209,396,16,0,10,1,0,0,0,0,0,1,633,7,649
2600,부산광역시,2611,사하구,,장림제1동제2투,1992,959,316,592,14,1,18,1,0,0,2,0,0,2,946,13,1033
2600,부산광역시,2611,사하구,,장림제1동제3투,3116,1987,977,900,61,2,21,0,0,1,2,1,0,1,1966,21,1129
2600,부산광역시,2611,사하구,장림제2동,소계,21161,14164,5820,7673,308,7,175,3,2,3,17,20,3,7,14038,126,6997
2600,부산광역시,2611,사하구,,관내사전투표,4676,4676,2135,2401,70,3,30,0,1,1,1,7,2,2,4653,23,0
2600,부산광역시,2611,사하구,,장림제2동제1투,2149,993,304,618,23,1,22,1,0,1,1,2,0,1,974,19,1156
2600,부산광역시,2611,사하구,,장림제2동제2투,2475,1398,597,716,49,0,14,1,0,0,7,1,1,1,1387,11,1077
2600,부산광역시,2611,사하구,,장림제2동제3투,2478,1531,609,849,22,1,24,1,1,0,2,3,0,0,1512,19,947
2600,부산광역시,2611,사하구,,장림제2동제4투,2542,1560,558,908,44,1,23,0,0,1,0,3,0,2,1540,20,982
2600,부산광역시,2611,사하구,,장림제2동제5투,3508,2006,804,1087,50,1,31,0,0,0,5,3,0,1,1982,24,1502
2600,부산광역시,2611,사하구,,장림제2동제6투,3333,2000,813,1094,50,0,31,0,0,0,1,1,0,0,1990,10,1333
2600,부산광역시,2611,사하구,다대제1동,소계,29830,21075,8722,11357,490,5,252,7,3,5,14,31,6,6,20898,177,8755
2600,부산광역시,2611,사하구,,관내사전투표,6159,6159,2784,3171,110,3,53,2,1,0,0,10,1,1,6136,23,0
2600,부산광역시,2611,사하구,,다대제1동제1투,2738,1538,641,811,42,1,19,0,0,0,0,3,1,0,1518,20,1200
2600,부산광역시,2611,사하구,,다대제1동제2투,2341,1373,467,832,34,0,22,0,1,0,1,2,0,0,1359,14,968
2600,부산광역시,2611,사하구,,다대제1동제3투,1715,938,324,556,25,0,16,2,0,1,1,1,1,2,929,9,777
2600,부산광역시,2611,사하구,,다대제1동제4투,2041,1399,541,779,35,0,22,0,0,0,1,0,0,0,1378,21,642
2600,부산광역시,2611,사하구,,다대제1동제5투,2289,1400,573,740,38,0,27,2,0,0,1,1,1,1,1384,16,889
2600,부산광역시,2611,사하구,,다대제1동제6투,1805,1035,471,497,33,0,18,0,0,0,3,2,1,0,1025,10,770
2600,부산광역시,2611,사하구,,다대제1동제7투,2364,1640,603,952,35,0,20,0,0,2,3,6,0,0,1621,19,724
2600,부산광역시,2611,사하구,,다대제1동제8투,1433,839,278,517,13,0,20,0,0,2,1,1,0,0,832,7,594
2600,부산광역시,2611,사하구,,다대제1동제9투,1377,834,346,437,26,0,10,1,0,0,1,0,1,1,823,11,543
2600,부산광역시,2611,사하구,,다대제1동제10투,3094,2119,908,1119,57,0,15,0,1,0,0,2,0,0,2102,17,975
2600,부산광역시,2611,사하구,,다대제1동제11투,2474,1801,786,946,42,1,10,0,0,0,2,3,0,1,1791,10,673
2600,부산광역시,2611,사하구,다대제2동,소계,22096,16098,6325,9075,312,7,178,4,2,4,15,25,6,11,15964,134,5998
2600,부산광역시,2611,사하구,,관내사전투표,5497,5497,2415,2913,91,2,30,3,0,1,3,8,2,3,5471,26,0
2600,부산광역시,2611,사하구,,다대제2동제1투,1906,1348,535,751,26,0,22,0,0,0,1,3,0,0,1338,10,558
2600,부산광역시,2611,사하구,,다대제2동제2투,2049,1518,549,894,38,1,20,0,0,1,1,0,0,1,1505,13,531
2600,부산광역시,2611,사하구,,다대제2동제3투,2177,1317,426,828,25,1,14,1,0,0,0,4,2,1,1302,15,860
2600,부산광역시,2611,사하구,,다대제2동제4투,2319,1366,562,739,26,1,21,0,0,2,3,1,0,1,1356,10,953
2600,부산광역시,2611,사하구,,다대제2동제5투,3222,2005,775,1145,34,1,22,0,0,0,3,1,0,0,1981,24,1217
2600,부산광역시,2611,사하구,,다대제2동제6투,2788,1887,686,1090,56,1,21,0,2,0,1,6,1,2,1866,21,901
2600,부산광역시,2611,사하구,,다대제2동제7투,2138,1160,377,715,16,0,28,0,0,0,3,2,1,3,1145,15,978
2600,부산광역시,2611,사하구,구평동,소계,9942,7038,3038,3672,172,4,89,1,0,0,3,6,0,3,6988,50,2904
2600,부산광역시,2611,사하구,,관내사전투표,2907,2907,1441,1358,59,4,24,0,0,0,0,1,0,1,2888,19,0
2600,부산광역시,2611,사하구,,구평동제1투,1589,1040,428,557,27,0,14,1,0,0,0,3,0,0,1030,10,549
2600,부산광역시,2611,사하구,,구평동제2투,1716,1006,313,634,28,0,21,0,0,0,2,1,0,0,999,7,710
2600,부산광역시,2611,사하구,,구평동제3투,254,155,36,112,3,0,3,0,0,0,0,0,0,0,154,1,99
2600,부산광역시,2611,사하구,,구평동제4투,3476,1930,820,1011,55,0,27,0,0,0,1,1,0,2,1917,13,1546
2600,부산광역시,2611,사하구,감천제1동,소계,15284,10721,4078,6165,232,4,116,1,3,0,11,9,3,9,10631,90,4563
2600,부산광역시,2611,사하구,,관내사전투표,3840,3840,1614,2104,69,0,27,1,1,0,2,5,0,2,3825,15,0
2600,부산광역시,2611,사하구,,감천제1동제1투,2050,1072,339,666,25,2,15,0,1,0,2,1,1,4,1056,16,978
2600,부산광역시,2611,사하구,,감천제1동제2투,1837,849,279,526,18,1,12,0,0,0,2,0,0,0,838,11,988
2600,부산광역시,2611,사하구,,감천제1동제3투,1633,955,332,574,27,0,12,0,0,0,1,0,0,0,946,9,678
2600,부산광역시,2611,사하구,,감천제1동제4투,1711,1241,515,672,27,0,9,0,0,0,1,0,2,0,1226,15,470
2600,부산광역시,2611,사하구,,감천제1동제5투,2061,1387,502,800,40,1,23,0,1,0,1,3,0,3,1374,13,674
2600,부산광역시,2611,사하구,,감천제1동제6투,2152,1377,497,823,26,0,18,0,0,0,2,0,0,0,1366,11,775
2600,부산광역시,2611,사하구,감천제2동,소계,4852,3059,1076,1831,48,2,56,1,0,1,1,4,4,3,3027,32,1793
2600,부산광역시,2611,사하구,,관내사전투표,1119,1119,474,606,17,0,8,0,0,0,0,2,1,2,1110,9,0
2600,부산광역시,2611,사하구,,감천제2동제1투,1406,674,181,457,9,1,18,0,0,1,0,0,0,0,667,7,732
2600,부산광역시,2611,사하구,,감천제2동제2투,1329,728,228,446,15,1,24,0,0,0,1,1,2,1,719,9,601
2600,부산광역시,2611,사하구,,감천제2동제3투,998,538,193,322,7,0,6,1,0,0,0,1,1,0,531,7,460
2600,부산광역시,2611,사하구,잘못 투입·구분된 투표지,,0,2,1,1,0,0,0,0,0,0,0,0,0,0,2,0,-2
2600,부산광역시,2612,금정구,합계,,201647,155206,54772,93283,3500,97,1397,38,29,45,147,234,51,71,153664,1542,46441
2600,부산광역시,2612,금정구,거소·선상투표,,488,439,135,233,5,2,3,0,1,2,0,0,2,2,385,54,49
2600,부산광역시,2612,금정구,관외사전투표,,17155,17154,7071,9138,478,8,192,5,3,4,8,36,6,20,16969,185,1
2600,부산광역시,2612,금정구,재외투표,,1082,804,449,259,20,0,1,0,0,0,1,1,0,0,731,73,278
2600,부산광역시,2612,금정구,서제1동,소계,4650,3135,1039,1962,41,1,46,0,2,0,4,6,3,3,3107,28,1515
2600,부산광역시,2612,금정구,,관내사전투표,1279,1279,480,761,13,0,13,0,0,0,2,2,0,2,1273,6,0
2600,부산광역시,2612,금정구,,서제1동제1투,2267,1190,357,775,15,1,26,0,0,0,2,1,0,0,1177,13,1077
2600,부산광역시,2612,금정구,,서제1동제2투,1104,666,202,426,13,0,7,0,2,0,0,3,3,1,657,9,438
2600,부산광역시,2612,금정구,서제2동,소계,7890,5588,1841,3513,96,4,61,4,1,1,9,5,4,2,5541,47,2302
2600,부산광역시,2612,금정구,,관내사전투표,2237,2237,823,1342,40,0,13,2,1,0,1,2,2,1,2227,10,0
2600,부산광역시,2612,금정구,,서제2동제1투,2037,1280,401,815,15,0,25,1,0,1,3,1,2,1,1265,15,757
2600,부산광역시,2612,금정구,,서제2동제2투,1758,944,255,637,25,1,11,0,0,0,2,1,0,0,932,12,814
2600,부산광역시,2612,금정구,,서제2동제3투,1858,1127,362,719,16,3,12,1,0,0,3,1,0,0,1117,10,731
2600,부산광역시,2612,금정구,서제3동,소계,9563,6605,2196,4113,131,6,84,0,4,3,9,6,5,1,6558,47,2958
2600,부산광역시,2612,금정구,,관내사전투표,2811,2810,1028,1680,49,2,36,0,1,0,1,1,2,0,2800,10,1
2600,부산광역시,2612,금정구,,서제3동제1투,1770,1010,303,669,17,0,7,0,2,0,2,2,2,0,1004,6,760
2600,부산광역시,2612,금정구,,서제3동제2투,1815,1095,351,682,23,2,21,0,1,0,2,1,0,0,1083,12,720
2600,부산광역시,2612,금정구,,서제3동제3투,1834,930,263,620,26,0,12,0,0,0,0,1,0,1,923,7,904
2600,부산광역시,2612,금정구,,서제3동제4투,1333,760,251,462,16,2,8,0,0,3,4,1,1,0,748,12,573
2600,부산광역시,2612,금정구,부곡제1동,소계,7627,5655,1920,3507,95,2,54,1,0,2,12,12,1,1,5607,48,1972
2600,부산광역시,2612,금정구,,관내사전투표,2984,2981,1151,1738,44,1,28,1,0,0,2,5,1,0,2971,10,3
2600,부산광역시,2612,금정구,,부곡제1동제1투,1166,617,152,430,13,0,5,0,0,1,7,1,0,0,609,8,549
2600,부산광역시,2612,금정구,,부곡제1동제2투,2146,1239,366,818,21,1,8,0,0,1,0,2,0,0,1217,22,907
2600,부산광역시,2612,금정구,,부곡제1동제3투,1331,818,251,521,17,0,13,0,0,0,3,4,0,1,810,8,513
2600,부산광역시,2612,금정구,부곡제2동,소계,14049,10665,3836,6344,255,8,96,4,1,3,8,12,5,5,10577,88,3384
2600,부산광역시,2612,금정구,,관내사전투표,4192,4192,1658,2385,95,4,22,3,1,0,3,4,1,0,4176,16,0
2600,부산광역시,2612,금정구,,부곡제2동제1투,1529,927,317,570,20,0,9,0,0,0,1,1,1,1,920,7,602
2600,부산광역시,2612,금정구,,부곡제2동제2투,2483,1502,465,940,31,1,35,0,0,0,2,3,3,1,1481,21,981
2600,부산광역시,2612,금정구,,부곡제2동제3투,3091,1969,715,1145,56,1,20,1,0,2,1,4,0,1,1946,23,1122
2600,부산광역시,2612,금정구,,부곡제2동제4투,2754,2075,681,1304,53,2,10,0,0,1,1,0,0,2,2054,21,679
2600,부산광역시,2612,금정구,부곡제3동,소계,13291,10385,3802,6156,241,4,74,2,3,0,6,14,4,1,10307,78,2906
2600,부산광역시,2612,금정구,,관내사전투표,4765,4765,2054,2544,111,2,22,1,0,0,1,5,1,0,4741,24,0
2600,부산광역시,2612,금정구,,부곡제3동제1투,891,551,179,346,12,0,5,0,1,0,3,0,0,0,546,5,340
2600,부산광역시,2612,금정구,,부곡제3동제2투,1713,1013,294,666,24,2,12,0,0,0,0,2,0,0,1000,13,700
2600,부산광역시,2612,금정구,,부곡제3동제3투,3197,2020,605,1323,41,0,20,0,0,0,1,6,2,0,1998,22,1177
2600,부산광역시,2612,금정구,,부곡제3동제4투,2725,2036,670,1277,53,0,15,1,2,0,1,1,1,1,2022,14,689
2600,부산광역시,2612,금정구,부곡제4동,소계,10639,7869,2590,4879,180,7,92,1,0,2,10,10,1,4,7776,93,2770
2600,부산광역시,2612,금정구,,관내사전투표,3681,3681,1369,2187,74,3,19,1,0,0,2,2,0,1,3658,23,0
2600,부산광역시,2612,금정구,,부곡제4동제1투,2236,1344,395,867,31,2,19,0,0,0,2,2,0,0,1318,26,892
2600,부산광역시,2612,금정구,,부곡제4동제2투,1776,1117,339,700,32,0,17,0,0,2,5,4,0,2,1101,16,659
2600,부산광역시,2612,금정구,,부곡제4동제3투,1293,734,189,490,14,2,21,0,0,0,1,0,1,0,718,16,559
2600,부산광역시,2612,금정구,,부곡제4동제4투,1653,993,298,635,29,0,16,0,0,0,0,2,0,1,981,12,660
2600,부산광역시,2612,금정구,장전제1동,소계,13900,10457,3651,6166,323,5,82,3,4,4,9,33,0,3,10283,174,3443
2600,부산광역시,2612,금정구,,관내사전투표,4558,4556,1840,2473,131,4,20,1,1,0,1,20,0,3,4494,62,2
2600,부산광역시,2612,금정구,,장전제1동제1투,2326,1410,414,887,50,0,19,0,1,0,1,3,0,0,1375,35,916
2600,부산광역시,2612,금정구,,장전제1동제2투,2730,1689,482,1070,57,1,23,2,1,1,2,6,0,0,1645,44,1041
2600,부산광역시,2612,금정구,,장전제1동제3투,2042,1267,359,831,38,0,11,0,1,1,5,2,0,0,1248,19,775
2600,부산광역시,2612,금정구,,장전제1동제4투,2244,1535,556,905,47,0,9,0,0,2,0,2,0,0,1521,14,709
2600,부산광역시,2612,금정구,장전제2동,소계,19050,14182,4992,8602,323,3,87,4,2,3,21,17,3,3,14060,122,4868
2600,부산광역시,2612,금정구,,관내사전투표,5178,5178,2142,2867,100,0,21,2,2,0,1,4,2,1,5142,36,0
2600,부산광역시,2612,금정구,,장전제2동제1투,1632,921,289,590,16,0,8,0,0,1,2,1,0,0,907,14,711
2600,부산광역시,2612,금정구,,장전제2동제2투,2366,1479,408,1000,38,0,8,1,0,1,4,3,1,0,1464,15,887
2600,부산광역시,2612,금정구,,장전제2동제3투,2451,1759,640,1034,45,1,11,0,0,0,5,2,0,0,1738,21,692
2600,부산광역시,2612,금정구,,장전제2동제4투,1637,957,266,649,20,2,6,1,0,1,1,2,0,0,948,9,680
2600,부산광역시,2612,금정구,,장전제2동제5투,2970,1667,513,1075,42,0,17,0,0,0,4,1,0,2,1654,13,1303
2600,부산광역시,2612,금정구,,장전제2동제6투,2816,2221,734,1387,62,0,16,0,0,0,4,4,0,0,2207,14,595
2600,부산광역시,2612,금정구,선두구동,소계,2358,1887,576,1235,34,0,20,1,1,0,1,0,0,2,1870,17,471
2600,부산광역시,2612,금정구,,관내사전투표,1117,1117,436,644,20,0,9,0,0,0,0,0,0,2,1111,6,0
2600,부산광역시,2612,금정구,,선두구동투표소,1241,770,140,591,14,0,11,1,1,0,1,0,0,0,759,11,471
2600,부산광역시,2612,금정구,청룡노포동,소계,8221,6353,2074,4063,100,5,42,0,0,2,4,12,1,3,6306,47,1868
2600,부산광역시,2612,금정구,,관내사전투표,3254,3253,1222,1938,49,2,14,0,0,0,0,7,1,1,3234,19,1
2600,부산광역시,2612,금정구,,청룡노포동제1투,2223,1396,444,893,28,2,13,0,0,1,2,0,0,1,1384,12,827
2600,부산광역시,2612,금정구,,청룡노포동제2투,2260,1390,340,995,21,0,13,0,0,1,2,4,0,1,1377,13,870
2600,부산광역시,2612,금정구,,청룡노포동제3투,484,314,68,237,2,1,2,0,0,0,0,1,0,0,311,3,170
2600,부산광역시,2612,금정구,남산동,소계,22935,16469,5611,10089,337,17,194,4,5,2,20,28,5,6,16318,151,6466
2600,부산광역시,2612,금정구,,관내사전투표,5906,5906,2265,3433,106,5,38,1,2,0,4,15,2,0,5871,35,0
2600,부산광역시,2612,금정구,,남산동제1투,2004,1267,410,793,29,1,13,0,2,0,1,2,0,1,1252,15,737
2600,부산광역시,2612,금정구,,남산동제2투,2182,1301,427,807,18,2,31,0,0,0,1,3,0,1,1290,11,881
2600,부산광역시,2612,금정구,,남산동제3투,2301,1443,456,917,31,3,17,0,0,0,1,0,1,2,1428,15,858
2600,부산광역시,2612,금정구,,남산동제4투,2794,1769,517,1148,40,0,32,0,0,0,2,0,2,1,1742,27,1025
2600,부산광역시,2612,금정구,,남산동제5투,2425,1566,480,1004,33,2,21,2,0,1,3,6,0,1,1553,13,859
2600,부산광역시,2612,금정구,,남산동제6투,3312,1899,627,1177,42,2,26,0,0,1,4,0,0,0,1879,20,1413
2600,부산광역시,2612,금정구,,남산동제7투,2011,1318,429,810,38,2,16,1,1,0,4,2,0,0,1303,15,693
2600,부산광역시,2612,금정구,구서제1동,소계,15708,12238,4370,7376,279,7,77,0,0,2,13,10,0,5,12139,99,3470
2600,부산광역시,2612,금정구,,관내사전투표,6028,6028,2449,3407,116,4,18,0,0,0,1,5,0,2,6002,26,0
2600,부산광역시,2612,금정구,,구서제1동제1투,2421,1570,468,1009,49,0,21,0,0,0,2,2,0,1,1552,18,851
2600,부산광역시,2612,금정구,,구서제1동제2투,3012,1754,567,1096,39,2,22,0,0,1,7,1,0,1,1736,18,1258
2600,부산광역시,2612,금정구,,구서제1동제3투,2200,1566,466,1025,44,0,7,0,0,0,3,1,0,0,1546,20,634
2600,부산광역시,2612,금정구,,구서제1동제4투,2047,1320,420,839,31,1,9,0,0,1,0,1,0,1,1303,17,727
2600,부산광역시,2612,금정구,구서제2동,소계,25258,19676,6761,12124,442,10,133,7,1,12,9,21,6,9,19535,141,5582
2600,부산광역시,2612,금정구,,관내사전투표,7105,7105,3001,3882,144,3,26,3,0,1,2,11,4,3,7080,25,0
2600,부산광역시,2612,금정구,,구서제2동제1투,2698,1583,517,980,38,1,22,0,1,0,2,3,0,0,1564,19,1115
2600,부산광역시,2612,금정구,,구서제2동제2투,2088,1373,394,917,31,0,16,0,0,4,0,1,0,0,1363,10,715
2600,부산광역시,2612,금정구,,구서제2동제3투,2512,1539,466,980,44,2,16,1,0,0,0,0,2,2,1513,26,973
2600,부산광역시,2612,금정구,,구서제2동제4투,2519,1807,579,1152,29,3,20,1,0,3,0,1,0,2,1790,17,712
2600,부산광역시,2612,금정구,,구서제2동제5투,2388,1583,489,1007,55,1,11,1,0,1,3,2,0,1,1571,12,805
2600,부산광역시,2612,금정구,,구서제2동제6투,2842,2274,720,1470,57,0,9,0,0,1,1,0,0,0,2258,16,568
2600,부산광역시,2612,금정구,,구서제2동제7투,3106,2412,595,1736,44,0,13,1,0,2,1,3,0,1,2396,16,694
2600,부산광역시,2612,금정구,금성동,소계,841,689,240,405,22,1,6,0,0,1,0,6,1,1,683,6,152
2600,부산광역시,2612,금정구,,관내사전투표,361,361,151,193,12,0,1,0,0,0,0,1,0,1,359,2,0
2600,부산광역시,2612,금정구,,금성동투표소,480,328,89,212,10,1,5,0,0,1,0,5,1,0,324,4,152
2600,부산광역시,2612,금정구,금사회동동,소계,6942,4956,1618,3119,98,7,53,2,1,2,3,5,4,0,4912,44,1986
2600,부산광역시,2612,금정구,,관내사전투표,2253,2253,856,1314,41,4,14,1,0,0,1,3,1,0,2235,18,0
2600,부산광역시,2612,금정구,,금사회동동제1투,1454,827,238,560,10,0,13,0,0,0,1,1,0,0,823,4,627
2600,부산광역시,2612,금정구,,금사회동동제2투,1822,1022,295,665,26,1,18,0,0,2,0,1,1,0,1009,13,800
2600,부산광역시,2612,금정구,,금사회동동제3투,1413,854,229,580,21,2,8,1,1,0,1,0,2,0,845,9,559
2600,부산광역시,2612,금정구,잘못 투입·구분된 투표지,,0,0,0,0,0,0,0,0,0,0,0,0,0,0,0,0,0
2600,부산광역시,2613,강서구,합계,,112330,84488,36016,44889,1834,30,944,8,15,14,42,72,16,21,83901,587,27842
2600,부산광역시,2613,강서구,거소·선상투표,,186,172,63,77,5,0,3,0,0,0,1,2,0,1,152,20,14
2600,부산광역시,2613,강서구,관외사전투표,,10798,10798,4609,5705,233,7,135,2,3,2,1,15,0,4,10716,82,0
2600,부산광역시,2613,강서구,재외투표,,463,319,164,109,6,0,0,0,0,0,0,1,0,0,280,39,144
2600,부산광역시,2613,강서구,대저1동,소계,5400,3876,1291,2441,58,1,44,0,1,0,2,2,1,1,3842,34,1524
2600,부산광역시,2613,강서구,,관내사전투표,1447,1447,550,849,21,0,13,0,1,0,0,1,0,0,1435,12,0
2600,부산광역시,2613,강서구,,대저1동제1투,917,524,171,331,12,0,5,0,0,0,0,0,0,0,519,5,393
2600,부산광역시,2613,강서구,,대저1동제2투,756,454,117,315,10,1,7,0,0,0,0,1,1,0,452,2,302
2600,부산광역시,2613,강서구,,대저1동제3투,865,558,148,395,3,0,6,0,0,0,2,0,0,1,555,3,307
2600,부산광역시,2613,강서구,,대저1동제4투,730,463,154,283,7,0,11,0,0,0,0,0,0,0,455,8,267
2600,부산광역시,2613,강서구,,대저1동제5투,685,430,151,268,5,0,2,0,0,0,0,0,0,0,426,4,255
2600,부산광역시,2613,강서구,대저2동,소계,5511,3998,1385,2471,55,4,43,0,0,2,3,3,1,1,3968,30,1513
2600,부산광역시,2613,강서구,,관내사전투표,1751,1751,747,947,25,3,17,0,0,0,1,1,1,1,1743,8,0
2600,부산광역시,2613,강서구,,대저2동제1투,1354,780,274,468,17,1,10,0,0,0,0,0,0,0,770,10,574
2600,부산광역시,2613,강서구,,대저2동제2투,937,645,158,473,4,0,4,0,0,0,1,1,0,0,641,4,292
2600,부산광역시,2613,강서구,,대저2동제3투,1469,822,206,583,9,0,12,0,0,2,1,1,0,0,814,8,647
2600,부산광역시,2613,강서구,강동동,소계,3573,2621,825,1708,39,0,22,0,1,2,4,2,1,1,2605,16,952
2600,부산광역시,2613,강서구,,관내사전투표,1137,1137,385,719,20,0,8,0,0,2,0,1,0,1,1136,1,0
2600,부산광역시,2613,강서구,,강동동제1투,662,386,119,244,12,0,1,0,0,0,3,1,0,0,380,6,276
2600,부산광역시,2613,강서구,,강동동제2투,1000,619,160,438,4,0,10,0,1,0,0,0,1,0,614,5,381
2600,부산광역시,2613,강서구,,강동동제3투,774,479,161,307,3,0,3,0,0,0,1,0,0,0,475,4,295
2600,부산광역시,2613,강서구,가락동,소계,2012,1528,516,949,26,1,24,0,0,1,1,0,0,0,1518,10,484
2600,부산광역시,2613,강서구,,관내사전투표,798,798,298,473,15,1,9,0,0,0,0,0,0,0,796,2,0
2600,부산광역시,2613,강서구,,가락동제1투,702,416,125,271,7,0,9,0,0,1,0,0,0,0,413,3,286
2600,부산광역시,2613,강서구,,가락동제2투,512,314,93,205,4,0,6,0,0,0,1,0,0,0,309,5,198
2600,부산광역시,2613,강서구,녹산동,소계,23323,14623,6360,7542,339,10,246,2,2,4,16,15,6,1,14543,80,8700
2600,부산광역시,2613,강서구,,관내사전투표,2124,2124,1057,1004,37,1,15,0,0,0,1,1,0,1,2117,7,0
2600,부산광역시,2613,강서구,,녹산동제1투,667,378,99,270,4,0,2,0,0,0,0,1,1,0,377,1,289
2600,부산광역시,2613,강서구,,녹산동제2투,1635,867,270,558,12,0,13,1,0,2,5,2,0,0,863,4,768
2600,부산광역시,2613,강서구,,녹산동제3투,914,476,156,304,8,0,7,0,0,0,0,1,0,0,476,0,438
2600,부산광역시,2613,강서구,,녹산동제4투,3460,1980,977,896,56,2,41,0,0,0,0,1,0,0,1973,7,1480
2600,부산광역시,2613,강서구,,녹산동제5투,3098,1713,710,895,37,1,41,1,0,0,2,0,1,0,1688,25,1385
2600,부산광역시,2613,강서구,,녹산동제6투,3530,2112,915,1100,55,2,33,0,1,0,1,2,0,0,2109,3,1418
2600,부산광역시,2613,강서구,,녹산동제7투,3639,2256,992,1146,64,2,38,0,0,1,0,3,3,0,2249,7,1383
2600,부산광역시,2613,강서구,,녹산동제8투,2533,1603,734,781,34,0,33,0,1,1,6,0,1,0,1591,12,930
2600,부산광역시,2613,강서구,,녹산동제9투,1723,1114,450,588,32,2,23,0,0,0,1,4,0,0,1100,14,609
2600,부산광역시,2613,강서구,가덕도동,소계,3097,2204,781,1347,22,2,32,0,1,0,2,0,0,3,2190,14,893
2600,부산광역시,2613,강서구,,관내사전투표,1026,1026,394,604,14,0,9,0,0,0,1,0,0,1,1023,3,0
2600,부산광역시,2613,강서구,,가덕도동제1투,904,457,182,255,5,1,9,0,1,0,0,0,0,0,453,4,447
2600,부산광역시,2613,강서구,,가덕도동제2투,725,460,118,324,1,0,10,0,0,0,0,0,0,1,454,6,265
2600,부산광역시,2613,강서구,,가덕도동제3투,442,261,87,164,2,1,4,0,0,0,1,0,0,1,260,1,181
2600,부산광역시,2613,강서구,명지1동,소계,34816,25627,11455,13081,636,3,245,2,3,1,6,23,6,5,25466,161,9189
2600,부산광역시,2613,강서구,,관내사전투표,8168,8168,4058,3841,179,2,46,1,1,0,1,6,2,1,8138,30,0
2600,부산광역시,2613,강서구,,명지1동제1투,3503,1785,587,1105,45,0,29,0,0,0,0,1,1,1,1769,16,1718
2600,부산광역시,2613,강서구,,명지1동제2투,3416,2244,1000,1099,87,0,32,0,1,0,0,5,0,0,2224,20,1172
2600,부산광역시,2613,강서구,,명지1동제3투,3391,2061,825,1133,44,1,31,0,0,0,0,3,1,1,2039,22,1330
2600,부산광역시,2613,강서구,,명지1동제4투,3050,1976,871,1026,49,0,17,1,0,0,2,1,0,0,1967,9,1074
2600,부산광역시,2613,강서구,,명지1동제5투,2957,2020,850,1084,55,0,19,0,0,0,1,1,0,0,2010,10,937
2600,부산광역시,2613,강서구,,명지1동제6투,2757,1968,888,999,47,0,15,0,0,0,1,2,0,0,1952,16,789
2600,부산광역시,2613,강서구,,명지1동제7투,3035,2031,895,1048,48,0,19,0,0,0,1,2,2,1,2016,15,1004
2600,부산광역시,2613,강서구,,명지1동제8투,2239,1679,731,884,35,0,13,0,1,0,0,0,0,1,1665,14,560
2600,부산광역시,2613,강서구,,명지1동제9투,2300,1695,750,862,47,0,24,0,0,1,0,2,0,0,1686,9,605
2600,부산광역시,2613,강서구,명지2동,소계,23151,18722,8567,9459,415,2,150,2,4,2,6,9,1,4,18621,101,4429
2600,부산광역시,2613,강서구,,관내사전투표,8872,8870,4604,3977,167,2,66,2,1,1,1,4,0,1,8826,44,2
2600,부산광역시,2613,강서구,,명지2동제1투,2672,1732,717,936,53,0,16,0,1,0,0,0,0,0,1723,9,940
2600,부산광역시,2613,강서구,,명지2동제2투,1427,952,378,525,27,0,10,0,0,0,0,2,0,1,943,9,475
2600,부산광역시,2613,강서구,,명지2동제3투,1409,894,393,451,22,0,12,0,1,0,4,2,0,0,885,9,515
2600,부산광역시,2613,강서구,,명지2동제4투,1698,1166,529,590,35,0,6,0,1,0,0,0,0,0,1161,5,532
2600,부산광역시,2613,강서구,,명지2동제5투,1861,1397,567,778,36,0,7,0,0,0,1,0,0,2,1391,6,464
2600,부산광역시,2613,강서구,,명지2동제6투,1769,1308,500,758,26,0,12,0,0,0,0,1,1,0,1298,10,461
2600,부산광역시,2613,강서구,,명지2동제7투,1664,1182,309,846,16,0,6,0,0,1,0,0,0,0,1178,4,482
2600,부산광역시,2613,강서구,,명지2동제8투,1779,1221,570,598,33,0,15,0,0,0,0,0,0,0,1216,5,558
2600,부산광역시,2613,강서구,잘못 투입·구분된 투표지,,0,0,0,0,0,0,0,0,0,0,0,0,0,0,0,0,0
2600,부산광역시,2614,연제구,합계,,180732,139351,51471,81889,3087,72,1198,19,16,31,108,209,20,44,138164,1187,41381
2600,부산광역시,2614,연제구,거소·선상투표,,419,389,127,190,9,0,12,0,0,0,0,0,0,0,338,51,30
2600,부산광역시,2614,연제구,관외사전투표,,17025,17022,7142,9059,439,12,165,5,2,1,10,30,4,8,16877,145,3
2600,부산광역시,2614,연제구,재외투표,,747,558,319,162,21,0,4,0,0,0,0,0,0,0,506,52,189
2600,부산광역시,2614,연제구,거제제1동,소계,20354,16006,5900,9435,415,7,90,1,1,2,3,14,1,4,15873,133,4348
2600,부산광역시,2614,연제구,,관내사전투표,4702,4702,2144,2417,104,2,10,0,0,0,0,5,0,2,4684,18,0
2600,부산광역시,2614,연제구,,거제제1동제1투,2423,1769,644,1032,53,0,18,0,0,1,0,1,0,0,1749,20,654
2600,부산광역시,2614,연제구,,거제제1동제2투,2827,2060,654,1323,43,2,16,0,0,0,2,3,1,1,2045,15,767
2600,부산광역시,2614,연제구,,거제제1동제3투,1937,1336,425,864,28,1,7,0,1,0,0,0,0,0,1326,10,601
2600,부산광역시,2614,연제구,,거제제1동제4투,1927,1401,488,846,38,0,6,0,0,1,0,1,0,0,1380,21,526
2600,부산광역시,2614,연제구,,거제제1동제5투,2296,1704,574,1046,56,1,13,0,0,0,0,1,0,0,1691,13,592
2600,부산광역시,2614,연제구,,거제제1동제6투,1893,1198,427,699,45,0,10,1,0,0,1,0,0,0,1183,15,695
2600,부산광역시,2614,연제구,,거제제1동제7투,2349,1836,544,1208,48,1,10,0,0,0,0,3,0,1,1815,21,513
2600,부산광역시,2614,연제구,거제제2동,소계,9057,7247,2603,4382,142,5,48,0,1,1,3,9,0,2,7196,51,1810
2600,부산광역시,2614,연제구,,관내사전투표,3102,3102,1279,1737,59,2,7,0,1,0,0,6,0,0,3091,11,0
2600,부산광역시,2614,연제구,,거제제2동제1투,1214,800,234,534,15,1,9,0,0,0,0,0,0,0,793,7,414
2600,부산광역시,2614,연제구,,거제제2동제2투,2094,1506,494,953,30,0,9,0,0,0,1,0,0,1,1488,18,588
2600,부산광역시,2614,연제구,,거제제2동제3투,1476,1009,303,658,22,1,10,0,0,1,2,2,0,0,999,10,467
2600,부산광역시,2614,연제구,,거제제2동제4투,1171,830,293,500,16,1,13,0,0,0,0,1,0,1,825,5,341
2600,부산광역시,2614,연제구,거제제3동,소계,8332,6424,2175,3982,129,2,61,0,0,1,7,11,3,3,6374,50,1908
2600,부산광역시,2614,연제구,,관내사전투표,2922,2922,1159,1662,58,0,18,0,0,0,2,7,2,1,2909,13,0
2600,부산광역시,2614,연제구,,거제제3동제1투,1950,1253,396,801,24,1,16,0,0,0,0,2,1,1,1242,11,697
2600,부산광역시,2614,연제구,,거제제3동제2투,1674,1030,288,687,24,1,12,0,0,1,1,1,0,1,1016,14,644
2600,부산광역시,2614,연제구,,거제제3동제3투,1786,1219,332,832,23,0,15,0,0,0,4,1,0,0,1207,12,567
2600,부산광역시,2614,연제구,거제제4동,소계,7975,6034,2182,3597,125,3,67,1,0,2,9,4,3,1,5994,40,1941
2600,부산광역시,2614,연제구,,관내사전투표,2591,2591,1067,1428,57,3,14,1,0,1,3,0,1,1,2576,15,0
2600,부산광역시,2614,연제구,,거제제4동제1투,2463,1574,516,989,32,0,19,0,0,1,1,1,0,0,1559,15,889
2600,부산광역시,2614,연제구,,거제제4동제2투,1147,717,253,429,20,0,10,0,0,0,0,0,1,0,713,4,430
2600,부산광역시,2614,연제구,,거제제4동제3투,1774,1152,346,751,16,0,24,0,0,0,5,3,1,0,1146,6,622
2600,부산광역시,2614,연제구,연산제1동,소계,13746,10529,3796,6355,206,4,72,1,1,1,7,16,2,0,10461,68,3217
2600,부산광역시,2614,연제구,,관내사전투표,4504,4504,1875,2497,80,1,23,1,1,0,1,9,1,0,4489,15,0
2600,부산광역시,2614,연제구,,연산제1동제1투,2246,1352,435,860,24,1,16,0,0,0,0,4,0,0,1340,12,894
2600,부산광역시,2614,연제구,,연산제1동제2투,2687,1763,572,1120,35,0,17,0,0,0,2,2,1,0,1749,14,924
2600,부산광역시,2614,연제구,,연산제1동제3투,1940,1110,337,724,25,2,10,0,0,1,0,1,0,0,1100,10,830
2600,부산광역시,2614,연제구,,연산제1동제4투,2369,1800,577,1154,42,0,6,0,0,0,4,0,0,0,1783,17,569
2600,부산광역시,2614,연제구,연산제2동,소계,16619,12663,4640,7523,289,2,85,1,1,1,11,14,0,6,12573,90,3956
2600,부산광역시,2614,연제구,,관내사전투표,4913,4913,2068,2676,113,1,24,0,0,0,1,6,0,3,4892,21,0
2600,부산광역시,2614,연제구,,연산제2동제1투,2300,1417,409,942,32,1,14,0,1,0,0,2,0,1,1402,15,883
2600,부산광역시,2614,연제구,,연산제2동제2투,2190,1580,521,982,43,0,8,0,0,1,4,2,0,0,1561,19,610
2600,부산광역시,2614,연제구,,연산제2동제3투,2706,1487,474,957,27,0,14,0,0,0,4,1,0,1,1478,9,1219
2600,부산광역시,2614,연제구,,연산제2동제4투,2686,1805,643,1089,37,0,14,1,0,0,2,3,0,1,1790,15,881
2600,부산광역시,2614,연제구,,연산제2동제5투,1824,1461,525,877,37,0,11,0,0,0,0,0,0,0,1450,11,363
2600,부산광역시,2614,연제구,연산제3동,소계,8248,6098,2175,3656,135,0,60,0,3,5,8,11,1,3,6057,41,2150
2600,부산광역시,2614,연제구,,관내사전투표,2282,2282,901,1314,39,0,9,0,2,0,0,5,0,2,2272,10,0
2600,부산광역시,2614,연제구,,연산제3동제1투,1705,1059,308,694,17,0,23,0,1,0,4,3,1,0,1051,8,646
2600,부산광역시,2614,연제구,,연산제3동제2투,1909,1126,346,716,27,0,17,0,0,4,4,3,0,1,1118,8,783
2600,부산광역시,2614,연제구,,연산제3동제3투,2352,1631,620,932,52,0,11,0,0,1,0,0,0,0,1616,15,721
2600,부산광역시,2614,연제구,연산제4동,소계,13935,10161,3546,6179,218,6,99,0,2,2,7,13,1,3,10076,85,3774
2600,부산광역시,2614,연제구,,관내사전투표,4291,4291,1658,2516,69,3,14,0,1,0,0,9,0,1,4271,20,0
2600,부산광역시,2614,연제구,,연산제4동제1투,1540,1129,387,695,23,0,8,0,0,1,0,1,0,0,1115,14,411
2600,부산광역시,2614,연제구,,연산제4동제2투,1956,1125,332,729,31,1,17,0,1,0,1,0,1,2,1115,10,831
2600,부산광역시,2614,연제구,,연산제4동제3투,2352,1319,409,842,24,1,30,0,0,0,1,1,0,0,1308,11,1033
2600,부산광역시,2614,연제구,,연산제4동제4투,1949,1259,389,799,33,1,18,0,0,1,4,1,0,0,1246,13,690
2600,부산광역시,2614,연제구,,연산제4동제5투,1847,1038,371,598,38,0,12,0,0,0,1,1,0,0,1021,17,809
2600,부산광역시,2614,연제구,연산제5동,소계,13930,9431,3525,5400,235,8,118,1,1,4,7,9,0,3,9311,120,4499
2600,부산광역시,2614,연제구,,관내사전투표,4023,4021,1709,2142,85,4,33,0,0,1,2,5,0,0,3981,40,2
2600,부산광역시,2614,연제구,,연산제5동제1투,2447,1301,417,798,34,0,18,1,0,2,1,3,0,0,1274,27,1146
2600,부산광역시,2614,연제구,,연산제5동제2투,2609,1417,468,859,42,1,19,0,0,0,2,0,0,1,1392,25,1192
2600,부산광역시,2614,연제구,,연산제5동제3투,2458,1326,436,796,36,2,29,0,0,1,2,1,0,2,1305,21,1132
2600,부산광역시,2614,연제구,,연산제5동제4투,2393,1366,495,805,38,1,19,0,1,0,0,0,0,0,1359,7,1027
2600,부산광역시,2614,연제구,연산제6동,소계,13093,9249,3253,5553,193,7,114,6,2,1,12,20,2,7,9170,79,3844
2600,부산광역시,2614,연제구,,관내사전투표,2954,2954,1198,1641,55,1,29,2,0,0,2,8,2,1,2939,15,0
2600,부산광역시,2614,연제구,,연산제6동제1투,979,612,177,404,10,0,14,0,0,0,1,1,0,1,608,4,367
2600,부산광역시,2614,연제구,,연산제6동제2투,2203,1325,380,881,28,2,14,1,1,1,2,3,0,1,1314,11,878
2600,부산광역시,2614,연제구,,연산제6동제3투,2013,1044,355,627,31,1,16,0,0,0,1,1,0,1,1033,11,969
2600,부산광역시,2614,연제구,,연산제6동제4투,1533,938,305,580,13,1,17,0,0,0,2,5,0,1,924,14,595
2600,부산광역시,2614,연제구,,연산제6동제5투,1809,1164,387,714,19,1,18,2,1,0,4,1,0,1,1148,16,645
2600,부산광역시,2614,연제구,,연산제6동제6투,1602,1212,451,706,37,1,6,1,0,0,0,1,0,1,1204,8,390
2600,부산광역시,2614,연제구,연산제8동,소계,11333,8608,3289,4965,182,7,72,0,1,2,9,21,0,1,8549,59,2725
2600,부산광역시,2614,연제구,,관내사전투표,3237,3234,1363,1762,59,2,23,0,0,0,0,12,0,0,3221,13,3
2600,부산광역시,2614,연제구,,연산제8동제1투,1778,959,299,620,17,1,14,0,0,1,2,0,0,0,954,5,819
2600,부산광역시,2614,연제구,,연산제8동제2투,1844,1207,397,748,31,2,10,0,1,0,1,2,0,1,1193,14,637
2600,부산광역시,2614,연제구,,연산제8동제3투,1556,947,288,600,23,2,16,0,0,0,6,3,0,0,938,9,609
2600,부산광역시,2614,연제구,,연산제8동제4투,2918,2261,942,1235,52,0,9,0,0,1,0,4,0,0,2243,18,657
2600,부산광역시,2614,연제구,연산제9동,소계,25919,18929,6799,11448,349,9,131,3,1,8,15,37,3,3,18806,123,6990
2600,부산광역시,2614,연제구,,관내사전투표,5043,5042,2163,2768,60,3,20,0,0,0,3,11,1,0,5029,13,1
2600,부산광역시,2614,연제구,,연산제9동제1투,2846,1956,626,1253,47,1,18,0,0,0,2,2,0,0,1949,7,890
2600,부산광역시,2614,연제구,,연산제9동제2투,2282,1477,448,960,36,0,7,1,0,2,4,3,0,2,1463,14,805
2600,부산광역시,2614,연제구,,연산제9동제3투,2494,1702,605,1039,31,0,11,2,0,1,0,4,0,0,1693,9,792
2600,부산광역시,2614,연제구,,연산제9동제4투,2805,1889,602,1194,41,0,17,0,0,1,3,2,1,0,1861,28,916
2600,부산광역시,2614,연제구,,연산제9동제5투,2168,1199,398,754,18,2,9,0,0,0,1,7,1,0,1190,9,969
2600,부산광역시,2614,연제구,,연산제9동제6투,1763,970,318,611,19,1,13,0,0,0,1,2,0,0,965,5,793
2600,부산광역시,2614,연제구,,연산제9동제7투,2597,1833,640,1121,36,0,15,0,0,3,1,5,0,1,1822,11,764
2600,부산광역시,2614,연제구,,연산제9동제8투,1150,910,252,625,12,0,9,0,0,1,0,0,0,0,899,11,240
2600,부산광역시,2614,연제구,,연산제9동제9투,2771,1951,747,1123,49,2,12,0,1,0,0,1,0,0,1935,16,820
2600,부산광역시,2614,연제구,잘못 투입·구분된 투표지,,0,3,0,3,0,0,0,0,0,0,0,0,0,0,3,0,-3
2600,부산광역시,2615,수영구,합계,,156367,118017,41801,71160,2617,49,1017,22,21,28,104,104,27,40,116990,1027,38350
2600,부산광역시,2615,수영구,거소·선상투표,,376,351,107,191,5,1,8,0,0,0,1,0,0,0,313,38,25
2600,부산광역시,2615,수영구,관외사전투표,,14746,14743,6134,7890,353,7,166,7,4,3,6,19,6,9,14604,139,3
2600,부산광역시,2615,수영구,재외투표,,996,690,349,242,28,0,3,0,1,0,4,1,0,0,628,62,306
2600,부산광역시,2615,수영구,남천제1동,소계,10426,7630,2637,4671,170,2,66,1,1,4,4,10,2,2,7570,60,2796
2600,부산광역시,2615,수영구,,관내사전투표,2758,2758,1206,1456,55,2,16,1,1,1,0,6,0,0,2744,14,0
2600,부산광역시,2615,수영구,,남천제1동제1투,1676,1053,274,739,23,0,7,0,0,0,1,0,1,0,1045,8,623
2600,부산광역시,2615,수영구,,남천제1동제2투,2430,1651,468,1111,29,0,19,0,0,2,0,3,0,1,1633,18,779
2600,부산광역시,2615,수영구,,남천제1동제3투,1597,1073,340,668,37,0,14,0,0,0,1,0,0,0,1060,13,524
2600,부산광역시,2615,수영구,,남천제1동제4투,1965,1095,349,697,26,0,10,0,0,1,2,1,1,1,1088,7,870
2600,부산광역시,2615,수영구,남천제2동,소계,10324,8205,2451,5539,114,3,40,1,0,3,7,7,0,1,8166,39,2119
2600,부산광역시,2615,수영구,,관내사전투표,4154,4154,1480,2575,59,2,18,1,0,2,0,3,0,1,4141,13,0
2600,부산광역시,2615,수영구,,남천제2동제1투,2125,1339,350,945,19,1,8,0,0,0,2,4,0,0,1329,10,786
2600,부산광역시,2615,수영구,,남천제2동제2투,2260,1434,359,1041,16,0,10,0,0,1,0,0,0,0,1427,7,826
2600,부산광역시,2615,수영구,,남천제2동제3투,1785,1278,262,978,20,0,4,0,0,0,5,0,0,0,1269,9,507
2600,부산광역시,2615,수영구,수영동,소계,13302,10135,3266,6492,191,4,85,2,2,2,12,7,0,5,10068,67,3167
2600,부산광역시,2615,수영구,,관내사전투표,4577,4577,1648,2815,70,1,16,2,1,0,1,5,0,3,4562,15,0
2600,부산광역시,2615,수영구,,수영동제1투,2123,1077,355,654,24,1,22,0,1,0,2,0,0,1,1060,17,1046
2600,부산광역시,2615,수영구,,수영동제2투,2634,1658,519,1059,43,1,19,0,0,1,4,1,0,1,1648,10,976
2600,부산광역시,2615,수영구,,수영동제3투,2076,1414,360,988,28,1,16,0,0,1,3,1,0,0,1398,16,662
2600,부산광역시,2615,수영구,,수영동제4투,1892,1409,384,976,26,0,12,0,0,0,2,0,0,0,1400,9,483
2600,부산광역시,2615,수영구,망미제1동,소계,21582,15996,5456,9914,329,7,119,2,2,3,19,20,6,4,15881,115,5586
2600,부산광역시,2615,수영구,,관내사전투표,6491,6491,2551,3754,114,3,32,1,0,0,1,6,3,0,6465,26,0
2600,부산광역시,2615,수영구,,망미제1동제1투,2514,1503,431,994,34,1,13,0,1,2,2,4,1,0,1483,20,1011
2600,부산광역시,2615,수영구,,망미제1동제2투,1841,1252,378,831,16,0,13,1,0,0,1,2,1,0,1243,9,589
2600,부산광역시,2615,수영구,,망미제1동제3투,2488,1578,485,1014,37,1,15,0,0,0,4,3,1,0,1560,18,910
2600,부산광역시,2615,수영구,,망미제1동제4투,2006,1216,375,780,35,1,11,0,0,0,2,0,0,1,1205,11,790
2600,부산광역시,2615,수영구,,망미제1동제5투,1456,907,252,620,12,0,8,0,0,0,3,3,0,0,898,9,549
2600,부산광역시,2615,수영구,,망미제1동제6투,2915,1796,583,1131,48,0,12,0,1,1,2,0,0,2,1780,16,1119
2600,부산광역시,2615,수영구,,망미제1동제7투,1871,1253,401,790,33,1,15,0,0,0,4,2,0,1,1247,6,618
2600,부산광역시,2615,수영구,망미제2동,소계,8494,6291,2240,3799,142,0,52,0,1,3,6,3,1,5,6252,39,2203
2600,부산광역시,2615,수영구,,관내사전투표,2136,2136,864,1222,29,0,13,0,0,0,2,2,0,1,2133,3,0
2600,부산광역시,2615,수영구,,망미제2동제1투,1566,902,301,552,24,0,13,0,0,2,1,0,0,0,893,9,664
2600,부산광역시,2615,수영구,,망미제2동제2투,2541,1816,668,1067,50,0,14,0,1,1,1,0,1,2,1805,11,725
2600,부산광역시,2615,수영구,,망미제2동제3투,2251,1437,407,958,39,0,12,0,0,0,2,1,0,2,1421,16,814
2600,부산광역시,2615,수영구,광안제1동,소계,20963,14492,5426,8328,384,12,158,3,3,4,12,10,2,8,14350,142,6471
2600,부산광역시,2615,수영구,,관내사전투표,5753,5753,2429,3097,135,5,37,2,0,0,2,5,0,4,5716,37,0
2600,부산광역시,2615,수영구,,광안제1동제1투,3379,1765,596,1060,48,2,29,0,0,1,1,1,2,2,1742,23,1614
2600,부산광역시,2615,수영구,,광안제1동제2투,2670,1721,624,1010,44,1,22,0,0,0,4,0,0,0,1705,16,949
2600,부산광역시,2615,수영구,,광안제1동제3투,2539,1701,586,1031,47,1,13,0,0,3,1,1,0,0,1683,18,838
2600,부산광역시,2615,수영구,,광안제1동제4투,3464,1808,598,1088,65,1,26,0,3,0,0,0,0,1,1782,26,1656
2600,부산광역시,2615,수영구,,광안제1동제5투,3158,1744,593,1042,45,2,31,1,0,0,4,3,0,1,1722,22,1414
2600,부산광역시,2615,수영구,광안제2동,소계,15095,10759,3837,6418,293,3,93,3,3,1,5,5,1,1,10663,96,4336
2600,부산광역시,2615,수영구,,관내사전투표,5037,5037,2070,2800,116,1,18,1,0,0,2,2,0,0,5010,27,0
2600,부산광역시,2615,수영구,,광안제2동제1투,2977,1651,493,1056,59,1,28,0,1,0,1,1,0,0,1640,11,1326
2600,부산광역시,2615,수영구,,광안제2동제2투,2264,1255,377,809,35,0,13,0,1,0,1,2,1,1,1240,15,1009
2600,부산광역시,2615,수영구,,광안제2동제3투,2412,1397,449,868,41,0,15,1,0,1,1,0,0,0,1376,21,1015
2600,부산광역시,2615,수영구,,광안제2동제4투,2405,1419,448,885,42,1,19,1,1,0,0,0,0,0,1397,22,986
2600,부산광역시,2615,수영구,광안제3동,소계,8291,5696,1939,3453,149,2,56,1,0,2,5,2,3,1,5613,83,2595
2600,부산광역시,2615,수영구,,관내사전투표,2470,2470,951,1411,61,1,17,0,0,1,0,2,1,0,2445,25,0
2600,부산광역시,2615,수영구,,광안제3동제1투,3036,1540,506,931,50,0,18,0,0,0,0,0,1,0,1506,34,1496
2600,부산광역시,2615,수영구,,광안제3동제2투,1775,1043,299,677,28,1,15,1,0,0,2,0,1,1,1025,18,732
2600,부산광역시,2615,수영구,,광안제3동제3투,1010,643,183,434,10,0,6,0,0,1,3,0,0,0,637,6,367
2600,부산광역시,2615,수영구,광안제4동,소계,10536,7706,2868,4495,187,1,65,2,1,1,6,9,1,1,7637,69,2830
2600,부산광역시,2615,수영구,,관내사전투표,3454,3454,1459,1874,81,0,18,0,0,0,1,4,0,0,3437,17,0
2600,부산광역시,2615,수영구,,광안제4동제1투,2616,1403,460,869,42,0,18,1,0,0,1,1,0,0,1392,11,1213
2600,부산광역시,2615,수영구,,광안제4동제2투,2517,1622,502,1046,33,0,15,1,0,1,1,1,1,0,1601,21,895
2600,부산광역시,2615,수영구,,광안제4동제3투,1949,1227,447,706,31,1,14,0,1,0,3,3,0,1,1207,20,722
2600,부산광역시,2615,수영구,민락동,소계,21236,15323,5091,9728,272,7,106,0,3,2,17,11,5,3,15245,78,5913
2600,부산광역시,2615,수영구,,관내사전투표,5558,5558,2150,3265,84,1,23,0,1,2,2,6,1,2,5537,21,0
2600,부산광역시,2615,수영구,,민락동제1투,2392,1282,378,844,27,0,19,0,1,0,4,0,1,0,1274,8,1110
2600,부산광역시,2615,수영구,,민락동제2투,2040,1052,340,655,23,2,15,0,0,0,3,1,1,0,1040,12,988
2600,부산광역시,2615,수영구,,민락동제3투,3253,1863,581,1220,38,2,7,0,0,0,1,0,1,1,1851,12,1390
2600,부산광역시,2615,수영구,,민락동제4투,2341,1432,466,909,17,1,24,0,1,0,4,0,1,0,1423,9,909
2600,부산광역시,2615,수영구,,민락동제5투,2542,1916,561,1287,42,1,11,0,0,0,1,3,0,0,1906,10,626
2600,부산광역시,2615,수영구,,민락동제6투,3110,2220,615,1548,41,0,7,0,0,0,2,1,0,0,2214,6,890
2600,부산광역시,2615,수영구,잘못 투입·구분된 투표지,,0,0,0,0,0,0,0,0,0,0,0,0,0,0,0,0,0
2600,부산광역시,2616,사상구,합계,,185365,136658,54207,75692,3076,78,1636,42,27,30,116,172,50,87,135213,1445,48707
2600,부산광역시,2616,사상구,거소·선상투표,,473,433,160,202,6,0,11,0,0,0,0,0,1,2,382,51,40
2600,부산광역시,2616,사상구,관외사전투표,,14140,14134,6158,7191,388,11,184,2,3,6,11,16,8,4,13982,152,6
2600,부산광역시,2616,사상구,재외투표,,574,404,240,118,13,0,2,0,0,1,0,1,0,0,375,29,170
2600,부산광역시,2616,사상구,삼락동,소계,5017,3500,1389,1954,67,3,43,0,0,1,5,3,1,3,3469,31,1517
2600,부산광역시,2616,사상구,,관내사전투표,1762,1762,795,903,33,2,13,0,0,0,1,1,0,2,1750,12,0
2600,부산광역시,2616,사상구,,삼락동제1투,655,443,121,296,8,0,11,0,0,0,2,0,0,0,438,5,212
2600,부산광역시,2616,사상구,,삼락동제2투,1328,648,222,390,14,1,11,0,0,0,1,1,1,1,642,6,680
2600,부산광역시,2616,사상구,,삼락동제3투,1272,647,251,365,12,0,8,0,0,1,1,1,0,0,639,8,625
2600,부산광역시,2616,사상구,모라제1동,소계,23108,16712,6359,9539,358,5,193,11,4,7,19,34,6,10,16545,167,6396
2600,부산광역시,2616,사상구,,관내사전투표,7196,7196,3035,3919,118,3,50,7,0,1,4,14,2,3,7156,40,0
2600,부산광역시,2616,사상구,,모라제1동제1투,2256,1332,483,772,38,0,16,1,1,1,1,1,1,1,1316,16,924
2600,부산광역시,2616,사상구,,모라제1동제2투,2316,1566,573,889,48,1,23,0,0,1,2,3,1,1,1542,24,750
2600,부산광역시,2616,사상구,,모라제1동제3투,2509,1459,513,875,24,0,20,0,0,1,5,2,0,0,1440,19,1050
2600,부산광역시,2616,사상구,,모라제1동제4투,2589,1661,658,891,52,0,23,0,2,1,1,7,1,4,1640,21,928
2600,부산광역시,2616,사상구,,모라제1동제5투,1909,1067,335,687,19,0,10,1,0,1,0,0,0,1,1054,13,842
2600,부산광역시,2616,사상구,,모라제1동제6투,2394,1369,456,830,28,1,26,2,1,1,3,1,0,0,1349,20,1025
2600,부산광역시,2616,사상구,,모라제1동제7투,1939,1062,306,676,31,0,25,0,0,0,3,6,1,0,1048,14,877
2600,부산광역시,2616,사상구,모라제3동,소계,9433,6674,2598,3776,111,1,72,3,3,0,8,12,5,4,6593,81,2759
2600,부산광역시,2616,사상구,,관내사전투표,3015,3015,1281,1627,47,1,21,3,2,0,2,4,1,1,2990,25,0
2600,부산광역시,2616,사상구,,모라제3동제1투,1745,913,336,527,24,0,14,0,0,0,2,0,0,1,904,9,832
2600,부산광역시,2616,사상구,,모라제3동제2투,1459,841,262,537,8,0,10,0,0,0,1,3,2,1,824,17,618
2600,부산광역시,2616,사상구,,모라제3동제3투,1585,911,330,532,15,0,12,0,0,0,1,3,1,1,895,16,674
2600,부산광역시,2616,사상구,,모라제3동제4투,1629,994,389,553,17,0,15,0,1,0,2,2,1,0,980,14,635
2600,부산광역시,2616,사상구,덕포제1동,소계,8211,6031,2318,3455,115,5,62,3,2,1,3,3,7,5,5979,52,2180
2600,부산광역시,2616,사상구,,관내사전투표,3059,3058,1229,1729,60,1,21,2,0,0,0,2,2,4,3050,8,1
2600,부산광역시,2616,사상구,,덕포제1동제1투,839,485,164,288,7,1,9,1,0,0,1,0,1,1,473,12,354
2600,부산광역시,2616,사상구,,덕포제1동제2투,1650,785,249,489,7,2,16,0,1,1,1,1,4,0,771,14,865
2600,부산광역시,2616,사상구,,덕포제1동제3투,2663,1703,676,949,41,1,16,0,1,0,1,0,0,0,1685,18,960
2600,부산광역시,2616,사상구,덕포제2동,소계,10587,7721,3172,4191,180,5,76,0,2,1,6,12,2,6,7653,68,2866
2600,부산광역시,2616,사상구,,관내사전투표,3114,3114,1421,1586,60,2,19,0,0,0,1,7,0,3,3099,15,0
2600,부산광역시,2616,사상구,,덕포제2동제1투,1392,794,270,481,23,1,6,0,0,0,1,0,1,0,783,11,598
2600,부산광역시,2616,사상구,,덕포제2동제2투,1465,851,304,501,27,1,6,0,0,0,1,2,0,1,843,8,614
2600,부산광역시,2616,사상구,,덕포제2동제3투,2411,1514,569,860,40,1,19,0,1,1,2,2,1,1,1497,17,897
2600,부산광역시,2616,사상구,,덕포제2동제4투,2205,1448,608,763,30,0,26,0,1,0,1,1,0,1,1431,17,757
2600,부산광역시,2616,사상구,괘법동,소계,18817,12721,4940,7080,290,11,203,0,4,2,11,14,5,4,12564,157,6096
2600,부산광역시,2616,사상구,,관내사전투표,4458,4458,1970,2311,84,1,44,0,1,1,3,4,3,2,4424,34,0
2600,부산광역시,2616,사상구,,괘법동제1투,3263,1688,588,966,54,1,36,0,2,1,2,1,1,0,1652,36,1575
2600,부산광역시,2616,사상구,,괘법동제2투,2482,1342,485,761,44,2,25,0,0,0,2,2,0,0,1321,21,1140
2600,부산광역시,2616,사상구,,괘법동제3투,3887,2075,718,1210,54,6,43,0,1,0,2,3,0,2,2039,36,1812
2600,부산광역시,2616,사상구,,괘법동제4투,2325,1576,580,918,28,1,30,0,0,0,2,1,0,0,1560,16,749
2600,부산광역시,2616,사상구,,괘법동제5투,2402,1582,599,914,26,0,25,0,0,0,0,3,1,0,1568,14,820
2600,부산광역시,2616,사상구,감전동,소계,10838,7226,2661,4236,133,1,95,4,0,1,1,10,4,4,7150,76,3612
2600,부산광역시,2616,사상구,,관내사전투표,2293,2293,1002,1208,46,0,19,1,0,0,0,3,1,0,2280,13,0
2600,부산광역시,2616,사상구,,감전동제1투,2687,1446,500,887,28,1,19,0,0,0,1,2,0,0,1438,8,1241
2600,부산광역시,2616,사상구,,감전동제2투,2014,1214,379,765,22,0,22,0,0,1,0,1,1,2,1193,21,800
2600,부산광역시,2616,사상구,,감전동제3투,2059,1196,435,696,16,0,25,2,0,0,0,3,0,0,1177,19,863
2600,부산광역시,2616,사상구,,감전동제4투,1785,1077,345,680,21,0,10,1,0,0,0,1,2,2,1062,15,708
2600,부산광역시,2616,사상구,주례제1동,소계,12002,8762,3367,4967,218,2,94,2,0,2,12,6,0,2,8672,90,3240
2600,부산광역시,2616,사상구,,관내사전투표,3179,3179,1340,1728,65,2,19,1,0,0,2,2,0,1,3160,19,0
2600,부산광역시,2616,사상구,,주례제1동제1투,1171,573,169,367,14,0,9,1,0,0,0,0,0,0,560,13,598
2600,부산광역시,2616,사상구,,주례제1동제2투,2723,1792,670,1021,52,0,23,0,0,1,4,1,0,0,1772,20,931
2600,부산광역시,2616,사상구,,주례제1동제3투,2629,1759,629,1038,43,0,23,0,0,1,5,2,0,0,1741,18,870
2600,부산광역시,2616,사상구,,주례제1동제4투,2300,1459,559,813,44,0,20,0,0,0,1,1,0,1,1439,20,841
2600,부산광역시,2616,사상구,주례제2동,소계,17612,12292,4791,6882,292,10,135,2,3,2,11,13,2,6,12149,143,5320
2600,부산광역시,2616,사상구,,관내사전투표,3245,3245,1377,1725,78,3,28,0,2,0,1,3,0,2,3219,26,0
2600,부산광역시,2616,사상구,,주례제2동제1투,1750,891,295,535,24,0,15,0,1,0,1,0,0,0,871,20,859
2600,부산광역시,2616,사상구,,주례제2동제2투,2477,1088,370,641,26,3,15,0,0,1,1,4,2,1,1064,24,1389
2600,부산광역시,2616,사상구,,주례제2동제3투,1702,975,345,564,24,1,22,0,0,0,1,2,0,1,960,15,727
2600,부산광역시,2616,사상구,,주례제2동제4투,1042,621,216,378,3,0,10,1,0,0,2,0,0,0,610,11,421
2600,부산광역시,2616,사상구,,주례제2동제5투,2219,1615,647,888,56,1,10,0,0,0,0,2,0,0,1604,11,604
2600,부산광역시,2616,사상구,,주례제2동제6투,2388,1731,672,982,40,0,17,0,0,1,3,2,0,1,1718,13,657
2600,부산광역시,2616,사상구,,주례제2동제7투,2789,2126,869,1169,41,2,18,1,0,0,2,0,0,1,2103,23,663
2600,부산광역시,2616,사상구,주례제3동,소계,10841,8118,3060,4705,159,4,93,5,1,1,7,11,1,5,8052,66,2723
2600,부산광역시,2616,사상구,,관내사전투표,3811,3811,1641,2051,66,4,28,2,0,1,3,3,1,1,3801,10,0
2600,부산광역시,2616,사상구,,주례제3동제1투,1657,935,312,574,11,0,17,1,1,0,1,1,0,2,920,15,722
2600,부산광역시,2616,사상구,,주례제3동제2투,2326,1519,500,943,38,0,21,2,0,0,0,0,0,0,1504,15,807
2600,부산광역시,2616,사상구,,주례제3동제3투,1731,1072,373,641,27,0,9,0,0,0,1,3,0,1,1055,17,659
2600,부산광역시,2616,사상구,,주례제3동제4투,1316,781,234,496,17,0,18,0,0,0,2,4,0,1,772,9,535
2600,부산광역시,2616,사상구,학장동,소계,22404,16165,6532,8870,369,9,183,7,3,3,18,19,3,13,16029,136,6239
2600,부산광역시,2616,사상구,,관내사전투표,4789,4785,2154,2477,93,1,27,0,0,1,3,4,0,3,4763,22,4
2600,부산광역시,2616,사상구,,학장동제1투,2047,1314,518,726,40,0,12,1,0,0,1,2,0,0,1300,14,733
2600,부산광역시,2616,사상구,,학장동제2투,1328,684,224,420,9,1,11,1,1,0,4,3,0,1,675,9,644
2600,부산광역시,2616,사상구,,학장동제3투,3123,2103,800,1196,50,1,29,2,0,0,1,0,0,1,2080,23,1020
2600,부산광역시,2616,사상구,,학장동제4투,1905,1196,453,677,33,0,13,1,0,0,3,1,1,3,1185,11,709
2600,부산광역시,2616,사상구,,학장동제5투,2218,1376,523,790,33,3,10,0,1,1,4,0,0,1,1366,10,842
2600,부산광역시,2616,사상구,,학장동제6투,1698,992,358,576,19,1,24,0,0,1,1,1,1,0,982,10,706
2600,부산광역시,2616,사상구,,학장동제7투,2285,1583,601,905,35,1,23,1,0,0,0,2,0,1,1569,14,702
2600,부산광역시,2616,사상구,,학장동제8투,3011,2132,901,1103,57,1,34,1,1,0,1,6,1,3,2109,23,879
2600,부산광역시,2616,사상구,엄궁동,소계,21308,15760,6461,8525,377,11,190,3,2,2,4,18,5,19,15617,143,5548
2600,부산광역시,2616,사상구,,관내사전투표,6037,6037,2649,3168,118,4,58,2,1,0,2,4,0,3,6009,28,0
2600,부산광역시,2616,사상구,,엄궁동제1투,2086,1218,492,651,33,0,15,0,0,1,0,3,1,8,1204,14,868
2600,부산광역시,2616,사상구,,엄궁동제2투,1664,878,301,537,17,0,13,0,0,0,0,1,0,0,869,9,786
2600,부산광역시,2616,사상구,,엄궁동제3투,2143,1266,432,756,33,1,20,1,0,0,1,1,1,1,1247,19,877
2600,부산광역시,2616,사상구,,엄궁동제4투,1359,822,324,443,23,1,15,0,0,0,1,3,0,0,810,12,537
2600,부산광역시,2616,사상구,,엄궁동제5투,2920,2004,876,1012,60,1,30,0,0,0,0,3,1,1,1984,20,916
2600,부산광역시,2616,사상구,,엄궁동제6투,2194,1474,616,762,44,1,20,0,0,1,0,3,1,2,1450,24,720
2600,부산광역시,2616,사상구,,엄궁동제7투,2905,2061,771,1196,49,3,19,0,1,0,0,0,1,4,2044,17,844
2600,부산광역시,2616,사상구,잘못 투입·구분된 투표지,,0,5,1,1,0,0,0,0,0,0,0,0,0,0,2,3,-52700,대구광역시,2701,중구,합계,,65964,51325,10913,38288,981,42,392,21,9,17,99,22,8,26,50818,507,14639
2700,대구광역시,2701,중구,거소·선상투표,,129,113,17,84,3,0,1,0,0,0,0,0,0,0,105,8,16
2700,대구광역시,2701,중구,관외사전투표,,6338,6335,1637,4424,134,5,55,3,1,0,4,4,2,2,6271,64,3
2700,대구광역시,2701,중구,재외투표,,390,267,113,119,7,0,4,0,0,0,0,0,0,0,243,24,123
2700,대구광역시,2701,중구,동인동,소계,6482,4589,891,3498,87,6,47,3,2,2,9,1,0,1,4547,42,1893
2700,대구광역시,2701,중구,,관내사전투표,1706,1706,401,1242,33,3,9,0,0,0,2,0,0,1,1691,15,0
2700,대구광역시,2701,중구,,동인동제1투,1894,1105,193,853,19,2,21,0,1,0,6,1,0,0,1096,9,789
2700,대구광역시,2701,중구,,동인동제2투,1570,989,155,795,20,0,5,1,1,2,0,0,0,0,979,10,581
2700,대구광역시,2701,중구,,동인동제3투,1312,789,142,608,15,1,12,2,0,0,1,0,0,0,781,8,523
2700,대구광역시,2701,중구,삼덕동,소계,5201,3701,887,2630,88,2,34,3,1,0,11,4,0,2,3662,39,1500
2700,대구광역시,2701,중구,,관내사전투표,1447,1447,403,986,34,1,7,0,1,0,2,0,0,1,1435,12,0
2700,대구광역시,2701,중구,,삼덕동제1투,2166,1395,303,1029,27,0,15,2,0,0,5,2,0,0,1383,12,771
2700,대구광역시,2701,중구,,삼덕동제2투,1588,859,181,615,27,1,12,1,0,0,4,2,0,1,844,15,729
2700,대구광역시,2701,중구,성내1동,소계,4025,2662,597,1927,63,3,29,0,1,0,11,0,0,3,2634,28,1363
2700,대구광역시,2701,중구,,관내사전투표,934,934,286,615,20,1,5,0,0,0,1,0,0,0,928,6,0
2700,대구광역시,2701,중구,,성내1동제1투,1889,981,188,733,24,1,13,0,1,0,5,0,0,2,967,14,908
2700,대구광역시,2701,중구,,성내1동제2투,1202,747,123,579,19,1,11,0,0,0,5,0,0,1,739,8,455
2700,대구광역시,2701,중구,성내2동,소계,3982,2819,563,2132,46,1,31,1,0,3,8,1,0,1,2787,32,1163
2700,대구광역시,2701,중구,,관내사전투표,1164,1164,259,854,26,0,7,0,0,1,3,0,0,0,1150,14,0
2700,대구광역시,2701,중구,,성내2동제1투,1610,938,183,706,12,1,17,0,0,1,4,0,0,1,925,13,672
2700,대구광역시,2701,중구,,성내2동제2투,1208,717,121,572,8,0,7,1,0,1,1,1,0,0,712,5,491
2700,대구광역시,2701,중구,성내3동,소계,3742,2923,595,2238,39,2,18,0,0,2,5,0,0,0,2899,24,819
2700,대구광역시,2701,중구,,관내사전투표,1352,1351,339,978,17,1,7,0,0,1,1,0,0,0,1344,7,1
2700,대구광역시,2701,중구,,성내3동제1투,2055,1343,229,1064,20,1,9,0,0,1,4,0,0,0,1328,15,712
2700,대구광역시,2701,중구,,성내3동제2투,335,229,27,196,2,0,2,0,0,0,0,0,0,0,227,2,106
2700,대구광역시,2701,중구,대신동,소계,6322,5038,976,3905,75,3,24,0,0,6,4,0,1,3,4997,41,1284
2700,대구광역시,2701,중구,,관내사전투표,2474,2474,547,1854,40,1,7,0,0,5,1,0,0,1,2456,18,0
2700,대구광역시,2701,중구,,대신동제1투,2488,1640,298,1291,24,1,11,0,0,0,1,0,1,2,1629,11,848
2700,대구광역시,2701,중구,,대신동제2투,1360,924,131,760,11,1,6,0,0,1,2,0,0,0,912,12,436
2700,대구광역시,2701,중구,남산1동,소계,3747,2742,542,2073,58,1,22,1,1,2,8,0,1,0,2709,33,1005
2700,대구광역시,2701,중구,,관내사전투표,1009,1008,232,734,18,0,6,0,1,1,3,0,1,0,996,12,1
2700,대구광역시,2701,중구,,남산1동제1투,1017,599,103,471,11,1,8,1,0,0,2,0,0,0,597,2,418
2700,대구광역시,2701,중구,,남산1동제2투,1721,1135,207,868,29,0,8,0,0,1,3,0,0,0,1116,19,586
2700,대구광역시,2701,중구,남산2동,소계,4925,3832,827,2854,91,1,18,3,1,0,9,2,0,3,3809,23,1093
2700,대구광역시,2701,중구,,관내사전투표,1515,1515,428,1045,26,0,4,1,0,0,0,1,0,0,1505,10,0
2700,대구광역시,2701,중구,,남산2동제1투,1495,940,141,761,22,0,5,1,0,0,4,0,0,1,935,5,555
2700,대구광역시,2701,중구,,남산2동제2투,1915,1377,258,1048,43,1,9,1,1,0,5,1,0,2,1369,8,538
2700,대구광역시,2701,중구,남산3동,소계,5003,3844,905,2809,57,3,24,0,0,1,8,4,0,4,3815,29,1159
2700,대구광역시,2701,중구,,관내사전투표,1707,1707,458,1203,21,2,7,0,0,1,3,3,0,2,1700,7,0
2700,대구광역시,2701,중구,,남산3동제1투,1855,1261,297,927,21,1,6,0,0,0,3,1,0,0,1256,5,594
2700,대구광역시,2701,중구,,남산3동제2투,1441,876,150,679,15,0,11,0,0,0,2,0,0,2,859,17,565
2700,대구광역시,2701,중구,남산4동,소계,8727,6983,1378,5289,135,10,58,4,1,0,13,4,2,6,6900,83,1744
2700,대구광역시,2701,중구,,관내사전투표,2688,2688,601,1986,51,5,14,4,1,0,2,1,0,2,2667,21,0
2700,대구광역시,2701,중구,,남산4동제1투,2080,1297,215,1008,20,4,18,0,0,0,6,1,1,1,1274,23,783
2700,대구광역시,2701,중구,,남산4동제2투,2524,1865,374,1399,43,1,19,0,0,0,1,1,0,1,1839,26,659
2700,대구광역시,2701,중구,,남산4동제3투,1435,1133,188,896,21,0,7,0,0,0,4,1,1,2,1120,13,302
2700,대구광역시,2701,중구,대봉1동,소계,5149,4046,698,3215,68,3,21,1,1,1,6,1,2,1,4018,28,1103
2700,대구광역시,2701,중구,,관내사전투표,1595,1595,341,1221,19,0,4,1,1,0,1,0,1,1,1590,5,0
2700,대구광역시,2701,중구,,대봉1동제1투,1747,1172,161,959,26,1,7,0,0,0,3,0,1,0,1158,14,575
2700,대구광역시,2701,중구,,대봉1동제2투,1807,1279,196,1035,23,2,10,0,0,1,2,1,0,0,1270,9,528
2700,대구광역시,2701,중구,대봉2동,소계,1802,1430,287,1090,30,2,6,2,0,0,3,1,0,0,1421,9,372
2700,대구광역시,2701,중구,,관내사전투표,751,751,177,547,13,2,5,0,0,0,3,1,0,0,748,3,0
2700,대구광역시,2701,중구,,대봉2동제1투,622,412,76,320,12,0,0,1,0,0,0,0,0,0,409,3,210
2700,대구광역시,2701,중구,,대봉2동제2투,429,267,34,223,5,0,1,1,0,0,0,0,0,0,264,3,162
2700,대구광역시,2701,중구,잘못 투입·구분된 투표지,,0,1,0,1,0,0,0,0,0,0,0,0,0,0,1,0,-1
2700,대구광역시,2702,동구,합계,,297312,232992,52170,171004,4522,111,2122,40,37,69,433,152,78,83,230821,2171,64320
2700,대구광역시,2702,동구,거소·선상투표,,685,643,151,349,16,6,15,3,1,1,4,1,4,3,554,89,42
2700,대구광역시,2702,동구,관외사전투표,,24773,24773,6673,16867,602,11,313,10,2,5,37,19,9,13,24561,212,0
2700,대구광역시,2702,동구,재외투표,,1077,733,377,255,23,1,2,0,0,0,0,0,0,0,658,75,344
2700,대구광역시,2702,동구,신암1동,소계,7498,5755,1001,4522,100,2,42,1,0,3,14,3,5,3,5696,59,1743
2700,대구광역시,2702,동구,,관내사전투표,2752,2750,549,2118,44,0,8,1,0,0,6,0,2,1,2729,21,2
2700,대구광역시,2702,동구,,신암1동제1투,2009,1232,220,939,36,1,14,0,0,1,5,1,1,0,1218,14,777
2700,대구광역시,2702,동구,,신암1동제2투,1655,1109,156,912,12,1,11,0,0,2,1,1,0,0,1096,13,546
2700,대구광역시,2702,동구,,신암1동제3투,1082,664,76,553,8,0,9,0,0,0,2,1,2,2,653,11,418
2700,대구광역시,2702,동구,신암2동,소계,8446,6867,1418,5194,127,1,54,1,0,2,11,4,3,2,6817,50,1579
2700,대구광역시,2702,동구,,관내사전투표,3227,3225,739,2374,59,1,22,0,0,2,2,2,1,0,3202,23,2
2700,대구광역시,2702,동구,,신암2동제1투,1765,1186,212,938,14,0,8,1,0,0,4,1,0,0,1178,8,579
2700,대구광역시,2702,동구,,신암2동제2투,1588,1021,223,757,17,0,10,0,0,0,3,1,0,1,1012,9,567
2700,대구광역시,2702,동구,,신암2동제3투,1866,1435,244,1125,37,0,14,0,0,0,2,0,2,1,1425,10,431
2700,대구광역시,2702,동구,신암3동,소계,8714,6688,1362,5084,116,1,49,2,1,3,5,1,1,0,6625,63,2026
2700,대구광역시,2702,동구,,관내사전투표,3015,3015,688,2250,37,0,14,1,0,2,1,1,1,0,2995,20,0
2700,대구광역시,2702,동구,,신암3동제1투,2452,1624,349,1212,34,1,9,1,0,0,1,0,0,0,1607,17,828
2700,대구광역시,2702,동구,,신암3동제2투,3247,2049,325,1622,45,0,26,0,1,1,3,0,0,0,2023,26,1198
2700,대구광역시,2702,동구,신암4동,소계,9306,6524,1170,5080,125,3,58,0,0,2,10,5,2,2,6457,67,2782
2700,대구광역시,2702,동구,,관내사전투표,2669,2669,541,2029,49,3,16,0,0,1,4,1,1,1,2646,23,0
2700,대구광역시,2702,동구,,신암4동제1투,2412,1249,222,971,19,0,15,0,0,1,3,2,0,0,1233,16,1163
2700,대구광역시,2702,동구,,신암4동제2투,2206,1459,210,1189,34,0,8,0,0,0,1,1,1,1,1445,14,747
2700,대구광역시,2702,동구,,신암4동제3투,2019,1147,197,891,23,0,19,0,0,0,2,1,0,0,1133,14,872
2700,대구광역시,2702,동구,신암5동,소계,6912,5644,1092,4326,110,5,46,2,2,3,8,1,4,1,5600,44,1268
2700,대구광역시,2702,동구,,관내사전투표,3311,3311,770,2417,76,4,17,2,0,0,4,1,2,0,3293,18,0
2700,대구광역시,2702,동구,,신암5동제1투,1555,1021,135,847,15,1,10,0,1,1,2,0,1,0,1013,8,534
2700,대구광역시,2702,동구,,신암5동제2투,2046,1312,187,1062,19,0,19,0,1,2,2,0,1,1,1294,18,734
2700,대구광역시,2702,동구,신천1·2동,소계,10402,8218,1695,6197,136,4,71,1,2,5,18,4,2,1,8136,82,2184
2700,대구광역시,2702,동구,,관내사전투표,3120,3114,690,2329,49,0,20,0,1,1,5,2,1,1,3099,15,6
2700,대구광역시,2702,동구,,신천1·2동제1투,1809,1313,254,1007,19,1,13,0,0,0,5,1,1,0,1301,12,496
2700,대구광역시,2702,동구,,신천1·2동제2투,1634,1080,224,811,19,1,9,0,1,1,3,0,0,0,1069,11,554
2700,대구광역시,2702,동구,,신천1·2동제3투,1580,1025,163,809,15,0,15,0,0,3,1,1,0,0,1007,18,555
2700,대구광역시,2702,동구,,신천1·2동제4투,2259,1686,364,1241,34,2,14,1,0,0,4,0,0,0,1660,26,573
2700,대구광역시,2702,동구,신천3동,소계,9264,7356,1570,5506,135,4,60,0,1,2,9,4,1,1,7293,63,1908
2700,대구광역시,2702,동구,,관내사전투표,2997,2997,771,2126,59,1,14,0,0,0,4,3,0,0,2978,19,0
2700,대구광역시,2702,동구,,신천3동제1투,1729,1113,225,843,14,1,13,0,1,1,1,0,1,0,1100,13,616
2700,대구광역시,2702,동구,,신천3동제2투,2235,1590,298,1227,36,0,15,0,0,1,2,0,0,0,1579,11,645
2700,대구광역시,2702,동구,,신천3동제3투,2303,1656,276,1310,26,2,18,0,0,0,2,1,0,1,1636,20,647
2700,대구광역시,2702,동구,신천4동,소계,6685,4900,979,3735,103,2,35,3,1,5,4,2,1,1,4871,29,1785
2700,대구광역시,2702,동구,,관내사전투표,1953,1953,436,1459,35,2,9,1,0,2,0,2,0,0,1946,7,0
2700,대구광역시,2702,동구,,신천4동제1투,1070,696,117,549,14,0,8,1,1,0,0,0,0,1,691,5,374
2700,대구광역시,2702,동구,,신천4동제2투,1903,1138,242,832,33,0,12,1,0,1,4,0,1,0,1126,12,765
2700,대구광역시,2702,동구,,신천4동제3투,1759,1113,184,895,21,0,6,0,0,2,0,0,0,0,1108,5,646
2700,대구광역시,2702,동구,효목1동,소계,10739,7877,1393,6195,94,3,79,0,0,2,31,6,3,2,7808,69,2862
2700,대구광역시,2702,동구,,관내사전투표,2350,2349,483,1799,27,0,23,0,0,0,6,0,0,0,2338,11,1
2700,대구광역시,2702,동구,,효목1동제1투,1431,931,147,740,13,1,11,0,0,0,5,1,1,2,921,10,500
2700,대구광역시,2702,동구,,효목1동제2투,1505,967,154,777,12,2,7,0,0,0,4,1,1,0,958,9,538
2700,대구광역시,2702,동구,,효목1동제3투,1534,976,147,789,5,0,17,0,0,0,8,0,0,0,966,10,558
2700,대구광역시,2702,동구,,효목1동제4투,2284,1658,293,1301,26,0,11,0,0,1,5,1,1,0,1639,19,626
2700,대구광역시,2702,동구,,효목1동제5투,1635,996,169,789,11,0,10,0,0,1,3,3,0,0,986,10,639
2700,대구광역시,2702,동구,효목2동,소계,10952,8303,1650,6353,137,4,73,0,1,6,13,3,3,1,8244,59,2649
2700,대구광역시,2702,동구,,관내사전투표,3281,3280,774,2412,52,1,19,0,1,1,5,0,1,1,3267,13,1
2700,대구광역시,2702,동구,,효목2동제1투,959,576,84,468,7,0,9,0,0,1,1,0,0,0,570,6,383
2700,대구광역시,2702,동구,,효목2동제2투,2021,1195,194,944,25,0,10,0,0,2,3,1,1,0,1180,15,826
2700,대구광역시,2702,동구,,효목2동제3투,1196,720,108,579,11,0,10,0,0,1,2,2,1,0,714,6,476
2700,대구광역시,2702,동구,,효목2동제4투,925,613,105,479,13,0,7,0,0,0,1,0,0,0,605,8,312
2700,대구광역시,2702,동구,,효목2동제5투,2570,1919,385,1471,29,3,18,0,0,1,1,0,0,0,1908,11,651
2700,대구광역시,2702,동구,도평동,소계,3546,2791,528,2162,38,1,31,0,0,1,5,1,0,4,2771,20,755
2700,대구광역시,2702,동구,,관내사전투표,1458,1458,317,1101,14,1,11,0,0,0,4,0,0,2,1450,8,0
2700,대구광역시,2702,동구,,도평동제1투,1420,916,136,734,20,0,15,0,0,1,0,1,0,0,907,9,504
2700,대구광역시,2702,동구,,도평동제2투,668,417,75,327,4,0,5,0,0,0,1,0,0,2,414,3,251
2700,대구광역시,2702,동구,불로·봉무동,소계,15409,12077,2628,9017,235,4,77,2,3,1,15,5,2,1,11990,87,3332
2700,대구광역시,2702,동구,,관내사전투표,3714,3714,873,2736,61,3,16,0,0,0,0,1,0,1,3691,23,0
2700,대구광역시,2702,동구,,불로·봉무동제1투,1803,1147,205,890,23,0,11,1,1,0,3,2,1,0,1137,10,656
2700,대구광역시,2702,동구,,불로·봉무동제2투,3150,2228,419,1730,39,1,20,0,1,0,3,0,0,0,2213,15,922
2700,대구광역시,2702,동구,,불로·봉무동제3투,1655,1013,146,813,25,0,12,0,0,1,2,0,1,0,1000,13,642
2700,대구광역시,2702,동구,,불로·봉무동제4투,2676,2119,554,1488,43,0,12,1,1,0,1,2,0,0,2102,17,557
2700,대구광역시,2702,동구,,불로·봉무동제5투,2411,1856,431,1360,44,0,6,0,0,0,6,0,0,0,1847,9,555
2700,대구광역시,2702,동구,지저동,소계,11998,9088,1701,7028,140,3,88,1,0,0,27,11,5,6,9010,78,2910
2700,대구광역시,2702,동구,,관내사전투표,3745,3744,757,2878,53,1,18,0,0,0,7,4,2,2,3722,22,1
2700,대구광역시,2702,동구,,지저동제1투,2296,1436,236,1137,18,1,22,0,0,0,5,2,0,2,1423,13,860
2700,대구광역시,2702,동구,,지저동제2투,2061,1252,198,1008,16,0,15,0,0,0,5,1,1,1,1245,7,809
2700,대구광역시,2702,동구,,지저동제3투,2031,1357,225,1063,18,0,23,1,0,0,7,2,2,0,1341,16,674
2700,대구광역시,2702,동구,,지저동제4투,1865,1299,285,942,35,1,10,0,0,0,3,2,0,1,1279,20,566
2700,대구광역시,2702,동구,동촌동,소계,13113,9571,1868,7316,168,5,89,0,1,1,33,3,3,6,9493,78,3542
2700,대구광역시,2702,동구,,관내사전투표,4227,4227,884,3224,63,2,23,0,0,1,7,2,0,2,4208,19,0
2700,대구광역시,2702,동구,,동촌동제1투,1757,1057,185,839,6,0,8,0,0,0,3,0,1,0,1042,15,700
2700,대구광역시,2702,동구,,동촌동제2투,2060,1176,194,905,30,1,24,0,1,0,9,0,1,1,1166,10,884
2700,대구광역시,2702,동구,,동촌동제3투,2894,1847,368,1385,45,1,16,0,0,0,12,1,1,3,1832,15,1047
2700,대구광역시,2702,동구,,동촌동제4투,2175,1264,237,963,24,1,18,0,0,0,2,0,0,0,1245,19,911
2700,대구광역시,2702,동구,방촌동,소계,15153,11860,2180,9252,199,10,92,1,2,2,18,5,5,5,11771,89,3293
2700,대구광역시,2702,동구,,관내사전투표,4170,4170,821,3248,64,4,14,1,0,1,2,2,0,1,4158,12,0
2700,대구광역시,2702,동구,,방촌동제1투,1817,1309,223,1037,26,0,8,0,1,0,4,2,0,0,1301,8,508
2700,대구광역시,2702,동구,,방촌동제2투,2318,1521,247,1204,31,1,12,0,0,0,5,0,3,2,1505,16,797
2700,대구광역시,2702,동구,,방촌동제3투,2015,1380,239,1078,23,1,23,0,1,1,2,0,0,1,1369,11,635
2700,대구광역시,2702,동구,,방촌동제4투,1682,1193,209,944,12,0,10,0,0,0,2,0,1,0,1178,15,489
2700,대구광역시,2702,동구,,방촌동제5투,1581,1214,239,926,25,2,12,0,0,0,0,1,0,0,1205,9,367
2700,대구광역시,2702,동구,,방촌동제6투,1570,1073,202,815,18,2,13,0,0,0,3,0,1,1,1055,18,497
2700,대구광역시,2702,동구,해안동,소계,13337,9969,1847,7730,150,7,113,1,2,3,7,8,5,1,9874,95,3368
2700,대구광역시,2702,동구,,관내사전투표,4247,4247,904,3208,54,4,31,1,1,0,2,4,2,0,4211,36,0
2700,대구광역시,2702,동구,,해안동제1투,2295,1367,236,1063,30,1,19,0,0,2,0,1,2,0,1354,13,928
2700,대구광역시,2702,동구,,해안동제2투,2174,1413,252,1104,16,1,22,0,0,0,0,0,0,0,1395,18,761
2700,대구광역시,2702,동구,,해안동제3투,1789,1091,179,861,17,0,15,0,0,0,3,1,1,1,1078,13,698
2700,대구광역시,2702,동구,,해안동제4투,1166,744,115,599,15,0,9,0,0,0,1,0,0,0,739,5,422
2700,대구광역시,2702,동구,,해안동제5투,1666,1107,161,895,18,1,17,0,1,1,1,2,0,0,1097,10,559
2700,대구광역시,2702,동구,안심1동,소계,32247,24078,5717,17325,497,8,223,5,2,9,40,25,7,9,23867,211,8169
2700,대구광역시,2702,동구,,관내사전투표,7588,7587,1915,5441,135,3,40,0,0,1,5,6,0,3,7549,38,1
2700,대구광역시,2702,동구,,안심1동제1투,2263,1295,233,989,32,1,21,0,0,0,3,1,2,0,1282,13,968
2700,대구광역시,2702,동구,,안심1동제2투,1611,973,191,719,29,0,12,0,0,1,0,3,1,0,956,17,638
2700,대구광역시,2702,동구,,안심1동제3투,2512,1406,287,1052,30,2,16,1,1,0,1,1,1,0,1392,14,1106
2700,대구광역시,2702,동구,,안심1동제4투,2453,1574,298,1198,26,0,25,0,1,0,4,2,1,0,1555,19,879
2700,대구광역시,2702,동구,,안심1동제5투,2332,1542,368,1081,45,2,15,0,0,2,8,1,0,3,1525,17,790
2700,대구광역시,2702,동구,,안심1동제6투,1952,1264,282,917,26,0,18,0,0,0,3,1,1,0,1248,16,688
2700,대구광역시,2702,동구,,안심1동제7투,2632,1873,428,1362,24,0,29,0,0,1,2,3,0,1,1850,23,759
2700,대구광역시,2702,동구,,안심1동제8투,2973,2117,577,1450,41,0,21,2,0,3,3,3,0,0,2100,17,856
2700,대구광역시,2702,동구,,안심1동제9투,2793,2129,574,1462,49,0,9,2,0,1,8,3,1,1,2110,19,664
2700,대구광역시,2702,동구,,안심1동제10투,3138,2318,564,1654,60,0,17,0,0,0,3,1,0,1,2300,18,820
2700,대구광역시,2702,동구,안심2동,소계,9087,6958,1420,5250,115,2,67,0,0,0,15,6,3,3,6881,77,2129
2700,대구광역시,2702,동구,,관내사전투표,2849,2849,706,2043,52,0,19,0,0,0,4,2,1,2,2829,20,0
2700,대구광역시,2702,동구,,안심2동제1투,2338,1510,262,1180,25,0,20,0,0,0,1,2,1,0,1491,19,828
2700,대구광역시,2702,동구,,안심2동제2투,2132,1519,252,1199,23,1,17,0,0,0,7,2,1,0,1502,17,613
2700,대구광역시,2702,동구,,안심2동제3투,1768,1080,200,828,15,1,11,0,0,0,3,0,0,1,1059,21,688
2700,대구광역시,2702,동구,공산동,소계,17320,13364,2909,9986,233,4,102,3,1,3,23,8,2,4,13278,86,3956
2700,대구광역시,2702,동구,,관내사전투표,4899,4899,1259,3527,66,2,25,0,0,1,1,2,1,0,4884,15,0
2700,대구광역시,2702,동구,,공산동제1투,2027,1288,146,1099,16,0,5,0,1,0,2,0,1,0,1270,18,739
2700,대구광역시,2702,동구,,공산동제2투,2215,1473,253,1153,30,0,18,0,0,1,2,2,0,1,1460,13,742
2700,대구광역시,2702,동구,,공산동제3투,2329,1626,294,1269,34,0,11,0,0,1,5,0,0,2,1616,10,703
2700,대구광역시,2702,동구,,공산동제4투,1307,801,78,699,5,2,8,1,0,0,2,2,0,0,797,4,506
2700,대구광역시,2702,동구,,공산동제5투,2125,1478,387,1021,36,0,17,0,0,0,4,0,0,0,1465,13,647
2700,대구광역시,2702,동구,,공산동제6투,2418,1799,492,1218,46,0,18,2,0,0,7,2,0,1,1786,13,619
2700,대구광역시,2702,동구,안심3동,소계,16721,13331,3847,8856,332,7,97,1,10,0,37,9,3,5,13204,127,3390
2700,대구광역시,2702,동구,,관내사전투표,5552,5552,1844,3513,117,5,21,1,1,0,3,4,0,4,5513,39,0
2700,대구광역시,2702,동구,,안심3동제1투,2369,1609,450,1055,48,1,18,0,4,0,11,3,1,0,1591,18,760
2700,대구광역시,2702,동구,,안심3동제2투,2822,1942,484,1340,64,0,18,0,2,0,9,0,0,0,1917,25,880
2700,대구광역시,2702,동구,,안심3동제3투,2204,1524,418,1031,37,1,17,0,1,0,4,1,0,0,1510,14,680
2700,대구광역시,2702,동구,,안심3동제4투,2341,1751,496,1163,50,0,10,0,2,0,6,1,1,1,1730,21,590
2700,대구광역시,2702,동구,,안심3동제5투,1433,953,155,754,16,0,13,0,0,0,4,0,1,0,943,10,480
2700,대구광역시,2702,동구,안심4동,소계,20035,14696,3359,10673,319,10,135,3,1,4,21,11,3,5,14544,152,5339
2700,대구광역시,2702,동구,,관내사전투표,3477,3477,920,2440,54,1,23,1,0,0,5,3,0,1,3448,29,0
2700,대구광역시,2702,동구,,안심4동제1투,2091,1251,282,922,25,1,9,0,0,0,0,2,0,0,1241,10,840
2700,대구광역시,2702,동구,,안심4동제2투,2413,1448,254,1103,33,2,24,0,0,1,1,0,1,1,1420,28,965
2700,대구광역시,2702,동구,,안심4동제3투,2072,1435,314,1039,41,1,12,1,0,0,5,2,0,0,1415,20,637
2700,대구광역시,2702,동구,,안심4동제4투,2096,1535,353,1114,37,0,13,0,1,0,2,1,1,1,1523,12,561
2700,대구광역시,2702,동구,,안심4동제5투,2673,1849,471,1299,45,2,13,0,0,0,3,2,0,0,1835,14,824
2700,대구광역시,2702,동구,,안심4동제6투,2598,1726,340,1293,34,2,24,0,0,2,2,1,1,1,1700,26,872
2700,대구광역시,2702,동구,,안심4동제7투,2615,1975,425,1463,50,1,17,1,0,1,3,0,0,1,1962,13,640
2700,대구광역시,2702,동구,혁신동,소계,13893,10927,3634,6746,272,3,111,0,4,6,28,7,2,4,10817,110,2966
2700,대구광역시,2702,동구,,관내사전투표,4244,4244,1522,2581,85,0,24,0,2,0,1,3,0,2,4220,24,0
2700,대구광역시,2702,동구,,혁신동제1투,2414,1754,671,991,51,1,19,0,0,2,2,1,1,0,1739,15,660
2700,대구광역시,2702,동구,,혁신동제2투,2438,1529,447,1000,38,1,20,0,1,0,5,1,0,1,1514,15,909
2700,대구광역시,2702,동구,,혁신동제3투,2381,1714,527,1055,56,1,32,0,0,0,4,1,1,0,1677,37,667
2700,대구광역시,2702,동구,,혁신동제4투,2416,1686,467,1119,42,0,16,0,1,4,16,1,0,1,1667,19,730
2700,대구광역시,2702,동구,잘못 투입·구분된 투표지,,0,1,1,0,0,0,0,0,0,0,0,0,0,0,1,0,-1
2700,대구광역시,2703,서구,합계,,149729,113904,19516,89620,1818,68,1172,28,20,22,236,79,57,46,112682,1222,35825
2700,대구광역시,2703,서구,거소·선상투표,,263,247,51,148,6,0,10,0,0,0,0,2,0,1,218,29,16
2700,대구광역시,2703,서구,관외사전투표,,11826,11824,2645,8583,255,7,189,4,4,2,17,10,2,7,11725,99,2
2700,대구광역시,2703,서구,재외투표,,394,272,132,100,8,0,2,0,0,0,0,0,0,0,242,30,122
2700,대구광역시,2703,서구,내당1동,소계,7110,5219,859,4153,88,2,45,1,2,0,15,2,2,4,5173,46,1891
2700,대구광역시,2703,서구,,관내사전투표,2455,2455,467,1909,34,1,13,1,1,0,6,2,1,2,2437,18,0
2700,대구광역시,2703,서구,,내당1동제1투,2363,1476,174,1245,28,1,9,0,0,0,7,0,1,2,1467,9,887
2700,대구광역시,2703,서구,,내당1동제2투,2292,1288,218,999,26,0,23,0,1,0,2,0,0,0,1269,19,1004
2700,대구광역시,2703,서구,내당2·3동,소계,7809,5661,895,4520,87,4,55,2,0,2,13,4,4,2,5588,73,2148
2700,대구광역시,2703,서구,,관내사전투표,1786,1787,325,1409,22,1,9,0,0,1,3,0,1,0,1771,16,-1
2700,대구광역시,2703,서구,,내당2·3동제1투,2265,1454,208,1177,21,2,14,0,0,0,5,1,0,1,1429,25,811
2700,대구광역시,2703,서구,,내당2·3동제2투,1786,1120,174,880,24,0,16,2,0,0,3,0,1,0,1100,20,666
2700,대구광역시,2703,서구,,내당2·3동제3투,1972,1300,188,1054,20,1,16,0,0,1,2,3,2,1,1288,12,672
2700,대구광역시,2703,서구,내당4동,소계,13663,10356,1771,8207,158,9,78,0,0,4,19,3,4,2,10255,101,3307
2700,대구광역시,2703,서구,,관내사전투표,4190,4188,782,3278,66,1,28,0,0,0,7,0,2,0,4164,24,2
2700,대구광역시,2703,서구,,내당4동제1투,1783,1120,201,877,17,2,10,0,0,0,0,0,2,0,1109,11,663
2700,대구광역시,2703,서구,,내당4동제2투,1949,1301,210,1040,18,2,13,0,0,1,3,1,0,0,1288,13,648
2700,대구광역시,2703,서구,,내당4동제3투,2105,1418,250,1112,21,1,10,0,0,3,1,0,0,1,1399,19,687
2700,대구광역시,2703,서구,,내당4동제4투,1710,1086,154,886,11,0,8,0,0,0,5,2,0,0,1066,20,624
2700,대구광역시,2703,서구,,내당4동제5투,1926,1243,174,1014,25,3,9,0,0,0,3,0,0,1,1229,14,683
2700,대구광역시,2703,서구,비산1동,소계,8421,6184,955,4971,86,8,83,2,0,0,9,7,1,3,6125,59,2237
2700,대구광역시,2703,서구,,관내사전투표,2854,2854,452,2319,27,2,22,2,0,0,2,2,0,2,2830,24,0
2700,대구광역시,2703,서구,,비산1동제1투,1621,933,137,739,21,2,17,0,0,0,3,2,0,0,921,12,688
2700,대구광역시,2703,서구,,비산1동제2투,1415,819,104,677,16,1,12,0,0,0,0,1,0,0,811,8,596
2700,대구광역시,2703,서구,,비산1동제3투,1268,787,131,618,10,1,14,0,0,0,2,2,0,0,778,9,481
2700,대구광역시,2703,서구,,비산1동제4투,1263,791,131,618,12,2,18,0,0,0,2,0,1,1,785,6,472
2700,대구광역시,2703,서구,비산2·3동,소계,7810,5664,853,4575,76,4,54,1,0,2,32,3,3,6,5609,55,2146
2700,대구광역시,2703,서구,,관내사전투표,1994,1994,325,1607,24,1,14,0,0,0,5,1,2,3,1982,12,0
2700,대구광역시,2703,서구,,비산2·3동제1투,2063,1430,215,1140,26,1,14,0,0,1,10,0,1,2,1410,20,633
2700,대구광역시,2703,서구,,비산2·3동제2투,1971,1222,170,993,18,1,13,1,0,1,10,0,0,0,1207,15,749
2700,대구광역시,2703,서구,,비산2·3동제3투,1782,1018,143,835,8,1,13,0,0,0,7,2,0,1,1010,8,764
2700,대구광역시,2703,서구,비산4동,소계,8329,6201,979,4953,113,3,48,0,1,0,11,7,7,2,6124,77,2128
2700,대구광역시,2703,서구,,관내사전투표,2260,2260,415,1765,36,0,11,0,0,0,4,2,4,1,2238,22,0
2700,대구광역시,2703,서구,,비산4동제1투,2040,1276,177,1035,21,1,7,0,0,0,5,1,1,0,1248,28,764
2700,대구광역시,2703,서구,,비산4동제2투,1886,1161,184,916,29,2,11,0,1,0,1,0,1,1,1146,15,725
2700,대구광역시,2703,서구,,비산4동제3투,2143,1504,203,1237,27,0,19,0,0,0,1,4,1,0,1492,12,639
2700,대구광역시,2703,서구,비산5동,소계,5297,3901,593,3153,66,2,31,1,2,3,4,3,2,0,3860,41,1396
2700,대구광역시,2703,서구,,관내사전투표,1782,1782,285,1443,25,1,8,0,1,2,0,1,0,0,1766,16,0
2700,대구광역시,2703,서구,,비산5동제1투,1644,986,141,794,20,1,14,0,1,0,1,0,1,0,973,13,658
2700,대구광역시,2703,서구,,비산5동제2투,1871,1133,167,916,21,0,9,1,0,1,3,2,1,0,1121,12,738
2700,대구광역시,2703,서구,비산6동,소계,6758,5023,785,4005,91,4,44,4,0,2,13,4,2,1,4955,68,1735
2700,대구광역시,2703,서구,,관내사전투표,2251,2251,378,1804,30,1,10,3,0,0,3,0,1,0,2230,21,0
2700,대구광역시,2703,서구,,비산6동제1투,2345,1414,211,1119,31,1,13,0,0,2,5,4,1,0,1387,27,931
2700,대구광역시,2703,서구,,비산6동제2투,2162,1358,196,1082,30,2,21,1,0,0,5,0,0,1,1338,20,804
2700,대구광역시,2703,서구,비산7동,소계,8402,5903,891,4779,67,3,73,0,2,0,15,2,7,2,5841,62,2499
2700,대구광역시,2703,서구,,관내사전투표,2036,2036,358,1627,19,0,10,0,2,0,3,1,4,1,2025,11,0
2700,대구광역시,2703,서구,,비산7동제1투,1509,836,124,674,11,1,15,0,0,0,4,0,1,1,831,5,673
2700,대구광역시,2703,서구,,비산7동제2투,1662,1130,138,937,15,0,18,0,0,0,2,0,1,0,1111,19,532
2700,대구광역시,2703,서구,,비산7동제3투,1728,970,138,777,13,1,18,0,0,0,5,1,0,0,953,17,758
2700,대구광역시,2703,서구,,비산7동제4투,1467,931,133,764,9,1,12,0,0,0,1,0,1,0,921,10,536
2700,대구광역시,2703,서구,평리1동,소계,7170,5367,878,4270,72,4,54,2,2,1,12,2,1,3,5301,66,1803
2700,대구광역시,2703,서구,,관내사전투표,2605,2605,409,2124,31,3,15,2,1,0,2,1,0,0,2588,17,0
2700,대구광역시,2703,서구,,평리1동제1투,1407,866,139,685,9,0,14,0,0,0,2,1,0,1,851,15,541
2700,대구광역시,2703,서구,,평리1동제2투,1524,903,150,703,15,0,11,0,0,0,1,0,1,2,883,20,621
2700,대구광역시,2703,서구,,평리1동제3투,1634,993,180,758,17,1,14,0,1,1,7,0,0,0,979,14,641
2700,대구광역시,2703,서구,평리2동,소계,6881,5336,1018,4125,76,2,41,0,1,2,4,2,3,2,5276,60,1545
2700,대구광역시,2703,서구,,관내사전투표,2668,2668,538,2045,31,1,12,0,0,1,3,2,1,2,2636,32,0
2700,대구광역시,2703,서구,,평리2동제1투,2358,1542,284,1194,27,0,18,0,1,1,1,0,1,0,1527,15,816
2700,대구광역시,2703,서구,,평리2동제2투,1855,1126,196,886,18,1,11,0,0,0,0,0,1,0,1113,13,729
2700,대구광역시,2703,서구,평리3동,소계,8709,6402,1085,5049,110,2,69,3,1,1,16,6,3,2,6347,55,2307
2700,대구광역시,2703,서구,,관내사전투표,2552,2552,532,1922,59,0,15,2,1,1,2,1,1,0,2536,16,0
2700,대구광역시,2703,서구,,평리3동제1투,1449,867,151,673,10,0,17,0,0,0,2,2,1,0,856,11,582
2700,대구광역시,2703,서구,,평리3동제2투,2041,1244,165,1027,19,1,15,0,0,0,4,1,0,1,1233,11,797
2700,대구광역시,2703,서구,,평리3동제3투,1810,1221,165,1008,12,1,15,0,0,0,5,2,0,1,1209,12,589
2700,대구광역시,2703,서구,,평리3동제4투,857,518,72,419,10,0,7,1,0,0,3,0,1,0,513,5,339
2700,대구광역시,2703,서구,평리4동,소계,13868,10229,1713,8099,146,5,120,4,1,2,16,5,2,5,10118,111,3639
2700,대구광역시,2703,서구,,관내사전투표,3569,3568,645,2828,44,0,31,1,0,0,2,2,0,1,3554,14,1
2700,대구광역시,2703,서구,,평리4동제1투,2774,1872,339,1454,36,1,15,3,0,1,3,0,1,0,1853,19,902
2700,대구광역시,2703,서구,,평리4동제2투,2365,1448,232,1151,11,3,23,0,0,0,2,0,0,1,1423,25,917
2700,대구광역시,2703,서구,,평리4동제3투,2424,1588,241,1271,23,0,23,0,1,1,6,0,0,0,1566,22,836
2700,대구광역시,2703,서구,,평리4동제4투,2736,1753,256,1395,32,1,28,0,0,0,3,3,1,3,1722,31,983
2700,대구광역시,2703,서구,평리5동,소계,1646,1243,199,1001,20,0,11,0,2,0,0,2,1,0,1236,7,403
2700,대구광역시,2703,서구,,관내사전투표,683,683,106,561,11,0,2,0,1,0,0,0,0,0,681,2,0
2700,대구광역시,2703,서구,,평리5동투표소,963,560,93,440,9,0,9,0,1,0,0,2,1,0,555,5,403
2700,대구광역시,2703,서구,평리6동,소계,3252,2342,330,1927,28,1,24,0,0,1,6,3,5,0,2325,17,910
2700,대구광역시,2703,서구,,관내사전투표,1116,1116,171,925,7,1,4,0,0,0,1,2,3,0,1114,2,0
2700,대구광역시,2703,서구,,평리6동제1투,1445,819,115,659,14,0,18,0,0,1,0,0,1,0,808,11,626
2700,대구광역시,2703,서구,,평리6동제2투,691,407,44,343,7,0,2,0,0,0,5,1,1,0,403,4,284
2700,대구광역시,2703,서구,상중이동,소계,15502,11751,2133,9166,199,6,91,2,2,0,26,9,5,1,11640,111,3751
2700,대구광역시,2703,서구,,관내사전투표,4321,4321,856,3333,73,3,18,1,2,0,6,6,1,0,4299,22,0
2700,대구광역시,2703,서구,,상중이동제1투,1068,494,87,384,6,0,6,0,0,0,3,0,1,0,487,7,574
2700,대구광역시,2703,서구,,상중이동제2투,2331,1556,231,1247,26,0,18,1,0,0,5,1,1,1,1531,25,775
2700,대구광역시,2703,서구,,상중이동제3투,2080,1392,232,1095,29,1,14,0,0,0,1,1,0,0,1373,19,688
2700,대구광역시,2703,서구,,상중이동제4투,1924,1288,204,1026,16,2,17,0,0,0,5,1,1,0,1272,16,636
2700,대구광역시,2703,서구,,상중이동제5투,2708,2049,447,1533,39,0,13,0,0,0,3,0,1,0,2036,13,659
2700,대구광역시,2703,서구,,상중이동제6투,479,283,35,246,0,0,2,0,0,0,0,0,0,0,283,0,196
2700,대구광역시,2703,서구,,상중이동제7투,591,368,41,302,10,0,3,0,0,0,3,0,0,0,359,9,223
2700,대구광역시,2703,서구,원대동,소계,6619,4777,749,3836,66,2,50,2,0,0,8,3,3,3,4722,55,1842
2700,대구광역시,2703,서구,,관내사전투표,2037,2037,301,1675,26,1,11,1,0,0,5,1,0,2,2023,14,0
2700,대구광역시,2703,서구,,원대동제1투,1056,553,90,440,10,0,9,0,0,0,0,0,0,0,549,4,503
2700,대구광역시,2703,서구,,원대동제2투,1828,1175,175,935,23,0,17,0,0,0,1,0,2,1,1154,21,653
2700,대구광역시,2703,서구,,원대동제3투,1698,1012,183,786,7,1,13,1,0,0,2,2,1,0,996,16,686
2700,대구광역시,2703,서구,잘못 투입·구분된 투표지,,0,2,2,0,0,0,0,0,0,0,0,0,0,0,2,0,-2
2700,대구광역시,2704,남구,합계,,129711,97962,19765,73865,1784,87,977,68,24,37,199,49,17,36,96908,1054,31749
2700,대구광역시,2704,남구,거소·선상투표,,221,202,43,129,3,0,6,0,0,0,0,0,0,1,182,20,19
2700,대구광역시,2704,남구,관외사전투표,,11989,11983,3057,8349,273,13,143,2,2,4,18,3,1,3,11868,115,6
2700,대구광역시,2704,남구,재외투표,,518,373,190,146,10,0,0,0,0,0,1,0,0,0,347,26,145
2700,대구광역시,2704,남구,이천동,소계,9339,7170,1475,5412,141,4,48,6,0,6,8,5,2,2,7109,61,2169
2700,대구광역시,2704,남구,,관내사전투표,1995,1995,517,1410,44,0,6,2,0,1,1,0,0,2,1983,12,0
2700,대구광역시,2704,남구,,이천동제1투,947,564,98,437,13,2,8,1,0,1,1,0,0,0,561,3,383
2700,대구광역시,2704,남구,,이천동제2투,1916,1381,245,1078,28,0,8,1,0,1,5,3,1,0,1370,11,535
2700,대구광역시,2704,남구,,이천동제3투,2311,1670,347,1246,33,2,12,2,0,0,1,2,0,0,1645,25,641
2700,대구광역시,2704,남구,,이천동제4투,2170,1560,268,1241,23,0,14,0,0,3,0,0,1,0,1550,10,610
2700,대구광역시,2704,남구,봉덕1동,소계,7648,5480,1048,4213,82,11,55,0,2,2,9,1,0,2,5425,55,2168
2700,대구광역시,2704,남구,,관내사전투표,2044,2044,476,1511,27,5,11,0,0,0,1,1,0,0,2032,12,0
2700,대구광역시,2704,남구,,봉덕1동제1투,1507,885,145,703,13,1,7,0,1,1,0,0,0,1,872,13,622
2700,대구광역시,2704,남구,,봉덕1동제2투,2044,1410,225,1131,16,1,16,0,1,0,3,0,0,1,1394,16,634
2700,대구광역시,2704,남구,,봉덕1동제3투,2053,1141,202,868,26,4,21,0,0,1,5,0,0,0,1127,14,912
2700,대구광역시,2704,남구,봉덕2동,소계,9850,7746,1353,6115,127,3,53,5,0,0,19,5,1,2,7683,63,2104
2700,대구광역시,2704,남구,,관내사전투표,2517,2517,490,1966,27,1,12,2,0,0,1,1,1,0,2501,16,0
2700,대구광역시,2704,남구,,봉덕2동제1투,1747,1131,195,893,21,1,7,1,0,0,4,0,0,0,1122,9,616
2700,대구광역시,2704,남구,,봉덕2동제2투,1444,1077,195,841,18,0,4,1,0,0,3,0,0,0,1062,15,367
2700,대구광역시,2704,남구,,봉덕2동제3투,2032,1385,203,1114,29,1,16,1,0,0,6,3,0,1,1374,11,647
2700,대구광역시,2704,남구,,봉덕2동제4투,2110,1636,270,1301,32,0,14,0,0,0,5,1,0,1,1624,12,474
2700,대구광역시,2704,남구,봉덕3동,소계,13137,9363,1664,7364,127,4,69,7,1,3,18,3,1,6,9267,96,3774
2700,대구광역시,2704,남구,,관내사전투표,3471,3471,713,2681,43,1,11,3,0,0,3,0,0,0,3455,16,0
2700,대구광역시,2704,남구,,봉덕3동제1투,2708,1352,187,1092,25,3,19,1,0,0,5,1,0,1,1334,18,1356
2700,대구광역시,2704,남구,,봉덕3동제2투,2539,1490,276,1142,19,0,22,1,0,1,4,0,0,0,1465,25,1049
2700,대구광역시,2704,남구,,봉덕3동제3투,2247,1486,240,1182,22,0,13,2,1,0,3,2,0,3,1468,18,761
2700,대구광역시,2704,남구,,봉덕3동제4투,2172,1564,248,1267,18,0,4,0,0,2,3,0,1,2,1545,19,608
2700,대구광역시,2704,남구,대명1동,소계,9551,7007,1415,5277,133,3,74,3,3,4,16,9,2,2,6941,66,2544
2700,대구광역시,2704,남구,,관내사전투표,2914,2914,684,2132,43,0,21,2,0,0,2,6,0,0,2890,24,0
2700,대구광역시,2704,남구,,대명1동제1투,2303,1416,243,1095,27,2,24,0,1,1,3,3,1,1,1401,15,887
2700,대구광역시,2704,남구,,대명1동제2투,1811,1046,193,796,24,1,12,1,1,1,6,0,0,1,1036,10,765
2700,대구광역시,2704,남구,,대명1동제3투,2523,1631,295,1254,39,0,17,0,1,2,5,0,1,0,1614,17,892
2700,대구광역시,2704,남구,대명2동,소계,8541,6269,1356,4559,150,7,76,4,6,3,17,5,0,1,6184,85,2272
2700,대구광역시,2704,남구,,관내사전투표,2138,2138,565,1463,56,1,21,2,0,1,5,4,0,1,2119,19,0
2700,대구광역시,2704,남구,,대명2동제1투,1627,947,208,671,33,1,12,0,0,1,2,1,0,0,929,18,680
2700,대구광역시,2704,남구,,대명2동제2투,1540,1027,187,774,21,2,13,1,3,1,5,0,0,0,1007,20,513
2700,대구광역시,2704,남구,,대명2동제3투,1600,1052,185,808,24,1,16,0,2,0,3,0,0,0,1039,13,548
2700,대구광역시,2704,남구,,대명2동제4투,1636,1105,211,843,16,2,14,1,1,0,2,0,0,0,1090,15,531
2700,대구광역시,2704,남구,대명3동,소계,8894,6215,1250,4669,110,9,73,7,2,2,19,2,3,2,6148,67,2679
2700,대구광역시,2704,남구,,관내사전투표,2481,2481,593,1798,38,3,19,3,1,1,2,1,2,2,2463,18,0
2700,대구광역시,2704,남구,,대명3동제1투,1488,822,139,640,15,0,13,2,0,0,4,0,1,0,814,8,666
2700,대구광역시,2704,남구,,대명3동제2투,1802,999,185,762,20,2,12,0,0,1,6,0,0,0,988,11,803
2700,대구광역시,2704,남구,,대명3동제3투,1233,779,139,600,11,2,13,1,0,0,3,0,0,0,769,10,454
2700,대구광역시,2704,남구,,대명3동제4투,1890,1134,194,869,26,2,16,1,1,0,4,1,0,0,1114,20,756
2700,대구광역시,2704,남구,대명4동,소계,9205,6757,1208,5276,90,5,57,11,2,2,12,5,1,3,6672,85,2448
2700,대구광역시,2704,남구,,관내사전투표,2655,2655,528,2043,30,3,18,5,0,2,3,1,1,2,2636,19,0
2700,대구광역시,2704,남구,,대명4동제1투,2124,1277,248,970,19,1,11,1,1,0,5,2,0,0,1258,19,847
2700,대구광역시,2704,남구,,대명4동제2투,1836,1180,211,911,16,0,14,3,1,0,3,1,0,1,1161,19,656
2700,대구광역시,2704,남구,,대명4동제3투,1636,1074,129,900,13,1,11,2,0,0,1,0,0,0,1057,17,562
2700,대구광역시,2704,남구,,대명4동제4투,954,571,92,452,12,0,3,0,0,0,0,1,0,0,560,11,383
2700,대구광역시,2704,남구,대명5동,소계,5232,3741,758,2799,79,2,35,4,0,2,8,4,0,2,3693,48,1491
2700,대구광역시,2704,남구,,관내사전투표,1307,1307,290,963,27,1,12,1,0,0,1,3,0,0,1298,9,0
2700,대구광역시,2704,남구,,대명5동제1투,428,211,39,161,5,1,1,0,0,0,2,0,0,0,209,2,217
2700,대구광역시,2704,남구,,대명5동제2투,2087,1366,296,1003,23,0,11,3,0,1,3,1,0,2,1343,23,721
2700,대구광역시,2704,남구,,대명5동제3투,1410,857,133,672,24,0,11,0,0,1,2,0,0,0,843,14,553
2700,대구광역시,2704,남구,대명6동,소계,7952,5787,1143,4355,118,11,77,6,1,2,13,0,2,3,5731,56,2165
2700,대구광역시,2704,남구,,관내사전투표,2427,2427,548,1782,48,3,22,1,1,0,2,0,0,1,2408,19,0
2700,대구광역시,2704,남구,,대명6동제1투,1694,995,153,793,14,0,20,0,0,0,1,0,0,1,982,13,699
2700,대구광역시,2704,남구,,대명6동제2투,1938,1217,242,905,31,1,18,1,0,1,3,0,1,0,1203,14,721
2700,대구광역시,2704,남구,,대명6동제3투,1893,1148,200,875,25,7,17,4,0,1,7,0,1,1,1138,10,745
2700,대구광역시,2704,남구,대명9동,소계,12602,8957,1922,6639,171,9,107,5,2,3,12,3,1,1,8875,82,3645
2700,대구광역시,2704,남구,,관내사전투표,3631,3631,911,2611,64,2,16,2,1,0,3,1,0,0,3611,20,0
2700,대구광역시,2704,남구,,대명9동제1투,2366,1357,259,1026,19,1,26,0,0,2,1,1,0,0,1335,22,1009
2700,대구광역시,2704,남구,,대명9동제2투,1959,1287,230,989,33,2,17,0,0,0,2,1,1,1,1276,11,672
2700,대구광역시,2704,남구,,대명9동제3투,2265,1288,247,986,22,0,19,1,1,1,1,0,0,0,1278,10,977
2700,대구광역시,2704,남구,,대명9동제4투,2381,1394,275,1027,33,4,29,2,0,0,5,0,0,0,1375,19,987
2700,대구광역시,2704,남구,대명10동,소계,7698,5659,1031,4406,80,1,49,4,1,3,16,1,1,2,5595,64,2039
2700,대구광역시,2704,남구,,관내사전투표,2340,2340,482,1784,27,0,15,4,1,2,5,0,0,0,2320,20,0
2700,대구광역시,2704,남구,,대명10동제1투,1973,1192,181,953,22,1,10,0,0,0,3,0,1,0,1171,21,781
2700,대구광역시,2704,남구,,대명10동제2투,1585,1009,160,803,12,0,13,0,0,1,4,1,0,2,996,13,576
2700,대구광역시,2704,남구,,대명10동제3투,1800,1118,208,866,19,0,11,0,0,0,4,0,0,0,1108,10,682
2700,대구광역시,2704,남구,대명11동,소계,7334,5249,851,4154,90,5,55,4,2,1,13,3,2,4,5184,65,2085
2700,대구광역시,2704,남구,,관내사전투표,2086,2086,383,1624,34,1,14,3,1,1,5,0,0,0,2066,20,0
2700,대구광역시,2704,남구,,대명11동제1투,1864,1042,154,821,28,1,16,0,0,0,2,1,1,2,1026,16,822
2700,대구광역시,2704,남구,,대명11동제2투,1665,1016,133,823,21,1,11,1,0,0,2,2,1,1,996,20,649
2700,대구광역시,2704,남구,,대명11동제3투,1719,1105,181,886,7,2,14,0,1,0,4,0,0,1,1096,9,614
2700,대구광역시,2704,남구,잘못 투입·구분된 투표지,,0,4,1,3,0,0,0,0,0,0,0,0,0,0,4,0,-4
2700,대구광역시,2705,북구,합계,,373173,294832,66469,215861,6090,155,2591,54,49,71,436,149,83,124,292132,2700,78341
2700,대구광역시,2705,북구,거소·선상투표,,793,740,149,432,13,5,17,2,0,0,5,4,3,7,637,103,53
2700,대구광역시,2705,북구,관외사전투표,,31281,31274,8182,21519,788,26,343,14,6,1,25,18,4,25,30951,323,7
2700,대구광역시,2705,북구,재외투표,,1015,706,310,301,18,1,3,0,0,0,1,0,0,0,634,72,309
2700,대구광역시,2705,북구,고성동,소계,4984,4150,919,3068,101,2,21,0,0,3,4,1,0,1,4120,30,834
2700,대구광역시,2705,북구,,관내사전투표,2534,2534,645,1797,68,2,9,0,0,0,1,0,0,0,2522,12,0
2700,대구광역시,2705,북구,,고성동제1투,1557,1039,175,822,19,0,5,0,0,2,2,1,0,0,1026,13,518
2700,대구광역시,2705,북구,,고성동제2투,893,577,99,449,14,0,7,0,0,1,1,0,0,1,572,5,316
2700,대구광역시,2705,북구,칠성동,소계,16746,12823,2657,9702,247,4,62,1,5,2,20,3,6,3,12712,111,3923
2700,대구광역시,2705,북구,,관내사전투표,3663,3663,835,2720,64,2,8,1,0,1,5,2,1,2,3641,22,0
2700,대구광역시,2705,북구,,칠성동제1투,2280,1371,196,1120,15,0,16,0,0,0,1,0,0,1,1349,22,909
2700,대구광역시,2705,북구,,칠성동제2투,2767,2000,504,1418,46,0,10,0,1,0,4,0,0,0,1983,17,767
2700,대구광역시,2705,북구,,칠성동제3투,1751,1127,169,907,20,0,7,0,2,0,4,1,2,0,1112,15,624
2700,대구광역시,2705,북구,,칠성동제4투,2747,2041,366,1599,41,2,12,0,0,1,4,0,2,0,2027,14,706
2700,대구광역시,2705,북구,,칠성동제5투,3538,2621,587,1938,61,0,9,0,2,0,2,0,1,0,2600,21,917
2700,대구광역시,2705,북구,침산1동,소계,3446,2605,429,2064,36,1,35,0,0,0,8,2,4,0,2579,26,841
2700,대구광역시,2705,북구,,관내사전투표,1076,1075,205,835,11,0,10,0,0,0,2,1,1,0,1065,10,1
2700,대구광역시,2705,북구,,침산1동제1투,1328,914,132,734,16,1,15,0,0,0,4,0,1,0,903,11,414
2700,대구광역시,2705,북구,,침산1동제2투,1042,616,92,495,9,0,10,0,0,0,2,1,2,0,611,5,426
2700,대구광역시,2705,북구,침산2동,소계,13648,11082,2534,8147,216,5,69,2,4,4,11,4,2,5,11003,79,2566
2700,대구광역시,2705,북구,,관내사전투표,4167,4167,1058,2989,71,1,17,0,2,1,2,1,1,1,4144,23,0
2700,대구광역시,2705,북구,,침산2동제1투,1998,1417,269,1073,35,3,18,0,0,1,3,0,1,1,1404,13,581
2700,대구광역시,2705,북구,,침산2동제2투,2302,1530,329,1129,40,1,10,0,1,1,2,2,0,2,1517,13,772
2700,대구광역시,2705,북구,,침산2동제3투,3085,2325,511,1739,44,0,12,2,0,1,1,1,0,1,2312,13,760
2700,대구광역시,2705,북구,,침산2동제4투,2096,1643,367,1217,26,0,12,0,1,0,3,0,0,0,1626,17,453
2700,대구광역시,2705,북구,침산3동,소계,15382,12302,2583,9244,256,10,76,4,1,1,16,6,5,4,12206,96,3080
2700,대구광역시,2705,북구,,관내사전투표,4704,4704,1078,3467,101,3,19,2,0,0,3,1,3,1,4678,26,0
2700,대구광역시,2705,북구,,침산3동제1투,2367,1534,288,1171,28,4,13,1,0,1,2,1,1,1,1511,23,833
2700,대구광역시,2705,북구,,침산3동제2투,2458,1709,316,1333,35,0,12,0,1,0,1,1,0,1,1700,9,749
2700,대구광역시,2705,북구,,침산3동제3투,2677,1961,371,1509,33,2,22,0,0,0,5,0,1,0,1943,18,716
2700,대구광역시,2705,북구,,침산3동제4투,3176,2394,530,1764,59,1,10,1,0,0,5,3,0,1,2374,20,782
2700,대구광역시,2705,북구,노원동,소계,10463,8206,1361,6553,129,4,67,0,0,0,17,6,2,2,8141,65,2257
2700,대구광역시,2705,북구,,관내사전투표,3663,3663,651,2924,38,2,21,0,0,0,1,1,2,1,3641,22,0
2700,대구광역시,2705,북구,,노원동제1투,1204,761,108,617,13,0,10,0,0,0,6,1,0,0,755,6,443
2700,대구광역시,2705,북구,,노원동제2투,1069,641,90,528,11,0,6,0,0,0,2,0,0,0,637,4,428
2700,대구광역시,2705,북구,,노원동제3투,1413,943,117,788,15,1,6,0,0,0,2,1,0,0,930,13,470
2700,대구광역시,2705,북구,,노원동제4투,1029,587,76,489,6,0,7,0,0,0,2,3,0,0,583,4,442
2700,대구광역시,2705,북구,,노원동제5투,2085,1611,319,1207,46,1,17,0,0,0,4,0,0,1,1595,16,474
2700,대구광역시,2705,북구,산격1동,소계,8055,5946,994,4688,76,4,72,2,0,4,15,3,5,2,5865,81,2109
2700,대구광역시,2705,북구,,관내사전투표,2729,2729,508,2114,30,2,24,2,0,0,4,3,2,1,2690,39,0
2700,대구광역시,2705,북구,,산격1동제1투,1948,1209,166,986,17,0,24,0,0,0,5,0,0,0,1198,11,739
2700,대구광역시,2705,북구,,산격1동제2투,1864,1220,189,979,19,0,8,0,0,1,5,0,1,1,1203,17,644
2700,대구광역시,2705,북구,,산격1동제3투,1514,788,131,609,10,2,16,0,0,3,1,0,2,0,774,14,726
2700,대구광역시,2705,북구,산격2동,소계,9393,7590,1460,5863,130,7,40,0,0,3,13,3,3,7,7529,61,1803
2700,대구광역시,2705,북구,,관내사전투표,3720,3720,760,2856,57,5,14,0,0,0,3,2,1,1,3699,21,0
2700,대구광역시,2705,북구,,산격2동제1투,1773,1242,238,959,17,1,6,0,0,0,1,0,1,2,1225,17,531
2700,대구광역시,2705,북구,,산격2동제2투,1822,1158,195,904,26,0,11,0,0,1,1,1,1,1,1141,17,664
2700,대구광역시,2705,북구,,산격2동제3투,2078,1470,267,1144,30,1,9,0,0,2,8,0,0,3,1464,6,608
2700,대구광역시,2705,북구,산격3동,소계,7528,5409,1188,3960,119,3,49,2,4,2,12,5,2,4,5350,59,2119
2700,대구광역시,2705,북구,,관내사전투표,2188,2188,564,1532,56,0,8,2,0,0,5,0,1,2,2170,18,0
2700,대구광역시,2705,북구,,산격3동제1투,2763,1636,359,1180,38,1,24,0,4,0,0,3,1,1,1611,25,1127
2700,대구광역시,2705,북구,,산격3동제2투,2577,1585,265,1248,25,2,17,0,0,2,7,2,0,1,1569,16,992
2700,대구광역시,2705,북구,산격4동,소계,7751,5958,1188,4506,109,1,61,1,1,1,12,1,6,5,5892,66,1793
2700,대구광역시,2705,북구,,관내사전투표,2700,2700,649,1950,54,1,19,1,1,0,2,0,3,1,2681,19,0
2700,대구광역시,2705,북구,,산격4동제1투,1658,1033,185,795,22,0,15,0,0,0,0,0,0,0,1017,16,625
2700,대구광역시,2705,북구,,산격4동제2투,1711,1039,147,841,17,0,11,0,0,0,5,1,2,2,1026,13,672
2700,대구광역시,2705,북구,,산격4동제3투,1682,1186,207,920,16,0,16,0,0,1,5,0,1,2,1168,18,496
2700,대구광역시,2705,북구,복현1동,소계,6704,4807,1043,3511,126,4,48,3,0,3,5,5,1,1,4750,57,1897
2700,대구광역시,2705,북구,,관내사전투표,2338,2338,576,1638,73,2,15,3,0,2,1,4,0,1,2315,23,0
2700,대구광역시,2705,북구,,복현1동제1투,2042,1134,206,873,20,1,14,0,0,1,3,1,1,0,1120,14,908
2700,대구광역시,2705,북구,,복현1동제2투,2324,1335,261,1000,33,1,19,0,0,0,1,0,0,0,1315,20,989
2700,대구광역시,2705,북구,복현2동,소계,21792,16646,3729,12236,359,8,121,2,3,7,25,6,2,7,16505,141,5146
2700,대구광역시,2705,북구,,관내사전투표,5526,5524,1453,3896,114,2,25,1,1,3,7,2,0,2,5506,18,2
2700,대구광역시,2705,북구,,복현2동제1투,2772,1678,332,1264,30,3,17,0,0,1,4,2,0,1,1654,24,1094
2700,대구광역시,2705,북구,,복현2동제2투,2272,1460,298,1097,38,1,8,0,1,0,2,0,0,0,1445,15,812
2700,대구광역시,2705,북구,,복현2동제3투,3054,2177,500,1554,63,0,23,1,1,1,3,0,0,1,2147,30,877
2700,대구광역시,2705,북구,,복현2동제4투,2768,2013,351,1586,37,0,18,0,0,0,6,1,0,1,2000,13,755
2700,대구광역시,2705,북구,,복현2동제5투,2992,2124,458,1571,48,2,20,0,0,0,0,1,1,2,2103,21,868
2700,대구광역시,2705,북구,,복현2동제6투,2408,1670,337,1268,29,0,10,0,0,2,3,0,1,0,1650,20,738
2700,대구광역시,2705,북구,대현동,소계,13967,10590,2154,8002,205,2,87,4,1,2,17,3,3,1,10481,109,3377
2700,대구광역시,2705,북구,,관내사전투표,4501,4501,1015,3346,73,0,22,2,0,0,3,1,0,0,4462,39,0
2700,대구광역시,2705,북구,,대현동제1투,1944,1067,178,831,24,1,15,0,0,0,4,1,0,0,1054,13,877
2700,대구광역시,2705,북구,,대현동제2투,1977,1266,204,1006,21,0,13,0,0,0,4,0,0,0,1248,18,711
2700,대구광역시,2705,북구,,대현동제3투,1723,1068,222,800,17,1,12,1,0,0,1,0,1,0,1055,13,655
2700,대구광역시,2705,북구,,대현동제4투,2172,1457,248,1140,31,0,12,1,1,0,5,1,1,1,1441,16,715
2700,대구광역시,2705,북구,,대현동제5투,1650,1231,287,879,39,0,13,0,0,2,0,0,1,0,1221,10,419
2700,대구광역시,2705,북구,검단동,소계,5756,4428,844,3417,59,2,51,0,2,0,7,3,1,0,4386,42,1328
2700,대구광역시,2705,북구,,관내사전투표,1813,1813,366,1386,25,1,23,0,1,0,1,1,1,0,1805,8,0
2700,대구광역시,2705,북구,,검단동제1투,1723,1082,184,855,11,0,13,0,1,0,0,0,0,0,1064,18,641
2700,대구광역시,2705,북구,,검단동제2투,2220,1533,294,1176,23,1,15,0,0,0,6,2,0,0,1517,16,687
2700,대구광역시,2705,북구,무태조야동,소계,26706,20467,4870,14826,373,4,185,1,2,6,38,14,3,6,20328,139,6239
2700,대구광역시,2705,북구,,관내사전투표,5963,5962,1531,4286,91,1,23,0,0,1,5,4,0,2,5944,18,1
2700,대구광역시,2705,북구,,무태조야동제1투,2855,1843,453,1309,39,0,18,0,0,0,5,0,0,1,1825,18,1012
2700,대구광역시,2705,북구,,무태조야동제2투,2060,1434,296,1081,19,1,19,0,0,1,6,1,0,0,1424,10,626
2700,대구광역시,2705,북구,,무태조야동제3투,2521,1706,409,1223,28,1,26,0,0,3,6,1,0,0,1697,9,815
2700,대구광역시,2705,북구,,무태조야동제4투,1744,1009,209,740,13,0,25,0,1,0,4,2,1,0,995,14,735
2700,대구광역시,2705,북구,,무태조야동제5투,1787,1278,283,930,32,0,13,1,1,0,2,2,0,1,1265,13,509
2700,대구광역시,2705,북구,,무태조야동제6투,3005,2280,539,1652,43,1,16,0,0,1,5,0,0,1,2258,22,725
2700,대구광역시,2705,북구,,무태조야동제7투,1103,798,107,657,10,0,15,0,0,0,1,0,1,0,791,7,305
2700,대구광역시,2705,북구,,무태조야동제8투,3147,2346,653,1588,66,0,19,0,0,0,1,2,0,0,2329,17,801
2700,대구광역시,2705,북구,,무태조야동제9투,2521,1811,390,1360,32,0,11,0,0,0,3,2,1,1,1800,11,710
2700,대구광역시,2705,북구,관문동,소계,26299,20439,4737,14934,372,5,160,3,2,3,40,3,6,6,20271,168,5860
2700,대구광역시,2705,북구,,관내사전투표,4344,4344,1090,3165,42,1,22,0,0,0,5,0,0,2,4327,17,0
2700,대구광역시,2705,북구,,관문동제1투,1298,781,142,607,11,0,10,1,0,1,2,0,0,0,774,7,517
2700,대구광역시,2705,북구,,관문동제2투,2497,1857,417,1370,37,0,10,0,0,0,4,1,1,0,1840,17,640
2700,대구광역시,2705,북구,,관문동제3투,2079,1497,291,1154,28,2,7,0,0,1,0,0,0,1,1484,13,582
2700,대구광역시,2705,북구,,관문동제4투,1962,1520,232,1226,26,0,14,0,0,1,2,0,0,0,1501,19,442
2700,대구광역시,2705,북구,,관문동제5투,672,498,72,403,6,0,7,0,0,0,1,0,0,0,489,9,174
2700,대구광역시,2705,북구,,관문동제6투,2640,1824,493,1242,47,0,17,0,0,0,5,1,1,0,1806,18,816
2700,대구광역시,2705,북구,,관문동제7투,2220,1595,373,1167,25,0,12,1,0,0,5,0,1,0,1584,11,625
2700,대구광역시,2705,북구,,관문동제8투,3573,2670,691,1859,57,1,25,0,1,0,12,1,0,2,2649,21,903
2700,대구광역시,2705,북구,,관문동제9투,2390,1743,476,1183,34,1,24,1,0,0,1,0,3,0,1723,20,647
2700,대구광역시,2705,북구,,관문동제10투,2624,2110,460,1558,59,0,12,0,1,0,3,0,0,1,2094,16,514
2700,대구광역시,2705,북구,태전1동,소계,17445,12964,2657,9741,266,7,150,0,3,7,16,6,6,1,12860,104,4481
2700,대구광역시,2705,북구,,관내사전투표,4043,4043,960,2936,80,1,36,0,0,1,1,3,4,0,4022,21,0
2700,대구광역시,2705,북구,,태전1동제1투,3196,2113,399,1616,36,2,32,0,1,1,2,1,0,0,2090,23,1083
2700,대구광역시,2705,북구,,태전1동제2투,2239,1569,314,1175,35,2,21,0,0,0,2,1,0,0,1550,19,670
2700,대구광역시,2705,북구,,태전1동제3투,1467,832,153,640,18,1,14,0,1,0,0,0,0,1,828,4,635
2700,대구광역시,2705,북구,,태전1동제4투,2198,1282,238,979,28,0,11,0,0,3,3,1,1,0,1264,18,916
2700,대구광역시,2705,북구,,태전1동제5투,2264,1540,297,1173,39,0,14,0,1,1,5,0,1,0,1531,9,724
2700,대구광역시,2705,북구,,태전1동제6투,2038,1585,296,1222,30,1,22,0,0,1,3,0,0,0,1575,10,453
2700,대구광역시,2705,북구,태전2동,소계,19705,14986,3173,11232,268,8,146,1,0,2,28,10,3,9,14880,106,4719
2700,대구광역시,2705,북구,,관내사전투표,5370,5370,1196,4036,76,3,32,0,0,0,2,4,0,2,5351,19,0
2700,대구광역시,2705,북구,,태전2동제1투,2501,1659,296,1283,29,1,21,1,0,1,3,3,0,1,1639,20,842
2700,대구광역시,2705,북구,,태전2동제2투,2886,1823,380,1380,31,0,14,0,0,0,3,0,2,4,1814,9,1063
2700,대구광역시,2705,북구,,태전2동제3투,2896,1980,385,1501,46,0,22,0,0,0,2,1,0,1,1958,22,916
2700,대구광역시,2705,북구,,태전2동제4투,3051,2083,418,1564,41,1,32,0,0,0,7,1,0,0,2064,19,968
2700,대구광역시,2705,북구,,태전2동제5투,3001,2071,498,1468,45,3,25,0,0,1,11,1,1,1,2054,17,930
2700,대구광역시,2705,북구,구암동,소계,26088,20257,5098,14279,476,7,197,1,6,5,22,9,6,5,20111,146,5831
2700,대구광역시,2705,북구,,관내사전투표,6436,6436,1967,4245,140,3,37,0,3,1,2,4,4,1,6407,29,0
2700,대구광역시,2705,북구,,구암동제1투,2010,1381,237,1074,30,1,24,0,0,1,3,0,1,0,1371,10,629
2700,대구광역시,2705,북구,,구암동제2투,2564,1905,371,1459,40,0,14,0,0,0,3,0,0,0,1887,18,659
2700,대구광역시,2705,북구,,구암동제3투,2372,1657,363,1218,38,0,14,0,0,0,3,0,1,1,1638,19,715
2700,대구광역시,2705,북구,,구암동제4투,2394,1822,379,1370,34,0,14,1,0,0,4,0,0,1,1803,19,572
2700,대구광역시,2705,북구,,구암동제5투,2626,1824,454,1284,47,1,23,0,2,0,1,0,0,0,1812,12,802
2700,대구광역시,2705,북구,,구암동제6투,2645,1749,453,1202,48,1,27,0,0,0,3,1,0,0,1735,14,896
2700,대구광역시,2705,북구,,구암동제7투,2382,1608,421,1097,46,1,24,0,0,1,2,2,0,0,1594,14,774
2700,대구광역시,2705,북구,,구암동제8투,2659,1875,453,1330,53,0,20,0,1,2,1,2,0,2,1864,11,784
2700,대구광역시,2705,북구,관음동,소계,14221,10879,2115,8330,210,6,103,2,2,4,17,6,2,4,10801,78,3342
2700,대구광역시,2705,북구,,관내사전투표,4742,4742,998,3590,92,4,21,1,0,0,4,3,1,1,4715,27,0
2700,대구광역시,2705,북구,,관음동제1투,2659,1651,289,1282,36,0,24,0,0,0,2,0,1,1,1635,16,1008
2700,대구광역시,2705,북구,,관음동제2투,2318,1563,257,1234,29,2,21,0,0,2,4,3,0,0,1552,11,755
2700,대구광역시,2705,북구,,관음동제3투,2027,1280,244,986,15,0,14,0,1,0,5,0,0,0,1265,15,747
2700,대구광역시,2705,북구,,관음동제4투,2475,1643,327,1238,38,0,23,1,1,2,2,0,0,2,1634,9,832
2700,대구광역시,2705,북구,읍내동,소계,20678,15487,3167,11621,315,12,152,1,3,4,23,7,5,7,15317,170,5191
2700,대구광역시,2705,북구,,관내사전투표,5847,5844,1296,4373,95,4,24,0,1,1,4,2,1,0,5801,43,3
2700,대구광역시,2705,북구,,읍내동제1투,2377,1435,289,1048,34,1,30,0,1,2,5,1,0,0,1411,24,942
2700,대구광역시,2705,북구,,읍내동제2투,2266,1497,278,1135,40,0,15,0,0,0,0,1,1,1,1471,26,769
2700,대구광역시,2705,북구,,읍내동제3투,2677,1681,343,1232,45,3,28,0,1,0,1,3,1,1,1658,23,996
2700,대구광역시,2705,북구,,읍내동제4투,2477,1502,284,1135,30,1,21,0,0,0,5,0,1,1,1478,24,975
2700,대구광역시,2705,북구,,읍내동제5투,2826,1981,370,1517,45,1,24,1,0,1,3,0,1,4,1967,14,845
2700,대구광역시,2705,북구,,읍내동제6투,2208,1547,307,1181,26,2,10,0,0,0,5,0,0,0,1531,16,661
2700,대구광역시,2705,북구,동천동,소계,22404,18003,4664,12533,469,11,127,7,4,3,25,11,1,9,17864,139,4401
2700,대구광역시,2705,북구,,관내사전투표,7188,7188,2101,4835,153,10,33,1,1,1,2,4,0,2,7143,45,0
2700,대구광역시,2705,북구,,동천동제1투,2484,1621,318,1208,41,0,21,1,1,0,6,0,1,0,1597,24,863
2700,대구광역시,2705,북구,,동천동제2투,1994,1377,281,1027,35,0,16,1,0,1,4,1,0,2,1368,9,617
2700,대구광역시,2705,북구,,동천동제3투,2414,1882,482,1305,58,1,13,0,0,1,4,2,0,0,1866,16,532
2700,대구광역시,2705,북구,,동천동제4투,2393,1674,445,1148,52,0,13,0,0,0,2,1,0,2,1663,11,719
2700,대구광역시,2705,북구,,동천동제5투,2965,2206,592,1507,68,0,16,2,0,0,5,0,0,1,2191,15,759
2700,대구광역시,2705,북구,,동천동제6투,2966,2055,445,1503,62,0,15,2,2,0,2,3,0,2,2036,19,911
2700,대구광역시,2705,북구,국우동,소계,20923,16084,4264,11148,354,6,149,1,0,4,14,10,2,3,15955,129,4839
2700,대구광역시,2705,북구,,관내사전투표,4998,4998,1471,3361,97,2,30,0,0,0,3,4,1,0,4969,29,0
2700,대구광역시,2705,북구,,국우동제1투,2950,1848,412,1358,36,1,21,0,0,1,3,2,1,0,1835,13,1102
2700,대구광역시,2705,북구,,국우동제2투,2155,1362,334,955,27,0,25,0,0,1,3,0,0,1,1346,16,793
2700,대구광역시,2705,북구,,국우동제3투,2683,1897,439,1377,42,2,16,0,0,1,2,0,0,1,1880,17,786
2700,대구광역시,2705,북구,,국우동제4투,2235,1601,451,1074,43,0,15,0,0,0,0,0,0,0,1583,18,634
2700,대구광역시,2705,북구,,국우동제5투,2947,2072,572,1408,39,0,25,1,0,0,2,2,0,1,2050,22,875
2700,대구광역시,2705,북구,,국우동제6투,2955,2306,585,1615,70,1,17,0,0,1,1,2,0,0,2292,14,649
2700,대구광역시,2705,북구,잘못 투입·구분된 투표지,,0,4,0,4,0,0,0,0,0,0,0,0,0,0,4,0,-4
2700,대구광역시,2706,수성구,합계,,349945,285537,59379,216031,5168,132,1848,37,33,89,385,127,57,88,283374,2163,64408
2700,대구광역시,2706,수성구,거소·선상투표,,553,525,78,363,7,1,9,0,0,0,2,1,0,3,464,61,28
2700,대구광역시,2706,수성구,관외사전투표,,33555,33545,8161,24014,669,31,302,3,5,8,24,19,8,18,33262,283,10
2700,대구광역시,2706,수성구,재외투표,,1712,1208,471,552,43,0,2,0,0,0,4,0,0,0,1072,136,504
2700,대구광역시,2706,수성구,범어1동,소계,12161,10046,1858,7871,179,5,44,3,1,5,12,5,2,6,9991,55,2115
2700,대구광역시,2706,수성구,,관내사전투표,3764,3762,829,2843,67,2,5,0,0,2,0,2,1,3,3754,8,2
2700,대구광역시,2706,수성구,,범어1동제1투,2050,1461,282,1116,30,0,14,2,0,0,1,0,0,2,1447,14,589
2700,대구광역시,2706,수성구,,범어1동제2투,2189,1682,228,1392,32,1,7,1,1,1,3,1,0,1,1668,14,507
2700,대구광역시,2706,수성구,,범어1동제3투,2285,1731,255,1405,30,2,11,0,0,2,7,2,1,0,1715,16,554
2700,대구광역시,2706,수성구,,범어1동제4투,1873,1410,264,1115,20,0,7,0,0,0,1,0,0,0,1407,3,463
2700,대구광역시,2706,수성구,범어2동,소계,10499,8024,1301,6490,116,4,42,2,2,3,8,3,1,0,7972,52,2475
2700,대구광역시,2706,수성구,,관내사전투표,2331,2331,499,1785,22,2,5,1,0,1,3,0,0,0,2318,13,0
2700,대구광역시,2706,수성구,,범어2동제1투,1936,1177,221,903,28,1,12,0,0,0,0,2,0,0,1167,10,759
2700,대구광역시,2706,수성구,,범어2동제2투,1496,1062,204,824,19,0,5,0,1,0,0,0,0,0,1053,9,434
2700,대구광역시,2706,수성구,,범어2동제3투,2225,1359,202,1095,33,0,14,1,1,2,5,0,1,0,1354,5,866
2700,대구광역시,2706,수성구,,범어2동제4투,2511,2095,175,1883,14,1,6,0,0,0,0,1,0,0,2080,15,416
2700,대구광역시,2706,수성구,범어3동,소계,11526,9506,1910,7306,183,4,39,0,2,4,6,4,0,2,9460,46,2020
2700,대구광역시,2706,수성구,,관내사전투표,3998,3998,932,2961,68,3,15,0,0,0,0,3,0,1,3983,15,0
2700,대구광역시,2706,수성구,,범어3동제1투,2614,2015,382,1580,36,1,3,0,0,1,2,0,0,1,2006,9,599
2700,대구광역시,2706,수성구,,범어3동제2투,2434,1648,287,1285,44,0,11,0,2,1,3,1,0,0,1634,14,786
2700,대구광역시,2706,수성구,,범어3동제3투,2480,1845,309,1480,35,0,10,0,0,2,1,0,0,0,1837,8,635
2700,대구광역시,2706,수성구,범어4동,소계,12198,9864,2068,7472,191,1,45,2,0,5,8,5,2,0,9799,65,2334
2700,대구광역시,2706,수성구,,관내사전투표,3309,3309,819,2400,62,0,5,1,0,1,3,1,1,0,3293,16,0
2700,대구광역시,2706,수성구,,범어4동제1투,1517,1008,175,794,11,0,9,0,0,0,2,1,0,0,992,16,509
2700,대구광역시,2706,수성구,,범어4동제2투,2705,2076,456,1547,48,1,10,1,0,0,1,1,0,0,2065,11,629
2700,대구광역시,2706,수성구,,범어4동제3투,2306,1708,326,1316,37,0,12,0,0,1,0,1,1,0,1694,14,598
2700,대구광역시,2706,수성구,,범어4동제4투,2361,1763,292,1415,33,0,9,0,0,3,2,1,0,0,1755,8,598
2700,대구광역시,2706,수성구,만촌1동,소계,17766,14394,2980,10920,246,12,81,0,2,3,31,5,2,2,14284,110,3372
2700,대구광역시,2706,수성구,,관내사전투표,6044,6038,1453,4418,98,5,18,0,0,2,5,1,1,1,6002,36,6
2700,대구광역시,2706,수성구,,만촌1동제1투,2094,1464,233,1174,28,0,8,0,2,0,4,0,0,0,1449,15,630
2700,대구광역시,2706,수성구,,만촌1동제2투,2266,1714,353,1301,31,1,8,0,0,1,3,0,0,1,1699,15,552
2700,대구광역시,2706,수성구,,만촌1동제3투,2145,1598,314,1227,21,3,12,0,0,0,6,1,0,0,1584,14,547
2700,대구광역시,2706,수성구,,만촌1동제4투,2513,1593,325,1181,35,3,21,0,0,0,7,2,1,0,1575,18,920
2700,대구광역시,2706,수성구,,만촌1동제5투,2704,1987,302,1619,33,0,14,0,0,0,6,1,0,0,1975,12,717
2700,대구광역시,2706,수성구,만촌2동,소계,8540,6648,1364,5004,128,3,52,0,1,1,16,2,1,2,6574,74,1892
2700,대구광역시,2706,수성구,,관내사전투표,2702,2702,659,1960,51,1,15,0,0,0,2,0,0,1,2689,13,0
2700,대구광역시,2706,수성구,,만촌2동제1투,2247,1467,295,1086,40,1,9,0,1,0,2,1,0,0,1435,32,780
2700,대구광역시,2706,수성구,,만촌2동제2투,1788,1210,182,970,20,0,12,0,0,1,5,1,1,1,1193,17,578
2700,대구광역시,2706,수성구,,만촌2동제3투,1803,1269,228,988,17,1,16,0,0,0,7,0,0,0,1257,12,534
2700,대구광역시,2706,수성구,만촌3동,소계,13007,10586,2175,8073,181,5,52,0,1,4,12,3,2,5,10513,73,2421
2700,대구광역시,2706,수성구,,관내사전투표,3752,3752,958,2704,52,2,15,0,0,0,2,1,1,3,3738,14,0
2700,대구광역시,2706,수성구,,만촌3동제1투,2415,1626,234,1329,28,0,7,0,1,3,2,2,0,0,1606,20,789
2700,대구광역시,2706,수성구,,만촌3동제2투,1891,1468,277,1142,29,0,7,0,0,1,3,0,0,0,1459,9,423
2700,대구광역시,2706,수성구,,만촌3동제3투,2097,1545,287,1188,36,1,8,0,0,0,3,0,0,2,1525,20,552
2700,대구광역시,2706,수성구,,만촌3동제4투,2852,2195,419,1710,36,2,15,0,0,0,2,0,1,0,2185,10,657
2700,대구광역시,2706,수성구,수성1가동,소계,13790,11159,2195,8603,182,4,64,2,0,3,19,3,3,5,11083,76,2631
2700,대구광역시,2706,수성구,,관내사전투표,4529,4529,1028,3392,72,4,11,0,0,0,6,0,1,1,4515,14,0
2700,대구광역시,2706,수성구,,수성1가동제1투,2258,1662,353,1255,32,0,10,1,0,0,1,0,0,0,1652,10,596
2700,대구광역시,2706,수성구,,수성1가동제2투,2669,1985,301,1608,36,0,14,0,0,2,4,1,0,2,1968,17,684
2700,대구광역시,2706,수성구,,수성1가동제3투,2176,1548,243,1246,26,0,12,0,0,0,2,0,0,0,1529,19,628
2700,대구광역시,2706,수성구,,수성1가동제4투,2158,1435,270,1102,16,0,17,1,0,1,6,2,2,2,1419,16,723
2700,대구광역시,2706,수성구,수성2·3가동,소계,9905,8328,1373,6705,138,5,44,1,0,3,5,6,1,2,8283,45,1577
2700,대구광역시,2706,수성구,,관내사전투표,4058,4057,779,3184,63,3,9,1,0,0,1,3,1,0,4044,13,1
2700,대구광역시,2706,수성구,,수성2·3가동제1투,2195,1692,231,1409,31,1,5,0,0,1,2,3,0,0,1683,9,503
2700,대구광역시,2706,수성구,,수성2·3가동제2투,1866,1379,190,1142,26,1,10,0,0,1,1,0,0,0,1371,8,487
2700,대구광역시,2706,수성구,,수성2·3가동제3투,1786,1200,173,970,18,0,20,0,0,1,1,0,0,2,1185,15,586
2700,대구광역시,2706,수성구,수성4가동,소계,11597,9495,1707,7490,158,4,47,0,1,1,7,8,3,3,9429,66,2102
2700,대구광역시,2706,수성구,,관내사전투표,4246,4245,879,3247,75,2,12,0,1,0,2,5,1,2,4226,19,1
2700,대구광역시,2706,수성구,,수성4가동제1투,2153,1521,270,1189,30,1,13,0,0,0,2,2,0,0,1507,14,632
2700,대구광역시,2706,수성구,,수성4가동제2투,2304,1618,246,1319,17,0,12,0,0,0,0,1,2,0,1597,21,686
2700,대구광역시,2706,수성구,,수성4가동제3투,1370,1024,151,837,16,1,8,0,0,0,2,0,0,0,1015,9,346
2700,대구광역시,2706,수성구,,수성4가동제4투,1524,1087,161,898,20,0,2,0,0,1,1,0,0,1,1084,3,437
2700,대구광역시,2706,수성구,황금1동,소계,16503,13779,2871,10523,233,1,52,1,1,4,16,2,1,4,13709,70,2724
2700,대구광역시,2706,수성구,,관내사전투표,5261,5261,1331,3832,69,0,10,0,1,1,3,2,0,1,5250,11,0
2700,대구광역시,2706,수성구,,황금1동제1투,2466,1818,237,1530,23,0,7,0,0,1,2,0,0,0,1800,18,648
2700,대구광역시,2706,수성구,,황금1동제2투,1434,994,185,756,16,1,13,0,0,1,1,0,1,2,976,18,440
2700,대구광역시,2706,수성구,,황금1동제3투,2951,2264,419,1786,44,0,7,1,0,0,3,0,0,0,2260,4,687
2700,대구광역시,2706,수성구,,황금1동제4투,2550,1999,439,1497,41,0,8,0,0,0,2,0,0,1,1988,11,551
2700,대구광역시,2706,수성구,,황금1동제5투,1841,1443,260,1122,40,0,7,0,0,1,5,0,0,0,1435,8,398
2700,대구광역시,2706,수성구,황금2동,소계,8964,6456,1255,4985,86,4,42,2,1,2,8,3,3,5,6396,60,2508
2700,대구광역시,2706,수성구,,관내사전투표,2547,2546,574,1901,34,1,8,1,0,1,2,0,0,1,2523,23,1
2700,대구광역시,2706,수성구,,황금2동제1투,1764,1087,178,865,13,2,13,0,0,1,1,2,1,1,1077,10,677
2700,대구광역시,2706,수성구,,황금2동제2투,2495,1532,276,1197,23,0,15,1,0,0,2,1,0,2,1517,15,963
2700,대구광역시,2706,수성구,,황금2동제3투,2158,1291,227,1022,16,1,6,0,1,0,3,0,2,1,1279,12,867
2700,대구광역시,2706,수성구,중동,소계,9857,7383,1348,5806,92,3,53,0,1,0,14,0,0,3,7320,63,2474
2700,대구광역시,2706,수성구,,관내사전투표,3221,3221,693,2444,39,2,11,0,0,0,4,0,0,2,3195,26,0
2700,대구광역시,2706,수성구,,중동제1투,1600,864,119,710,10,1,10,0,0,0,1,0,0,1,852,12,736
2700,대구광역시,2706,수성구,,중동제2투,1679,1193,208,950,17,0,9,0,0,0,4,0,0,0,1188,5,486
2700,대구광역시,2706,수성구,,중동제3투,1960,1185,194,945,15,0,16,0,0,0,4,0,0,0,1174,11,775
2700,대구광역시,2706,수성구,,중동제4투,1397,920,134,757,11,0,7,0,1,0,1,0,0,0,911,9,477
2700,대구광역시,2706,수성구,상동,소계,13142,9957,1719,7935,142,2,70,1,0,9,14,2,0,4,9898,59,3185
2700,대구광역시,2706,수성구,,관내사전투표,3434,3434,708,2649,38,0,17,1,0,3,1,0,0,4,3421,13,0
2700,대구광역시,2706,수성구,,상동제1투,2316,1281,234,983,31,1,18,0,0,0,2,0,0,0,1269,12,1035
2700,대구광역시,2706,수성구,,상동제2투,3256,2350,305,1991,26,0,9,0,0,1,4,1,0,0,2337,13,906
2700,대구광역시,2706,수성구,,상동제3투,2086,1554,233,1279,19,1,9,0,0,2,4,0,0,0,1547,7,532
2700,대구광역시,2706,수성구,,상동제4투,2050,1338,239,1033,28,0,17,0,0,3,3,1,0,0,1324,14,712
2700,대구광역시,2706,수성구,파동,소계,9661,7629,1425,5942,120,3,67,2,3,3,14,7,4,1,7591,38,2032
2700,대구광역시,2706,수성구,,관내사전투표,2966,2966,647,2250,39,2,8,0,0,0,4,5,1,0,2956,10,0
2700,대구광역시,2706,수성구,,파동제1투,1940,1265,194,1021,16,1,16,1,0,2,4,0,1,0,1256,9,675
2700,대구광역시,2706,수성구,,파동제2투,2350,1749,309,1376,29,0,19,0,1,1,4,2,1,1,1743,6,601
2700,대구광역시,2706,수성구,,파동제3투,2405,1649,275,1295,36,0,24,1,2,0,2,0,1,0,1636,13,756
2700,대구광역시,2706,수성구,두산동,소계,11610,8663,1501,6908,114,8,64,0,1,1,9,2,0,1,8609,54,2947
2700,대구광역시,2706,수성구,,관내사전투표,3292,3292,654,2562,35,5,12,0,0,0,4,1,0,0,3273,19,0
2700,대구광역시,2706,수성구,,두산동제1투,2252,1304,219,1038,16,0,17,0,1,0,2,0,0,0,1293,11,948
2700,대구광역시,2706,수성구,,두산동제2투,2985,1663,312,1274,36,1,24,0,0,0,1,1,0,1,1650,13,1322
2700,대구광역시,2706,수성구,,두산동제3투,3081,2404,316,2034,27,2,11,0,0,1,2,0,0,0,2393,11,677
2700,대구광역시,2706,수성구,지산1동,소계,18176,13801,2629,10676,228,3,109,2,1,5,32,5,4,4,13698,103,4375
2700,대구광역시,2706,수성구,,관내사전투표,5717,5717,1250,4306,94,1,22,1,1,1,3,1,1,1,5682,35,0
2700,대구광역시,2706,수성구,,지산1동제1투,1891,1217,178,992,18,0,18,0,0,1,1,1,0,0,1209,8,674
2700,대구광역시,2706,수성구,,지산1동제2투,1412,913,152,727,18,0,6,0,0,0,1,0,1,1,906,7,499
2700,대구광역시,2706,수성구,,지산1동제3투,1629,1024,176,798,18,0,11,0,0,1,8,0,2,1,1015,9,605
2700,대구광역시,2706,수성구,,지산1동제4투,2206,1472,215,1201,27,1,12,0,0,1,7,0,0,1,1465,7,734
2700,대구광역시,2706,수성구,,지산1동제5투,2586,1712,328,1302,30,0,19,1,0,1,10,2,0,0,1693,19,874
2700,대구광역시,2706,수성구,,지산1동제6투,2735,1746,330,1350,23,1,21,0,0,0,2,1,0,0,1728,18,989
2700,대구광역시,2706,수성구,지산2동,소계,13989,10771,2175,8216,196,2,70,2,1,2,21,4,2,2,10693,78,3218
2700,대구광역시,2706,수성구,,관내사전투표,4260,4260,985,3168,65,1,21,2,0,0,2,3,1,0,4248,12,0
2700,대구광역시,2706,수성구,,지산2동제1투,2272,1345,251,1034,23,0,14,0,0,0,6,0,1,1,1330,15,927
2700,대구광역시,2706,수성구,,지산2동제2투,2298,1710,306,1345,33,0,5,0,0,2,4,0,0,1,1696,14,588
2700,대구광역시,2706,수성구,,지산2동제3투,1278,857,163,663,17,0,7,0,1,0,0,0,0,0,851,6,421
2700,대구광역시,2706,수성구,,지산2동제4투,1945,1277,241,970,26,1,13,0,0,0,4,1,0,0,1256,21,668
2700,대구광역시,2706,수성구,,지산2동제5투,1936,1322,229,1036,32,0,10,0,0,0,5,0,0,0,1312,10,614
2700,대구광역시,2706,수성구,범물1동,소계,9791,7630,1355,6003,117,2,58,0,0,6,19,3,5,2,7570,60,2161
2700,대구광역시,2706,수성구,,관내사전투표,3471,3471,707,2665,51,2,18,0,0,2,4,0,3,0,3452,19,0
2700,대구광역시,2706,수성구,,범물1동제1투,1535,908,140,724,14,0,14,0,0,0,0,3,2,0,897,11,627
2700,대구광역시,2706,수성구,,범물1동제2투,1031,551,80,444,4,0,9,0,0,0,6,0,0,1,544,7,480
2700,대구광역시,2706,수성구,,범물1동제3투,1850,1387,214,1120,25,0,5,0,0,2,7,0,0,0,1373,14,463
2700,대구광역시,2706,수성구,,범물1동제4투,1904,1313,214,1050,23,0,12,0,0,2,2,0,0,1,1304,9,591
2700,대구광역시,2706,수성구,범물2동,소계,13000,10522,2276,7896,185,1,67,3,2,2,11,10,4,0,10457,65,2478
2700,대구광역시,2706,수성구,,관내사전투표,4298,4297,1050,3134,74,0,18,1,1,0,1,5,2,0,4286,11,1
2700,대구광역시,2706,수성구,,범물2동제1투,2585,1832,332,1447,26,0,11,1,1,0,3,3,0,0,1824,8,753
2700,대구광역시,2706,수성구,,범물2동제2투,1753,1167,239,875,19,0,17,1,0,0,3,1,1,0,1156,11,586
2700,대구광역시,2706,수성구,,범물2동제3투,1985,1430,290,1092,29,0,5,0,0,1,0,1,0,0,1418,12,555
2700,대구광역시,2706,수성구,,범물2동제4투,2379,1796,365,1348,37,1,16,0,0,1,4,0,1,0,1773,23,583
2700,대구광역시,2706,수성구,고산1동,소계,23206,19047,4750,13532,441,8,119,5,3,3,28,8,3,6,18906,141,4159
2700,대구광역시,2706,수성구,,관내사전투표,7636,7635,2243,5159,160,4,30,1,1,0,3,2,0,2,7605,30,1
2700,대구광역시,2706,수성구,,고산1동제1투,1883,1337,339,939,41,0,7,1,0,0,1,1,0,0,1329,8,546
2700,대구광역시,2706,수성구,,고산1동제2투,2040,1397,278,1052,26,1,17,0,1,0,7,3,0,1,1386,11,643
2700,대구광역시,2706,수성구,,고산1동제3투,2111,1463,289,1092,36,1,15,1,0,0,4,0,0,0,1438,25,648
2700,대구광역시,2706,수성구,,고산1동제4투,1903,1347,271,995,42,1,15,0,0,2,3,0,1,0,1330,17,556
2700,대구광역시,2706,수성구,,고산1동제5투,2134,1683,330,1300,25,0,7,1,0,1,0,1,1,1,1667,16,451
2700,대구광역시,2706,수성구,,고산1동제6투,3147,2386,518,1755,54,1,17,1,1,0,10,1,1,1,2360,26,761
2700,대구광역시,2706,수성구,,고산1동제7투,2352,1799,482,1240,57,0,11,0,0,0,0,0,0,1,1791,8,553
2700,대구광역시,2706,수성구,고산2동,소계,21167,17113,3918,12564,360,9,115,3,1,7,19,11,5,3,17015,98,4054
2700,대구광역시,2706,수성구,,관내사전투표,6624,6624,1696,4727,134,4,29,1,0,1,4,5,1,0,6602,22,0
2700,대구광역시,2706,수성구,,고산2동제1투,2163,1450,272,1113,31,1,9,0,0,3,5,1,0,1,1436,14,713
2700,대구광역시,2706,수성구,,고산2동제2투,2311,1748,416,1263,42,0,13,0,1,0,0,0,1,0,1736,12,563
2700,대구광역시,2706,수성구,,고산2동제3투,2106,1350,231,1082,15,0,10,0,0,1,0,1,1,0,1341,9,756
2700,대구광역시,2706,수성구,,고산2동제4투,2627,1967,416,1462,44,1,14,2,0,1,5,3,1,2,1951,16,660
2700,대구광역시,2706,수성구,,고산2동제5투,2777,2131,457,1592,46,1,19,0,0,0,4,1,1,0,2121,10,646
2700,대구광역시,2706,수성구,,고산2동제6투,2559,1843,430,1325,48,2,21,0,0,1,1,0,0,0,1828,15,716
2700,대구광역시,2706,수성구,고산3동,소계,24070,19451,4516,14175,433,7,139,3,3,5,26,6,1,5,19319,132,4619
2700,대구광역시,2706,수성구,,관내사전투표,7283,7283,1918,5149,140,2,31,1,1,2,6,4,0,1,7255,28,0
2700,대구광역시,2706,수성구,,고산3동제1투,2249,1508,307,1121,39,1,17,0,1,0,4,1,0,1,1492,16,741
2700,대구광역시,2706,수성구,,고산3동제2투,2106,1476,244,1170,33,1,12,0,1,1,1,0,0,0,1463,13,630
2700,대구광역시,2706,수성구,,고산3동제3투,2039,1375,336,978,32,0,17,1,0,0,2,0,0,1,1367,8,664
2700,대구광역시,2706,수성구,,고산3동제4투,1668,1193,267,866,31,0,13,0,0,0,2,1,0,1,1181,12,475
2700,대구광역시,2706,수성구,,고산3동제5투,2630,2037,429,1524,48,0,16,0,0,1,2,0,1,1,2022,15,593
2700,대구광역시,2706,수성구,,고산3동제6투,2748,2024,467,1464,51,1,16,1,0,1,6,0,0,0,2007,17,724
2700,대구광역시,2706,수성구,,고산3동제7투,3347,2555,548,1903,59,2,17,0,0,0,3,0,0,0,2532,23,792
2700,대구광역시,2706,수성구,잘못 투입·구분된 투표지,,0,7,0,7,0,0,0,0,0,0,0,0,0,0,7,0,-7
2700,대구광역시,2707,달서구,합계,,466792,368662,77951,275155,7361,180,3102,63,58,102,786,209,109,132,365208,3454,98130
2700,대구광역시,2707,달서구,거소·선상투표,,770,730,146,475,7,1,13,2,1,1,0,1,1,1,649,81,40
2700,대구광역시,2707,달서구,관외사전투표,,39313,39304,9506,27833,934,26,456,9,5,9,51,32,9,20,38890,414,9
2700,대구광역시,2707,달서구,재외투표,,1414,1002,454,389,46,1,3,0,0,1,1,0,0,0,895,107,412
2700,대구광역시,2707,달서구,성당동,소계,17389,12713,2320,9846,223,6,122,2,5,2,42,1,6,8,12583,130,4676
2700,대구광역시,2707,달서구,,관내사전투표,4353,4353,828,3378,69,1,30,0,3,1,4,0,2,1,4317,36,0
2700,대구광역시,2707,달서구,,성당동제1투,2344,1482,234,1175,27,1,24,0,0,0,7,0,0,0,1468,14,862
2700,대구광역시,2707,달서구,,성당동제2투,2033,1294,187,1037,21,1,16,2,0,1,3,0,4,3,1275,19,739
2700,대구광역시,2707,달서구,,성당동제3투,2572,1416,218,1123,13,0,23,0,1,0,6,0,0,1,1385,31,1156
2700,대구광역시,2707,달서구,,성당동제4투,3044,2147,471,1583,43,0,13,0,1,0,17,0,0,3,2131,16,897
2700,대구광역시,2707,달서구,,성당동제5투,3043,2021,382,1550,50,3,16,0,0,0,5,1,0,0,2007,14,1022
2700,대구광역시,2707,달서구,두류1·2동,소계,11820,8124,1355,6379,151,6,71,0,3,5,37,7,5,2,8021,103,3696
2700,대구광역시,2707,달서구,,관내사전투표,3141,3141,602,2421,58,2,18,0,1,1,16,2,1,1,3123,18,0
2700,대구광역시,2707,달서구,,두류1·2동제1투,1689,1025,140,821,18,1,14,0,0,2,5,1,0,0,1002,23,664
2700,대구광역시,2707,달서구,,두류1·2동제2투,1849,1163,167,932,24,2,9,0,1,0,5,0,2,0,1142,21,686
2700,대구광역시,2707,달서구,,두류1·2동제3투,1791,930,141,738,17,1,9,0,1,0,5,1,0,1,914,16,861
2700,대구광역시,2707,달서구,,두류1·2동제4투,1583,873,140,685,19,0,8,0,0,1,3,3,2,0,861,12,710
2700,대구광역시,2707,달서구,,두류1·2동제5투,1767,992,165,782,15,0,13,0,0,1,3,0,0,0,979,13,775
2700,대구광역시,2707,달서구,두류3동,소계,7638,6113,1097,4782,105,4,50,0,0,1,18,1,2,2,6062,51,1525
2700,대구광역시,2707,달서구,,관내사전투표,3203,3203,655,2442,60,2,17,0,0,0,8,1,1,1,3187,16,0
2700,대구광역시,2707,달서구,,두류3동제1투,1987,1396,197,1147,22,0,10,0,0,0,6,0,0,0,1382,14,591
2700,대구광역시,2707,달서구,,두류3동제2투,1509,923,152,730,16,1,12,0,0,0,2,0,0,1,914,9,586
2700,대구광역시,2707,달서구,,두류3동제3투,939,591,93,463,7,1,11,0,0,1,2,0,1,0,579,12,348
2700,대구광역시,2707,달서구,본리동,소계,16584,13099,2845,9761,231,7,97,2,5,3,51,7,0,1,13010,89,3485
2700,대구광역시,2707,달서구,,관내사전투표,5351,5351,1299,3903,83,2,19,0,1,1,17,4,0,1,5330,21,0
2700,대구광역시,2707,달서구,,본리동제1투,2306,1790,401,1320,43,0,10,0,0,0,4,1,0,0,1779,11,516
2700,대구광역시,2707,달서구,,본리동제2투,2825,1597,319,1199,27,2,25,0,1,1,13,0,0,0,1587,10,1228
2700,대구광역시,2707,달서구,,본리동제3투,2378,1638,280,1280,32,1,22,1,2,1,2,2,0,0,1623,15,740
2700,대구광역시,2707,달서구,,본리동제4투,1816,1370,261,1051,25,1,10,1,0,0,6,0,0,0,1355,15,446
2700,대구광역시,2707,달서구,,본리동제5투,1908,1353,285,1008,21,1,11,0,1,0,9,0,0,0,1336,17,555
2700,대구광역시,2707,달서구,감삼동,소계,19552,14843,2729,11478,298,3,121,2,0,2,53,12,3,3,14704,139,4709
2700,대구광역시,2707,달서구,,관내사전투표,3691,3691,827,2720,93,0,18,0,0,2,9,4,1,0,3674,17,0
2700,대구광역시,2707,달서구,,감삼동제1투,1902,1116,181,877,23,0,11,0,0,0,8,0,0,0,1100,16,786
2700,대구광역시,2707,달서구,,감삼동제2투,2660,1815,280,1449,33,0,18,2,0,0,9,3,0,1,1795,20,845
2700,대구광역시,2707,달서구,,감삼동제3투,2535,1680,306,1291,30,1,27,0,0,0,7,1,1,0,1664,16,855
2700,대구광역시,2707,달서구,,감삼동제4투,2711,1921,350,1477,33,0,24,0,0,0,6,2,0,1,1893,28,790
2700,대구광역시,2707,달서구,,감삼동제5투,1532,1203,265,874,30,0,9,0,0,0,9,0,1,1,1189,14,329
2700,대구광역시,2707,달서구,,감삼동제6투,2302,1685,234,1411,20,0,2,0,0,0,0,0,0,0,1667,18,617
2700,대구광역시,2707,달서구,,감삼동제7투,2219,1732,286,1379,36,2,12,0,0,0,5,2,0,0,1722,10,487
2700,대구광역시,2707,달서구,죽전동,소계,11120,8073,1508,6208,156,4,77,1,2,1,15,4,3,2,7981,92,3047
2700,대구광역시,2707,달서구,,관내사전투표,2745,2746,565,2077,59,2,19,1,2,0,2,1,0,1,2729,17,-1
2700,대구광역시,2707,달서구,,죽전동제1투,959,550,103,420,9,0,4,0,0,1,4,0,0,0,541,9,409
2700,대구광역시,2707,달서구,,죽전동제2투,1950,1271,230,987,16,0,14,0,0,0,4,0,0,0,1251,20,679
2700,대구광역시,2707,달서구,,죽전동제3투,2873,1876,377,1402,35,0,27,0,0,0,2,2,0,1,1846,30,997
2700,대구광역시,2707,달서구,,죽전동제4투,2593,1630,233,1322,37,2,13,0,0,0,3,1,3,0,1614,16,963
2700,대구광역시,2707,달서구,장기동,소계,14200,11211,2267,8474,238,3,101,3,0,2,17,5,4,5,11119,92,2989
2700,대구광역시,2707,달서구,,관내사전투표,4835,4834,1132,3536,98,1,30,1,0,0,4,0,3,4,4809,25,1
2700,대구광역시,2707,달서구,,장기동제1투,2437,1670,297,1309,36,1,10,0,0,0,4,1,0,0,1658,12,767
2700,대구광역시,2707,달서구,,장기동제2투,1528,951,142,755,21,1,20,1,0,0,2,1,0,0,943,8,577
2700,대구광역시,2707,달서구,,장기동제3투,2744,1980,362,1530,39,0,16,0,0,1,3,3,1,1,1956,24,764
2700,대구광역시,2707,달서구,,장기동제4투,2656,1776,334,1344,44,0,25,1,0,1,4,0,0,0,1753,23,880
2700,대구광역시,2707,달서구,용산1동,소계,23906,18709,3737,14256,356,7,142,2,1,6,34,9,4,4,18558,151,5197
2700,대구광역시,2707,달서구,,관내사전투표,5788,5788,1266,4374,77,1,32,1,0,1,7,1,3,1,5764,24,0
2700,대구광역시,2707,달서구,,용산1동제1투,2432,1562,315,1180,25,2,17,0,0,0,6,1,0,1,1547,15,870
2700,대구광역시,2707,달서구,,용산1동제2투,2817,2068,415,1558,50,2,14,1,0,1,4,1,0,0,2046,22,749
2700,대구광역시,2707,달서구,,용산1동제3투,2256,1551,276,1202,31,0,13,0,0,0,4,3,1,0,1530,21,705
2700,대구광역시,2707,달서구,,용산1동제4투,2457,1855,402,1378,42,0,19,0,0,3,1,2,0,0,1847,8,602
2700,대구광역시,2707,달서구,,용산1동제5투,2648,1781,359,1336,42,0,19,0,0,0,4,0,0,1,1761,20,867
2700,대구광역시,2707,달서구,,용산1동제6투,2519,1853,326,1435,45,1,15,0,0,0,3,0,0,1,1826,27,666
2700,대구광역시,2707,달서구,,용산1동제7투,2989,2251,378,1793,44,1,13,0,1,1,5,1,0,0,2237,14,738
2700,대구광역시,2707,달서구,용산2동,소계,22674,17712,3765,13169,403,7,170,2,1,0,30,11,4,6,17568,144,4962
2700,대구광역시,2707,달서구,,관내사전투표,6376,6371,1483,4686,129,0,35,1,0,0,9,5,2,2,6352,19,5
2700,대구광역시,2707,달서구,,용산2동제1투,2102,1291,278,947,36,1,13,0,0,0,3,0,0,0,1278,13,811
2700,대구광역시,2707,달서구,,용산2동제2투,2909,1715,324,1296,44,2,28,0,0,0,2,3,0,0,1699,16,1194
2700,대구광역시,2707,달서구,,용산2동제3투,1666,1268,279,933,29,2,12,0,0,0,0,0,1,1,1257,11,398
2700,대구광역시,2707,달서구,,용산2동제4투,2643,2051,413,1553,41,0,18,0,0,0,2,0,0,0,2027,24,592
2700,대구광역시,2707,달서구,,용산2동제5투,2617,1783,376,1299,44,0,26,0,1,0,5,1,0,2,1754,29,834
2700,대구광역시,2707,달서구,,용산2동제6투,2076,1563,316,1175,37,1,15,1,0,0,5,1,0,1,1552,11,513
2700,대구광역시,2707,달서구,,용산2동제7투,2285,1670,296,1280,43,1,23,0,0,0,4,1,1,0,1649,21,615
2700,대구광역시,2707,달서구,이곡1동,소계,18998,14805,3212,10937,343,9,123,4,3,9,36,9,2,9,14696,109,4193
2700,대구광역시,2707,달서구,,관내사전투표,5053,5053,1267,3587,118,0,35,1,0,3,10,5,0,3,5029,24,0
2700,대구광역시,2707,달서구,,이곡1동제1투,2068,1200,237,912,22,1,11,0,1,0,1,1,0,1,1187,13,868
2700,대구광역시,2707,달서구,,이곡1동제2투,1463,1088,186,854,28,0,5,1,0,0,5,0,0,1,1080,8,375
2700,대구광역시,2707,달서구,,이곡1동제3투,2713,1993,431,1462,53,3,17,2,1,2,2,2,0,1,1976,17,720
2700,대구광역시,2707,달서구,,이곡1동제4투,2127,1467,241,1153,39,3,9,0,1,1,6,0,1,2,1456,11,660
2700,대구광역시,2707,달서구,,이곡1동제5투,2369,1732,424,1224,38,1,20,0,0,1,8,0,0,0,1716,16,637
2700,대구광역시,2707,달서구,,이곡1동제6투,3205,2272,426,1745,45,1,26,0,0,2,4,1,1,1,2252,20,933
2700,대구광역시,2707,달서구,이곡2동,소계,14869,11916,2416,9042,215,7,92,0,2,2,15,6,2,0,11799,117,2953
2700,대구광역시,2707,달서구,,관내사전투표,5003,5003,1088,3764,80,1,27,0,0,1,5,2,2,0,4970,33,0
2700,대구광역시,2707,달서구,,이곡2동제1투,2302,1472,322,1074,40,0,17,0,1,0,0,0,0,0,1454,18,830
2700,대구광역시,2707,달서구,,이곡2동제2투,2681,1692,357,1262,30,2,18,0,1,0,3,3,0,0,1676,16,989
2700,대구광역시,2707,달서구,,이곡2동제3투,2411,1880,324,1473,36,1,8,0,0,0,7,0,0,0,1849,31,531
2700,대구광역시,2707,달서구,,이곡2동제4투,2472,1869,325,1469,29,3,22,0,0,1,0,1,0,0,1850,19,603
2700,대구광역시,2707,달서구,신당동,소계,24628,17515,3766,12939,368,13,171,2,3,4,23,12,10,5,17316,199,7113
2700,대구광역시,2707,달서구,,관내사전투표,3012,3012,743,2159,51,3,14,1,0,1,2,4,0,1,2979,33,0
2700,대구광역시,2707,달서구,,신당동제1투,2686,1518,319,1116,28,2,27,1,1,0,4,1,1,0,1500,18,1168
2700,대구광역시,2707,달서구,,신당동제2투,1776,1000,186,753,22,1,17,0,0,0,2,1,0,0,982,18,776
2700,대구광역시,2707,달서구,,신당동제3투,1404,824,173,605,23,0,7,0,0,0,1,0,1,0,810,14,580
2700,대구광역시,2707,달서구,,신당동제4투,1519,820,181,607,11,0,5,0,0,1,1,1,1,0,808,12,699
2700,대구광역시,2707,달서구,,신당동제5투,2209,1332,249,1006,29,0,18,0,1,1,3,3,4,1,1315,17,877
2700,대구광역시,2707,달서구,,신당동제6투,3138,2571,529,1938,61,1,12,0,0,0,2,2,1,1,2547,24,567
2700,대구광역시,2707,달서구,,신당동제7투,3373,1956,407,1437,51,0,30,0,0,0,5,0,1,0,1931,25,1417
2700,대구광역시,2707,달서구,,신당동제8투,3870,3143,689,2323,60,6,31,0,1,1,2,0,1,2,3116,27,727
2700,대구광역시,2707,달서구,,신당동제9투,1641,1339,290,995,32,0,10,0,0,0,1,0,0,0,1328,11,302
2700,대구광역시,2707,달서구,월성1동,소계,22406,17851,4269,12900,381,6,112,0,1,8,17,10,5,7,17716,135,4555
2700,대구광역시,2707,달서구,,관내사전투표,4063,4063,1036,2907,78,2,18,0,0,1,0,2,1,3,4048,15,0
2700,대구광역시,2707,달서구,,월성1동제1투,2725,2006,518,1402,61,1,11,0,0,0,1,0,0,1,1995,11,719
2700,대구광역시,2707,달서구,,월성1동제2투,3490,2547,613,1832,49,0,17,0,0,1,8,2,2,0,2524,23,943
2700,대구광역시,2707,달서구,,월성1동제3투,2700,2194,511,1579,62,1,13,0,0,1,1,1,1,1,2171,23,506
2700,대구광역시,2707,달서구,,월성1동제4투,2480,1871,353,1448,30,2,17,0,0,3,1,0,0,0,1854,17,609
2700,대구광역시,2707,달서구,,월성1동제5투,1444,1008,202,760,17,0,12,0,0,1,2,2,1,0,997,11,436
2700,대구광역시,2707,달서구,,월성1동제6투,2708,2034,499,1460,34,0,14,0,1,1,4,0,0,2,2015,19,674
2700,대구광역시,2707,달서구,,월성1동제7투,2796,2128,537,1512,50,0,10,0,0,0,0,3,0,0,2112,16,668
2700,대구광역시,2707,달서구,월성2동,소계,15426,12054,2617,8936,217,7,99,4,6,6,33,7,5,11,11948,106,3372
2700,대구광역시,2707,달서구,,관내사전투표,5606,5606,1442,3983,104,3,28,2,1,0,7,1,2,4,5577,29,0
2700,대구광역시,2707,달서구,,월성2동제1투,1236,673,97,535,10,0,12,0,1,3,3,0,0,1,662,11,563
2700,대구광역시,2707,달서구,,월성2동제2투,1693,1100,216,831,22,0,14,0,0,0,5,0,1,0,1089,11,593
2700,대구광역시,2707,달서구,,월성2동제3투,1543,989,174,778,11,1,9,1,0,0,2,1,0,0,977,12,554
2700,대구광역시,2707,달서구,,월성2동제4투,2092,1514,276,1175,33,0,9,0,1,0,7,0,0,1,1502,12,578
2700,대구광역시,2707,달서구,,월성2동제5투,1358,845,166,632,11,2,8,1,1,2,4,2,2,2,833,12,513
2700,대구광역시,2707,달서구,,월성2동제6투,1898,1327,246,1002,26,1,19,0,2,1,5,3,0,3,1308,19,571
2700,대구광역시,2707,달서구,진천동,소계,38165,29403,6261,21987,578,14,222,2,6,5,60,12,11,6,29164,239,8762
2700,대구광역시,2707,달서구,,관내사전투표,7633,7631,1719,5707,111,3,29,1,0,1,7,5,3,3,7589,42,2
2700,대구광역시,2707,달서구,,진천동제1투,3124,2081,406,1584,39,2,24,0,0,0,8,0,0,0,2063,18,1043
2700,대구광역시,2707,달서구,,진천동제2투,3254,2208,361,1766,44,0,12,0,0,0,4,1,0,1,2189,19,1046
2700,대구광역시,2707,달서구,,진천동제3투,2544,1655,286,1299,33,0,20,0,2,0,0,0,0,0,1640,15,889
2700,대구광역시,2707,달서구,,진천동제4투,2704,1774,348,1329,38,2,25,0,0,0,4,0,1,0,1747,27,930
2700,대구광역시,2707,달서구,,진천동제5투,2772,2107,503,1528,43,1,7,0,0,1,5,2,2,2,2094,13,665
2700,대구광역시,2707,달서구,,진천동제6투,2313,1771,280,1414,39,1,13,0,0,1,7,0,2,0,1757,14,542
2700,대구광역시,2707,달서구,,진천동제7투,3134,2219,516,1606,55,0,15,0,0,0,4,0,0,0,2196,23,915
2700,대구광역시,2707,달서구,,진천동제8투,2373,1715,386,1268,22,1,13,0,2,0,5,1,0,0,1698,17,658
2700,대구광역시,2707,달서구,,진천동제9투,2122,1505,312,1122,45,2,6,1,0,1,6,0,0,0,1495,10,617
2700,대구광역시,2707,달서구,,진천동제10투,3150,2515,549,1866,54,1,20,0,0,0,2,2,2,0,2496,19,635
2700,대구광역시,2707,달서구,,진천동제11투,3042,2222,595,1498,55,1,38,0,2,1,8,1,1,0,2200,22,820
2700,대구광역시,2707,달서구,상인1동,소계,27088,22247,4560,16906,404,6,130,5,1,4,44,7,1,4,22072,175,4841
2700,대구광역시,2707,달서구,,관내사전투표,6671,6671,1585,4894,115,0,23,2,0,1,8,2,0,3,6633,38,0
2700,대구광역시,2707,달서구,,상인1동제1투,2881,2181,374,1728,36,0,15,1,0,0,4,0,0,0,2158,23,700
2700,대구광역시,2707,달서구,,상인1동제2투,1724,1310,239,1026,21,0,11,0,0,1,3,1,0,0,1302,8,414
2700,대구광역시,2707,달서구,,상인1동제3투,2339,1714,313,1331,37,2,7,0,0,2,7,0,0,0,1699,15,625
2700,대구광역시,2707,달서구,,상인1동제4투,1686,1226,213,971,17,0,11,0,0,0,4,0,1,0,1217,9,460
2700,대구광역시,2707,달서구,,상인1동제5투,2081,1641,292,1281,39,0,10,0,1,0,3,1,0,0,1627,14,440
2700,대구광역시,2707,달서구,,상인1동제6투,2318,1655,309,1277,34,1,14,0,0,0,4,0,0,1,1640,15,663
2700,대구광역시,2707,달서구,,상인1동제7투,2751,2177,470,1629,36,1,17,0,0,0,3,1,0,0,2157,20,574
2700,대구광역시,2707,달서구,,상인1동제8투,2426,1847,348,1432,34,1,12,1,0,0,5,1,0,0,1834,13,579
2700,대구광역시,2707,달서구,,상인1동제9투,2211,1825,417,1337,35,1,10,1,0,0,3,1,0,0,1805,20,386
2700,대구광역시,2707,달서구,상인2동,소계,16640,12376,2380,9493,238,4,107,5,1,2,22,8,5,4,12269,107,4264
2700,대구광역시,2707,달서구,,관내사전투표,4839,4839,1018,3686,73,2,25,2,0,1,4,3,1,2,4817,22,0
2700,대구광역시,2707,달서구,,상인2동제1투,2063,1138,182,899,18,0,19,0,0,1,5,2,0,0,1126,12,925
2700,대구광역시,2707,달서구,,상인2동제2투,2157,1410,241,1109,21,0,13,0,0,0,1,0,3,0,1388,22,747
2700,대구광역시,2707,달서구,,상인2동제3투,1932,1201,193,941,22,1,13,2,1,0,3,1,1,2,1180,21,731
2700,대구광역시,2707,달서구,,상인2동제4투,2864,1866,362,1418,43,1,19,0,0,0,8,2,0,0,1853,13,998
2700,대구광역시,2707,달서구,,상인2동제5투,2785,1922,384,1440,61,0,18,1,0,0,1,0,0,0,1905,17,863
2700,대구광역시,2707,달서구,상인3동,소계,10622,8099,1510,6259,130,6,61,2,2,1,27,8,4,5,8015,84,2523
2700,대구광역시,2707,달서구,,관내사전투표,3932,3932,821,2994,58,1,14,2,1,1,7,5,0,2,3906,26,0
2700,대구광역시,2707,달서구,,상인3동제1투,1489,883,126,722,13,1,9,0,0,0,1,0,1,1,874,9,606
2700,대구광역시,2707,달서구,,상인3동제2투,1909,1270,201,1004,24,1,13,0,1,0,4,0,1,2,1251,19,639
2700,대구광역시,2707,달서구,,상인3동제3투,1839,1130,204,868,17,0,15,0,0,0,5,0,2,0,1111,19,709
2700,대구광역시,2707,달서구,,상인3동제4투,1453,884,158,671,18,3,10,0,0,0,10,3,0,0,873,11,569
2700,대구광역시,2707,달서구,도원동,소계,28753,23242,5086,17276,456,9,156,8,5,8,35,10,9,9,23067,175,5511
2700,대구광역시,2707,달서구,,관내사전투표,7844,7844,1963,5643,143,4,33,3,0,1,11,4,6,0,7811,33,0
2700,대구광역시,2707,달서구,,도원동제1투,2038,1346,274,1002,27,0,12,0,0,4,6,0,0,2,1327,19,692
2700,대구광역시,2707,달서구,,도원동제2투,1920,1295,251,994,30,0,10,1,0,0,1,0,0,0,1287,8,625
2700,대구광역시,2707,달서구,,도원동제3투,2060,1406,301,1047,31,1,11,0,1,0,0,0,1,1,1394,12,654
2700,대구광역시,2707,달서구,,도원동제4투,1824,1333,246,1018,27,0,12,0,0,0,6,0,0,3,1312,21,491
2700,대구광역시,2707,달서구,,도원동제5투,1820,1389,293,1029,42,0,6,0,1,0,3,2,0,0,1376,13,431
2700,대구광역시,2707,달서구,,도원동제6투,1965,1394,284,1052,23,0,15,1,1,0,1,2,0,0,1379,15,571
2700,대구광역시,2707,달서구,,도원동제7투,2122,1668,312,1294,34,1,10,0,0,1,2,0,1,0,1655,13,454
2700,대구광역시,2707,달서구,,도원동제8투,2641,2111,444,1575,42,1,20,1,2,2,4,2,0,2,2095,16,530
2700,대구광역시,2707,달서구,,도원동제9투,2650,1997,388,1553,30,1,13,2,0,0,1,0,1,0,1989,8,653
2700,대구광역시,2707,달서구,,도원동제10투,1869,1459,330,1069,27,1,14,0,0,0,0,0,0,1,1442,17,410
2700,대구광역시,2707,달서구,송현1동,소계,16389,11637,2160,8928,203,11,138,4,3,5,38,8,5,6,11509,128,4752
2700,대구광역시,2707,달서구,,관내사전투표,4258,4258,908,3210,69,7,25,1,0,0,9,4,2,1,4236,22,0
2700,대구광역시,2707,달서구,,송현1동제1투,2356,1329,219,1027,30,2,21,1,1,1,5,1,1,0,1309,20,1027
2700,대구광역시,2707,달서구,,송현1동제2투,1869,1149,182,904,22,0,19,0,0,1,4,1,0,0,1133,16,720
2700,대구광역시,2707,달서구,,송현1동제3투,2329,1381,212,1091,22,1,23,1,0,1,9,0,1,2,1363,18,948
2700,대구광역시,2707,달서구,,송현1동제4투,3087,1937,362,1471,32,0,33,1,1,2,3,0,0,2,1907,30,1150
2700,대구광역시,2707,달서구,,송현1동제5투,2490,1583,277,1225,28,1,17,0,1,0,8,2,1,1,1561,22,907
2700,대구광역시,2707,달서구,송현2동,소계,13920,9852,1746,7638,180,4,98,1,0,8,46,7,6,5,9739,113,4068
2700,대구광역시,2707,달서구,,관내사전투표,3070,3070,622,2337,59,1,14,0,0,0,5,2,3,3,3046,24,0
2700,대구광역시,2707,달서구,,송현2동제1투,2891,1724,281,1358,31,0,23,0,0,1,9,2,0,0,1705,19,1167
2700,대구광역시,2707,달서구,,송현2동제2투,1166,658,98,505,19,1,14,0,0,0,6,0,0,0,643,15,508
2700,대구광역시,2707,달서구,,송현2동제3투,2579,1522,295,1131,27,1,28,0,0,2,12,1,1,0,1498,24,1057
2700,대구광역시,2707,달서구,,송현2동제4투,1852,1242,183,1001,21,0,10,0,0,5,5,2,0,2,1229,13,610
2700,대구광역시,2707,달서구,,송현2동제5투,2362,1636,267,1306,23,1,9,1,0,0,9,0,2,0,1618,18,726
2700,대구광역시,2707,달서구,본동,소계,11384,8700,1667,6714,132,4,66,1,1,2,28,8,2,2,8627,73,2684
2700,대구광역시,2707,달서구,,관내사전투표,3689,3689,766,2818,57,1,14,0,0,0,11,2,0,0,3669,20,0
2700,대구광역시,2707,달서구,,본동제1투,1672,965,193,727,14,0,11,0,0,0,1,1,0,0,947,18,707
2700,대구광역시,2707,달서구,,본동제2투,1865,1319,200,1071,21,2,8,0,0,1,5,2,0,0,1310,9,546
2700,대구광역시,2707,달서구,,본동제3투,1962,1381,287,1031,19,0,14,1,0,0,6,3,0,2,1363,18,581
2700,대구광역시,2707,달서구,,본동제4투,2196,1346,221,1067,21,1,19,0,1,1,5,0,2,0,1338,8,850
2700,대구광역시,2707,달서구,유천동,소계,21124,17328,4569,12150,368,4,104,0,1,5,13,7,1,5,17227,101,3796
2700,대구광역시,2707,달서구,,관내사전투표,5232,5232,1609,3468,99,1,27,0,0,1,1,2,1,2,5211,21,0
2700,대구광역시,2707,달서구,,유천동제1투,2595,1893,463,1348,50,1,13,0,0,0,2,2,0,1,1880,13,702
2700,대구광역시,2707,달서구,,유천동제2투,1641,1346,263,1040,25,0,9,0,0,0,1,0,0,0,1338,8,295
2700,대구광역시,2707,달서구,,유천동제3투,2912,2199,559,1569,35,0,18,0,0,1,0,2,0,1,2185,14,713
2700,대구광역시,2707,달서구,,유천동제4투,2388,1746,462,1226,36,0,9,0,0,1,2,0,0,1,1737,9,642
2700,대구광역시,2707,달서구,,유천동제5투,3566,2708,703,1890,70,0,18,0,1,2,4,0,0,0,2688,20,858
2700,대구광역시,2707,달서구,,유천동제6투,2790,2204,510,1609,53,2,10,0,0,0,3,1,0,0,2188,16,586
2700,대구광역시,2707,달서구,잘못 투입·구분된 투표지,,0,4,3,0,0,1,0,0,0,0,0,0,0,0,4,0,-4
2700,대구광역시,2708,달성군,합계,,214088,166298,38882,120064,3407,117,1737,33,31,44,250,151,63,84,164863,1435,47790
2700,대구광역시,2708,달성군,거소·선상투표,,558,514,117,285,17,3,12,2,3,2,4,1,3,0,449,65,44
2700,대구광역시,2708,달성군,관외사전투표,,20672,20669,5268,14428,479,8,250,7,2,8,34,17,3,18,20522,147,3
2700,대구광역시,2708,달성군,재외투표,,608,397,197,149,15,0,0,0,0,0,0,0,0,0,361,36,211
2700,대구광역시,2708,달성군,화원읍,소계,36427,27752,5377,21208,560,15,254,3,4,6,51,25,12,11,27526,226,8675
2700,대구광역시,2708,달성군,,관내사전투표,7422,7422,1574,5626,121,7,34,1,0,0,6,8,3,2,7382,40,0
2700,대구광역시,2708,달성군,,화원읍제1투,1932,1199,176,967,22,1,15,0,0,0,2,1,1,1,1186,13,733
2700,대구광역시,2708,달성군,,화원읍제2투,2670,1864,295,1489,32,1,26,1,0,0,3,2,2,0,1851,13,806
2700,대구광역시,2708,달성군,,화원읍제3투,2005,1341,202,1075,25,2,20,0,0,0,1,0,1,0,1326,15,664
2700,대구광역시,2708,달성군,,화원읍제4투,2509,1252,245,947,31,1,12,0,0,1,4,0,0,0,1241,11,1257
2700,대구광역시,2708,달성군,,화원읍제5투,2747,1977,397,1493,43,0,17,1,1,0,2,0,0,0,1954,23,770
2700,대구광역시,2708,달성군,,화원읍제6투,2884,2046,349,1582,53,2,30,0,1,1,3,1,0,2,2024,22,838
2700,대구광역시,2708,달성군,,화원읍제7투,1072,820,148,627,16,0,16,0,0,2,0,0,3,1,813,7,252
2700,대구광역시,2708,달성군,,화원읍제8투,1817,1214,180,994,15,1,11,0,0,2,2,1,1,0,1207,7,603
2700,대구광역시,2708,달성군,,화원읍제9투,3056,2138,380,1654,42,0,24,0,0,0,9,4,0,1,2114,24,918
2700,대구광역시,2708,달성군,,화원읍제10투,2386,1721,373,1240,45,0,27,0,1,0,7,5,0,4,1702,19,665
2700,대구광역시,2708,달성군,,화원읍제11투,1469,1104,236,816,28,0,8,0,1,0,6,1,1,0,1097,7,365
2700,대구광역시,2708,달성군,,화원읍제12투,2621,2213,547,1578,58,0,10,0,0,0,5,2,0,0,2200,13,408
2700,대구광역시,2708,달성군,,화원읍제13투,1837,1441,275,1120,29,0,4,0,0,0,1,0,0,0,1429,12,396
2700,대구광역시,2708,달성군,논공읍,소계,14289,9979,2087,7420,175,7,150,3,1,3,14,17,7,8,9892,87,4310
2700,대구광역시,2708,달성군,,관내사전투표,2677,2676,582,2013,36,3,22,1,0,0,1,2,2,2,2664,12,1
2700,대구광역시,2708,달성군,,논공읍제1투,1769,1005,157,805,17,0,17,0,0,2,1,0,1,0,1000,5,764
2700,대구광역시,2708,달성군,,논공읍제2투,663,441,44,378,2,0,9,0,1,0,1,0,0,0,435,6,222
2700,대구광역시,2708,달성군,,논공읍제3투,1774,1074,221,788,19,1,19,0,0,1,3,3,1,1,1057,17,700
2700,대구광역시,2708,달성군,,논공읍제4투,1416,924,201,669,28,0,8,0,0,0,1,5,1,1,914,10,492
2700,대구광역시,2708,달성군,,논공읍제5투,2315,1543,356,1109,37,0,26,0,0,0,2,2,1,1,1534,9,772
2700,대구광역시,2708,달성군,,논공읍제6투,1926,1117,242,822,13,1,19,2,0,0,2,2,1,2,1106,11,809
2700,대구광역시,2708,달성군,,논공읍제7투,1749,1199,284,836,23,2,30,0,0,0,3,3,0,1,1182,17,550
2700,대구광역시,2708,달성군,다사읍,소계,60750,46519,11385,33238,991,20,411,7,10,7,61,26,10,20,46186,333,14231
2700,대구광역시,2708,달성군,,관내사전투표,8452,8451,2373,5833,150,3,45,1,2,1,6,6,2,2,8424,27,1
2700,대구광역시,2708,달성군,,다사읍제1투,1745,1215,272,897,23,0,14,0,1,0,1,1,0,1,1210,5,530
2700,대구광역시,2708,달성군,,다사읍제2투,2326,1645,372,1201,33,0,13,1,0,2,4,0,3,2,1631,14,681
2700,대구광역시,2708,달성군,,다사읍제3투,2090,1503,305,1143,19,0,17,1,0,0,3,1,0,2,1491,12,587
2700,대구광역시,2708,달성군,,다사읍제4투,528,411,39,354,7,0,4,0,0,0,2,1,0,1,408,3,117
2700,대구광역시,2708,달성군,,다사읍제5투,2485,1742,341,1329,38,2,11,0,2,0,4,0,1,0,1728,14,743
2700,대구광역시,2708,달성군,,다사읍제6투,2365,1736,366,1268,54,0,25,1,0,0,6,1,0,1,1722,14,629
2700,대구광역시,2708,달성군,,다사읍제7투,2530,1855,404,1360,37,2,22,0,1,1,2,2,1,1,1833,22,675
2700,대구광역시,2708,달성군,,다사읍제8투,2788,1948,445,1414,42,0,20,0,1,1,3,1,0,2,1929,19,840
2700,대구광역시,2708,달성군,,다사읍제9투,2418,1821,394,1336,46,0,22,0,0,1,3,1,0,2,1805,16,597
2700,대구광역시,2708,달성군,,다사읍제10투,2785,2109,478,1549,49,2,12,0,0,0,2,2,1,1,2096,13,676
2700,대구광역시,2708,달성군,,다사읍제11투,3294,2468,598,1751,75,2,18,1,0,0,2,2,0,3,2452,16,826
2700,대구광역시,2708,달성군,,다사읍제12투,2741,2044,465,1497,32,0,27,0,0,0,2,0,0,0,2023,21,697
2700,대구광역시,2708,달성군,,다사읍제13투,3066,2189,565,1546,39,1,15,1,2,0,4,1,0,1,2175,14,877
2700,대구광역시,2708,달성군,,다사읍제14투,1817,1157,242,866,27,0,9,0,0,0,0,0,1,0,1145,12,660
2700,대구광역시,2708,달성군,,다사읍제15투,3134,2056,570,1395,39,3,29,1,0,0,1,0,1,1,2040,16,1078
2700,대구광역시,2708,달성군,,다사읍제16투,2562,1800,495,1223,42,3,20,0,0,0,2,2,0,0,1787,13,762
2700,대구광역시,2708,달성군,,다사읍제17투,2694,2148,564,1499,49,1,9,0,0,0,3,3,0,0,2128,20,546
2700,대구광역시,2708,달성군,,다사읍제18투,2645,1986,486,1425,44,0,18,0,0,1,1,0,0,0,1975,11,659
2700,대구광역시,2708,달성군,,다사읍제19투,2640,1954,559,1317,51,0,12,0,1,0,2,0,0,0,1942,12,686
2700,대구광역시,2708,달성군,,다사읍제20투,2705,2122,567,1461,48,0,28,0,0,0,2,0,0,0,2106,16,583
2700,대구광역시,2708,달성군,,다사읍제21투,2940,2159,485,1574,47,1,21,0,0,0,6,2,0,0,2136,23,781
2700,대구광역시,2708,달성군,가창면,소계,6142,4700,779,3741,70,1,35,0,3,2,9,3,3,4,4650,50,1442
2700,대구광역시,2708,달성군,,관내사전투표,1662,1662,366,1251,20,0,10,0,0,0,1,1,1,0,1650,12,0
2700,대구광역시,2708,달성군,,가창면제1투,1416,915,126,752,12,0,10,0,0,0,4,0,0,0,904,11,501
2700,대구광역시,2708,달성군,,가창면제2투,755,526,98,394,18,0,4,0,3,0,1,0,2,1,521,5,229
2700,대구광역시,2708,달성군,,가창면제3투,1410,986,116,838,11,0,4,0,0,2,2,0,0,2,975,11,424
2700,대구광역시,2708,달성군,,가창면제4투,899,611,73,506,9,1,7,0,0,0,1,2,0,1,600,11,288
2700,대구광역시,2708,달성군,하빈면,소계,3910,3176,572,2509,24,4,12,1,2,2,6,4,6,5,3147,29,734
2700,대구광역시,2708,달성군,,관내사전투표,1772,1772,403,1315,10,2,9,1,2,2,5,3,2,3,1757,15,0
2700,대구광역시,2708,달성군,,하빈면제1투,1106,737,79,641,4,2,1,0,0,0,1,1,1,1,731,6,369
2700,대구광역시,2708,달성군,,하빈면제2투,1032,667,90,553,10,0,2,0,0,0,0,0,3,1,659,8,365
2700,대구광역시,2708,달성군,구지면,소계,14393,10230,2665,7068,216,37,124,3,1,4,8,9,6,3,10144,86,4163
2700,대구광역시,2708,달성군,,관내사전투표,4291,4291,1248,2874,95,1,40,1,0,4,2,3,4,2,4274,17,0
2700,대구광역시,2708,달성군,,구지면제1투,2477,1388,316,999,28,0,21,0,1,0,4,1,0,1,1371,17,1089
2700,대구광역시,2708,달성군,,구지면제2투,464,320,19,286,3,0,6,1,0,0,0,0,1,0,316,4,144
2700,대구광역시,2708,달성군,,구지면제3투,2503,1294,373,842,18,0,40,0,0,0,0,3,0,0,1276,18,1209
2700,대구광역시,2708,달성군,,구지면제4투,1652,1053,215,776,25,2,17,1,0,0,2,2,1,0,1041,12,599
2700,대구광역시,2708,달성군,,구지면제5투,3006,1884,494,1291,47,34,0,0,0,0,0,0,0,0,1866,18,1122
2700,대구광역시,2708,달성군,유가읍,소계,20953,16239,4835,10649,390,10,159,3,1,2,18,27,4,1,16099,140,4714
2700,대구광역시,2708,달성군,,관내사전투표,7328,7326,2479,4523,177,6,59,2,0,1,5,15,2,1,7270,56,2
2700,대구광역시,2708,달성군,,유가읍제1투,2569,1562,421,1056,37,0,22,0,0,0,4,5,1,0,1546,16,1007
2700,대구광역시,2708,달성군,,유가읍제2투,897,550,61,470,7,0,5,0,1,0,1,0,0,0,545,5,347
2700,대구광역시,2708,달성군,,유가읍제3투,2280,1498,363,1073,29,0,16,0,0,0,3,1,1,0,1486,12,782
2700,대구광역시,2708,달성군,,유가읍제4투,2669,1736,463,1172,58,0,19,0,0,1,2,3,0,0,1718,18,933
2700,대구광역시,2708,달성군,,유가읍제5투,2857,1896,582,1236,42,0,13,1,0,0,2,1,0,0,1877,19,961
2700,대구광역시,2708,달성군,,유가읍제6투,2353,1671,466,1119,40,4,25,0,0,0,1,2,0,0,1657,14,682
2700,대구광역시,2708,달성군,옥포읍,소계,19005,14766,2979,11188,274,5,154,3,1,5,26,8,2,7,14652,114,4239
2700,대구광역시,2708,달성군,,관내사전투표,4739,4739,1112,3498,74,3,31,1,1,0,7,1,0,1,4729,10,0
2700,대구광역시,2708,달성군,,옥포읍제1투,1623,1042,136,850,21,0,14,0,0,0,5,0,0,1,1027,15,581
2700,대구광역시,2708,달성군,,옥포읍제2투,1166,828,87,714,7,0,8,0,0,0,1,0,1,0,818,10,338
2700,대구광역시,2708,달성군,,옥포읍제3투,2140,1516,249,1198,34,0,16,0,0,2,3,3,1,0,1506,10,624
2700,대구광역시,2708,달성군,,옥포읍제4투,3007,2046,393,1566,29,1,17,0,0,3,7,1,0,2,2019,27,961
2700,대구광역시,2708,달성군,,옥포읍제5투,2550,1816,438,1285,44,0,26,2,0,0,2,2,0,1,1800,16,734
2700,대구광역시,2708,달성군,,옥포읍제6투,1660,1248,242,941,27,1,26,0,0,0,0,0,0,0,1237,11,412
2700,대구광역시,2708,달성군,,옥포읍제7투,2120,1531,322,1136,38,0,16,0,0,0,1,1,0,2,1516,15,589
2700,대구광역시,2708,달성군,현풍읍,소계,16381,11348,2616,8177,196,7,176,1,3,3,19,14,7,7,11226,122,5033
2700,대구광역시,2708,달성군,,관내사전투표,3291,3291,823,2364,42,0,32,1,1,0,0,6,1,0,3270,21,0
2700,대구광역시,2708,달성군,,현풍읍제1투,1712,976,158,751,20,1,29,0,1,0,1,1,1,3,966,10,736
2700,대구광역시,2708,달성군,,현풍읍제2투,2236,1189,226,916,13,1,16,0,0,0,3,1,1,0,1177,12,1047
2700,대구광역시,2708,달성군,,현풍읍제3투,1092,682,88,563,7,1,10,0,0,0,4,1,0,0,674,8,410
2700,대구광역시,2708,달성군,,현풍읍제4투,1827,1103,230,804,19,1,18,0,1,0,2,0,3,2,1080,23,724
2700,대구광역시,2708,달성군,,현풍읍제5투,3114,2038,551,1374,44,1,33,0,0,2,6,2,0,1,2014,24,1076
2700,대구광역시,2708,달성군,,현풍읍제6투,3109,2069,540,1405,51,2,38,0,0,1,3,3,1,1,2045,24,1040
2700,대구광역시,2708,달성군,잘못 투입·구분된 투표지,,0,9,5,4,0,0,0,0,0,0,0,0,0,0,9,0,-92800,인천광역시,2801,중구,합계,,121916,90125,43942,41805,2296,42,944,18,12,22,88,73,15,34,89291,834,31791
2800,인천광역시,2801,중구,거소·선상투표,,226,208,64,95,3,0,8,0,0,0,0,0,0,2,172,36,18
2800,인천광역시,2801,중구,관외사전투표,,10447,10444,5036,4929,254,7,99,2,1,2,3,13,2,3,10351,93,3
2800,인천광역시,2801,중구,재외투표,,719,527,288,170,14,0,5,0,0,0,0,0,0,0,477,50,192
2800,인천광역시,2801,중구,신포동,소계,4403,3073,1418,1508,75,1,29,0,1,0,6,1,0,1,3040,33,1330
2800,인천광역시,2801,중구,,관내사전투표,1370,1370,664,663,22,0,8,0,1,0,0,1,0,1,1360,10,0
2800,인천광역시,2801,중구,,신포동제1투,1694,1053,500,485,39,1,12,0,0,0,2,0,0,0,1039,14,641
2800,인천광역시,2801,중구,,신포동제2투,1339,650,254,360,14,0,9,0,0,0,4,0,0,0,641,9,689
2800,인천광역시,2801,중구,연안동,소계,5186,3539,1500,1929,56,0,30,0,1,1,7,2,0,0,3526,13,1647
2800,인천광역시,2801,중구,,관내사전투표,1690,1690,772,877,24,0,10,0,0,0,2,1,0,0,1686,4,0
2800,인천광역시,2801,중구,,연안동제1투,508,290,101,179,3,0,5,0,1,0,1,0,0,0,290,0,218
2800,인천광역시,2801,중구,,연안동제2투,1505,701,273,410,10,0,3,0,0,1,3,0,0,0,700,1,804
2800,인천광역시,2801,중구,,연안동제3투,1483,858,354,463,19,0,12,0,0,0,1,1,0,0,850,8,625
2800,인천광역시,2801,중구,신흥동,소계,9986,6860,3104,3446,158,5,81,1,1,1,7,7,1,5,6817,43,3126
2800,인천광역시,2801,중구,,관내사전투표,2390,2390,1191,1112,48,2,24,0,1,0,0,3,1,1,2383,7,0
2800,인천광역시,2801,중구,,신흥동제1투,1459,748,326,385,18,1,7,1,0,0,0,0,0,1,739,9,711
2800,인천광역시,2801,중구,,신흥동제2투,2031,1220,516,658,21,0,13,0,0,0,3,3,0,0,1214,6,811
2800,인천광역시,2801,중구,,신흥동제3투,350,200,94,89,12,0,4,0,0,0,0,0,0,0,199,1,150
2800,인천광역시,2801,중구,,신흥동제4투,2298,1502,635,796,40,0,12,0,0,1,3,0,0,2,1489,13,796
2800,인천광역시,2801,중구,,신흥동제5투,1458,800,342,406,19,2,21,0,0,0,1,1,0,1,793,7,658
2800,인천광역시,2801,중구,도원동,소계,3698,2668,1143,1396,63,1,32,1,1,2,3,2,2,2,2648,20,1030
2800,인천광역시,2801,중구,,관내사전투표,1346,1346,597,698,20,1,11,0,0,1,2,2,1,1,1334,12,0
2800,인천광역시,2801,중구,,도원동제1투,1279,729,302,387,25,0,12,0,1,0,0,0,0,0,727,2,550
2800,인천광역시,2801,중구,,도원동제2투,1073,593,244,311,18,0,9,1,0,1,1,0,1,1,587,6,480
2800,인천광역시,2801,중구,율목동,소계,2720,1798,758,930,44,3,22,1,0,0,5,2,1,1,1767,31,922
2800,인천광역시,2801,중구,,관내사전투표,743,743,345,362,13,0,9,1,0,0,2,2,0,1,735,8,0
2800,인천광역시,2801,중구,,율목동투표소,1977,1055,413,568,31,3,13,0,0,0,3,0,1,0,1032,23,922
2800,인천광역시,2801,중구,동인천동,소계,5037,3256,1342,1731,83,1,53,1,0,2,5,2,2,3,3225,31,1781
2800,인천광역시,2801,중구,,관내사전투표,1493,1493,685,748,32,0,15,0,0,1,1,0,2,0,1484,9,0
2800,인천광역시,2801,중구,,동인천동제1투,1367,645,234,372,16,0,9,0,0,1,1,0,0,2,635,10,722
2800,인천광역시,2801,중구,,동인천동제2투,2177,1118,423,611,35,1,29,1,0,0,3,2,0,1,1106,12,1059
2800,인천광역시,2801,중구,영종동,소계,15051,10423,4847,5128,243,4,104,1,0,3,5,14,2,2,10353,70,4628
2800,인천광역시,2801,중구,,관내사전투표,4282,4282,2197,1968,70,3,22,1,0,1,1,2,2,0,4267,15,0
2800,인천광역시,2801,중구,,영종동제1투,3031,1384,592,706,39,0,29,0,0,0,0,3,0,0,1369,15,1647
2800,인천광역시,2801,중구,,영종동제2투,2561,1557,680,799,41,0,20,0,0,2,2,1,0,2,1547,10,1004
2800,인천광역시,2801,중구,,영종동제3투,1294,779,279,463,21,1,7,0,0,0,0,2,0,0,773,6,515
2800,인천광역시,2801,중구,,영종동제4투,1938,1033,385,616,13,0,10,0,0,0,2,1,0,0,1027,6,905
2800,인천광역시,2801,중구,,영종동제5투,1945,1388,714,576,59,0,16,0,0,0,0,5,0,0,1370,18,557
2800,인천광역시,2801,중구,용유동,소계,3143,2206,719,1417,30,0,26,0,0,1,0,0,1,0,2194,12,937
2800,인천광역시,2801,중구,,관내사전투표,1065,1065,384,646,15,0,17,0,0,0,0,0,0,0,1062,3,0
2800,인천광역시,2801,중구,,용유동제1투,860,421,129,280,4,0,5,0,0,0,0,0,1,0,419,2,439
2800,인천광역시,2801,중구,,용유동제2투,758,401,139,242,8,0,4,0,0,1,0,0,0,0,394,7,357
2800,인천광역시,2801,중구,,용유동제3투,404,277,55,219,3,0,0,0,0,0,0,0,0,0,277,0,127
2800,인천광역시,2801,중구,,용유동제4투,56,42,12,30,0,0,0,0,0,0,0,0,0,0,42,0,14
2800,인천광역시,2801,중구,운서동,소계,27545,20247,10847,8209,663,14,230,5,3,6,32,17,2,4,20032,215,7298
2800,인천광역시,2801,중구,,관내사전투표,10703,10703,6178,3973,331,9,96,3,1,2,9,10,1,4,10617,86,0
2800,인천광역시,2801,중구,,운서동제1투,2116,1311,604,603,58,2,15,0,0,1,4,1,0,0,1288,23,805
2800,인천광역시,2801,중구,,운서동제2투,1903,1010,467,468,41,1,15,0,2,0,3,2,0,0,999,11,893
2800,인천광역시,2801,중구,,운서동제3투,2214,1467,793,598,41,1,18,0,0,0,1,2,0,0,1454,13,747
2800,인천광역시,2801,중구,,운서동제4투,2989,1554,762,692,37,1,38,1,0,1,2,1,0,0,1535,19,1435
2800,인천광역시,2801,중구,,운서동제5투,2435,1481,771,633,46,0,13,1,0,0,3,0,0,0,1467,14,954
2800,인천광역시,2801,중구,,운서동제6투,3142,1409,613,678,62,0,16,0,0,0,5,0,0,0,1374,35,1733
2800,인천광역시,2801,중구,,운서동제7투,2043,1312,659,564,47,0,19,0,0,2,5,1,1,0,1298,14,731
2800,인천광역시,2801,중구,영종1동,소계,28463,21325,11303,9109,537,6,170,4,4,3,10,9,1,9,21165,160,7138
2800,인천광역시,2801,중구,,관내사전투표,5425,5425,3151,2130,90,1,20,1,0,0,3,3,1,3,5403,22,0
2800,인천광역시,2801,중구,,영종1동제1투,2296,1649,860,704,49,0,11,0,0,0,0,2,0,3,1629,20,647
2800,인천광역시,2801,중구,,영종1동제2투,2266,1389,701,606,42,0,25,0,0,0,1,2,0,0,1377,12,877
2800,인천광역시,2801,중구,,영종1동제3투,2632,1759,919,754,43,2,19,0,0,1,0,1,0,1,1740,19,873
2800,인천광역시,2801,중구,,영종1동제4투,2223,1547,804,663,47,0,10,1,1,1,1,1,0,0,1529,18,676
2800,인천광역시,2801,중구,,영종1동제5투,3267,2285,1203,1007,53,0,12,0,1,0,1,0,0,0,2277,8,982
2800,인천광역시,2801,중구,,영종1동제6투,2741,1914,955,871,49,0,22,0,0,0,0,0,0,0,1897,17,827
2800,인천광역시,2801,중구,,영종1동제7투,2551,1851,965,795,61,2,18,1,0,0,3,0,0,1,1846,5,700
2800,인천광역시,2801,중구,,영종1동제8투,828,589,298,260,17,0,8,0,0,0,0,0,0,0,583,6,239
2800,인천광역시,2801,중구,,영종1동제9투,2576,1721,882,739,50,1,20,1,2,1,0,0,0,1,1697,24,855
2800,인천광역시,2801,중구,,영종1동제10투,1658,1196,565,580,36,0,5,0,0,0,1,0,0,0,1187,9,462
2800,인천광역시,2801,중구,개항동,소계,5292,3551,1573,1808,73,0,55,2,0,1,5,4,1,2,3524,27,1741
2800,인천광역시,2801,중구,,관내사전투표,1292,1292,622,626,24,0,11,1,0,1,1,1,0,0,1287,5,0
2800,인천광역시,2801,중구,,개항동제1투,1210,665,284,347,15,0,12,0,0,0,1,0,0,2,661,4,545
2800,인천광역시,2801,중구,,개항동제2투,570,393,152,228,5,0,2,0,0,0,1,0,0,0,388,5,177
2800,인천광역시,2801,중구,,개항동제3투,1447,801,364,389,16,0,19,1,0,0,1,1,1,0,792,9,646
2800,인천광역시,2801,중구,,개항동제4투,773,400,151,218,13,0,11,0,0,0,1,2,0,0,396,4,373
2800,인천광역시,2801,중구,잘못 투입·구분된 투표지,,0,0,0,0,0,0,0,0,0,0,0,0,0,0,0,0,0
2800,인천광역시,2802,동구,합계,,53909,40918,19195,19661,1196,32,346,11,4,6,44,48,17,19,40579,339,12991
2800,인천광역시,2802,동구,거소·선상투표,,79,72,32,30,1,0,3,0,0,0,0,0,0,0,66,6,7
2800,인천광역시,2802,동구,관외사전투표,,4047,4045,1980,1840,135,2,45,0,0,0,5,4,0,3,4014,31,2
2800,인천광역시,2802,동구,재외투표,,218,142,85,37,6,0,1,0,0,0,0,0,0,0,129,13,76
2800,인천광역시,2802,동구,만석동,소계,5687,4132,2031,1896,125,4,34,0,1,0,4,9,1,4,4109,23,1555
2800,인천광역시,2802,동구,,관내사전투표,1689,1689,882,749,42,2,8,0,0,0,1,1,0,0,1685,4,0
2800,인천광역시,2802,동구,,만석동제1투,1687,879,401,419,24,2,15,0,1,0,3,5,0,1,871,8,808
2800,인천광역시,2802,동구,,만석동제2투,2311,1564,748,728,59,0,11,0,0,0,0,3,1,3,1553,11,747
2800,인천광역시,2802,동구,화수1·화평동,소계,4823,3537,1600,1774,86,5,31,1,0,0,3,2,4,1,3507,30,1286
2800,인천광역시,2802,동구,,관내사전투표,1616,1616,795,747,40,3,11,1,0,0,1,0,2,0,1600,16,0
2800,인천광역시,2802,동구,,화수1·화평동제1투,1454,781,316,421,20,1,12,0,0,0,0,1,1,1,773,8,673
2800,인천광역시,2802,동구,,화수1·화평동제2투,1753,1140,489,606,26,1,8,0,0,0,2,1,1,0,1134,6,613
2800,인천광역시,2802,동구,화수2동,소계,5923,4252,1893,2133,123,2,42,0,0,1,6,4,2,5,4211,41,1671
2800,인천광역시,2802,동구,,관내사전투표,1355,1355,614,681,34,2,12,0,0,0,1,3,1,0,1348,7,0
2800,인천광역시,2802,동구,,화수2동제1투,1222,706,310,351,22,0,10,0,0,0,0,1,0,2,696,10,516
2800,인천광역시,2802,동구,,화수2동제2투,1709,1044,479,508,24,0,11,0,0,0,3,0,0,3,1028,16,665
2800,인천광역시,2802,동구,,화수2동제3투,1637,1147,490,593,43,0,9,0,0,1,2,0,1,0,1139,8,490
2800,인천광역시,2802,동구,송현1·2동,소계,8414,6625,3178,3125,212,4,44,2,1,2,4,6,4,2,6584,41,1789
2800,인천광역시,2802,동구,,관내사전투표,3384,3384,1744,1502,108,1,17,0,0,1,1,0,2,0,3376,8,0
2800,인천광역시,2802,동구,,송현1·2동제1투,1208,806,334,433,20,0,13,0,0,1,1,2,0,1,805,1,402
2800,인천광역시,2802,동구,,송현1·2동제2투,1904,1253,554,638,36,0,4,1,1,0,0,1,1,1,1237,16,651
2800,인천광역시,2802,동구,,송현1·2동제3투,1918,1182,546,552,48,3,10,1,0,0,2,3,1,0,1166,16,736
2800,인천광역시,2802,동구,송현3동,소계,2948,2141,950,1083,54,2,22,2,0,0,2,4,2,1,2122,19,807
2800,인천광역시,2802,동구,,관내사전투표,893,893,453,413,19,0,3,0,0,0,0,2,0,0,890,3,0
2800,인천광역시,2802,동구,,송현3동제1투,1090,673,276,365,14,0,6,1,0,0,0,1,1,0,664,9,417
2800,인천광역시,2802,동구,,송현3동제2투,965,575,221,305,21,2,13,1,0,0,2,1,1,1,568,7,390
2800,인천광역시,2802,동구,송림1동,소계,1281,948,397,518,21,0,7,0,0,0,0,0,1,0,944,4,333
2800,인천광역시,2802,동구,,관내사전투표,461,461,212,231,13,0,3,0,0,0,0,0,0,0,459,2,0
2800,인천광역시,2802,동구,,송림1동투표소,820,487,185,287,8,0,4,0,0,0,0,0,1,0,485,2,333
2800,인천광역시,2802,동구,송림2동,소계,2578,1865,773,1013,42,0,15,1,0,0,4,4,0,1,1853,12,713
2800,인천광역시,2802,동구,,관내사전투표,982,982,454,496,18,0,5,0,0,0,0,1,0,1,975,7,0
2800,인천광역시,2802,동구,,송림2동제1투,832,423,141,258,12,0,8,0,0,0,0,3,0,0,422,1,409
2800,인천광역시,2802,동구,,송림2동제2투,764,460,178,259,12,0,2,1,0,0,4,0,0,0,456,4,304
2800,인천광역시,2802,동구,송림3·5동,소계,5930,4292,2012,2056,130,3,29,1,0,0,5,8,1,1,4246,46,1638
2800,인천광역시,2802,동구,,관내사전투표,1974,1973,1032,865,46,3,12,0,0,0,3,6,0,0,1967,6,1
2800,인천광역시,2802,동구,,송림3·5동제1투,1526,861,309,502,22,0,9,0,0,0,1,0,0,1,844,17,665
2800,인천광역시,2802,동구,,송림3·5동제2투,2430,1458,671,689,62,0,8,1,0,0,1,2,1,0,1435,23,972
2800,인천광역시,2802,동구,송림4동,소계,4530,3411,1757,1494,105,4,23,1,1,1,1,3,1,0,3391,20,1119
2800,인천광역시,2802,동구,,관내사전투표,1434,1434,752,637,32,1,7,0,0,0,0,2,0,0,1431,3,0
2800,인천광역시,2802,동구,,송림4동제1투,1415,846,426,373,29,1,7,1,0,0,1,0,1,0,839,7,569
2800,인천광역시,2802,동구,,송림4동제2투,1681,1131,579,484,44,2,9,0,1,1,0,1,0,0,1121,10,550
2800,인천광역시,2802,동구,송림6동,소계,4934,3664,1749,1725,112,5,28,3,1,2,4,1,1,1,3632,32,1270
2800,인천광역시,2802,동구,,관내사전투표,1768,1768,921,780,44,2,7,1,0,1,1,0,1,1,1759,9,0
2800,인천광역시,2802,동구,,송림6동제1투,778,420,162,229,6,1,7,1,0,1,3,1,0,0,411,9,358
2800,인천광역시,2802,동구,,송림6동제2투,2388,1476,666,716,62,2,14,1,1,0,0,0,0,0,1462,14,912
2800,인천광역시,2802,동구,금창동,소계,2517,1791,757,937,44,1,22,0,0,0,6,3,0,0,1770,21,726
2800,인천광역시,2802,동구,,관내사전투표,894,894,395,459,19,1,7,0,0,0,1,2,0,0,884,10,0
2800,인천광역시,2802,동구,,금창동제1투,879,466,192,245,14,0,6,0,0,0,3,1,0,0,461,5,413
2800,인천광역시,2802,동구,,금창동제2투,744,431,170,233,11,0,9,0,0,0,2,0,0,0,425,6,313
2800,인천광역시,2802,동구,잘못 투입·구분된 투표지,,0,1,1,0,0,0,0,0,0,0,0,0,0,0,1,0,-1
2800,인천광역시,2803,미추홀구,합계,,356862,253347,119287,121122,6951,154,2732,67,37,68,196,199,75,106,250994,2353,103515
2800,인천광역시,2803,미추홀구,거소·선상투표,,686,636,252,254,23,1,17,0,0,2,1,2,0,2,554,82,50
2800,인천광역시,2803,미추홀구,관외사전투표,,26748,26744,13312,11933,777,20,357,10,4,6,16,28,8,15,26486,258,4
2800,인천광역시,2803,미추홀구,재외투표,,1305,913,537,269,22,0,7,1,0,1,1,0,1,0,839,74,392
2800,인천광역시,2803,미추홀구,숭의1·3동,소계,10710,6619,3143,3120,184,10,86,0,2,4,6,3,2,4,6564,55,4091
2800,인천광역시,2803,미추홀구,,관내사전투표,2439,2439,1258,1087,63,3,13,0,0,2,2,1,1,2,2432,7,0
2800,인천광역시,2803,미추홀구,,숭의1·3동제1투,2968,1502,718,689,47,1,28,0,0,2,1,1,0,1,1488,14,1466
2800,인천광역시,2803,미추홀구,,숭의1·3동제2투,2359,1224,520,630,32,3,23,0,2,0,0,1,0,0,1211,13,1135
2800,인천광역시,2803,미추홀구,,숭의1·3동제3투,2944,1454,647,714,42,3,22,0,0,0,3,0,1,1,1433,21,1490
2800,인천광역시,2803,미추홀구,숭의2동,소계,13114,8725,4264,3996,233,5,132,3,1,2,5,8,3,3,8655,70,4389
2800,인천광역시,2803,미추홀구,,관내사전투표,4210,4210,2144,1882,107,2,39,0,0,1,2,6,2,1,4186,24,0
2800,인천광역시,2803,미추홀구,,숭의2동제1투,3033,1480,677,695,48,1,40,2,1,0,0,0,0,0,1464,16,1553
2800,인천광역시,2803,미추홀구,,숭의2동제2투,3705,1999,972,903,53,2,39,0,0,1,2,2,0,2,1976,23,1706
2800,인천광역시,2803,미추홀구,,숭의2동제3투,2166,1036,471,516,25,0,14,1,0,0,1,0,1,0,1029,7,1130
2800,인천광역시,2803,미추홀구,숭의4동,소계,13165,8703,4011,4223,229,6,123,2,1,2,8,8,4,6,8623,80,4462
2800,인천광역시,2803,미추홀구,,관내사전투표,3778,3778,1816,1792,97,2,29,1,0,1,2,1,2,5,3748,30,0
2800,인천광역시,2803,미추홀구,,숭의4동제1투,3416,1665,754,818,45,1,27,0,1,0,0,1,1,1,1649,16,1751
2800,인천광역시,2803,미추홀구,,숭의4동제2투,2680,1474,623,752,37,1,39,0,0,0,3,3,1,0,1459,15,1206
2800,인천광역시,2803,미추홀구,,숭의4동제3투,3291,1786,818,861,50,2,28,1,0,1,3,3,0,0,1767,19,1505
2800,인천광역시,2803,미추홀구,용현1·4동,소계,14041,9332,3782,5039,242,10,81,3,0,4,10,6,3,6,9186,146,4709
2800,인천광역시,2803,미추홀구,,관내사전투표,3520,3520,1572,1804,76,5,16,1,0,1,1,2,1,4,3483,37,0
2800,인천광역시,2803,미추홀구,,용현1·4동제1투,1831,858,362,454,18,0,10,0,0,1,1,0,1,1,848,10,973
2800,인천광역시,2803,미추홀구,,용현1·4동제2투,1618,832,328,447,30,2,7,2,0,1,3,0,0,0,820,12,786
2800,인천광역시,2803,미추홀구,,용현1·4동제3투,2820,1619,635,903,33,0,18,0,0,1,1,0,0,1,1592,27,1201
2800,인천광역시,2803,미추홀구,,용현1·4동제4투,1853,1079,345,657,29,3,11,0,0,0,0,2,1,0,1048,31,774
2800,인천광역시,2803,미추홀구,,용현1·4동제5투,2399,1424,540,774,56,0,19,0,0,0,4,2,0,0,1395,29,975
2800,인천광역시,2803,미추홀구,용현2동,소계,14763,10699,5099,5087,300,2,102,1,0,1,3,5,2,8,10610,89,4064
2800,인천광역시,2803,미추홀구,,관내사전투표,4384,4375,2208,2025,99,2,22,0,0,0,0,2,0,5,4363,12,9
2800,인천광역시,2803,미추홀구,,용현2동제1투,1738,984,482,460,17,0,13,0,0,0,1,0,0,1,974,10,754
2800,인천광역시,2803,미추홀구,,용현2동제2투,3016,1715,741,880,51,0,21,0,0,0,1,1,1,1,1697,18,1301
2800,인천광역시,2803,미추홀구,,용현2동제3투,3161,2005,895,1014,55,0,20,0,0,1,1,0,0,0,1986,19,1156
2800,인천광역시,2803,미추홀구,,용현2동제4투,2464,1620,773,708,78,0,26,1,0,0,0,2,1,1,1590,30,844
2800,인천광역시,2803,미추홀구,용현3동,소계,7046,4782,2017,2550,112,3,46,0,1,4,7,2,3,4,4749,33,2264
2800,인천광역시,2803,미추홀구,,관내사전투표,2439,2439,1080,1287,47,1,8,0,0,2,1,1,1,0,2428,11,0
2800,인천광역시,2803,미추홀구,,용현3동제1투,2418,1171,478,629,28,1,23,0,0,1,3,1,0,1,1165,6,1247
2800,인천광역시,2803,미추홀구,,용현3동제2투,2189,1172,459,634,37,1,15,0,1,1,3,0,2,3,1156,16,1017
2800,인천광역시,2803,미추홀구,용현5동,소계,36041,25522,12137,12218,716,14,207,2,2,6,13,13,5,5,25338,184,10519
2800,인천광역시,2803,미추홀구,,관내사전투표,9179,9179,4569,4281,214,5,45,1,0,3,6,7,2,3,9136,43,0
2800,인천광역시,2803,미추홀구,,용현5동제1투,2772,1552,712,751,50,0,22,0,0,1,2,0,1,0,1539,13,1220
2800,인천광역시,2803,미추홀구,,용현5동제2투,3068,1571,699,788,40,2,22,0,0,2,2,3,0,0,1558,13,1497
2800,인천광역시,2803,미추홀구,,용현5동제3투,2347,1221,547,603,29,1,19,0,0,0,0,0,0,0,1199,22,1126
2800,인천광역시,2803,미추홀구,,용현5동제4투,2581,1248,578,591,39,0,25,1,0,0,0,0,0,0,1234,14,1333
2800,인천광역시,2803,미추홀구,,용현5동제5투,2799,1793,807,891,61,2,11,0,0,0,1,2,0,0,1775,18,1006
2800,인천광역시,2803,미추홀구,,용현5동제6투,2867,1979,885,991,68,2,15,0,1,0,0,1,0,0,1963,16,888
2800,인천광역시,2803,미추홀구,,용현5동제7투,3063,1870,922,849,64,1,19,0,0,0,0,0,0,1,1856,14,1193
2800,인천광역시,2803,미추홀구,,용현5동제8투,3549,2435,1170,1151,76,1,17,0,0,0,2,0,1,0,2418,17,1114
2800,인천광역시,2803,미추홀구,,용현5동제9투,3816,2674,1248,1322,75,0,12,0,1,0,0,0,1,1,2660,14,1142
2800,인천광역시,2803,미추홀구,학익1동,소계,24711,18442,8652,8935,505,2,133,3,6,3,12,20,7,7,18285,157,6269
2800,인천광역시,2803,미추홀구,,관내사전투표,6598,6598,3427,2957,146,0,32,0,0,0,1,4,3,4,6574,24,0
2800,인천광역시,2803,미추홀구,,학익1동제1투,3034,1934,768,1072,54,0,12,0,1,0,5,1,1,0,1914,20,1100
2800,인천광역시,2803,미추홀구,,학익1동제2투,1715,926,401,472,30,0,9,0,0,0,1,0,1,0,914,12,789
2800,인천광역시,2803,미추홀구,,학익1동제3투,2355,1709,668,940,53,0,12,2,0,1,0,8,1,0,1685,24,646
2800,인천광역시,2803,미추홀구,,학익1동제4투,3453,2216,1029,1076,61,0,20,0,4,0,1,1,0,0,2192,24,1237
2800,인천광역시,2803,미추홀구,,학익1동제5투,2208,1337,653,599,43,1,18,0,1,0,1,3,0,0,1319,18,871
2800,인천광역시,2803,미추홀구,,학익1동제6투,1865,1152,494,592,34,0,14,0,0,1,2,2,1,1,1141,11,713
2800,인천광역시,2803,미추홀구,,학익1동제7투,3483,2570,1212,1227,84,1,16,1,0,1,1,1,0,2,2546,24,913
2800,인천광역시,2803,미추홀구,학익2동,소계,15074,11007,4930,5551,308,8,97,2,4,3,4,2,1,2,10912,95,4067
2800,인천광역시,2803,미추홀구,,관내사전투표,4201,4201,1949,2086,113,5,23,2,0,1,1,2,1,0,4183,18,0
2800,인천광역시,2803,미추홀구,,학익2동제1투,1690,813,367,386,28,0,20,0,0,0,1,0,0,2,804,9,877
2800,인천광역시,2803,미추홀구,,학익2동제2투,1932,941,391,495,22,1,12,0,0,0,0,0,0,0,921,20,991
2800,인천광역시,2803,미추홀구,,학익2동제3투,2137,1365,629,666,37,1,20,0,0,0,1,0,0,0,1354,11,772
2800,인천광역시,2803,미추홀구,,학익2동제4투,2577,1889,788,1016,49,1,13,0,1,2,1,0,0,0,1871,18,688
2800,인천광역시,2803,미추홀구,,학익2동제5투,2537,1798,806,902,59,0,9,0,3,0,0,0,0,0,1779,19,739
2800,인천광역시,2803,미추홀구,도화1동,소계,18172,11501,5417,5464,310,8,146,8,3,4,17,13,3,8,11401,100,6671
2800,인천광역시,2803,미추홀구,,관내사전투표,4414,4414,2227,2021,88,4,36,3,0,2,3,2,1,2,4389,25,0
2800,인천광역시,2803,미추홀구,,도화1동제1투,3673,1737,768,852,58,0,27,3,2,0,3,1,0,4,1718,19,1936
2800,인천광역시,2803,미추홀구,,도화1동제2투,3510,1774,831,838,45,1,31,0,0,0,2,1,1,1,1751,23,1736
2800,인천광역시,2803,미추홀구,,도화1동제3투,2932,1719,746,867,53,2,23,1,0,0,4,2,1,0,1699,20,1213
2800,인천광역시,2803,미추홀구,,도화1동제4투,3643,1857,845,886,66,1,29,1,1,2,5,7,0,1,1844,13,1786
2800,인천광역시,2803,미추홀구,도화2·3동,소계,25352,18249,9051,8208,554,8,208,4,2,4,19,15,2,4,18079,170,7103
2800,인천광역시,2803,미추홀구,,관내사전투표,7649,7649,4111,3211,205,3,64,1,0,0,7,7,0,2,7611,38,0
2800,인천광역시,2803,미추홀구,,도화2·3동제1투,1656,931,407,467,27,1,16,0,0,2,1,1,0,1,923,8,725
2800,인천광역시,2803,미추홀구,,도화2·3동제2투,2616,1481,624,742,54,2,26,1,1,0,4,1,0,0,1455,26,1135
2800,인천광역시,2803,미추홀구,,도화2·3동제3투,2586,1516,700,729,43,0,20,1,0,1,2,1,0,0,1497,19,1070
2800,인천광역시,2803,미추홀구,,도화2·3동제4투,2568,1593,770,735,51,1,23,0,0,0,1,1,2,0,1584,9,975
2800,인천광역시,2803,미추홀구,,도화2·3동제5투,2640,1737,908,729,57,1,17,1,0,0,2,3,0,1,1719,18,903
2800,인천광역시,2803,미추홀구,,도화2·3동제6투,2985,1651,722,821,52,0,25,0,0,0,1,1,0,0,1622,29,1334
2800,인천광역시,2803,미추홀구,,도화2·3동제7투,2652,1691,809,774,65,0,17,0,1,1,1,0,0,0,1668,23,961
2800,인천광역시,2803,미추홀구,주안1동,소계,17083,9672,4821,4237,296,5,161,4,2,1,7,12,1,4,9551,121,7411
2800,인천광역시,2803,미추홀구,,관내사전투표,3623,3623,1951,1478,102,2,39,2,2,0,2,5,1,1,3585,38,0
2800,인천광역시,2803,미추홀구,,주안1동제1투,3641,1596,758,718,58,0,28,2,0,1,3,2,0,0,1570,26,2045
2800,인천광역시,2803,미추홀구,,주안1동제2투,2899,1258,619,558,35,1,28,0,0,0,1,3,0,0,1245,13,1641
2800,인천광역시,2803,미추홀구,,주안1동제3투,3810,1636,790,716,55,0,45,0,0,0,1,2,0,2,1611,25,2174
2800,인천광역시,2803,미추홀구,,주안1동제4투,3110,1559,703,767,46,2,21,0,0,0,0,0,0,1,1540,19,1551
2800,인천광역시,2803,미추홀구,주안2동,소계,13500,8745,3850,4465,237,6,94,2,0,1,12,5,2,4,8678,67,4755
2800,인천광역시,2803,미추홀구,,관내사전투표,3421,3421,1630,1669,75,1,18,2,0,0,4,1,1,2,3403,18,0
2800,인천광역시,2803,미추홀구,,주안2동제1투,2315,1138,461,614,35,0,15,0,0,0,0,0,1,1,1127,11,1177
2800,인천광역시,2803,미추홀구,,주안2동제2투,3001,1654,652,909,51,2,21,0,0,1,3,3,0,0,1642,12,1347
2800,인천광역시,2803,미추홀구,,주안2동제3투,1893,1015,424,522,35,2,21,0,0,0,3,0,0,0,1007,8,878
2800,인천광역시,2803,미추홀구,,주안2동제4투,2870,1517,683,751,41,1,19,0,0,0,2,1,0,1,1499,18,1353
2800,인천광역시,2803,미추홀구,주안3동,소계,7111,4727,2238,2240,134,4,47,3,0,4,4,9,3,2,4688,39,2384
2800,인천광역시,2803,미추홀구,,관내사전투표,1736,1736,882,790,39,1,11,0,0,1,1,1,0,0,1726,10,0
2800,인천광역시,2803,미추홀구,,주안3동제1투,1140,513,245,224,25,1,9,3,0,0,0,0,2,0,509,4,627
2800,인천광역시,2803,미추홀구,,주안3동제2투,2202,1276,530,669,29,0,19,0,0,2,2,7,0,1,1259,17,926
2800,인천광역시,2803,미추홀구,,주안3동제3투,2033,1202,581,557,41,2,8,0,0,1,1,1,1,1,1194,8,831
2800,인천광역시,2803,미추홀구,주안4동,소계,10939,7119,2848,3960,153,1,77,1,0,4,5,4,4,4,7061,58,3820
2800,인천광역시,2803,미추홀구,,관내사전투표,2678,2678,1138,1457,52,0,9,1,0,1,2,1,2,0,2663,15,0
2800,인천광역시,2803,미추홀구,,주안4동제1투,2182,1126,429,632,28,0,19,0,0,1,1,1,0,1,1112,14,1056
2800,인천광역시,2803,미추홀구,,주안4동제2투,1903,1010,366,598,19,0,15,0,0,1,2,1,0,0,1002,8,893
2800,인천광역시,2803,미추홀구,,주안4동제3투,2479,1428,539,817,35,1,19,0,0,1,0,1,1,2,1416,12,1051
2800,인천광역시,2803,미추홀구,,주안4동제4투,1697,877,376,456,19,0,15,0,0,0,0,0,1,1,868,9,820
2800,인천광역시,2803,미추홀구,주안5동,소계,17244,12084,5917,5594,311,13,126,6,1,1,5,9,5,3,11991,93,5160
2800,인천광역시,2803,미추홀구,,관내사전투표,4448,4448,2408,1865,111,4,28,1,1,1,0,5,2,1,4427,21,0
2800,인천광역시,2803,미추홀구,,주안5동제1투,2501,1486,696,731,34,2,12,0,0,0,1,1,0,0,1477,9,1015
2800,인천광역시,2803,미추홀구,,주안5동제2투,2112,1245,522,657,33,2,25,1,0,0,0,0,0,1,1241,4,867
2800,인천광역시,2803,미추홀구,,주안5동제3투,2235,1468,687,707,39,0,17,1,0,0,0,0,1,0,1452,16,767
2800,인천광역시,2803,미추홀구,,주안5동제4투,2935,1726,820,814,45,1,18,1,0,0,1,1,1,0,1702,24,1209
2800,인천광역시,2803,미추홀구,,주안5동제5투,3013,1711,784,820,49,4,26,2,0,0,3,2,1,1,1692,19,1302
2800,인천광역시,2803,미추홀구,주안6동,소계,17204,11841,5587,5731,302,8,107,3,0,1,11,7,2,2,11761,80,5363
2800,인천광역시,2803,미추홀구,,관내사전투표,4746,4746,2438,2166,99,3,22,0,0,0,1,1,2,0,4732,14,0
2800,인천광역시,2803,미추홀구,,주안6동제1투,2533,1324,639,609,35,1,21,1,0,0,1,1,0,1,1309,15,1209
2800,인천광역시,2803,미추홀구,,주안6동제2투,3780,1865,860,888,62,1,30,1,0,0,3,1,0,1,1847,18,1915
2800,인천광역시,2803,미추홀구,,주안6동제3투,1839,1011,381,567,34,1,12,0,0,1,1,1,0,0,998,13,828
2800,인천광역시,2803,미추홀구,,주안6동제4투,1855,1277,580,648,31,0,7,1,0,0,3,1,0,0,1271,6,578
2800,인천광역시,2803,미추홀구,,주안6동제5투,2451,1618,689,853,41,2,15,0,0,0,2,2,0,0,1604,14,833
2800,인천광역시,2803,미추홀구,주안7동,소계,12338,9074,4142,4491,243,4,95,3,2,3,14,4,5,5,9011,63,3264
2800,인천광역시,2803,미추홀구,,관내사전투표,4946,4946,2357,2391,138,2,31,2,1,1,5,0,2,2,4932,14,0
2800,인천광역시,2803,미추홀구,,주안7동제1투,1954,1247,519,668,22,1,16,0,0,1,1,1,0,1,1230,17,707
2800,인천광역시,2803,미추홀구,,주안7동제2투,2198,1271,604,593,43,0,11,1,0,1,1,0,2,1,1257,14,927
2800,인천광역시,2803,미추홀구,,주안7동제3투,1530,663,286,329,16,0,17,0,1,0,5,2,0,0,656,7,867
2800,인천광역시,2803,미추홀구,,주안7동제4투,1710,947,376,510,24,1,20,0,0,0,2,1,1,1,936,11,763
2800,인천광역시,2803,미추홀구,주안8동,소계,16468,11642,5544,5541,313,7,113,2,4,2,6,14,2,3,11551,91,4826
2800,인천광역시,2803,미추홀구,,관내사전투표,3890,3890,2007,1757,78,2,22,0,0,1,1,3,0,1,3872,18,0
2800,인천광역시,2803,미추홀구,,주안8동제1투,2196,1136,539,526,43,1,13,0,2,0,1,1,2,0,1128,8,1060
2800,인천광역시,2803,미추홀구,,주안8동제2투,1728,965,458,458,20,0,18,0,0,0,0,2,0,1,957,8,763
2800,인천광역시,2803,미추홀구,,주안8동제3투,2592,1577,691,788,57,1,18,0,0,1,1,1,0,1,1559,18,1015
2800,인천광역시,2803,미추홀구,,주안8동제4투,2691,1890,891,900,50,2,19,1,2,0,1,4,0,0,1870,20,801
2800,인천광역시,2803,미추홀구,,주안8동제5투,3371,2184,958,1112,65,1,23,1,0,0,2,3,0,0,2165,19,1187
2800,인천광역시,2803,미추홀구,관교동,소계,12188,9297,4024,4841,270,5,52,2,0,3,7,6,4,3,9217,80,2891
2800,인천광역시,2803,미추홀구,,관내사전투표,4013,4013,1886,1996,90,2,15,0,0,0,2,5,3,0,3999,14,0
2800,인천광역시,2803,미추홀구,,관교동제1투,2096,1438,486,872,50,1,6,1,0,1,2,0,0,0,1419,19,658
2800,인천광역시,2803,미추홀구,,관교동제2투,1841,1099,452,579,37,0,8,1,0,2,1,1,1,1,1083,16,742
2800,인천광역시,2803,미추홀구,,관교동제3투,1775,1210,461,681,42,1,14,0,0,0,0,0,0,0,1199,11,565
2800,인천광역시,2803,미추홀구,,관교동제4투,2463,1537,739,713,51,1,9,0,0,0,2,0,0,2,1517,20,926
2800,인천광역시,2803,미추홀구,문학동,소계,11859,7271,3712,3174,177,4,118,2,2,2,3,4,3,2,7203,68,4588
2800,인천광역시,2803,미추홀구,,관내사전투표,3169,3169,1741,1315,61,2,30,2,1,0,0,2,1,0,3155,14,0
2800,인천광역시,2803,미추홀구,,문학동제1투,2855,1248,594,579,28,2,26,0,1,0,0,0,1,2,1233,15,1607
2800,인천광역시,2803,미추홀구,,문학동제2투,2664,1388,662,632,41,0,29,0,0,1,3,0,0,0,1368,20,1276
2800,인천광역시,2803,미추홀구,,문학동제3투,3171,1466,715,648,47,0,33,0,0,1,0,2,1,0,1447,19,1705
2800,인천광역시,2803,미추홀구,잘못 투입·구분된 투표지,,0,1,0,1,0,0,0,0,0,0,0,0,0,0,1,0,-1
2800,인천광역시,2804,연수구,합계,,317609,250104,111446,127768,6812,120,1456,62,22,40,133,136,48,72,248115,1989,67505
2800,인천광역시,2804,연수구,거소·선상투표,,569,530,184,244,14,2,16,2,0,1,0,0,0,0,463,67,39
2800,인천광역시,2804,연수구,관외사전투표,,25715,25706,11547,12919,703,13,238,10,1,0,6,11,6,13,25467,239,9
2800,인천광역시,2804,연수구,재외투표,,1998,1452,789,469,44,0,5,1,0,0,1,1,0,0,1310,142,546
2800,인천광역시,2804,연수구,옥련1동,소계,14478,10441,4656,5299,288,3,87,3,2,4,5,10,2,1,10360,81,4037
2800,인천광역시,2804,연수구,,관내사전투표,3445,3445,1681,1643,78,1,24,1,2,1,0,3,0,0,3434,11,0
2800,인천광역시,2804,연수구,,옥련1동제1투,2335,1426,570,772,57,0,15,0,0,0,0,2,0,0,1416,10,909
2800,인천광역시,2804,연수구,,옥련1동제2투,1342,832,328,459,16,0,13,1,0,2,1,0,1,0,821,11,510
2800,인천광역시,2804,연수구,,옥련1동제3투,2297,1364,588,705,31,1,12,0,0,1,2,2,1,0,1343,21,933
2800,인천광역시,2804,연수구,,옥련1동제4투,2455,1656,708,866,56,0,8,0,0,0,2,3,0,0,1643,13,799
2800,인천광역시,2804,연수구,,옥련1동제5투,2604,1718,781,854,50,1,15,1,0,0,0,0,0,1,1703,15,886
2800,인천광역시,2804,연수구,옥련2동,소계,17064,13005,6034,6377,373,7,95,4,0,0,6,11,3,4,12914,91,4059
2800,인천광역시,2804,연수구,,관내사전투표,5643,5641,2896,2582,108,5,10,1,0,0,3,3,1,1,5610,31,2
2800,인천광역시,2804,연수구,,옥련2동제1투,1990,1153,443,628,39,1,22,2,0,0,2,1,0,0,1138,15,837
2800,인천광역시,2804,연수구,,옥련2동제2투,1719,1025,450,505,39,0,20,0,0,0,0,0,0,0,1014,11,694
2800,인천광역시,2804,연수구,,옥련2동제3투,2910,2014,820,1080,78,1,17,1,0,0,0,2,1,0,2000,14,896
2800,인천광역시,2804,연수구,,옥련2동제4투,2361,1486,672,729,51,0,16,0,0,0,1,5,1,0,1475,11,875
2800,인천광역시,2804,연수구,,옥련2동제5투,2441,1686,753,853,58,0,10,0,0,0,0,0,0,3,1677,9,755
2800,인천광역시,2804,연수구,선학동,소계,14302,10294,4732,5091,271,11,87,3,1,1,12,6,3,4,10222,72,4008
2800,인천광역시,2804,연수구,,관내사전투표,4395,4395,2196,2059,92,3,19,1,0,0,4,3,0,1,4378,17,0
2800,인천광역시,2804,연수구,,선학동제1투,1709,1036,479,504,33,2,9,0,0,1,3,0,1,1,1033,3,673
2800,인천광역시,2804,연수구,,선학동제2투,2044,1420,571,772,45,2,11,1,1,0,1,0,0,1,1405,15,624
2800,인천광역시,2804,연수구,,선학동제3투,2645,1649,698,868,42,2,19,0,0,0,1,0,2,1,1633,16,996
2800,인천광역시,2804,연수구,,선학동제4투,1640,750,331,372,19,0,16,0,0,0,2,1,0,0,741,9,890
2800,인천광역시,2804,연수구,,선학동제5투,1869,1044,457,516,40,2,13,1,0,0,1,2,0,0,1032,12,825
2800,인천광역시,2804,연수구,연수1동,소계,16241,10917,5007,5391,279,9,104,3,4,3,6,12,1,5,10824,93,5324
2800,인천광역시,2804,연수구,,관내사전투표,4798,4798,2413,2201,122,4,27,1,1,2,2,5,0,1,4779,19,0
2800,인천광역시,2804,연수구,,연수1동제1투,2008,1173,503,601,32,1,13,1,0,0,3,1,0,0,1155,18,835
2800,인천광역시,2804,연수구,,연수1동제2투,2045,1320,575,667,39,1,16,0,1,0,0,1,0,0,1300,20,725
2800,인천광역시,2804,연수구,,연수1동제3투,2126,1390,566,751,42,1,15,0,0,0,0,3,0,2,1380,10,736
2800,인천광역시,2804,연수구,,연수1동제4투,1823,676,292,343,11,1,11,1,0,0,0,2,0,2,663,13,1147
2800,인천광역시,2804,연수구,,연수1동제5투,1814,877,366,465,21,0,14,0,0,1,0,0,1,0,868,9,937
2800,인천광역시,2804,연수구,,연수1동제6투,1627,683,292,363,12,1,8,0,2,0,1,0,0,0,679,4,944
2800,인천광역시,2804,연수구,연수2동,소계,17431,13201,5913,6635,374,5,90,7,1,10,12,12,3,2,13064,137,4230
2800,인천광역시,2804,연수구,,관내사전투표,5468,5461,2660,2594,144,2,14,3,0,1,0,6,3,1,5428,33,7
2800,인천광역시,2804,연수구,,연수2동제1투,2161,1454,588,801,37,1,8,0,0,3,0,0,0,0,1438,16,707
2800,인천광역시,2804,연수구,,연수2동제2투,2170,1576,684,798,57,1,18,0,1,4,1,0,0,0,1564,12,594
2800,인천광역시,2804,연수구,,연수2동제3투,2270,1395,572,724,41,0,22,2,0,1,5,2,0,0,1369,26,875
2800,인천광역시,2804,연수구,,연수2동제4투,1729,1205,576,563,39,0,8,0,0,1,4,1,0,0,1192,13,524
2800,인천광역시,2804,연수구,,연수2동제5투,2361,1426,592,751,40,1,10,1,0,0,1,3,0,1,1400,26,935
2800,인천광역시,2804,연수구,,연수2동제6투,1272,684,241,404,16,0,10,1,0,0,1,0,0,0,673,11,588
2800,인천광역시,2804,연수구,연수3동,소계,13197,9866,4581,4794,301,3,68,2,4,2,10,12,1,8,9786,80,3331
2800,인천광역시,2804,연수구,,관내사전투표,3967,3964,2050,1780,91,0,14,0,1,1,5,1,0,4,3947,17,3
2800,인천광역시,2804,연수구,,연수3동제1투,2082,1400,613,723,39,0,6,1,0,0,2,0,0,1,1385,15,682
2800,인천광역시,2804,연수구,,연수3동제2투,1968,1247,521,633,60,0,18,1,1,0,0,0,0,0,1234,13,721
2800,인천광역시,2804,연수구,,연수3동제3투,1977,1267,550,635,52,1,10,0,0,0,0,2,0,0,1250,17,710
2800,인천광역시,2804,연수구,,연수3동제4투,1405,757,292,423,12,2,13,0,1,0,3,3,1,1,751,6,648
2800,인천광역시,2804,연수구,,연수3동제5투,1798,1231,555,600,47,0,7,0,1,1,0,6,0,2,1219,12,567
2800,인천광역시,2804,연수구,청학동,소계,20262,14090,6364,7047,385,10,130,2,0,1,18,3,11,8,13979,111,6172
2800,인천광역시,2804,연수구,,관내사전투표,5154,5154,2543,2435,115,5,25,1,0,0,4,1,5,2,5136,18,0
2800,인천광역시,2804,연수구,,청학동제1투,2543,1396,579,734,42,0,18,0,0,0,5,0,1,1,1380,16,1147
2800,인천광역시,2804,연수구,,청학동제2투,1778,1169,503,608,37,0,8,0,0,1,0,0,1,0,1158,11,609
2800,인천광역시,2804,연수구,,청학동제3투,2094,1384,629,688,41,2,12,0,0,0,3,0,0,1,1376,8,710
2800,인천광역시,2804,연수구,,청학동제4투,2510,1435,623,728,49,0,15,0,0,0,0,0,3,1,1419,16,1075
2800,인천광역시,2804,연수구,,청학동제5투,2271,1299,580,639,40,0,18,1,0,0,2,0,1,1,1282,17,972
2800,인천광역시,2804,연수구,,청학동제6투,2204,1266,560,632,35,2,15,0,0,0,2,1,0,1,1248,18,938
2800,인천광역시,2804,연수구,,청학동제7투,1708,987,347,583,26,1,19,0,0,0,2,1,0,1,980,7,721
2800,인천광역시,2804,연수구,동춘1동,소계,18869,14685,6989,7019,456,9,77,7,0,4,6,8,5,5,14585,100,4184
2800,인천광역시,2804,연수구,,관내사전투표,5124,5122,2696,2247,122,5,15,3,0,1,0,5,0,0,5094,28,2
2800,인천광역시,2804,연수구,,동춘1동제1투,2179,1420,618,732,45,1,12,1,0,0,3,1,1,0,1414,6,759
2800,인천광역시,2804,연수구,,동춘1동제2투,2506,1744,837,811,65,0,11,0,0,0,0,1,1,1,1727,17,762
2800,인천광역시,2804,연수구,,동춘1동제3투,1939,1266,536,658,44,0,11,0,0,1,3,0,1,1,1255,11,673
2800,인천광역시,2804,연수구,,동춘1동제4투,2433,1719,755,871,63,2,8,2,0,1,0,1,1,1,1705,14,714
2800,인천광역시,2804,연수구,,동춘1동제5투,1010,639,309,296,27,0,4,0,0,0,0,0,0,0,636,3,371
2800,인천광역시,2804,연수구,,동춘1동제6투,3678,2775,1238,1404,90,1,16,1,0,1,0,0,1,2,2754,21,903
2800,인천광역시,2804,연수구,동춘2동,소계,14596,11581,5606,5435,360,11,59,3,0,2,10,6,1,3,11496,85,3015
2800,인천광역시,2804,연수구,,관내사전투표,5347,5347,2868,2273,141,4,24,2,0,0,4,5,0,1,5322,25,0
2800,인천광역시,2804,연수구,,동춘2동제1투,1966,1217,527,618,49,0,11,0,0,0,0,1,1,0,1207,10,749
2800,인천광역시,2804,연수구,,동춘2동제2투,2322,1588,715,796,45,2,10,0,0,0,2,0,0,1,1571,17,734
2800,인천광역시,2804,연수구,,동춘2동제3투,2282,1566,695,771,72,3,6,0,0,0,3,0,0,1,1551,15,716
2800,인천광역시,2804,연수구,,동춘2동제4투,2679,1863,801,977,53,2,8,1,0,2,1,0,0,0,1845,18,816
2800,인천광역시,2804,연수구,동춘3동,소계,13874,11428,5385,5596,314,4,41,2,1,5,3,12,1,2,11366,62,2446
2800,인천광역시,2804,연수구,,관내사전투표,5437,5437,2834,2449,120,0,10,0,0,1,2,1,1,1,5419,18,0
2800,인천광역시,2804,연수구,,동춘3동제1투,1954,1373,515,787,51,0,5,0,0,2,0,4,0,0,1364,9,581
2800,인천광역시,2804,연수구,,동춘3동제2투,2124,1498,686,740,42,1,12,1,0,0,1,1,0,0,1484,14,626
2800,인천광역시,2804,연수구,,동춘3동제3투,2404,1720,741,897,51,1,8,1,0,1,0,5,0,0,1705,15,684
2800,인천광역시,2804,연수구,,동춘3동제4투,1955,1400,609,723,50,2,6,0,1,1,0,1,0,1,1394,6,555
2800,인천광역시,2804,연수구,송도1동,소계,26431,20995,8945,11271,521,9,72,6,3,2,10,11,3,3,20856,139,5436
2800,인천광역시,2804,연수구,,관내사전투표,7662,7660,3753,3717,133,4,14,0,1,0,1,4,0,1,7628,32,2
2800,인천광역시,2804,연수구,,송도1동제1투,2234,1612,745,788,66,1,2,0,0,0,1,1,0,0,1604,8,622
2800,인천광역시,2804,연수구,,송도1동제2투,2262,1677,596,1023,38,1,8,0,0,1,0,0,1,0,1668,9,585
2800,인천광역시,2804,연수구,,송도1동제3투,2300,1536,679,783,46,0,8,0,1,1,3,0,1,0,1522,14,764
2800,인천광역시,2804,연수구,,송도1동제4투,2112,1555,613,867,56,0,9,0,0,0,0,0,1,0,1546,9,557
2800,인천광역시,2804,연수구,,송도1동제5투,3578,2468,916,1447,63,1,9,2,0,0,0,1,0,0,2439,29,1110
2800,인천광역시,2804,연수구,,송도1동제6투,3160,2189,912,1167,72,1,13,2,0,0,1,4,0,1,2173,16,971
2800,인천광역시,2804,연수구,,송도1동제7투,3123,2298,731,1479,47,1,9,2,1,0,4,1,0,1,2276,22,825
2800,인천광역시,2804,연수구,송도2동,소계,24915,20153,8200,11331,426,6,60,1,0,1,9,6,1,2,20043,110,4762
2800,인천광역시,2804,연수구,,관내사전투표,8219,8218,3820,4216,130,2,15,1,0,1,1,3,0,1,8190,28,1
2800,인천광역시,2804,연수구,,송도2동제1투,1850,1352,581,719,36,0,4,0,0,0,1,0,0,0,1341,11,498
2800,인천광역시,2804,연수구,,송도2동제2투,2648,1925,696,1160,42,1,12,0,0,0,0,0,0,1,1912,13,723
2800,인천광역시,2804,연수구,,송도2동제3투,3002,1960,619,1294,35,0,5,0,0,0,1,0,1,0,1955,5,1042
2800,인천광역시,2804,연수구,,송도2동제4투,1977,1341,552,726,42,1,5,0,0,0,1,1,0,0,1328,13,636
2800,인천광역시,2804,연수구,,송도2동제5투,2173,1691,642,987,40,0,5,0,0,0,0,1,0,0,1675,16,482
2800,인천광역시,2804,연수구,,송도2동제6투,2597,1920,727,1115,56,1,7,0,0,0,4,0,0,0,1910,10,677
2800,인천광역시,2804,연수구,,송도2동제7투,2449,1746,563,1114,45,1,7,0,0,0,1,1,0,0,1732,14,703
2800,인천광역시,2804,연수구,송도3동,소계,33330,26676,11685,13893,794,10,93,2,1,1,7,5,5,5,26501,175,6654
2800,인천광역시,2804,연수구,,관내사전투표,9732,9732,4758,4659,250,3,12,1,1,0,1,1,1,2,9689,43,0
2800,인천광역시,2804,연수구,,송도3동제1투,2705,1900,726,1078,68,1,11,0,0,0,0,0,1,0,1885,15,805
2800,인천광역시,2804,연수구,,송도3동제2투,2373,1822,818,921,56,0,8,0,0,0,2,0,0,1,1806,16,551
2800,인천광역시,2804,연수구,,송도3동제3투,3101,2125,801,1241,50,2,10,0,0,0,3,0,0,0,2107,18,976
2800,인천광역시,2804,연수구,,송도3동제4투,2205,1654,623,956,56,0,7,0,0,0,0,1,0,0,1643,11,551
2800,인천광역시,2804,연수구,,송도3동제5투,3319,2300,956,1258,64,0,7,1,0,0,0,0,0,0,2286,14,1019
2800,인천광역시,2804,연수구,,송도3동제6투,1848,1274,540,657,52,2,10,0,0,0,1,0,0,0,1262,12,574
2800,인천광역시,2804,연수구,,송도3동제7투,2751,1886,827,966,58,1,12,0,0,1,0,1,2,1,1869,17,865
2800,인천광역시,2804,연수구,,송도3동제8투,1497,1123,470,585,49,1,4,0,0,0,0,1,0,1,1111,12,374
2800,인천광역시,2804,연수구,,송도3동제9투,3799,2860,1166,1572,91,0,12,0,0,0,0,1,1,0,2843,17,939
2800,인천광역시,2804,연수구,송도4동,소계,17416,13979,5780,7706,337,4,47,3,1,2,6,3,2,3,13894,85,3437
2800,인천광역시,2804,연수구,,관내사전투표,5350,5349,2586,2593,124,2,17,1,0,1,1,1,1,2,5329,20,1
2800,인천광역시,2804,연수구,,송도4동제1투,2210,1387,493,822,36,2,9,1,1,0,1,1,0,0,1366,21,823
2800,인천광역시,2804,연수구,,송도4동제2투,2387,1742,595,1089,42,0,3,0,0,1,1,0,0,0,1731,11,645
2800,인천광역시,2804,연수구,,송도4동제3투,1980,1454,578,816,42,0,4,0,0,0,1,0,0,1,1442,12,526
2800,인천광역시,2804,연수구,,송도4동제4투,2783,2083,834,1188,41,0,6,1,0,0,2,0,0,0,2072,11,700
2800,인천광역시,2804,연수구,,송도4동제5투,2706,1964,694,1198,52,0,8,0,0,0,0,1,1,0,1954,10,742
2800,인천광역시,2804,연수구,송도5동,소계,26921,21097,9047,11246,571,4,87,1,3,1,6,7,0,4,20977,120,5824
2800,인천광역시,2804,연수구,,관내사전투표,7258,7257,3534,3504,173,2,19,1,0,0,0,3,0,1,7237,20,1
2800,인천광역시,2804,연수구,,송도5동제1투,2872,1906,765,1050,54,0,14,0,0,0,1,0,0,1,1885,21,966
2800,인천광역시,2804,연수구,,송도5동제2투,3158,2186,837,1266,60,0,7,0,0,0,2,2,0,0,2174,12,972
2800,인천광역시,2804,연수구,,송도5동제3투,3199,2390,952,1337,72,0,10,0,0,0,1,2,0,1,2375,15,809
2800,인천광역시,2804,연수구,,송도5동제4투,3197,2341,975,1258,71,1,13,0,1,0,0,0,0,1,2320,21,856
2800,인천광역시,2804,연수구,,송도5동제5투,2278,1751,675,999,54,0,9,0,0,0,1,0,0,0,1738,13,527
2800,인천광역시,2804,연수구,,송도5동제6투,2807,1793,682,1051,42,0,8,0,2,0,1,0,0,0,1786,7,1014
2800,인천광역시,2804,연수구,,송도5동제7투,2152,1473,627,781,45,1,7,0,0,1,0,0,0,0,1462,11,679
2800,인천광역시,2804,연수구,잘못 투입·구분된 투표지,,0,8,2,5,1,0,0,0,0,0,0,0,0,0,8,0,-8
2800,인천광역시,2805,남동구,합계,,441525,329653,162476,150877,9232,215,2928,82,55,74,253,301,76,138,326707,2946,111872
2800,인천광역시,2805,남동구,거소·선상투표,,1061,998,390,416,26,2,26,2,1,1,1,0,0,4,869,129,63
2800,인천광역시,2805,남동구,관외사전투표,,33832,33826,17027,15007,902,29,408,17,6,5,17,41,14,18,33491,335,6
2800,인천광역시,2805,남동구,재외투표,,1677,1151,713,289,39,0,5,0,0,0,1,1,0,0,1048,103,526
2800,인천광역시,2805,남동구,구월1동,소계,24615,18414,9115,8446,557,6,125,5,6,6,9,16,4,3,18298,116,6201
2800,인천광역시,2805,남동구,,관내사전투표,7919,7919,4189,3453,198,3,37,1,2,1,0,7,2,2,7895,24,0
2800,인천광역시,2805,남동구,,구월1동제1투,2153,1361,588,698,38,1,18,1,1,3,1,1,0,0,1350,11,792
2800,인천광역시,2805,남동구,,구월1동제2투,2157,1279,620,577,48,1,14,2,0,0,2,1,1,0,1266,13,878
2800,인천광역시,2805,남동구,,구월1동제3투,2352,1176,536,563,39,0,17,1,2,0,2,4,0,0,1164,12,1176
2800,인천광역시,2805,남동구,,구월1동제4투,2429,1428,641,697,62,0,10,0,1,1,2,0,0,0,1414,14,1001
2800,인천광역시,2805,남동구,,구월1동제5투,3114,1871,892,888,59,1,12,0,0,1,1,1,0,0,1855,16,1243
2800,인천광역시,2805,남동구,,구월1동제6투,2099,1545,784,680,59,0,7,0,0,0,1,1,0,0,1532,13,554
2800,인천광역시,2805,남동구,,구월1동제7투,2392,1835,865,890,54,0,10,0,0,0,0,1,1,1,1822,13,557
2800,인천광역시,2805,남동구,구월2동,소계,26634,20840,9981,9988,553,9,119,10,4,1,13,7,3,7,20695,145,5794
2800,인천광역시,2805,남동구,,관내사전투표,8834,8834,4666,3866,212,3,40,5,1,0,2,3,2,4,8804,30,0
2800,인천광역시,2805,남동구,,구월2동제1투,2129,1387,642,679,43,0,11,0,1,0,0,0,0,0,1376,11,742
2800,인천광역시,2805,남동구,,구월2동제2투,2799,1959,918,957,55,2,9,1,1,0,1,1,0,0,1945,14,840
2800,인천광역시,2805,남동구,,구월2동제3투,2505,1746,731,936,53,0,7,1,0,0,2,0,0,0,1730,16,759
2800,인천광역시,2805,남동구,,구월2동제4투,2475,1837,807,944,49,1,8,1,0,0,1,1,0,1,1813,24,638
2800,인천광역시,2805,남동구,,구월2동제5투,2623,1869,845,940,51,0,15,0,0,0,2,0,0,0,1853,16,754
2800,인천광역시,2805,남동구,,구월2동제6투,3287,1993,858,1027,61,2,15,2,1,1,5,1,1,2,1976,17,1294
2800,인천광역시,2805,남동구,,구월2동제7투,1982,1215,514,639,29,1,14,0,0,0,0,1,0,0,1198,17,767
2800,인천광역시,2805,남동구,구월3동,소계,23590,14419,7025,6551,448,9,173,3,1,3,6,12,4,6,14241,178,9171
2800,인천광역시,2805,남동구,,관내사전투표,4314,4314,2368,1743,119,4,34,1,0,1,1,4,3,2,4280,34,0
2800,인천광역시,2805,남동구,,구월3동제1투,2418,1331,619,630,36,0,26,0,0,0,1,0,0,0,1312,19,1087
2800,인천광역시,2805,남동구,,구월3동제2투,2629,1429,652,671,52,1,28,1,0,1,1,2,0,1,1410,19,1200
2800,인천광역시,2805,남동구,,구월3동제3투,2849,1629,641,904,33,0,27,1,1,0,3,1,0,2,1613,16,1220
2800,인천광역시,2805,남동구,,구월3동제4투,3937,2123,1052,940,82,2,16,0,0,0,0,1,0,0,2093,30,1814
2800,인천광역시,2805,남동구,,구월3동제5투,3824,1860,895,842,70,2,21,0,0,1,0,0,1,0,1832,28,1964
2800,인천광역시,2805,남동구,,구월3동제6투,3619,1733,798,821,56,0,21,0,0,0,0,4,0,1,1701,32,1886
2800,인천광역시,2805,남동구,구월4동,소계,12631,8197,3975,3774,224,10,100,1,2,4,1,8,2,6,8107,90,4434
2800,인천광역시,2805,남동구,,관내사전투표,3336,3336,1781,1399,91,7,23,0,1,3,0,4,1,2,3312,24,0
2800,인천광역시,2805,남동구,,구월4동제1투,1992,978,443,468,22,1,15,0,1,0,0,2,1,2,955,23,1014
2800,인천광역시,2805,남동구,,구월4동제2투,1796,979,421,506,26,0,16,0,0,0,0,0,0,1,970,9,817
2800,인천광역시,2805,남동구,,구월4동제3투,1968,1029,480,479,24,0,25,1,0,1,0,1,0,0,1011,18,939
2800,인천광역시,2805,남동구,,구월4동제4투,1887,973,424,495,34,1,9,0,0,0,1,0,0,0,964,9,914
2800,인천광역시,2805,남동구,,구월4동제5투,1652,902,426,427,27,1,12,0,0,0,0,1,0,1,895,7,750
2800,인천광역시,2805,남동구,간석1동,소계,17975,12917,6201,6080,351,10,106,3,3,3,4,12,3,7,12783,134,5058
2800,인천광역시,2805,남동구,,관내사전투표,5180,5180,2750,2258,123,3,15,0,1,1,0,2,0,2,5155,25,0
2800,인천광역시,2805,남동구,,간석1동제1투,2893,1632,731,785,55,2,25,0,0,1,0,0,0,0,1599,33,1261
2800,인천광역시,2805,남동구,,간석1동제2투,3218,1598,709,790,40,0,29,1,2,0,2,2,0,3,1578,20,1620
2800,인천광역시,2805,남동구,,간석1동제3투,2726,1696,798,809,38,2,18,1,0,0,1,3,0,0,1670,26,1030
2800,인천광역시,2805,남동구,,간석1동제4투,2320,1749,735,930,57,2,8,1,0,0,1,4,0,1,1739,10,571
2800,인천광역시,2805,남동구,,간석1동제5투,1638,1062,478,508,38,1,11,0,0,1,0,1,3,1,1042,20,576
2800,인천광역시,2805,남동구,간석2동,소계,16539,11730,5261,5936,298,4,92,1,2,2,13,14,3,1,11627,103,4809
2800,인천광역시,2805,남동구,,관내사전투표,3785,3780,1885,1758,72,1,32,0,1,1,3,6,2,0,3761,19,5
2800,인천광역시,2805,남동구,,간석2동제1투,3116,1401,582,733,44,1,16,1,0,0,3,2,1,0,1383,18,1715
2800,인천광역시,2805,남동구,,간석2동제2투,2801,1417,637,707,31,2,23,0,0,0,2,0,0,0,1402,15,1384
2800,인천광역시,2805,남동구,,간석2동제3투,2762,2017,817,1101,65,0,9,0,0,0,1,4,0,0,1997,20,745
2800,인천광역시,2805,남동구,,간석2동제4투,2096,1658,705,879,46,0,8,0,0,1,1,2,0,0,1642,16,438
2800,인천광역시,2805,남동구,,간석2동제5투,1979,1457,635,758,40,0,4,0,1,0,3,0,0,1,1442,15,522
2800,인천광역시,2805,남동구,간석3동,소계,21833,14514,7191,6512,407,10,200,2,4,5,15,18,5,7,14376,138,7319
2800,인천광역시,2805,남동구,,관내사전투표,4969,4969,2735,2033,114,5,47,1,0,0,4,9,1,1,4950,19,0
2800,인천광역시,2805,남동구,,간석3동제1투,3960,1948,926,879,64,3,42,0,0,0,1,1,1,1,1918,30,2012
2800,인천광역시,2805,남동구,,간석3동제2투,3104,2086,976,1011,63,0,17,0,1,0,1,0,1,2,2072,14,1018
2800,인천광역시,2805,남동구,,간석3동제3투,2565,1278,605,573,32,0,31,0,1,1,7,3,1,3,1257,21,1287
2800,인천광역시,2805,남동구,,간석3동제4투,2325,1466,644,741,52,0,12,0,0,1,1,1,1,0,1453,13,859
2800,인천광역시,2805,남동구,,간석3동제5투,3631,1999,974,891,61,1,37,1,0,1,0,2,0,0,1968,31,1632
2800,인천광역시,2805,남동구,,간석3동제6투,1279,768,331,384,21,1,14,0,2,2,1,2,0,0,758,10,511
2800,인천광역시,2805,남동구,간석4동,소계,21990,14981,7174,7036,432,11,139,3,1,3,20,17,2,10,14848,133,7009
2800,인천광역시,2805,남동구,,관내사전투표,4666,4666,2404,2083,108,4,25,2,0,0,2,7,0,2,4637,29,0
2800,인천광역시,2805,남동구,,간석4동제1투,2201,1108,488,552,32,2,15,0,0,0,7,0,0,1,1097,11,1093
2800,인천광역시,2805,남동구,,간석4동제2투,4881,2440,1185,1110,76,2,28,0,0,0,4,1,1,2,2409,31,2441
2800,인천광역시,2805,남동구,,간석4동제3투,2793,1832,737,985,57,1,25,0,0,0,4,3,0,1,1813,19,961
2800,인천광역시,2805,남동구,,간석4동제4투,2133,1527,676,769,56,0,10,1,0,0,2,1,0,2,1517,10,606
2800,인천광역시,2805,남동구,,간석4동제5투,2638,1487,789,612,45,0,17,0,1,1,1,3,1,0,1470,17,1151
2800,인천광역시,2805,남동구,,간석4동제6투,2678,1921,895,925,58,2,19,0,0,2,0,2,0,2,1905,16,757
2800,인천광역시,2805,남동구,만수1동,소계,14783,10418,4912,4880,336,7,141,2,2,4,14,9,2,7,10316,102,4365
2800,인천광역시,2805,남동구,,관내사전투표,4241,4241,2197,1865,121,2,32,1,0,1,0,2,0,2,4223,18,0
2800,인천광역시,2805,남동구,,만수1동제1투,2201,1257,543,620,47,1,24,0,0,1,3,2,0,0,1241,16,944
2800,인천광역시,2805,남동구,,만수1동제2투,2771,1598,716,779,53,1,23,0,0,0,6,1,1,0,1580,18,1173
2800,인천광역시,2805,남동구,,만수1동제3투,2310,1253,543,600,55,1,30,0,0,0,2,2,1,1,1235,18,1057
2800,인천광역시,2805,남동구,,만수1동제4투,1667,1044,443,533,19,0,19,1,1,1,1,1,0,2,1021,23,623
2800,인천광역시,2805,남동구,,만수1동제5투,1593,1025,470,483,41,2,13,0,1,1,2,1,0,2,1016,9,568
2800,인천광역시,2805,남동구,만수2동,소계,19456,14504,7535,6274,402,13,103,4,3,8,13,13,2,6,14376,128,4952
2800,인천광역시,2805,남동구,,관내사전투표,5778,5776,3259,2304,145,7,27,1,1,1,0,3,1,4,5753,23,2
2800,인천광역시,2805,남동구,,만수2동제1투,2029,1178,628,464,45,1,13,1,0,1,0,3,0,0,1156,22,851
2800,인천광역시,2805,남동구,,만수2동제2투,2450,1442,701,661,35,2,21,1,0,1,2,1,0,1,1426,16,1008
2800,인천광역시,2805,남동구,,만수2동제3투,2600,1584,718,779,53,0,6,0,2,0,4,2,1,0,1565,19,1016
2800,인천광역시,2805,남동구,,만수2동제4투,1719,993,498,435,27,0,17,0,0,0,3,2,0,0,982,11,726
2800,인천광역시,2805,남동구,,만수2동제5투,2215,1611,774,742,56,0,12,1,0,5,0,1,0,1,1592,19,604
2800,인천광역시,2805,남동구,,만수2동제6투,2665,1920,957,889,41,3,7,0,0,0,4,1,0,0,1902,18,745
2800,인천광역시,2805,남동구,만수3동,소계,14657,10503,5286,4723,291,8,87,0,2,3,3,13,1,4,10421,82,4154
2800,인천광역시,2805,남동구,,관내사전투표,4272,4272,2254,1868,96,3,20,0,1,2,1,5,1,1,4252,20,0
2800,인천광역시,2805,남동구,,만수3동제1투,2798,1700,829,767,67,1,16,0,0,0,1,1,0,2,1684,16,1098
2800,인천광역시,2805,남동구,,만수3동제2투,1641,865,433,369,24,2,18,0,0,0,0,3,0,1,850,15,776
2800,인천광역시,2805,남동구,,만수3동제3투,2523,1325,634,619,36,0,18,0,1,0,1,1,0,0,1310,15,1198
2800,인천광역시,2805,남동구,,만수3동제4투,3423,2341,1136,1100,68,2,15,0,0,1,0,3,0,0,2325,16,1082
2800,인천광역시,2805,남동구,만수4동,소계,16878,12724,5967,6132,397,5,91,10,0,6,8,12,1,3,12632,92,4154
2800,인천광역시,2805,남동구,,관내사전투표,5941,5941,3055,2698,131,3,18,5,0,3,2,4,0,1,5920,21,0
2800,인천광역시,2805,남동구,,만수4동제1투,1745,931,394,483,26,1,11,0,0,0,1,2,0,0,918,13,814
2800,인천광역시,2805,남동구,,만수4동제2투,1911,1241,533,620,64,1,12,0,0,1,1,1,0,0,1233,8,670
2800,인천광역시,2805,남동구,,만수4동제3투,1886,1184,516,588,49,0,12,1,0,0,3,1,1,0,1171,13,702
2800,인천광역시,2805,남동구,,만수4동제4투,2158,1390,630,677,54,0,12,3,0,1,0,2,0,0,1379,11,768
2800,인천광역시,2805,남동구,,만수4동제5투,1686,1058,437,560,28,0,15,0,0,0,0,0,0,1,1041,17,628
2800,인천광역시,2805,남동구,,만수4동제6투,1551,979,402,506,45,0,11,1,0,1,1,2,0,1,970,9,572
2800,인천광역시,2805,남동구,만수5동,소계,13068,8975,4408,4118,237,7,107,2,0,2,3,7,3,7,8901,74,4093
2800,인천광역시,2805,남동구,,관내사전투표,3677,3677,1933,1603,86,2,27,2,0,0,1,2,2,4,3662,15,0
2800,인천광역시,2805,남동구,,만수5동제1투,2256,1216,585,558,24,0,25,0,0,0,1,2,0,1,1196,20,1040
2800,인천광역시,2805,남동구,,만수5동제2투,2316,1475,675,711,49,1,19,0,0,2,0,2,0,1,1460,15,841
2800,인천광역시,2805,남동구,,만수5동제3투,2353,1209,555,591,35,2,21,0,0,0,0,0,0,0,1204,5,1144
2800,인천광역시,2805,남동구,,만수5동제4투,2466,1398,660,655,43,2,15,0,0,0,1,1,1,1,1379,19,1068
2800,인천광역시,2805,남동구,만수6동,소계,20339,15246,7355,7156,461,20,122,2,3,2,10,8,1,9,15149,97,5093
2800,인천광역시,2805,남동구,,관내사전투표,5972,5972,3164,2554,174,11,35,1,2,0,2,4,0,1,5948,24,0
2800,인천광역시,2805,남동구,,만수6동제1투,2217,1286,577,653,27,1,14,0,0,0,2,0,1,0,1275,11,931
2800,인천광역시,2805,남동구,,만수6동제2투,2214,1453,711,687,34,4,8,0,0,0,1,1,0,1,1447,6,761
2800,인천광역시,2805,남동구,,만수6동제3투,2321,1448,674,692,43,1,16,1,1,0,1,0,0,1,1430,18,873
2800,인천광역시,2805,남동구,,만수6동제4투,2628,1815,836,871,72,1,17,0,0,2,0,1,0,1,1801,14,813
2800,인천광역시,2805,남동구,,만수6동제5투,2770,1652,778,782,51,1,17,0,0,0,4,2,0,5,1640,12,1118
2800,인천광역시,2805,남동구,,만수6동제6투,2217,1620,615,917,60,1,15,0,0,0,0,0,0,0,1608,12,597
2800,인천광역시,2805,남동구,장수서창동,소계,15119,11500,5501,5507,303,5,71,2,2,1,16,3,3,5,11419,81,3619
2800,인천광역시,2805,남동구,,관내사전투표,4897,4896,2641,2096,111,1,21,1,1,0,2,1,0,1,4876,20,1
2800,인천광역시,2805,남동구,,장수서창동제1투,3028,1847,825,934,47,0,14,0,0,0,3,1,2,3,1829,18,1181
2800,인천광역시,2805,남동구,,장수서창동제2투,197,143,26,110,5,1,0,0,0,0,0,0,0,0,142,1,54
2800,인천광역시,2805,남동구,,장수서창동제3투,3319,2159,904,1144,70,0,20,1,1,0,3,0,1,0,2144,15,1160
2800,인천광역시,2805,남동구,,장수서창동제4투,1717,1195,547,580,35,2,9,0,0,0,6,0,0,1,1180,15,522
2800,인천광역시,2805,남동구,,장수서창동제5투,1961,1260,558,643,35,1,7,0,0,1,2,1,0,0,1248,12,701
2800,인천광역시,2805,남동구,남촌도림동,소계,16225,11278,5429,5242,329,12,124,2,2,5,11,18,6,5,11185,93,4947
2800,인천광역시,2805,남동구,,관내사전투표,3600,3600,1833,1602,97,2,27,1,1,4,3,3,3,1,3577,23,0
2800,인천광역시,2805,남동구,,남촌도림동제1투,1588,813,372,383,25,1,24,1,1,0,0,1,0,2,810,3,775
2800,인천광역시,2805,남동구,,남촌도림동제2투,2274,1199,579,529,52,4,18,0,0,0,0,3,0,0,1185,14,1075
2800,인천광역시,2805,남동구,,남촌도림동제3투,2711,1597,738,768,41,2,23,0,0,1,0,5,1,1,1580,17,1114
2800,인천광역시,2805,남동구,,남촌도림동제4투,3392,2159,1056,984,63,3,23,0,0,0,4,3,1,0,2137,22,1233
2800,인천광역시,2805,남동구,,남촌도림동제5투,2331,1680,788,814,48,0,8,0,0,0,4,3,1,1,1667,13,651
2800,인천광역시,2805,남동구,,남촌도림동제6투,329,230,63,162,3,0,1,0,0,0,0,0,0,0,229,1,99
2800,인천광역시,2805,남동구,논현1동,소계,24281,18082,9131,8143,487,11,145,1,1,2,16,24,3,3,17967,115,6199
2800,인천광역시,2805,남동구,,관내사전투표,7245,7245,3924,3067,165,4,36,0,0,0,6,10,2,2,7216,29,0
2800,인천광역시,2805,남동구,,논현1동제1투,2045,1194,603,517,41,1,16,0,0,1,1,4,0,0,1184,10,851
2800,인천광역시,2805,남동구,,논현1동제2투,2872,1589,770,742,41,1,15,0,0,1,1,1,0,0,1572,17,1283
2800,인천광역시,2805,남동구,,논현1동제3투,3603,2549,1216,1185,85,1,27,1,0,0,3,3,1,0,2522,27,1054
2800,인천광역시,2805,남동구,,논현1동제4투,2078,1125,497,574,29,1,15,0,1,0,2,1,0,0,1120,5,953
2800,인천광역시,2805,남동구,,논현1동제5투,1882,1200,579,563,28,0,20,0,0,0,1,3,0,1,1195,5,682
2800,인천광역시,2805,남동구,,논현1동제6투,2534,1738,879,776,58,2,5,0,0,0,1,1,0,0,1722,16,796
2800,인천광역시,2805,남동구,,논현1동제7투,2022,1442,663,719,40,1,11,0,0,0,1,1,0,0,1436,6,580
2800,인천광역시,2805,남동구,논현2동,소계,26149,19156,9471,8727,521,10,176,4,3,6,21,21,5,7,18972,184,6993
2800,인천광역시,2805,남동구,,관내사전투표,7071,7071,3848,2960,148,4,42,2,1,0,6,6,2,2,7021,50,0
2800,인천광역시,2805,남동구,,논현2동제1투,2469,1204,553,579,24,1,20,0,0,0,5,2,0,0,1184,20,1265
2800,인천광역시,2805,남동구,,논현2동제2투,1850,1266,527,669,40,1,8,0,0,0,2,0,0,0,1247,19,584
2800,인천광역시,2805,남동구,,논현2동제3투,2047,1318,513,738,37,0,15,1,0,1,2,1,0,0,1308,10,729
2800,인천광역시,2805,남동구,,논현2동제4투,3682,2252,1140,983,71,0,27,1,2,2,1,2,0,1,2230,22,1430
2800,인천광역시,2805,남동구,,논현2동제5투,3694,2347,1146,1047,79,1,28,0,0,2,4,7,0,3,2317,30,1347
2800,인천광역시,2805,남동구,,논현2동제6투,1993,1400,684,652,41,0,14,0,0,1,1,1,1,1,1396,4,593
2800,인천광역시,2805,남동구,,논현2동제7투,2119,1527,727,696,63,2,15,0,0,0,0,2,1,0,1506,21,592
2800,인천광역시,2805,남동구,,논현2동제8투,1224,771,333,403,18,1,7,0,0,0,0,0,1,0,763,8,453
2800,인천광역시,2805,남동구,논현고잔동,소계,30191,23435,11769,10711,609,10,127,2,4,1,18,16,5,7,23279,156,6756
2800,인천광역시,2805,남동구,,관내사전투표,9463,9461,5227,3937,197,5,37,2,1,1,4,4,3,2,9420,41,2
2800,인천광역시,2805,남동구,,논현고잔동제1투,2271,1500,734,699,40,0,12,0,1,0,3,0,0,2,1491,9,771
2800,인천광역시,2805,남동구,,논현고잔동제2투,3603,1933,975,856,56,1,22,0,1,0,4,3,1,1,1920,13,1670
2800,인천광역시,2805,남동구,,논현고잔동제3투,3252,2165,1032,1019,74,0,14,0,0,0,0,3,1,0,2143,22,1087
2800,인천광역시,2805,남동구,,논현고잔동제4투,2631,1874,945,849,56,0,12,0,0,0,1,0,0,0,1863,11,757
2800,인천광역시,2805,남동구,,논현고잔동제5투,3665,2660,1008,1542,66,4,16,0,0,0,2,2,0,1,2641,19,1005
2800,인천광역시,2805,남동구,,논현고잔동제6투,2717,2071,1026,935,78,0,8,0,1,0,1,2,0,1,2052,19,646
2800,인천광역시,2805,남동구,,논현고잔동제7투,2051,1529,740,722,37,0,4,0,0,0,3,2,0,0,1508,21,522
2800,인천광역시,2805,남동구,,논현고잔동제8투,538,242,82,152,5,0,2,0,0,0,0,0,0,0,241,1,296
2800,인천광역시,2805,남동구,서창2동,소계,28002,21841,11659,9225,622,7,141,4,3,1,20,11,4,6,21703,138,6161
2800,인천광역시,2805,남동구,,관내사전투표,8568,8568,4933,3347,203,1,41,1,1,0,3,4,2,3,8539,29,0
2800,인천광역시,2805,남동구,,서창2동제1투,2643,1714,810,811,63,0,14,2,0,0,1,1,0,1,1703,11,929
2800,인천광역시,2805,남동구,,서창2동제2투,2056,1314,583,652,33,2,18,0,2,0,4,0,0,0,1294,20,742
2800,인천광역시,2805,남동구,,서창2동제3투,3171,2156,1223,812,77,1,17,0,0,1,1,1,1,0,2134,22,1015
2800,인천광역시,2805,남동구,,서창2동제4투,3063,2194,1145,956,69,0,15,0,0,0,2,0,0,0,2187,7,869
2800,인천광역시,2805,남동구,,서창2동제5투,1735,1306,682,555,40,0,8,0,0,0,6,2,0,1,1294,12,429
2800,인천광역시,2805,남동구,,서창2동제6투,2878,1909,954,865,54,2,17,0,0,0,2,0,0,1,1895,14,969
2800,인천광역시,2805,남동구,,서창2동제7투,1266,754,380,345,24,0,1,0,0,0,0,1,1,0,752,2,512
2800,인천광역시,2805,남동구,,서창2동제8투,2622,1926,949,882,59,1,10,1,0,0,1,2,0,0,1905,21,696
2800,인천광역시,2805,남동구,잘못 투입·구분된 투표지,,0,4,0,4,0,0,0,0,0,0,0,0,0,0,4,0,-4
2800,인천광역시,2806,부평구,합계,,424164,316024,159280,141072,8977,194,2718,91,44,77,263,298,94,131,313239,2785,108140
2800,인천광역시,2806,부평구,거소·선상투표,,714,641,264,263,10,2,23,3,0,2,0,1,2,2,572,69,73
2800,인천광역시,2806,부평구,관외사전투표,,31456,31452,16386,13295,951,27,352,8,11,4,14,48,10,15,31121,331,4
2800,인천광역시,2806,부평구,재외투표,,1813,1324,782,388,33,0,3,0,0,0,1,1,1,0,1209,115,489
2800,인천광역시,2806,부평구,부평1동,소계,29554,21264,10148,10058,658,12,182,6,4,4,8,15,2,7,21104,160,8290
2800,인천광역시,2806,부평구,,관내사전투표,8535,8535,4460,3717,234,6,54,3,0,0,2,6,1,1,8484,51,0
2800,인천광역시,2806,부평구,,부평1동제1투,2186,1250,532,643,48,1,12,0,2,1,1,0,0,0,1240,10,936
2800,인천광역시,2806,부평구,,부평1동제2투,3653,1650,863,688,63,2,20,0,2,0,0,1,0,0,1639,11,2003
2800,인천광역시,2806,부평구,,부평1동제3투,2274,1694,653,964,51,0,9,1,0,0,1,3,0,1,1683,11,580
2800,인천광역시,2806,부평구,,부평1동제4투,2515,1705,648,974,47,0,17,0,0,1,1,3,0,0,1691,14,810
2800,인천광역시,2806,부평구,,부평1동제5투,2604,1732,831,822,50,2,8,1,0,1,1,0,0,1,1717,15,872
2800,인천광역시,2806,부평구,,부평1동제6투,2387,1767,798,877,61,0,14,0,0,1,0,2,0,2,1755,12,620
2800,인천광역시,2806,부평구,,부평1동제7투,3187,1800,828,851,66,1,27,0,0,0,1,0,1,2,1777,23,1387
2800,인천광역시,2806,부평구,,부평1동제8투,2213,1131,535,522,38,0,21,1,0,0,1,0,0,0,1118,13,1082
2800,인천광역시,2806,부평구,부평2동,소계,12291,8380,4236,3699,231,7,106,2,1,4,10,18,3,3,8320,60,3911
2800,인천광역시,2806,부평구,,관내사전투표,3361,3361,1798,1441,74,1,25,2,0,0,0,7,1,0,3349,12,0
2800,인천광역시,2806,부평구,,부평2동제1투,2583,1370,645,641,39,2,18,0,0,2,5,2,0,0,1354,16,1213
2800,인천광역시,2806,부평구,,부평2동제2투,2477,1413,695,627,50,1,22,0,0,0,2,4,2,1,1404,9,1064
2800,인천광역시,2806,부평구,,부평2동제3투,1600,925,448,412,35,2,14,0,0,0,1,5,0,1,918,7,675
2800,인천광역시,2806,부평구,,부평2동제4투,2270,1311,650,578,33,1,27,0,1,2,2,0,0,1,1295,16,959
2800,인천광역시,2806,부평구,부평3동,소계,10917,7610,3719,3479,238,8,72,4,1,3,10,10,3,2,7549,61,3307
2800,인천광역시,2806,부평구,,관내사전투표,3500,3500,1861,1490,92,5,21,2,0,1,4,4,1,0,3481,19,0
2800,인천광역시,2806,부평구,,부평3동제1투,2611,1328,580,671,38,1,16,0,0,1,1,1,0,0,1309,19,1283
2800,인천광역시,2806,부평구,,부평3동제2투,3005,1752,837,786,78,1,24,1,1,1,2,4,1,2,1738,14,1253
2800,인천광역시,2806,부평구,,부평3동제3투,1801,1030,441,532,30,1,11,1,0,0,3,1,1,0,1021,9,771
2800,인천광역시,2806,부평구,부평4동,소계,31497,21139,11168,8861,634,7,209,6,3,1,18,16,5,9,20937,202,10358
2800,인천광역시,2806,부평구,,관내사전투표,8183,8183,4706,3117,259,0,45,2,0,1,1,6,2,3,8142,41,0
2800,인천광역시,2806,부평구,,부평4동제1투,2132,1100,498,530,36,0,19,1,0,0,1,1,0,1,1087,13,1032
2800,인천광역시,2806,부평구,,부평4동제2투,3291,1738,914,733,50,0,21,1,0,0,0,1,1,2,1723,15,1553
2800,인천광역시,2806,부평구,,부평4동제3투,2475,1494,698,723,45,1,6,0,0,0,0,2,0,1,1476,18,981
2800,인천광역시,2806,부평구,,부평4동제4투,2351,1421,662,675,36,0,14,1,1,0,2,3,1,0,1395,26,930
2800,인천광역시,2806,부평구,,부평4동제5투,2731,1584,777,724,35,0,23,1,0,0,4,0,0,0,1564,20,1147
2800,인천광역시,2806,부평구,,부평4동제6투,2579,1516,795,628,50,4,17,0,0,0,2,1,0,1,1498,18,1063
2800,인천광역시,2806,부평구,,부평4동제7투,3083,1689,848,728,62,0,24,0,1,0,4,1,1,0,1669,20,1394
2800,인천광역시,2806,부평구,,부평4동제8투,2365,1221,640,510,30,1,20,0,0,0,3,0,0,1,1205,16,1144
2800,인천광역시,2806,부평구,,부평4동제9투,2307,1193,630,493,31,1,20,0,1,0,1,1,0,0,1178,15,1114
2800,인천광역시,2806,부평구,부평5동,소계,25107,15623,8574,6250,400,8,203,2,0,2,20,13,7,7,15486,137,9484
2800,인천광역시,2806,부평구,,관내사전투표,4994,4994,2976,1859,102,2,26,2,0,1,0,4,1,2,4975,19,0
2800,인천광역시,2806,부평구,,부평5동제1투,1921,819,415,339,30,0,15,0,0,1,4,1,0,1,806,13,1102
2800,인천광역시,2806,부평구,,부평5동제2투,2421,1336,730,526,44,1,23,0,0,0,1,1,0,0,1326,10,1085
2800,인천광역시,2806,부평구,,부평5동제3투,3810,2195,1108,974,50,1,38,0,0,0,4,0,1,0,2176,19,1615
2800,인천광역시,2806,부평구,,부평5동제4투,3265,1676,889,684,47,2,31,0,0,0,2,2,0,3,1660,16,1589
2800,인천광역시,2806,부평구,,부평5동제5투,3313,1794,930,756,43,1,31,0,0,0,2,3,2,0,1768,26,1519
2800,인천광역시,2806,부평구,,부평5동제6투,2862,1570,840,632,44,1,29,0,0,0,5,1,1,1,1554,16,1292
2800,인천광역시,2806,부평구,,부평5동제7투,2521,1239,686,480,40,0,10,0,0,0,2,1,2,0,1221,18,1282
2800,인천광역시,2806,부평구,부평6동,소계,12589,8867,4590,3817,264,6,79,5,2,0,9,9,2,1,8784,83,3722
2800,인천광역시,2806,부평구,,관내사전투표,3857,3857,2146,1540,107,3,28,4,0,0,3,3,0,0,3834,23,0
2800,인천광역시,2806,부평구,,부평6동제1투,2165,1131,541,522,36,1,13,0,0,0,0,2,1,0,1116,15,1034
2800,인천광역시,2806,부평구,,부평6동제2투,1826,1034,508,467,31,2,6,0,1,0,0,2,0,0,1017,17,792
2800,인천광역시,2806,부평구,,부평6동제3투,2063,1107,552,491,34,0,10,0,1,0,5,1,1,0,1095,12,956
2800,인천광역시,2806,부평구,,부평6동제4투,2678,1738,843,797,56,0,22,1,0,0,1,1,0,1,1722,16,940
2800,인천광역시,2806,부평구,산곡1동,소계,9769,7113,3364,3391,221,4,48,1,0,0,8,13,0,4,7054,59,2656
2800,인천광역시,2806,부평구,,관내사전투표,2776,2776,1440,1212,86,0,12,0,0,0,1,7,0,3,2761,15,0
2800,인천광역시,2806,부평구,,산곡1동제1투,1456,793,345,400,30,2,7,0,0,0,0,0,0,0,784,9,663
2800,인천광역시,2806,부평구,,산곡1동제2투,1969,1390,620,701,41,2,11,1,0,0,1,5,0,0,1382,8,579
2800,인천광역시,2806,부평구,,산곡1동제3투,1691,1068,467,533,38,0,11,0,0,0,3,0,0,0,1052,16,623
2800,인천광역시,2806,부평구,,산곡1동제4투,1877,1086,492,545,26,0,7,0,0,0,3,1,0,1,1075,11,791
2800,인천광역시,2806,부평구,산곡2동,소계,22373,17211,8518,7900,515,6,99,3,2,6,13,12,4,3,17081,130,5162
2800,인천광역시,2806,부평구,,관내사전투표,5600,5597,3037,2370,146,0,18,0,0,0,0,3,1,2,5577,20,3
2800,인천광역시,2806,부평구,,산곡2동제1투,2477,1647,773,767,69,2,14,0,0,2,0,1,0,0,1628,19,830
2800,인천광역시,2806,부평구,,산곡2동제2투,2040,1438,714,652,49,1,8,0,0,1,1,0,0,0,1426,12,602
2800,인천광역시,2806,부평구,,산곡2동제3투,3158,2134,957,1083,60,1,13,1,1,2,1,0,1,0,2120,14,1024
2800,인천광역시,2806,부평구,,산곡2동제4투,3001,2095,959,1041,62,1,5,1,0,0,3,2,0,0,2074,21,906
2800,인천광역시,2806,부평구,,산곡2동제5투,2990,2082,971,997,63,0,19,0,1,0,6,2,2,1,2062,20,908
2800,인천광역시,2806,부평구,,산곡2동제6투,3107,2218,1107,990,66,1,22,1,0,1,2,4,0,0,2194,24,889
2800,인천광역시,2806,부평구,산곡3동,소계,17756,13426,5898,6912,380,9,78,2,2,5,12,16,2,8,13324,102,4330
2800,인천광역시,2806,부평구,,관내사전투표,5009,5009,2451,2395,108,2,18,0,0,1,4,10,0,3,4992,17,0
2800,인천광역시,2806,부평구,,산곡3동제1투,2469,1688,723,873,52,1,9,1,0,1,2,1,0,0,1663,25,781
2800,인천광역시,2806,부평구,,산곡3동제2투,3193,2029,830,1096,65,3,15,1,0,0,3,1,1,4,2019,10,1164
2800,인천광역시,2806,부평구,,산곡3동제3투,2957,1887,830,944,69,1,14,0,1,1,2,2,0,1,1865,22,1070
2800,인천광역시,2806,부평구,,산곡3동제4투,2007,1480,514,896,45,2,6,0,1,2,1,1,0,0,1468,12,527
2800,인천광역시,2806,부평구,,산곡3동제5투,2121,1333,550,708,41,0,16,0,0,0,0,1,1,0,1317,16,788
2800,인천광역시,2806,부평구,산곡4동,소계,16153,13108,6394,6189,334,5,68,2,0,6,4,14,4,3,13023,85,3045
2800,인천광역시,2806,부평구,,관내사전투표,6060,6060,3222,2652,132,4,21,1,0,0,0,4,1,1,6038,22,0
2800,인천광역시,2806,부평구,,산곡4동제1투,2702,1899,877,939,52,0,10,0,0,1,2,2,0,0,1883,16,803
2800,인천광역시,2806,부평구,,산곡4동제2투,2292,1535,661,790,51,0,13,1,0,1,1,2,1,0,1521,14,757
2800,인천광역시,2806,부평구,,산곡4동제3투,2761,1968,884,993,56,0,10,0,0,4,1,0,2,0,1950,18,793
2800,인천광역시,2806,부평구,,산곡4동제4투,2338,1646,750,815,43,1,14,0,0,0,0,6,0,2,1631,15,692
2800,인천광역시,2806,부평구,청천1동,소계,6206,4139,2117,1826,118,2,27,2,0,2,4,5,0,3,4106,33,2067
2800,인천광역시,2806,부평구,,관내사전투표,2096,2096,1138,879,55,0,7,1,0,1,0,3,0,1,2085,11,0
2800,인천광역시,2806,부평구,,청천1동제1투,1989,929,456,413,27,1,10,0,0,1,4,2,0,1,915,14,1060
2800,인천광역시,2806,부평구,,청천1동제2투,2121,1114,523,534,36,1,10,1,0,0,0,0,0,1,1106,8,1007
2800,인천광역시,2806,부평구,청천2동,소계,25162,17826,8924,8025,506,11,150,7,1,5,10,16,5,9,17669,157,7336
2800,인천광역시,2806,부평구,,관내사전투표,4909,4909,2668,2064,115,4,26,4,1,2,0,2,1,1,4888,21,0
2800,인천광역시,2806,부평구,,청천2동제1투,3390,1692,872,750,33,2,21,0,0,0,0,3,0,2,1683,9,1698
2800,인천광역시,2806,부평구,,청천2동제2투,3157,1884,891,877,75,0,18,1,0,1,1,1,0,1,1866,18,1273
2800,인천광역시,2806,부평구,,청천2동제3투,2163,1537,685,761,54,1,10,1,0,0,2,3,0,1,1518,19,626
2800,인천광역시,2806,부평구,,청천2동제4투,2201,1546,770,684,50,1,20,0,0,0,0,0,0,0,1525,21,655
2800,인천광역시,2806,부평구,,청천2동제5투,2111,1535,747,726,41,0,9,0,0,0,1,0,1,0,1525,10,576
2800,인천광역시,2806,부평구,,청천2동제6투,2289,1606,816,699,55,0,13,0,0,0,2,0,2,1,1588,18,683
2800,인천광역시,2806,부평구,,청천2동제7투,2291,1567,766,725,35,0,13,1,0,2,1,1,0,0,1544,23,724
2800,인천광역시,2806,부평구,,청천2동제8투,2651,1550,709,739,48,3,20,0,0,0,3,6,1,3,1532,18,1101
2800,인천광역시,2806,부평구,갈산1동,소계,13929,9864,5067,4288,291,11,97,4,0,1,9,9,5,7,9789,75,4065
2800,인천광역시,2806,부평구,,관내사전투표,4276,4276,2386,1730,98,8,20,2,0,0,1,5,5,2,4257,19,0
2800,인천광역시,2806,부평구,,갈산1동제1투,1761,878,398,422,31,0,17,0,0,0,0,0,0,0,868,10,883
2800,인천광역시,2806,부평구,,갈산1동제2투,2947,1651,801,753,58,0,17,1,0,0,5,2,0,0,1637,14,1296
2800,인천광역시,2806,부평구,,갈산1동제3투,2712,1614,767,747,54,2,21,1,0,1,1,1,0,4,1599,15,1098
2800,인천광역시,2806,부평구,,갈산1동제4투,2233,1445,715,636,50,1,22,0,0,0,2,1,0,1,1428,17,788
2800,인천광역시,2806,부평구,갈산2동,소계,15297,11586,5520,5559,303,7,86,2,1,5,4,7,5,3,11502,84,3711
2800,인천광역시,2806,부평구,,관내사전투표,5232,5232,2756,2302,121,1,27,1,0,0,0,1,3,2,5214,18,0
2800,인천광역시,2806,부평구,,갈산2동제1투,2930,1820,810,918,60,1,10,0,0,0,2,3,1,0,1805,15,1110
2800,인천광역시,2806,부평구,,갈산2동제2투,2171,1341,619,640,43,3,14,0,1,0,1,1,1,0,1323,18,830
2800,인천광역시,2806,부평구,,갈산2동제3투,2094,1361,583,710,31,0,12,0,0,5,0,1,0,1,1343,18,733
2800,인천광역시,2806,부평구,,갈산2동제4투,2870,1832,752,989,48,2,23,1,0,0,1,1,0,0,1817,15,1038
2800,인천광역시,2806,부평구,삼산1동,소계,26162,19312,10376,8001,514,12,175,4,3,11,16,11,4,9,19136,176,6850
2800,인천광역시,2806,부평구,,관내사전투표,7330,7329,4249,2835,152,5,45,2,0,0,1,6,1,2,7298,31,1
2800,인천광역시,2806,부평구,,삼산1동제1투,2623,1512,785,632,47,0,19,0,0,3,2,0,0,1,1489,23,1111
2800,인천광역시,2806,부평구,,삼산1동제2투,2187,1424,659,687,39,1,16,0,0,0,2,0,0,0,1404,20,763
2800,인천광역시,2806,부평구,,삼산1동제3투,2302,1345,655,608,29,2,22,1,0,3,2,1,0,2,1325,20,957
2800,인천광역시,2806,부평구,,삼산1동제4투,1852,1091,572,444,40,2,11,0,2,0,0,0,0,1,1072,19,761
2800,인천광역시,2806,부평구,,삼산1동제5투,1866,1050,460,520,27,0,21,0,0,2,5,1,1,2,1039,11,816
2800,인천광역시,2806,부평구,,삼산1동제6투,2974,2049,1060,892,56,0,17,0,0,0,3,1,0,0,2029,20,925
2800,인천광역시,2806,부평구,,삼산1동제7투,2510,1734,985,647,62,2,13,0,0,0,1,2,1,1,1714,20,776
2800,인천광역시,2806,부평구,,삼산1동제8투,2518,1778,951,736,62,0,11,1,1,3,0,0,1,0,1766,12,740
2800,인천광역시,2806,부평구,삼산2동,소계,21425,17010,8956,7356,468,4,77,5,0,4,12,10,8,4,16904,106,4415
2800,인천광역시,2806,부평구,,관내사전투표,6599,6598,3886,2515,130,1,21,2,0,0,2,6,3,1,6567,31,1
2800,인천광역시,2806,부평구,,삼산2동제1투,2645,1814,896,832,58,0,12,0,0,0,3,1,0,1,1803,11,831
2800,인천광역시,2806,부평구,,삼산2동제2투,2667,1985,1088,787,81,0,9,0,0,0,2,0,1,0,1968,17,682
2800,인천광역시,2806,부평구,,삼산2동제3투,2167,1506,662,786,33,1,8,0,0,2,0,0,0,0,1492,14,661
2800,인천광역시,2806,부평구,,삼산2동제4투,2245,1441,677,684,43,2,12,1,0,1,3,2,2,2,1429,12,804
2800,인천광역시,2806,부평구,,삼산2동제5투,2572,1959,909,965,64,0,5,2,0,0,2,0,2,0,1949,10,613
2800,인천광역시,2806,부평구,,삼산2동제6투,2530,1707,838,787,59,0,10,0,0,1,0,1,0,0,1696,11,823
2800,인천광역시,2806,부평구,부개1동,소계,13083,9161,4474,4255,221,9,94,1,1,1,15,7,5,3,9086,75,3922
2800,인천광역시,2806,부평구,,관내사전투표,3869,3869,2007,1722,74,4,32,1,0,0,4,4,2,0,3850,19,0
2800,인천광역시,2806,부평구,,부개1동제1투,2357,1302,610,607,52,0,19,0,0,0,4,1,0,1,1294,8,1055
2800,인천광역시,2806,부평구,,부개1동제2투,2756,1756,835,822,48,3,16,0,1,1,5,2,1,1,1735,21,1000
2800,인천광역시,2806,부평구,,부개1동제3투,2138,1126,496,579,27,0,9,0,0,0,1,0,1,0,1113,13,1012
2800,인천광역시,2806,부평구,,부개1동제4투,1963,1108,526,525,20,2,18,0,0,0,1,0,1,1,1094,14,855
2800,인천광역시,2806,부평구,부개2동,소계,15765,11836,5932,5324,366,5,76,4,1,3,10,12,2,3,11738,98,3929
2800,인천광역시,2806,부평구,,관내사전투표,4724,4724,2605,1910,145,4,21,2,0,0,1,10,1,1,4700,24,0
2800,인천광역시,2806,부평구,,부개2동제1투,3279,2086,981,996,55,1,21,0,0,0,0,0,0,2,2056,30,1193
2800,인천광역시,2806,부평구,,부개2동제2투,2461,1660,760,818,53,0,10,1,0,1,2,0,0,0,1645,15,801
2800,인천광역시,2806,부평구,,부개2동제3투,3043,1905,925,882,67,0,8,1,1,0,2,2,0,0,1888,17,1138
2800,인천광역시,2806,부평구,,부개2동제4투,2258,1461,661,718,46,0,16,0,0,2,5,0,1,0,1449,12,797
2800,인천광역시,2806,부평구,부개3동,소계,25389,19872,10203,8722,606,14,131,7,4,0,22,20,3,6,19738,134,5517
2800,인천광역시,2806,부평구,,관내사전투표,8071,8071,4547,3228,211,4,35,3,0,0,2,10,1,1,8042,29,0
2800,인천광역시,2806,부평구,,부개3동제1투,2271,1438,672,664,53,3,23,0,0,0,4,1,0,0,1420,18,833
2800,인천광역시,2806,부평구,,부개3동제2투,2022,1129,537,522,38,4,13,1,0,0,2,1,0,0,1118,11,893
2800,인천광역시,2806,부평구,,부개3동제3투,2384,1710,879,731,64,0,10,2,2,0,3,0,1,2,1694,16,674
2800,인천광역시,2806,부평구,,부개3동제4투,2397,1563,764,718,44,0,16,0,0,0,2,3,0,0,1547,16,834
2800,인천광역시,2806,부평구,,부개3동제5투,2872,2145,945,1116,57,2,8,0,1,0,3,2,0,0,2134,11,727
2800,인천광역시,2806,부평구,,부개3동제6투,2710,2003,1010,879,83,1,10,1,0,0,2,1,0,0,1987,16,707
2800,인천광역시,2806,부평구,,부개3동제7투,2662,1813,849,864,56,0,16,0,1,0,4,2,1,3,1796,17,849
2800,인천광역시,2806,부평구,일신동,소계,10265,7914,3924,3598,221,5,79,4,0,0,9,4,3,3,7850,64,2351
2800,인천광역시,2806,부평구,,관내사전투표,3664,3664,1989,1515,90,2,40,1,0,0,2,2,0,1,3642,22,0
2800,인천광역시,2806,부평구,,일신동제1투,2400,1447,660,710,45,1,13,0,0,0,3,1,1,1,1435,12,953
2800,인천광역시,2806,부평구,,일신동제2투,2274,1512,715,717,36,2,19,2,0,0,2,1,1,0,1495,17,762
2800,인천광역시,2806,부평구,,일신동제3투,1927,1291,560,656,50,0,7,1,0,0,2,0,1,1,1278,13,636
2800,인천광역시,2806,부평구,십정1동,소계,11951,8789,4336,4045,211,6,82,5,4,4,5,6,2,7,8713,76,3162
2800,인천광역시,2806,부평구,,관내사전투표,3768,3765,1962,1682,59,1,27,1,1,1,2,3,1,6,3746,19,3
2800,인천광역시,2806,부평구,,십정1동제1투,3041,1615,722,813,28,0,18,1,2,2,3,0,0,0,1589,26,1426
2800,인천광역시,2806,부평구,,십정1동제2투,2834,1876,900,848,74,3,23,1,1,1,0,1,0,1,1853,23,958
2800,인천광역시,2806,부평구,,십정1동제3투,2308,1533,752,702,50,2,14,2,0,0,0,2,1,0,1525,8,775
2800,인천광역시,2806,부평구,십정2동,소계,17541,11553,5410,5568,282,7,122,2,3,4,20,5,7,10,11440,113,5988
2800,인천광역시,2806,부평구,,관내사전투표,3589,3589,1843,1595,79,3,26,2,1,0,8,1,1,2,3561,28,0
2800,인천광역시,2806,부평구,,십정2동제1투,2366,1204,530,605,30,1,14,0,0,1,2,3,0,2,1188,16,1162
2800,인천광역시,2806,부평구,,십정2동제2투,2669,1479,684,714,37,1,27,0,0,1,0,0,1,2,1467,12,1190
2800,인천광역시,2806,부평구,,십정2동제3투,3274,1770,835,844,46,1,19,0,0,0,5,0,1,0,1751,19,1504
2800,인천광역시,2806,부평구,,십정2동제4투,3056,1659,722,837,36,0,30,0,1,2,3,1,4,3,1639,20,1397
2800,인천광역시,2806,부평구,,십정2동제5투,2587,1852,796,973,54,1,6,0,1,0,2,0,0,1,1834,18,735
2800,인천광역시,2806,부평구,잘못 투입·구분된 투표지,,0,4,0,3,1,0,0,0,0,0,0,0,0,0,4,0,-4
2800,인천광역시,2807,계양구,합계,,258741,193864,100532,83638,5502,124,1722,62,24,64,132,218,58,81,192157,1707,64877
2800,인천광역시,2807,계양구,거소·선상투표,,524,451,182,185,10,2,12,0,0,0,1,0,2,3,397,54,73
2800,인천광역시,2807,계양구,관외사전투표,,19742,19739,10406,8219,586,13,258,6,3,6,8,31,6,12,19554,185,3
2800,인천광역시,2807,계양구,재외투표,,1033,751,457,202,27,0,2,0,1,0,0,1,0,1,691,60,282
2800,인천광역시,2807,계양구,효성1동,소계,22354,16531,8548,7215,452,5,134,1,1,5,16,11,4,7,16399,132,5823
2800,인천광역시,2807,계양구,,관내사전투표,6448,6448,3672,2556,139,4,35,1,1,2,3,4,2,2,6421,27,0
2800,인천광역시,2807,계양구,,효성1동제1투,2577,1479,670,717,56,1,15,0,0,1,1,2,0,1,1464,15,1098
2800,인천광역시,2807,계양구,,효성1동제2투,1682,1009,473,487,23,0,15,0,0,0,0,0,0,0,998,11,673
2800,인천광역시,2807,계양구,,효성1동제3투,2565,1558,711,751,55,0,17,0,0,0,2,1,0,2,1539,19,1007
2800,인천광역시,2807,계양구,,효성1동제4투,2294,1331,652,601,42,0,14,0,0,0,5,0,1,0,1315,16,963
2800,인천광역시,2807,계양구,,효성1동제5투,2321,1538,739,716,49,0,14,0,0,0,2,1,0,1,1522,16,783
2800,인천광역시,2807,계양구,,효성1동제6투,2121,1509,734,697,42,0,16,0,0,1,1,2,0,0,1493,16,612
2800,인천광역시,2807,계양구,,효성1동제7투,2346,1659,897,690,46,0,8,0,0,1,2,1,1,1,1647,12,687
2800,인천광역시,2807,계양구,효성2동,소계,22806,16168,8220,7202,411,9,137,2,3,2,18,19,4,7,16034,134,6638
2800,인천광역시,2807,계양구,,관내사전투표,5310,5310,2937,2188,109,3,31,1,1,1,2,6,0,1,5280,30,0
2800,인천광역시,2807,계양구,,효성2동제1투,2530,1315,621,609,46,0,19,0,0,0,0,3,0,1,1299,16,1215
2800,인천광역시,2807,계양구,,효성2동제2투,3053,1634,839,714,39,2,21,0,0,0,3,3,1,1,1623,11,1419
2800,인천광역시,2807,계양구,,효성2동제3투,3096,2069,1016,959,52,1,16,0,0,0,5,4,0,1,2054,15,1027
2800,인천광역시,2807,계양구,,효성2동제4투,3055,2145,989,1063,51,2,15,0,0,1,4,1,1,1,2128,17,910
2800,인천광역시,2807,계양구,,효성2동제5투,2513,1470,719,675,33,0,21,0,0,0,2,0,1,1,1452,18,1043
2800,인천광역시,2807,계양구,,효성2동제6투,3249,2225,1099,994,81,1,14,1,2,0,2,2,1,1,2198,27,1024
2800,인천광역시,2807,계양구,계산1동,소계,15169,9974,4934,4506,289,11,104,5,1,4,8,13,6,5,9886,88,5195
2800,인천광역시,2807,계양구,,관내사전투표,3547,3547,1926,1481,83,4,26,2,0,0,0,6,4,0,3532,15,0
2800,인천광역시,2807,계양구,,계산1동제1투,2496,1321,578,652,49,2,18,0,0,2,0,2,1,2,1306,15,1175
2800,인천광역시,2807,계양구,,계산1동제2투,2796,1578,772,726,49,1,11,0,1,0,3,1,0,0,1564,14,1218
2800,인천광역시,2807,계양구,,계산1동제3투,1985,1044,471,515,26,2,17,2,0,0,1,1,0,0,1035,9,941
2800,인천광역시,2807,계양구,,계산1동제4투,2589,1512,756,666,43,1,12,1,0,1,1,3,1,2,1487,25,1077
2800,인천광역시,2807,계양구,,계산1동제5투,1756,972,431,466,39,1,20,0,0,1,3,0,0,1,962,10,784
2800,인천광역시,2807,계양구,계산2동,소계,15301,11386,5898,4917,316,9,109,6,0,3,7,13,6,9,11293,93,3915
2800,인천광역시,2807,계양구,,관내사전투표,5860,5858,3330,2275,158,4,37,5,0,1,2,8,4,3,5827,31,2
2800,인천광역시,2807,계양구,,계산2동제1투,2233,1201,551,576,33,0,18,0,0,0,3,2,0,2,1185,16,1032
2800,인천광역시,2807,계양구,,계산2동제2투,2313,1275,585,625,28,1,20,0,0,0,0,1,0,0,1260,15,1038
2800,인천광역시,2807,계양구,,계산2동제3투,2649,1818,863,855,58,2,16,1,0,1,1,1,1,3,1802,16,831
2800,인천광역시,2807,계양구,,계산2동제4투,2246,1234,569,586,39,2,18,0,0,1,1,1,1,1,1219,15,1012
2800,인천광역시,2807,계양구,계산3동,소계,16894,12815,6642,5527,367,15,91,5,1,10,8,26,1,3,12696,119,4079
2800,인천광역시,2807,계양구,,관내사전투표,5875,5873,3264,2394,135,4,28,1,0,3,1,11,1,1,5843,30,2
2800,인천광역시,2807,계양구,,계산3동제1투,2573,1649,800,765,48,1,8,2,0,2,1,3,0,0,1630,19,924
2800,인천광역시,2807,계양구,,계산3동제2투,2159,1390,688,622,49,2,11,0,0,0,2,2,0,0,1376,14,769
2800,인천광역시,2807,계양구,,계산3동제3투,1945,1201,586,552,40,2,6,2,0,4,0,3,0,0,1195,6,744
2800,인천광역시,2807,계양구,,계산3동제4투,2202,1427,678,657,50,1,17,0,0,1,2,0,0,0,1406,21,775
2800,인천광역시,2807,계양구,,계산3동제5투,2140,1275,626,537,45,5,21,0,1,0,2,7,0,2,1246,29,865
2800,인천광역시,2807,계양구,계산4동,소계,19970,15680,8125,6895,452,6,84,5,1,3,5,7,3,2,15588,92,4290
2800,인천광역시,2807,계양구,,관내사전투표,6899,6899,3915,2763,158,1,25,2,1,1,0,2,3,1,6872,27,0
2800,인천광역시,2807,계양구,,계산4동제1투,2939,1607,786,738,46,1,14,1,0,0,2,1,0,0,1589,18,1332
2800,인천광역시,2807,계양구,,계산4동제2투,1936,1329,640,599,63,1,12,1,0,2,0,1,0,0,1319,10,607
2800,인천광역시,2807,계양구,,계산4동제3투,3304,2215,958,1164,65,0,12,0,0,0,1,1,0,0,2201,14,1089
2800,인천광역시,2807,계양구,,계산4동제4투,2870,2005,1012,894,71,0,9,1,0,0,2,2,0,1,1992,13,865
2800,인천광역시,2807,계양구,,계산4동제5투,2022,1625,814,737,49,3,12,0,0,0,0,0,0,0,1615,10,397
2800,인천광역시,2807,계양구,작전1동,소계,21378,15667,8114,6745,481,12,129,7,0,5,8,12,4,7,15524,143,5711
2800,인천광역시,2807,계양구,,관내사전투표,5625,5625,3258,2164,141,5,18,1,0,0,0,5,1,1,5594,31,0
2800,인천광역시,2807,계양구,,작전1동제1투,3165,2004,940,917,80,1,29,4,0,0,1,2,0,0,1974,30,1161
2800,인천광역시,2807,계양구,,작전1동제2투,2777,1687,874,724,48,0,12,1,0,3,2,2,0,4,1670,17,1090
2800,인천광역시,2807,계양구,,작전1동제3투,2752,1862,850,909,54,2,21,1,0,1,1,0,1,0,1840,22,890
2800,인천광역시,2807,계양구,,작전1동제4투,1739,983,445,479,34,0,15,0,0,0,0,0,0,0,973,10,756
2800,인천광역시,2807,계양구,,작전1동제5투,2895,1871,919,837,70,3,21,0,0,0,2,0,2,0,1854,17,1024
2800,인천광역시,2807,계양구,,작전1동제6투,2425,1635,828,715,54,1,13,0,0,1,2,3,0,2,1619,16,790
2800,인천광역시,2807,계양구,작전2동,소계,16678,11962,6202,5186,326,7,119,2,3,4,12,11,4,2,11878,84,4716
2800,인천광역시,2807,계양구,,관내사전투표,5367,5369,3009,2164,120,1,36,1,1,1,1,5,0,1,5340,29,-2
2800,인천광역시,2807,계양구,,작전2동제1투,2165,1143,556,531,26,1,14,0,0,1,2,1,1,0,1133,10,1022
2800,인천광역시,2807,계양구,,작전2동제2투,2267,1420,704,637,42,1,16,0,0,0,1,2,3,0,1406,14,847
2800,인천광역시,2807,계양구,,작전2동제3투,1929,1079,520,489,35,3,16,0,1,1,3,0,0,1,1069,10,850
2800,인천광역시,2807,계양구,,작전2동제4투,3036,1905,928,882,61,0,21,0,1,1,2,1,0,0,1897,8,1131
2800,인천광역시,2807,계양구,,작전2동제5투,1914,1046,485,483,42,1,16,1,0,0,3,2,0,0,1033,13,868
2800,인천광역시,2807,계양구,작전서운동,소계,25365,18535,9701,7990,505,5,131,9,2,8,6,17,4,8,18386,149,6830
2800,인천광역시,2807,계양구,,관내사전투표,5364,5364,3011,2174,116,3,23,3,0,2,0,3,1,1,5337,27,0
2800,인천광역시,2807,계양구,,작전서운동제1투,2434,1221,622,512,33,0,25,1,0,1,0,6,0,1,1201,20,1213
2800,인천광역시,2807,계양구,,작전서운동제2투,2845,2023,1073,877,45,1,10,1,0,1,2,3,0,0,2013,10,822
2800,인천광역시,2807,계양구,,작전서운동제3투,2207,1484,668,737,49,0,11,2,0,0,0,0,0,0,1467,17,723
2800,인천광역시,2807,계양구,,작전서운동제4투,3240,2355,1134,1087,75,0,14,1,2,1,2,3,0,4,2323,32,885
2800,인천광역시,2807,계양구,,작전서운동제5투,2756,1909,1012,804,59,1,16,0,0,0,0,1,1,0,1894,15,847
2800,인천광역시,2807,계양구,,작전서운동제6투,2590,1737,903,747,56,0,13,0,0,1,1,1,1,2,1725,12,853
2800,인천광역시,2807,계양구,,작전서운동제7투,2631,1562,798,687,47,0,15,1,0,2,0,0,1,0,1551,11,1069
2800,인천광역시,2807,계양구,,작전서운동제8투,1298,880,480,365,25,0,4,0,0,0,1,0,0,0,875,5,418
2800,인천광역시,2807,계양구,계양1동,소계,14566,10436,5096,4791,312,4,90,5,2,3,9,18,1,7,10338,98,4130
2800,인천광역시,2807,계양구,,관내사전투표,3202,3202,1707,1351,85,0,16,1,1,1,1,5,1,3,3172,30,0
2800,인천광역시,2807,계양구,,계양1동제1투,2784,1611,656,861,44,1,25,1,0,0,2,4,0,0,1594,17,1173
2800,인천광역시,2807,계양구,,계양1동제2투,3500,2088,1046,925,63,1,19,0,1,1,4,8,0,1,2069,19,1412
2800,인천광역시,2807,계양구,,계양1동제3투,2972,2088,1011,965,74,1,15,1,0,0,1,1,0,2,2071,17,884
2800,인천광역시,2807,계양구,,계양1동제4투,2108,1447,676,689,46,1,15,2,0,1,1,0,0,1,1432,15,661
2800,인천광역시,2807,계양구,계양2동,소계,27801,19522,10039,8453,559,17,190,6,3,7,18,28,7,8,19335,187,8279
2800,인천광역시,2807,계양구,,관내사전투표,7174,7174,3936,2986,156,6,38,1,0,1,1,11,1,1,7138,36,0
2800,인천광역시,2807,계양구,,계양2동제1투,3231,1776,886,787,55,0,24,2,0,0,2,2,0,1,1759,17,1455
2800,인천광역시,2807,계양구,,계양2동제2투,2502,1479,704,696,35,2,23,0,0,0,2,3,1,1,1467,12,1023
2800,인천광역시,2807,계양구,,계양2동제3투,1889,1185,568,537,44,2,13,0,1,0,1,1,3,1,1171,14,704
2800,인천광역시,2807,계양구,,계양2동제4투,1868,1058,479,508,25,1,13,0,2,1,4,2,0,1,1036,22,810
2800,인천광역시,2807,계양구,,계양2동제5투,2114,1216,540,592,46,3,17,0,0,3,1,0,0,0,1202,14,898
2800,인천광역시,2807,계양구,,계양2동제6투,3054,1641,826,683,59,2,31,2,0,0,5,0,1,2,1611,30,1413
2800,인천광역시,2807,계양구,,계양2동제7투,3206,2198,1201,861,83,0,23,1,0,1,2,2,0,0,2174,24,1008
2800,인천광역시,2807,계양구,,계양2동제8투,2763,1795,899,803,56,1,8,0,0,1,0,7,1,1,1777,18,968
2800,인천광역시,2807,계양구,계양3동,소계,19160,14245,7967,5605,409,9,132,3,3,4,8,11,6,0,14157,88,4915
2800,인천광역시,2807,계양구,,관내사전투표,5951,5950,3628,2112,137,2,43,3,0,2,0,3,2,0,5932,18,1
2800,인천광역시,2807,계양구,,계양3동제1투,2112,1296,667,548,48,1,19,0,0,0,1,1,1,0,1286,10,816
2800,인천광역시,2807,계양구,,계양3동제2투,309,211,75,129,2,0,5,0,0,0,0,0,0,0,211,0,98
2800,인천광역시,2807,계양구,,계양3동제3투,2788,1808,956,745,64,4,23,0,1,0,0,2,0,0,1795,13,980
2800,인천광역시,2807,계양구,,계양3동제4투,2768,1687,928,668,47,0,22,0,2,0,5,1,0,0,1673,14,1081
2800,인천광역시,2807,계양구,,계양3동제5투,3038,1620,897,630,57,1,13,0,0,1,1,2,1,0,1603,17,1418
2800,인천광역시,2807,계양구,,계양3동제6투,2194,1673,816,773,54,1,7,0,0,1,1,2,2,0,1657,16,521
2800,인천광역시,2807,계양구,잘못 투입·구분된 투표지,,0,2,1,0,0,0,0,0,0,0,0,0,0,0,1,1,-2
2800,인천광역시,2808,서구,합계,,462821,346084,174908,154553,9594,197,3123,79,63,81,224,263,85,130,343300,2784,116737
2800,인천광역시,2808,서구,거소·선상투표,,930,839,311,386,14,3,25,1,1,0,0,1,0,2,744,95,91
2800,인천광역시,2808,서구,관외사전투표,,34328,34319,17496,14963,963,23,442,6,6,4,13,38,6,23,33983,336,9
2800,인천광역시,2808,서구,재외투표,,1777,1297,743,396,37,0,7,0,0,0,0,0,0,0,1183,114,480
2800,인천광역시,2808,서구,검암경서동,소계,33717,24154,12903,10074,736,15,196,6,6,3,15,11,6,5,23976,178,9563
2800,인천광역시,2808,서구,,관내사전투표,7521,7522,4364,2880,200,4,36,2,2,1,3,4,1,0,7497,25,-1
2800,인천광역시,2808,서구,,검암경서동제1투,2707,1751,788,866,69,3,11,1,0,0,0,1,1,0,1740,11,956
2800,인천광역시,2808,서구,,검암경서동제2투,224,85,20,62,2,0,1,0,0,0,0,0,0,0,85,0,139
2800,인천광역시,2808,서구,,검암경서동제3투,3572,1912,980,831,45,0,34,0,0,1,0,2,0,0,1893,19,1660
2800,인천광역시,2808,서구,,검암경서동제4투,2294,1555,763,710,53,1,2,1,1,0,4,0,1,0,1536,19,739
2800,인천광역시,2808,서구,,검암경서동제5투,2800,1864,955,806,64,3,19,0,0,0,4,0,1,0,1852,12,936
2800,인천광역시,2808,서구,,검암경서동제6투,2111,1569,783,703,57,1,12,0,1,0,0,2,0,1,1560,9,542
2800,인천광역시,2808,서구,,검암경서동제7투,2272,1401,763,555,46,2,16,0,0,0,0,0,0,1,1383,18,871
2800,인천광역시,2808,서구,,검암경서동제8투,2521,1804,963,765,49,0,12,0,0,0,3,0,1,1,1794,10,717
2800,인천광역시,2808,서구,,검암경서동제9투,2412,1402,743,577,47,1,18,0,1,1,0,1,0,2,1391,11,1010
2800,인천광역시,2808,서구,,검암경서동제10투,3252,1888,1045,732,54,0,24,1,1,0,1,1,0,0,1859,29,1364
2800,인천광역시,2808,서구,,검암경서동제11투,2031,1401,736,587,50,0,11,1,0,0,0,0,1,0,1386,15,630
2800,인천광역시,2808,서구,연희동,소계,33952,23218,11682,10284,696,12,257,10,9,7,11,14,8,9,22999,219,10734
2800,인천광역시,2808,서구,,관내사전투표,9229,9229,4956,3874,247,5,69,6,3,3,4,4,0,4,9175,54,0
2800,인천광역시,2808,서구,,연희동제1투,2877,1565,827,650,44,0,28,0,3,1,0,0,2,1,1556,9,1312
2800,인천광역시,2808,서구,,연희동제2투,3070,1889,854,917,63,2,20,0,1,1,0,0,1,3,1862,27,1181
2800,인천광역시,2808,서구,,연희동제3투,2799,1467,660,716,51,0,21,1,0,0,0,1,0,0,1450,17,1332
2800,인천광역시,2808,서구,,연희동제4투,2662,1505,718,701,44,0,17,1,0,1,1,2,1,1,1487,18,1157
2800,인천광역시,2808,서구,,연희동제5투,2672,1612,771,742,61,1,20,0,0,0,0,3,1,0,1599,13,1060
2800,인천광역시,2808,서구,,연희동제6투,2594,1535,783,665,48,2,18,0,0,0,0,2,2,0,1520,15,1059
2800,인천광역시,2808,서구,,연희동제7투,2672,1439,680,672,35,0,26,2,0,1,2,0,1,0,1419,20,1233
2800,인천광역시,2808,서구,,연희동제8투,2250,1393,666,635,53,1,15,0,1,0,1,0,0,0,1372,21,857
2800,인천광역시,2808,서구,,연희동제9투,3127,1584,767,712,50,1,23,0,1,0,3,2,0,0,1559,25,1543
2800,인천광역시,2808,서구,청라1동,소계,22141,16908,8574,7676,444,4,82,3,1,6,5,7,3,4,16809,99,5233
2800,인천광역시,2808,서구,,관내사전투표,5865,5865,3247,2448,129,1,16,0,0,0,0,0,1,1,5843,22,0
2800,인천광역시,2808,서구,,청라1동제1투,2896,2054,1076,883,59,0,15,0,0,0,0,1,1,2,2037,17,842
2800,인천광역시,2808,서구,,청라1동제2투,2765,1996,1003,913,55,2,9,2,1,0,0,1,0,0,1986,10,769
2800,인천광역시,2808,서구,,청라1동제3투,3515,2153,940,1118,49,0,17,0,0,4,0,3,1,0,2132,21,1362
2800,인천광역시,2808,서구,,청라1동제4투,3792,2445,1139,1186,86,1,16,1,0,0,3,1,0,1,2434,11,1347
2800,인천광역시,2808,서구,,청라1동제5투,3308,2395,1169,1128,66,0,9,0,0,2,2,1,0,0,2377,18,913
2800,인천광역시,2808,서구,가정1동,소계,22533,16259,8438,7011,521,8,116,5,3,0,11,17,5,9,16144,115,6274
2800,인천광역시,2808,서구,,관내사전투표,5927,5923,3459,2231,170,1,29,2,1,0,2,5,1,0,5901,22,4
2800,인천광역시,2808,서구,,가정1동제1투,2482,1259,537,657,28,1,15,0,0,0,1,2,2,0,1243,16,1223
2800,인천광역시,2808,서구,,가정1동제2투,2404,1311,546,679,38,0,17,2,0,0,3,2,2,3,1292,19,1093
2800,인천광역시,2808,서구,,가정1동제3투,3587,2299,1177,992,84,2,20,1,0,0,3,4,0,2,2285,14,1288
2800,인천광역시,2808,서구,,가정1동제4투,3453,2351,1185,1031,88,2,16,0,0,0,1,3,0,2,2328,23,1102
2800,인천광역시,2808,서구,,가정1동제5투,4680,3116,1534,1421,113,2,19,0,2,0,1,1,0,2,3095,21,1564
2800,인천광역시,2808,서구,가정2동,소계,5530,3946,1952,1781,113,6,35,2,1,1,6,4,3,1,3905,41,1584
2800,인천광역시,2808,서구,,관내사전투표,1967,1967,1086,793,54,3,10,1,0,0,2,0,3,1,1953,14,0
2800,인천광역시,2808,서구,,가정2동제1투,1921,1033,425,538,27,3,22,1,0,1,2,3,0,0,1022,11,888
2800,인천광역시,2808,서구,,가정2동제2투,1642,946,441,450,32,0,3,0,1,0,2,1,0,0,930,16,696
2800,인천광역시,2808,서구,가정3동,소계,8138,5913,2904,2677,174,7,74,2,1,4,11,8,1,1,5864,49,2225
2800,인천광역시,2808,서구,,관내사전투표,2509,2509,1343,1066,60,0,20,0,0,1,2,4,0,0,2496,13,0
2800,인천광역시,2808,서구,,가정3동제1투,2484,1479,686,695,49,3,21,1,0,1,3,3,0,0,1462,17,1005
2800,인천광역시,2808,서구,,가정3동제2투,1549,753,358,335,23,2,20,1,0,0,4,1,1,1,746,7,796
2800,인천광역시,2808,서구,,가정3동제3투,1596,1172,517,581,42,2,13,0,1,2,2,0,0,0,1160,12,424
2800,인천광역시,2808,서구,신현원창동,소계,24272,17706,8527,8358,472,12,144,3,3,5,14,11,7,7,17563,143,6566
2800,인천광역시,2808,서구,,관내사전투표,5457,5450,2783,2481,114,4,30,1,2,1,2,2,1,1,5422,28,7
2800,인천광역시,2808,서구,,신현원창동제1투,2097,1086,474,540,37,0,22,0,1,0,1,1,0,0,1076,10,1011
2800,인천광역시,2808,서구,,신현원창동제2투,2369,1378,682,636,22,1,19,0,0,0,2,2,2,0,1366,12,991
2800,인천광역시,2808,서구,,신현원창동제3투,2229,1280,615,584,40,2,18,0,0,1,1,0,0,2,1263,17,949
2800,인천광역시,2808,서구,,신현원창동제4투,3148,1968,943,911,70,2,15,1,0,1,5,3,2,1,1954,14,1180
2800,인천광역시,2808,서구,,신현원창동제5투,15,11,2,9,0,0,0,0,0,0,0,0,0,0,11,0,4
2800,인천광역시,2808,서구,,신현원창동제6투,3269,2381,1061,1190,81,1,13,1,0,0,0,3,1,3,2354,27,888
2800,인천광역시,2808,서구,,신현원창동제7투,2656,1912,814,1012,51,2,13,0,0,0,3,0,1,0,1896,16,744
2800,인천광역시,2808,서구,,신현원창동제8투,3032,2240,1153,995,57,0,14,0,0,2,0,0,0,0,2221,19,792
2800,인천광역시,2808,서구,석남1동,소계,18609,12424,6025,5739,323,12,169,8,3,5,17,5,7,4,12317,107,6185
2800,인천광역시,2808,서구,,관내사전투표,4318,4318,2236,1934,76,4,40,1,0,0,3,0,2,1,4297,21,0
2800,인천광역시,2808,서구,,석남1동제1투,2964,1722,838,775,50,0,27,0,0,2,4,1,2,2,1701,21,1242
2800,인천광역시,2808,서구,,석남1동제2투,2718,1729,758,879,49,2,24,0,0,1,0,2,0,0,1715,14,989
2800,인천광역시,2808,서구,,석남1동제3투,3098,1712,781,816,49,2,31,2,0,0,5,0,2,1,1689,23,1386
2800,인천광역시,2808,서구,,석남1동제4투,2019,1104,521,501,35,2,21,1,2,1,4,2,1,0,1091,13,915
2800,인천광역시,2808,서구,,석남1동제5투,3492,1839,891,834,64,2,26,4,1,1,1,0,0,0,1824,15,1653
2800,인천광역시,2808,서구,석남2동,소계,11540,8364,4018,3958,204,5,83,4,2,3,2,8,4,4,8295,69,3176
2800,인천광역시,2808,서구,,관내사전투표,3474,3473,1795,1552,69,2,27,3,0,1,0,3,1,2,3455,18,1
2800,인천광역시,2808,서구,,석남2동제1투,2718,1415,577,743,38,1,28,0,2,0,0,4,1,0,1394,21,1303
2800,인천광역시,2808,서구,,석남2동제2투,2682,1819,867,871,49,0,12,1,0,1,0,0,0,0,1801,18,863
2800,인천광역시,2808,서구,,석남2동제3투,2666,1657,779,792,48,2,16,0,0,1,2,1,2,2,1645,12,1009
2800,인천광역시,2808,서구,석남3동,소계,10960,7139,3509,3242,198,4,97,2,0,4,7,7,2,3,7075,64,3821
2800,인천광역시,2808,서구,,관내사전투표,2877,2877,1546,1207,76,1,25,0,0,2,1,3,0,0,2861,16,0
2800,인천광역시,2808,서구,,석남3동제1투,2386,1274,598,586,43,0,19,2,0,1,0,2,1,1,1253,21,1112
2800,인천광역시,2808,서구,,석남3동제2투,2905,1581,760,733,40,2,27,0,0,0,4,1,0,1,1568,13,1324
2800,인천광역시,2808,서구,,석남3동제3투,2792,1407,605,716,39,1,26,0,0,1,2,1,1,1,1393,14,1385
2800,인천광역시,2808,서구,가좌1동,소계,10648,7057,3476,3187,183,7,110,1,6,2,7,5,4,3,6991,66,3591
2800,인천광역시,2808,서구,,관내사전투표,3058,3058,1605,1320,68,2,31,0,3,2,1,3,2,2,3039,19,0
2800,인천광역시,2808,서구,,가좌1동제1투,2371,1190,545,566,27,2,24,0,1,0,3,2,1,0,1171,19,1181
2800,인천광역시,2808,서구,,가좌1동제2투,2406,1292,569,647,32,0,25,1,0,0,2,0,1,1,1278,14,1114
2800,인천광역시,2808,서구,,가좌1동제3투,2813,1517,757,654,56,3,30,0,2,0,1,0,0,0,1503,14,1296
2800,인천광역시,2808,서구,가좌2동,소계,16183,12545,6006,5959,347,8,96,1,1,1,8,14,1,3,12445,100,3638
2800,인천광역시,2808,서구,,관내사전투표,5296,5296,2790,2346,96,2,26,1,0,1,0,4,0,3,5269,27,0
2800,인천광역시,2808,서구,,가좌2동제1투,2390,1448,619,735,60,0,13,0,1,0,0,0,0,0,1428,20,942
2800,인천광역시,2808,서구,,가좌2동제2투,2316,1398,633,682,52,3,13,0,0,0,1,2,0,0,1386,12,918
2800,인천광역시,2808,서구,,가좌2동제3투,2577,1776,759,923,49,3,20,0,0,0,2,2,1,0,1759,17,801
2800,인천광역시,2808,서구,,가좌2동제4투,3604,2627,1205,1273,90,0,24,0,0,0,5,6,0,0,2603,24,977
2800,인천광역시,2808,서구,가좌3동,소계,14107,10120,4817,4782,268,8,114,4,0,6,11,11,3,5,10029,91,3987
2800,인천광역시,2808,서구,,관내사전투표,4641,4641,2314,2137,116,2,27,4,0,4,1,5,1,1,4612,29,0
2800,인천광역시,2808,서구,,가좌3동제1투,1857,1088,488,541,26,2,21,0,0,0,2,0,0,0,1080,8,769
2800,인천광역시,2808,서구,,가좌3동제2투,2372,1284,570,624,46,0,20,0,0,1,3,2,0,1,1267,17,1088
2800,인천광역시,2808,서구,,가좌3동제3투,2665,1519,741,689,47,0,21,0,0,1,1,1,1,1,1503,16,1146
2800,인천광역시,2808,서구,,가좌3동제4투,2572,1588,704,791,33,4,25,0,0,0,4,3,1,2,1567,21,984
2800,인천광역시,2808,서구,가좌4동,소계,8046,5786,2700,2781,172,1,56,2,1,4,3,10,3,4,5737,49,2260
2800,인천광역시,2808,서구,,관내사전투표,2422,2422,1261,1060,62,0,16,2,1,2,0,4,1,2,2411,11,0
2800,인천광역시,2808,서구,,가좌4동제1투,2399,1472,671,702,60,1,16,0,0,0,2,1,0,1,1454,18,927
2800,인천광역시,2808,서구,,가좌4동제2투,975,529,207,290,11,0,10,0,0,0,0,3,1,0,522,7,446
2800,인천광역시,2808,서구,,가좌4동제3투,2250,1363,561,729,39,0,14,0,0,2,1,2,1,1,1350,13,887
2800,인천광역시,2808,서구,청라2동,소계,33755,26205,12738,12469,686,6,125,3,5,6,13,4,3,12,26070,135,7550
2800,인천광역시,2808,서구,,관내사전투표,10530,10530,5516,4680,247,0,35,0,1,0,4,3,1,3,10490,40,0
2800,인천광역시,2808,서구,,청라2동제1투,3332,2474,1171,1219,57,2,11,0,2,0,1,0,1,0,2464,10,858
2800,인천광역시,2808,서구,,청라2동제2투,1969,1421,621,743,35,1,11,1,1,1,0,0,0,0,1414,7,548
2800,인천광역시,2808,서구,,청라2동제3투,2543,1652,692,892,37,1,13,0,0,0,1,0,0,4,1640,12,891
2800,인천광역시,2808,서구,,청라2동제4투,2215,1365,561,743,42,0,6,0,0,0,0,0,0,1,1353,12,850
2800,인천광역시,2808,서구,,청라2동제5투,3343,2496,1317,1078,63,1,11,2,0,2,6,0,0,1,2481,15,847
2800,인천광역시,2808,서구,,청라2동제6투,2663,1729,900,743,50,1,13,0,0,2,1,0,1,2,1713,16,934
2800,인천광역시,2808,서구,,청라2동제7투,1485,938,327,585,20,0,3,0,1,0,0,0,0,0,936,2,547
2800,인천광역시,2808,서구,,청라2동제8투,2232,1612,817,724,61,0,6,0,0,0,0,0,0,1,1609,3,620
2800,인천광역시,2808,서구,,청라2동제9투,3443,1988,816,1062,74,0,16,0,0,1,0,1,0,0,1970,18,1455
2800,인천광역시,2808,서구,청라3동,소계,21861,17139,8478,8016,421,7,102,1,3,3,5,9,3,2,17050,89,4722
2800,인천광역시,2808,서구,,관내사전투표,7027,7026,3811,3017,139,2,23,0,0,0,0,6,1,1,7000,26,1
2800,인천광역시,2808,서구,,청라3동제1투,2576,1788,855,857,48,1,11,1,1,1,1,1,1,0,1778,10,788
2800,인천광역시,2808,서구,,청라3동제2투,3146,2305,1133,1088,55,0,12,0,0,2,0,0,0,0,2290,15,841
2800,인천광역시,2808,서구,,청라3동제3투,2734,1739,810,850,50,2,12,0,1,0,2,2,0,0,1729,10,995
2800,인천광역시,2808,서구,,청라3동제4투,2090,1551,619,854,49,0,13,0,0,0,1,0,0,0,1536,15,539
2800,인천광역시,2808,서구,,청라3동제5투,2227,1304,607,623,43,1,19,0,1,0,0,0,1,0,1295,9,923
2800,인천광역시,2808,서구,,청라3동제6투,2061,1426,643,727,37,1,12,0,0,0,1,0,0,1,1422,4,635
2800,인천광역시,2808,서구,검단동,소계,26006,17903,9193,7858,475,7,216,2,1,6,10,13,6,7,17794,109,8103
2800,인천광역시,2808,서구,,관내사전투표,7102,7102,3911,2934,163,1,48,0,1,2,0,3,4,3,7070,32,0
2800,인천광역시,2808,서구,,검단동제1투,4068,2473,1262,1082,76,1,29,0,0,0,1,1,1,1,2454,19,1595
2800,인천광역시,2808,서구,,검단동제2투,2049,1073,520,470,42,2,26,0,0,0,2,2,0,1,1065,8,976
2800,인천광역시,2808,서구,,검단동제3투,2836,1795,847,857,52,0,18,0,0,1,1,2,1,2,1781,14,1041
2800,인천광역시,2808,서구,,검단동제4투,3689,1923,938,883,48,1,35,1,0,1,0,2,0,0,1909,14,1766
2800,인천광역시,2808,서구,,검단동제5투,3865,2362,1174,1081,58,1,34,1,0,1,1,2,0,0,2353,9,1503
2800,인천광역시,2808,서구,,검단동제6투,2397,1175,541,551,36,1,26,0,0,1,5,1,0,0,1162,13,1222
2800,인천광역시,2808,서구,불로대곡동,소계,17263,12554,6535,5458,319,9,121,4,2,2,7,10,3,4,12474,80,4709
2800,인천광역시,2808,서구,,관내사전투표,5756,5755,3247,2340,110,5,26,1,1,0,4,2,1,1,5738,17,1
2800,인천광역시,2808,서구,,불로대곡동제1투,3313,1892,849,923,58,1,30,1,1,0,0,2,1,2,1868,24,1421
2800,인천광역시,2808,서구,,불로대곡동제2투,2409,1523,769,671,47,0,21,0,0,0,1,1,1,0,1511,12,886
2800,인천광역시,2808,서구,,불로대곡동제3투,3073,1905,952,857,54,2,21,2,0,0,1,1,0,1,1891,14,1168
2800,인천광역시,2808,서구,,불로대곡동제4투,2712,1479,718,667,50,1,23,0,0,2,1,4,0,0,1466,13,1233
2800,인천광역시,2808,서구,원당동,소계,17470,12824,7125,5149,359,3,79,1,2,0,7,11,1,4,12741,83,4646
2800,인천광역시,2808,서구,,관내사전투표,5322,5313,3170,1963,131,1,22,1,1,0,0,4,1,4,5298,15,9
2800,인천광역시,2808,서구,,원당동제1투,1818,1072,497,506,39,0,15,0,1,0,0,1,0,0,1059,13,746
2800,인천광역시,2808,서구,,원당동제2투,3208,2095,1134,863,63,2,11,0,0,0,4,3,0,0,2080,15,1113
2800,인천광역시,2808,서구,,원당동제3투,2405,1612,897,643,50,0,10,0,0,0,0,0,0,0,1600,12,793
2800,인천광역시,2808,서구,,원당동제4투,3093,1676,872,728,41,0,12,0,0,0,1,1,0,0,1655,21,1417
2800,인천광역시,2808,서구,,원당동제5투,1624,1056,555,446,35,0,9,0,0,0,2,2,0,0,1049,7,568
2800,인천광역시,2808,서구,당하동,소계,21291,15987,8507,6750,450,9,130,3,4,4,11,15,1,5,15889,98,5304
2800,인천광역시,2808,서구,,관내사전투표,7030,7030,4008,2765,178,2,36,1,3,0,0,4,0,3,7000,30,0
2800,인천광역시,2808,서구,,당하동제1투,2288,1457,755,621,51,1,15,0,0,0,2,4,0,0,1449,8,831
2800,인천광역시,2808,서구,,당하동제2투,3166,2034,1021,908,64,1,17,0,1,1,2,3,0,0,2018,16,1132
2800,인천광역시,2808,서구,,당하동제3투,2701,1680,827,763,56,2,13,1,0,2,0,3,1,0,1668,12,1021
2800,인천광역시,2808,서구,,당하동제4투,3434,2054,1032,899,62,2,36,1,0,1,2,0,0,1,2036,18,1380
2800,인천광역시,2808,서구,,당하동제5투,2672,1732,864,794,39,1,13,0,0,0,5,1,0,1,1718,14,940
2800,인천광역시,2808,서구,오류왕길동,소계,18764,13291,6771,5909,342,12,117,2,0,4,18,11,1,4,13191,100,5473
2800,인천광역시,2808,서구,,관내사전투표,5467,5466,3026,2278,108,4,26,1,0,0,1,5,1,2,5452,14,1
2800,인천광역시,2808,서구,,오류왕길동제1투,3674,1957,931,897,57,2,30,1,0,1,8,1,0,2,1930,27,1717
2800,인천광역시,2808,서구,,오류왕길동제2투,2928,1772,845,832,56,2,16,0,0,1,2,1,0,0,1755,17,1156
2800,인천광역시,2808,서구,,오류왕길동제3투,3510,2008,901,984,68,2,28,0,0,1,4,1,0,0,1989,19,1502
2800,인천광역시,2808,서구,,오류왕길동제4투,3185,2088,1068,918,53,2,17,0,0,1,3,3,0,0,2065,23,1097
2800,인천광역시,2808,서구,마전동,소계,16695,12456,6553,5327,368,5,79,3,0,1,9,14,4,3,12366,90,4239
2800,인천광역시,2808,서구,,관내사전투표,5443,5443,3086,2136,158,3,25,1,0,0,1,6,3,1,5420,23,0
2800,인천광역시,2808,서구,,마전동제1투,3316,2086,1029,964,55,1,15,1,0,0,5,2,0,2,2074,12,1230
2800,인천광역시,2808,서구,,마전동제2투,2508,1595,755,749,53,0,8,0,0,0,1,4,0,0,1570,25,913
2800,인천광역시,2808,서구,,마전동제3투,3681,2335,1215,999,75,1,21,1,0,1,1,2,0,0,2316,19,1346
2800,인천광역시,2808,서구,,마전동제4투,1747,997,468,479,27,0,10,0,0,0,1,0,1,0,986,11,750
2800,인천광역시,2808,서구,아라동,소계,12305,9729,4926,4362,309,4,51,0,2,0,3,5,0,2,9664,65,2576
2800,인천광역시,2808,서구,,관내사전투표,3773,3773,2172,1458,115,0,9,0,0,0,0,4,0,1,3759,14,0
2800,인천광역시,2808,서구,,아라동제1투,1835,1242,614,573,39,0,5,0,0,0,0,0,0,1,1232,10,593
2800,인천광역시,2808,서구,,아라동제2투,3351,2306,1070,1133,68,1,17,0,1,0,2,1,0,0,2293,13,1045
2800,인천광역시,2808,서구,,아라동제3투,2319,1657,708,865,59,2,11,0,0,0,0,0,0,0,1645,12,662
2800,인천광역시,2808,서구,,아라동제4투,1027,751,362,333,28,1,9,0,1,0,1,0,0,0,735,16,276
2800,인천광역시,2808,서구,잘못 투입·구분된 투표지,,0,2,1,1,0,0,0,0,0,0,0,0,0,0,2,0,-2
2800,인천광역시,2809,강화군,합계,,63019,48473,17036,29267,988,22,513,23,11,12,34,39,32,32,48009,464,14546
2800,인천광역시,2809,강화군,거소·선상투표,,360,313,113,106,13,5,4,3,4,2,0,3,0,2,255,58,47
2800,인천광역시,2809,강화군,관외사전투표,,6194,6194,2478,3471,132,2,48,1,0,1,1,2,3,5,6144,50,0
2800,인천광역시,2809,강화군,재외투표,,332,244,160,57,5,0,1,0,0,0,0,0,0,0,223,21,88
2800,인천광역시,2809,강화군,강화읍,소계,17906,12928,4964,7364,302,1,169,5,2,2,10,10,6,6,12841,87,4978
2800,인천광역시,2809,강화군,,관내사전투표,5736,5736,2396,3123,129,0,49,2,0,1,4,3,0,1,5708,28,0
2800,인천광역시,2809,강화군,,강화읍제1투,1373,818,254,526,13,1,10,1,1,0,1,1,0,3,811,7,555
2800,인천광역시,2809,강화군,,강화읍제2투,2152,1264,431,779,26,0,11,0,0,0,2,1,2,0,1252,12,888
2800,인천광역시,2809,강화군,,강화읍제3투,1157,660,233,398,7,0,18,0,0,0,0,0,0,0,656,4,497
2800,인천광역시,2809,강화군,,강화읍제4투,1665,1038,403,582,27,0,18,1,0,0,0,0,1,0,1032,6,627
2800,인천광역시,2809,강화군,,강화읍제5투,2598,1562,606,864,48,0,24,0,0,0,1,1,1,1,1546,16,1036
2800,인천광역시,2809,강화군,,강화읍제6투,1331,732,254,435,20,0,19,0,0,0,1,0,0,0,729,3,599
2800,인천광역시,2809,강화군,,강화읍제7투,1894,1118,387,657,32,0,20,1,1,1,1,4,2,1,1107,11,776
2800,인천광역시,2809,강화군,선원면,소계,6247,4753,1783,2752,108,2,54,2,1,2,6,4,2,2,4718,35,1494
2800,인천광역시,2809,강화군,,관내사전투표,2644,2644,1063,1474,63,0,22,2,1,1,0,0,2,0,2628,16,0
2800,인천광역시,2809,강화군,,선원면제1투,1496,860,252,570,13,0,10,0,0,1,4,2,0,1,853,7,636
2800,인천광역시,2809,강화군,,선원면제2투,2107,1249,468,708,32,2,22,0,0,0,2,2,0,1,1237,12,858
2800,인천광역시,2809,강화군,불은면,소계,3938,2907,1019,1798,45,1,18,0,0,1,0,1,1,0,2884,23,1031
2800,인천광역시,2809,강화군,,관내사전투표,1464,1464,563,863,20,0,7,0,0,1,0,1,0,0,1455,9,0
2800,인천광역시,2809,강화군,,불은면제1투,1544,882,288,567,16,0,5,0,0,0,0,0,0,0,876,6,662
2800,인천광역시,2809,강화군,,불은면제2투,930,561,168,368,9,1,6,0,0,0,0,0,1,0,553,8,369
2800,인천광역시,2809,강화군,길상면,소계,6055,4591,1485,2912,81,2,36,2,1,1,7,2,2,4,4535,56,1464
2800,인천광역시,2809,강화군,,관내사전투표,2301,2301,836,1386,29,1,5,2,1,0,2,1,1,2,2266,35,0
2800,인천광역시,2809,강화군,,길상면제1투,1411,800,260,503,19,0,7,0,0,0,2,0,1,0,792,8,611
2800,인천광역시,2809,강화군,,길상면제2투,935,574,153,386,19,0,7,0,0,0,2,1,0,1,569,5,361
2800,인천광역시,2809,강화군,,길상면제3투,906,568,142,394,11,0,12,0,0,1,0,0,0,1,561,7,338
2800,인천광역시,2809,강화군,,길상면제4투,502,348,94,243,3,1,5,0,0,0,1,0,0,0,347,1,154
2800,인천광역시,2809,강화군,화도면,소계,3598,2640,794,1747,43,0,26,3,0,1,2,0,2,1,2619,21,958
2800,인천광역시,2809,강화군,,관내사전투표,1038,1038,357,648,18,0,7,1,0,1,1,0,0,0,1033,5,0
2800,인천광역시,2809,강화군,,화도면제1투,928,560,153,377,10,0,10,1,0,0,1,0,1,0,553,7,368
2800,인천광역시,2809,강화군,,화도면제2투,694,454,122,314,9,0,3,1,0,0,0,0,0,1,450,4,240
2800,인천광역시,2809,강화군,,화도면제3투,537,335,101,225,2,0,4,0,0,0,0,0,0,0,332,3,202
2800,인천광역시,2809,강화군,,화도면제4투,401,253,61,183,4,0,2,0,0,0,0,0,1,0,251,2,148
2800,인천광역시,2809,강화군,양도면,소계,3408,2558,825,1638,39,0,27,1,2,0,1,3,3,1,2540,18,850
2800,인천광역시,2809,강화군,,관내사전투표,1300,1300,463,801,17,0,10,0,0,0,1,0,0,1,1293,7,0
2800,인천광역시,2809,강화군,,양도면제1투,1101,607,195,384,10,0,7,1,2,0,0,1,2,0,602,5,494
2800,인천광역시,2809,강화군,,양도면제2투,1007,651,167,453,12,0,10,0,0,0,0,2,1,0,645,6,356
2800,인천광역시,2809,강화군,내가면,소계,2581,2026,598,1352,36,2,21,2,0,0,4,0,0,2,2017,9,555
2800,인천광역시,2809,강화군,,관내사전투표,885,885,305,553,15,2,7,1,0,0,0,0,0,1,884,1,0
2800,인천광역시,2809,강화군,,내가면제1투,846,535,150,353,13,0,14,0,0,0,0,0,0,1,531,4,311
2800,인천광역시,2809,강화군,,내가면제2투,405,298,78,211,5,0,0,0,0,0,4,0,0,0,298,0,107
2800,인천광역시,2809,강화군,,내가면제3투,445,308,65,235,3,0,0,1,0,0,0,0,0,0,304,4,137
2800,인천광역시,2809,강화군,하점면,소계,3344,2456,752,1591,52,1,21,2,0,1,0,4,4,2,2430,26,888
2800,인천광역시,2809,강화군,,관내사전투표,1125,1125,409,664,28,1,10,0,0,0,0,2,2,0,1116,9,0
2800,인천광역시,2809,강화군,,하점면제1투,1022,598,161,417,6,0,6,1,0,0,0,0,0,0,591,7,424
2800,인천광역시,2809,강화군,,하점면제2투,598,400,93,285,13,0,1,0,0,0,0,1,0,1,394,6,198
2800,인천광역시,2809,강화군,,하점면제3투,599,333,89,225,5,0,4,1,0,1,0,1,2,1,329,4,266
2800,인천광역시,2809,강화군,양사면,소계,1517,1168,395,725,23,0,17,0,1,0,1,0,1,0,1163,5,349
2800,인천광역시,2809,강화군,,관내사전투표,526,526,199,308,9,0,6,0,1,0,0,0,0,0,523,3,0
2800,인천광역시,2809,강화군,,양사면제1투,333,215,74,132,3,0,4,0,0,0,1,0,1,0,215,0,118
2800,인천광역시,2809,강화군,,양사면제2투,433,270,87,171,5,0,5,0,0,0,0,0,0,0,268,2,163
2800,인천광역시,2809,강화군,,양사면제3투,225,157,35,114,6,0,2,0,0,0,0,0,0,0,157,0,68
2800,인천광역시,2809,강화군,송해면,소계,2878,2163,689,1375,49,1,20,1,0,0,0,3,1,1,2140,23,715
2800,인천광역시,2809,강화군,,관내사전투표,1374,1374,456,859,30,1,8,0,0,0,0,3,1,1,1359,15,0
2800,인천광역시,2809,강화군,,송해면투표소,1504,789,233,516,19,0,12,1,0,0,0,0,0,0,781,8,715
2800,인천광역시,2809,강화군,교동면,소계,2368,1815,520,1195,32,4,32,0,0,0,0,5,3,1,1792,23,553
2800,인천광역시,2809,강화군,,관내사전투표,830,830,272,522,15,3,5,0,0,0,0,3,2,1,823,7,0
2800,인천광역시,2809,강화군,,교동면제1투,726,456,95,325,8,0,18,0,0,0,0,1,0,0,447,9,270
2800,인천광역시,2809,강화군,,교동면제2투,427,264,81,170,5,1,3,0,0,0,0,0,1,0,261,3,163
2800,인천광역시,2809,강화군,,교동면제3투,385,265,72,178,4,0,6,0,0,0,0,1,0,0,261,4,120
2800,인천광역시,2809,강화군,삼산면,소계,1791,1328,373,897,23,0,17,1,0,1,1,2,3,4,1322,6,463
2800,인천광역시,2809,강화군,,관내사전투표,619,619,197,407,11,0,4,0,0,0,0,0,0,0,619,0,0
2800,인천광역시,2809,강화군,,삼산면제1투,348,187,56,122,1,0,2,1,0,0,0,0,0,3,185,2,161
2800,인천광역시,2809,강화군,,삼산면제2투,195,119,33,79,1,0,0,0,0,0,1,1,1,1,117,2,76
2800,인천광역시,2809,강화군,,삼산면제3투,582,363,78,258,10,0,11,0,0,1,0,1,2,0,361,2,219
2800,인천광역시,2809,강화군,,삼산면제4투,47,40,9,31,0,0,0,0,0,0,0,0,0,0,40,0,7
2800,인천광역시,2809,강화군,서도면,소계,502,389,88,287,5,1,2,0,0,0,1,0,1,1,386,3,113
2800,인천광역시,2809,강화군,,관내사전투표,108,108,31,73,1,0,1,0,0,0,0,0,0,1,107,1,0
2800,인천광역시,2809,강화군,,서도면제1투,206,137,32,102,1,1,0,0,0,0,0,0,0,0,136,1,69
2800,인천광역시,2809,강화군,,서도면제2투,188,144,25,112,3,0,1,0,0,0,1,0,1,0,143,1,44
2800,인천광역시,2809,강화군,잘못 투입·구분된 투표지,,0,0,0,0,0,0,0,0,0,0,0,0,0,0,0,0,0
2800,인천광역시,2810,옹진군,합계,,18659,14912,5218,8797,304,16,251,13,4,5,11,18,11,15,14663,249,3747
2800,인천광역시,2810,옹진군,거소·선상투표,,97,95,33,41,1,0,7,0,0,0,1,1,0,0,84,11,2
2800,인천광역시,2810,옹진군,관외사전투표,,3554,3553,1344,2031,72,6,45,1,0,1,2,6,1,0,3509,44,1
2800,인천광역시,2810,옹진군,재외투표,,48,35,21,12,1,0,0,0,0,0,0,0,0,0,34,1,13
2800,인천광역시,2810,옹진군,북도면,소계,1437,1104,270,748,19,1,11,3,0,2,0,2,1,3,1060,44,333
2800,인천광역시,2810,옹진군,,관내사전투표,377,377,91,270,8,0,3,1,0,0,0,1,0,0,374,3,0
2800,인천광역시,2810,옹진군,,북도면제1투,234,146,41,100,2,0,2,0,0,0,0,0,0,1,146,0,88
2800,인천광역시,2810,옹진군,,북도면제2투,144,66,15,49,1,0,0,0,0,0,0,0,0,0,65,1,78
2800,인천광역시,2810,옹진군,,북도면제3투,682,515,123,329,8,1,6,2,0,2,0,1,1,2,475,40,167
2800,인천광역시,2810,옹진군,연평면,소계,1507,1046,349,587,30,2,46,2,0,0,1,3,3,1,1024,22,461
2800,인천광역시,2810,옹진군,,관내사전투표,725,725,236,412,19,2,37,1,0,0,0,1,2,1,711,14,0
2800,인천광역시,2810,옹진군,,연평면제1투,715,282,97,154,10,0,9,1,0,0,1,2,1,0,275,7,433
2800,인천광역시,2810,옹진군,,연평면제2투,67,39,16,21,1,0,0,0,0,0,0,0,0,0,38,1,28
2800,인천광역시,2810,옹진군,백령면,소계,3741,2798,950,1665,63,0,64,0,1,0,3,0,1,3,2750,48,943
2800,인천광역시,2810,옹진군,,관내사전투표,1307,1307,493,697,37,0,48,0,0,0,2,0,1,2,1280,27,0
2800,인천광역시,2810,옹진군,,백령면제1투,883,484,172,300,5,0,1,0,0,0,0,0,0,0,478,6,399
2800,인천광역시,2810,옹진군,,백령면제2투,975,591,197,362,13,0,8,0,1,0,0,0,0,1,582,9,384
2800,인천광역시,2810,옹진군,,백령면제3투,322,240,58,174,4,0,1,0,0,0,1,0,0,0,238,2,82
2800,인천광역시,2810,옹진군,,백령면제4투,254,176,30,132,4,0,6,0,0,0,0,0,0,0,172,4,78
2800,인천광역시,2810,옹진군,대청면,소계,1109,880,224,582,20,2,28,2,0,0,1,1,0,1,861,19,229
2800,인천광역시,2810,옹진군,,관내사전투표,487,487,125,320,13,2,15,1,0,0,0,1,0,0,477,10,0
2800,인천광역시,2810,옹진군,,대청면제1투,285,176,41,121,4,0,7,0,0,0,0,0,0,0,173,3,109
2800,인천광역시,2810,옹진군,,대청면제2투,160,72,20,45,2,0,2,0,0,0,0,0,0,0,69,3,88
2800,인천광역시,2810,옹진군,,대청면제3투,177,145,38,96,1,0,4,1,0,0,1,0,0,1,142,3,32
2800,인천광역시,2810,옹진군,덕적면,소계,1285,996,346,604,18,1,12,1,1,0,1,1,0,3,988,8,289
2800,인천광역시,2810,옹진군,,관내사전투표,497,497,187,286,9,1,8,1,1,0,1,1,0,0,495,2,0
2800,인천광역시,2810,옹진군,,덕적면제1투,298,147,51,83,6,0,4,0,0,0,0,0,0,1,145,2,151
2800,인천광역시,2810,옹진군,,덕적면제2투,200,141,52,86,0,0,0,0,0,0,0,0,0,1,139,2,59
2800,인천광역시,2810,옹진군,,덕적면제3투,130,94,29,64,1,0,0,0,0,0,0,0,0,0,94,0,36
2800,인천광역시,2810,옹진군,,덕적면제4투,71,57,15,40,1,0,0,0,0,0,0,0,0,0,56,1,14
2800,인천광역시,2810,옹진군,,덕적면제5투,43,28,3,23,1,0,0,0,0,0,0,0,0,0,27,1,15
2800,인천광역시,2810,옹진군,,덕적면제6투,46,32,9,22,0,0,0,0,0,0,0,0,0,1,32,0,14
2800,인천광역시,2810,옹진군,자월면,소계,893,680,184,466,10,0,6,0,1,0,0,1,2,0,670,10,213
2800,인천광역시,2810,옹진군,,관내사전투표,204,204,65,131,4,0,2,0,0,0,0,1,0,0,203,1,0
2800,인천광역시,2810,옹진군,,자월면제1투,257,143,48,87,2,0,2,0,0,0,0,0,0,0,139,4,114
2800,인천광역시,2810,옹진군,,자월면제2투,160,120,29,85,1,0,1,0,0,0,0,0,2,0,118,2,40
2800,인천광역시,2810,옹진군,,자월면제3투,195,152,34,112,2,0,1,0,1,0,0,0,0,0,150,2,43
2800,인천광역시,2810,옹진군,,자월면제4투,77,61,8,51,1,0,0,0,0,0,0,0,0,0,60,1,16
2800,인천광역시,2810,옹진군,영흥면,소계,4988,3724,1496,2061,70,4,32,4,1,2,2,3,3,4,3682,42,1264
2800,인천광역시,2810,옹진군,,관내사전투표,1986,1986,839,1059,31,3,18,4,1,1,1,2,2,1,1962,24,0
2800,인천광역시,2810,옹진군,,영흥면제1투,1357,713,304,372,19,0,8,0,0,1,1,0,0,0,705,8,644
2800,인천광역시,2810,옹진군,,영흥면제2투,1088,649,240,380,17,1,4,0,0,0,0,0,1,1,644,5,439
2800,인천광역시,2810,옹진군,,영흥면제3투,557,376,113,250,3,0,2,0,0,0,0,1,0,2,371,5,181
2800,인천광역시,2810,옹진군,잘못 투입·구분된 투표지,,0,1,1,0,0,0,0,0,0,0,0,0,0,0,1,0,-12900,광주광역시,2901,동구,합계,,90678,73877,60669,11036,1063,28,389,22,5,16,4,88,12,31,73363,514,16801
2900,광주광역시,2901,동구,거소·선상투표,,267,244,177,34,5,0,5,0,0,1,0,0,0,0,222,22,23
2900,광주광역시,2901,동구,관외사전투표,,14027,14025,11414,2165,215,4,84,7,2,2,0,22,3,5,13923,102,2
2900,광주광역시,2901,동구,재외투표,,346,238,181,32,8,0,0,0,0,0,0,1,0,0,222,16,108
2900,광주광역시,2901,동구,충장동,소계,3942,2748,2204,432,54,4,30,1,0,1,0,0,0,0,2726,22,1194
2900,광주광역시,2901,동구,,관내사전투표,1532,1532,1268,211,27,4,13,1,0,0,0,0,0,0,1524,8,0
2900,광주광역시,2901,동구,,충장동제1투,1278,667,532,102,16,0,6,0,0,1,0,0,0,0,657,10,611
2900,광주광역시,2901,동구,,충장동제2투,1132,549,404,119,11,0,11,0,0,0,0,0,0,0,545,4,583
2900,광주광역시,2901,동구,동명동,소계,3474,2587,2081,419,46,0,15,1,1,0,0,4,0,1,2568,19,887
2900,광주광역시,2901,동구,,관내사전투표,1616,1616,1316,245,34,0,9,1,0,0,0,4,0,0,1609,7,0
2900,광주광역시,2901,동구,,동명동제1투,873,379,272,88,6,0,3,0,1,0,0,0,0,1,371,8,494
2900,광주광역시,2901,동구,,동명동제2투,985,592,493,86,6,0,3,0,0,0,0,0,0,0,588,4,393
2900,광주광역시,2901,동구,계림1동,소계,7984,6092,4982,947,70,4,31,2,0,1,0,11,1,2,6051,41,1892
2900,광주광역시,2901,동구,,관내사전투표,2955,2955,2501,393,29,2,11,1,0,0,0,6,1,0,2944,11,0
2900,광주광역시,2901,동구,,계림1동제1투,1343,661,556,85,8,1,5,0,0,0,0,0,0,0,655,6,682
2900,광주광역시,2901,동구,,계림1동제2투,1299,696,567,102,8,1,5,0,0,0,0,3,0,1,687,9,603
2900,광주광역시,2901,동구,,계림1동제3투,2387,1780,1358,367,25,0,10,1,0,1,0,2,0,1,1765,15,607
2900,광주광역시,2901,동구,계림2동,소계,7529,6336,5232,934,87,3,34,0,0,3,0,6,2,4,6305,31,1193
2900,광주광역시,2901,동구,,관내사전투표,3906,3906,3329,507,37,2,15,0,0,1,0,3,1,0,3895,11,0
2900,광주광역시,2901,동구,,계림2동제1투,1419,914,704,160,20,1,12,0,0,2,0,2,1,2,904,10,505
2900,광주광역시,2901,동구,,계림2동제2투,916,571,435,115,13,0,2,0,0,0,0,0,0,1,566,5,345
2900,광주광역시,2901,동구,,계림2동제3투,1288,945,764,152,17,0,5,0,0,0,0,1,0,1,940,5,343
2900,광주광역시,2901,동구,산수1동,소계,5603,4142,3531,494,72,1,19,2,0,0,0,4,2,1,4126,16,1461
2900,광주광역시,2901,동구,,관내사전투표,2081,2081,1853,185,32,0,4,2,0,0,0,2,0,0,2078,3,0
2900,광주광역시,2901,동구,,산수1동제1투,1105,612,527,73,6,0,3,0,0,0,0,0,0,0,609,3,493
2900,광주광역시,2901,동구,,산수1동제2투,1219,625,505,87,16,0,6,0,0,0,0,1,2,1,618,7,594
2900,광주광역시,2901,동구,,산수1동제3투,1198,824,646,149,18,1,6,0,0,0,0,1,0,0,821,3,374
2900,광주광역시,2901,동구,산수2동,소계,7421,5910,4978,790,70,2,24,1,0,0,0,9,0,1,5875,35,1511
2900,광주광역시,2901,동구,,관내사전투표,2866,2866,2515,298,29,1,6,0,0,0,0,5,0,1,2855,11,0
2900,광주광역시,2901,동구,,산수2동제1투,1141,642,550,69,9,0,6,0,0,0,0,0,0,0,634,8,499
2900,광주광역시,2901,동구,,산수2동제2투,1052,683,562,102,9,1,1,0,0,0,0,0,0,0,675,8,369
2900,광주광역시,2901,동구,,산수2동제3투,1213,829,688,113,12,0,10,0,0,0,0,3,0,0,826,3,384
2900,광주광역시,2901,동구,,산수2동제4투,1149,890,663,208,11,0,1,1,0,0,0,1,0,0,885,5,259
2900,광주광역시,2901,동구,지산1동,소계,3107,2379,1897,390,46,0,24,2,0,1,0,0,0,0,2360,19,728
2900,광주광역시,2901,동구,,관내사전투표,1437,1437,1185,206,22,0,12,1,0,1,0,0,0,0,1427,10,0
2900,광주광역시,2901,동구,,지산1동제1투,1045,632,488,118,14,0,6,1,0,0,0,0,0,0,627,5,413
2900,광주광역시,2901,동구,,지산1동제2투,625,310,224,66,10,0,6,0,0,0,0,0,0,0,306,4,315
2900,광주광역시,2901,동구,지산2동,소계,3593,2713,2233,394,44,0,11,0,0,0,0,6,0,2,2690,23,880
2900,광주광역시,2901,동구,,관내사전투표,1614,1614,1374,196,25,0,3,0,0,0,0,5,0,1,1604,10,0
2900,광주광역시,2901,동구,,지산2동제1투,1335,724,539,154,14,0,6,0,0,0,0,0,0,1,714,10,611
2900,광주광역시,2901,동구,,지산2동제2투,644,375,320,44,5,0,2,0,0,0,0,1,0,0,372,3,269
2900,광주광역시,2901,동구,서남동,소계,2693,1943,1521,359,29,1,11,0,0,0,0,3,0,3,1927,16,750
2900,광주광역시,2901,동구,,관내사전투표,1345,1345,1086,217,23,1,2,0,0,0,0,3,0,2,1334,11,0
2900,광주광역시,2901,동구,,서남동제1투,800,380,250,115,6,0,4,0,0,0,0,0,0,0,375,5,420
2900,광주광역시,2901,동구,,서남동제2투,548,218,185,27,0,0,5,0,0,0,0,0,0,1,218,0,330
2900,광주광역시,2901,동구,학동,소계,5431,4416,3458,848,61,1,14,1,2,0,0,2,1,3,4391,25,1015
2900,광주광역시,2901,동구,,관내사전투표,2428,2428,1923,459,25,1,4,1,0,0,0,1,1,2,2417,11,0
2900,광주광역시,2901,동구,,학동제1투,1621,1152,959,156,22,0,6,0,1,0,0,1,0,1,1146,6,469
2900,광주광역시,2901,동구,,학동제2투,1382,836,576,233,14,0,4,0,1,0,0,0,0,0,828,8,546
2900,광주광역시,2901,동구,학운동,소계,9488,7751,6252,1310,96,4,30,1,0,3,0,7,2,5,7710,41,1737
2900,광주광역시,2901,동구,,관내사전투표,4777,4776,3968,713,50,4,12,1,0,0,0,5,1,2,4756,20,1
2900,광주광역시,2901,동구,,학운동제1투,1104,552,425,105,6,0,5,0,0,1,0,2,0,0,544,8,552
2900,광주광역시,2901,동구,,학운동제2투,1399,919,677,211,20,0,5,0,0,0,0,0,0,2,915,4,480
2900,광주광역시,2901,동구,,학운동제3투,971,683,537,126,7,0,3,0,0,1,0,0,1,1,676,7,288
2900,광주광역시,2901,동구,,학운동제4투,1237,821,645,155,13,0,5,0,0,1,0,0,0,0,819,2,416
2900,광주광역시,2901,동구,지원1동,소계,5691,4511,3854,530,63,3,23,1,0,0,1,6,1,1,4483,28,1180
2900,광주광역시,2901,동구,,관내사전투표,2770,2770,2465,256,22,2,7,0,0,0,0,5,1,1,2759,11,0
2900,광주광역시,2901,동구,,지원1동제1투,1453,875,695,132,25,1,9,0,0,0,0,0,0,0,862,13,578
2900,광주광역시,2901,동구,,지원1동제2투,907,541,436,90,9,0,3,1,0,0,0,1,0,0,540,1,366
2900,광주광역시,2901,동구,,지원1동제3투,561,325,258,52,7,0,4,0,0,0,1,0,0,0,322,3,236
2900,광주광역시,2901,동구,지원2동,소계,10082,7842,6674,958,97,1,34,3,0,4,3,7,0,3,7784,58,2240
2900,광주광역시,2901,동구,,관내사전투표,3684,3684,3197,395,36,1,14,2,0,2,1,4,0,3,3655,29,0
2900,광주광역시,2901,동구,,지원2동제1투,1648,1249,1048,169,19,0,6,0,0,0,1,1,0,0,1244,5,399
2900,광주광역시,2901,동구,,지원2동제2투,1188,805,698,87,11,0,4,0,0,1,0,0,0,0,801,4,383
2900,광주광역시,2901,동구,,지원2동제3투,1722,922,793,95,11,0,5,1,0,0,0,1,0,0,906,16,800
2900,광주광역시,2901,동구,,지원2동제4투,1840,1182,938,212,20,0,5,0,0,1,1,1,0,0,1178,4,658
2900,광주광역시,2901,동구,잘못 투입·구분된 투표지,,0,0,0,0,0,0,0,0,0,0,0,0,0,0,0,0,0
2900,광주광역시,2902,서구,합계,,248147,202633,170357,26262,2961,68,1127,44,18,29,19,277,34,82,201278,1355,45514
2900,광주광역시,2902,서구,거소·선상투표,,581,557,374,104,9,0,12,0,0,0,0,1,0,0,500,57,24
2900,광주광역시,2902,서구,관외사전투표,,31427,31421,25377,4902,569,13,249,10,5,2,3,47,5,9,31191,230,6
2900,광주광역시,2902,서구,재외투표,,732,557,428,69,18,1,3,0,0,0,0,0,0,0,519,38,175
2900,광주광역시,2902,서구,양동,소계,3529,2844,2502,279,19,2,13,1,0,1,0,7,0,3,2827,17,685
2900,광주광역시,2902,서구,,관내사전투표,1816,1816,1626,154,10,2,3,1,0,0,0,7,0,3,1806,10,0
2900,광주광역시,2902,서구,,양동제1투,962,634,542,79,6,0,4,0,0,1,0,0,0,0,632,2,328
2900,광주광역시,2902,서구,,양동제2투,751,394,334,46,3,0,6,0,0,0,0,0,0,0,389,5,357
2900,광주광역시,2902,서구,양3동,소계,3533,2841,2465,286,39,2,19,1,0,0,0,5,1,1,2819,22,692
2900,광주광역시,2902,서구,,관내사전투표,1660,1660,1481,148,15,0,6,0,0,0,0,2,1,0,1653,7,0
2900,광주광역시,2902,서구,,양3동제1투,1280,789,668,86,19,2,6,1,0,0,0,0,0,0,782,7,491
2900,광주광역시,2902,서구,,양3동제2투,593,392,316,52,5,0,7,0,0,0,0,3,0,1,384,8,201
2900,광주광역시,2902,서구,농성1동,소계,7756,5642,4787,701,70,0,34,3,0,1,0,5,0,1,5602,40,2114
2900,광주광역시,2902,서구,,관내사전투표,3179,3179,2787,329,29,0,8,3,0,0,0,3,0,1,3160,19,0
2900,광주광역시,2902,서구,,농성1동제1투,1233,618,507,87,11,0,7,0,0,1,0,0,0,0,613,5,615
2900,광주광역시,2902,서구,,농성1동제2투,1743,946,754,148,24,0,11,0,0,0,0,0,0,0,937,9,797
2900,광주광역시,2902,서구,,농성1동제3투,1601,899,739,137,6,0,8,0,0,0,0,2,0,0,892,7,702
2900,광주광역시,2902,서구,농성2동,소계,4290,3197,2678,393,59,3,29,1,1,0,1,2,1,2,3170,27,1093
2900,광주광역시,2902,서구,,관내사전투표,1971,1971,1708,205,24,2,13,0,1,0,1,2,0,2,1958,13,0
2900,광주광역시,2902,서구,,농성2동제1투,1120,536,427,82,12,1,9,0,0,0,0,0,0,0,531,5,584
2900,광주광역시,2902,서구,,농성2동제2투,1199,690,543,106,23,0,7,1,0,0,0,0,1,0,681,9,509
2900,광주광역시,2902,서구,광천동,소계,6094,4705,3911,660,71,0,17,1,2,1,2,2,0,2,4669,36,1389
2900,광주광역시,2902,서구,,관내사전투표,2865,2865,2461,339,37,0,8,1,0,0,0,2,0,0,2848,17,0
2900,광주광역시,2902,서구,,광천동제1투,1027,482,372,84,11,0,4,0,0,0,1,0,0,1,473,9,545
2900,광주광역시,2902,서구,,광천동제2투,1644,1017,798,191,18,0,4,0,0,0,1,0,0,1,1013,4,627
2900,광주광역시,2902,서구,,광천동제3투,558,341,280,46,5,0,1,0,2,1,0,0,0,0,335,6,217
2900,광주광역시,2902,서구,유덕동,소계,7988,6437,5547,706,91,2,39,0,0,1,0,12,1,3,6402,35,1551
2900,광주광역시,2902,서구,,관내사전투표,3546,3544,3110,360,41,1,12,0,0,0,0,7,1,1,3533,11,2
2900,광주광역시,2902,서구,,유덕동제1투,516,331,281,39,4,0,2,0,0,0,0,1,0,2,329,2,185
2900,광주광역시,2902,서구,,유덕동제2투,1910,1197,1011,140,24,0,8,0,0,1,0,4,0,0,1188,9,713
2900,광주광역시,2902,서구,,유덕동제3투,2016,1365,1145,167,22,1,17,0,0,0,0,0,0,0,1352,13,651
2900,광주광역시,2902,서구,치평동,소계,23665,18976,15698,2724,305,5,97,2,2,4,2,24,5,8,18876,100,4689
2900,광주광역시,2902,서구,,관내사전투표,10664,10664,9060,1382,133,0,35,1,1,2,1,13,3,5,10636,28,0
2900,광주광역시,2902,서구,,치평동제1투,2238,1358,1042,244,28,2,19,0,0,1,0,2,0,0,1338,20,880
2900,광주광역시,2902,서구,,치평동제2투,1695,1027,832,157,22,0,6,0,0,0,0,3,1,0,1021,6,668
2900,광주광역시,2902,서구,,치평동제3투,1882,1260,958,246,30,1,9,0,0,1,0,1,0,1,1247,13,622
2900,광주광역시,2902,서구,,치평동제4투,2376,1563,1269,238,29,1,12,1,1,0,0,0,0,1,1552,11,813
2900,광주광역시,2902,서구,,치평동제5투,1499,1092,905,147,26,0,5,0,0,0,0,4,0,0,1087,5,407
2900,광주광역시,2902,서구,,치평동제6투,3311,2012,1632,310,37,1,11,0,0,0,1,1,1,1,1995,17,1299
2900,광주광역시,2902,서구,상무1동,소계,18792,13948,11772,1746,210,5,97,1,1,1,1,17,2,9,13862,86,4844
2900,광주광역시,2902,서구,,관내사전투표,6671,6671,5826,707,80,3,24,0,0,0,0,5,1,6,6652,19,0
2900,광주광역시,2902,서구,,상무1동제1투,2946,1815,1478,266,34,1,17,0,0,0,0,2,0,0,1798,17,1131
2900,광주광역시,2902,서구,,상무1동제2투,2240,1445,1188,197,28,0,14,0,0,0,0,3,0,1,1431,14,795
2900,광주광역시,2902,서구,,상무1동제3투,2326,1473,1175,244,21,1,13,0,1,0,1,2,0,1,1459,14,853
2900,광주광역시,2902,서구,,상무1동제4투,2183,886,713,127,16,0,18,0,0,1,0,1,0,0,876,10,1297
2900,광주광역시,2902,서구,,상무1동제5투,2426,1658,1392,205,31,0,11,1,0,0,0,4,1,1,1646,12,768
2900,광주광역시,2902,서구,상무2동,소계,17694,12882,10982,1543,146,5,73,1,2,3,2,28,5,6,12796,86,4812
2900,광주광역시,2902,서구,,관내사전투표,6164,6164,5466,585,53,2,23,0,1,1,1,14,2,2,6150,14,0
2900,광주광역시,2902,서구,,상무2동제1투,1886,1188,998,153,13,1,6,0,0,0,0,0,0,1,1172,16,698
2900,광주광역시,2902,서구,,상무2동제2투,1515,803,658,116,15,1,5,0,0,0,0,1,1,1,798,5,712
2900,광주광역시,2902,서구,,상무2동제3투,2370,1561,1230,277,20,0,7,1,0,1,0,4,0,0,1540,21,809
2900,광주광역시,2902,서구,,상무2동제4투,2431,1284,1053,183,12,0,14,0,1,1,0,8,2,0,1274,10,1147
2900,광주광역시,2902,서구,,상무2동제5투,3328,1882,1577,229,33,1,18,0,0,0,1,1,0,2,1862,20,1446
2900,광주광역시,2902,서구,화정1동,소계,12082,8934,7440,1199,165,2,42,2,3,3,1,14,1,6,8878,56,3148
2900,광주광역시,2902,서구,,관내사전투표,4609,4609,3923,561,82,2,11,1,2,1,0,7,0,0,4590,19,0
2900,광주광역시,2902,서구,,화정1동제1투,2405,1643,1405,192,22,0,5,0,1,0,0,4,0,4,1633,10,762
2900,광주광역시,2902,서구,,화정1동제2투,2459,1339,1078,198,32,0,11,1,0,2,0,1,0,1,1324,15,1120
2900,광주광역시,2902,서구,,화정1동제3투,2609,1343,1034,248,29,0,15,0,0,0,1,2,1,1,1331,12,1266
2900,광주광역시,2902,서구,화정2동,소계,14395,11967,9980,1694,159,7,48,5,1,1,2,11,3,3,11914,53,2428
2900,광주광역시,2902,서구,,관내사전투표,6644,6644,5681,842,70,6,12,3,1,0,2,7,2,3,6629,15,0
2900,광주광역시,2902,서구,,화정2동제1투,2067,1240,994,198,29,1,9,0,0,0,0,2,0,0,1233,7,827
2900,광주광역시,2902,서구,,화정2동제2투,1071,752,603,114,16,0,11,0,0,0,0,0,1,0,745,7,319
2900,광주광역시,2902,서구,,화정2동제3투,2244,1639,1385,208,18,0,10,1,0,1,0,1,0,0,1624,15,605
2900,광주광역시,2902,서구,,화정2동제4투,2369,1692,1317,332,26,0,6,1,0,0,0,1,0,0,1683,9,677
2900,광주광역시,2902,서구,화정3동,소계,7168,5494,4593,732,69,5,42,1,0,0,1,5,2,1,5451,43,1674
2900,광주광역시,2902,서구,,관내사전투표,2512,2512,2202,244,30,3,16,0,0,0,1,3,0,0,2499,13,0
2900,광주광역시,2902,서구,,화정3동제1투,1122,722,577,121,9,0,8,0,0,0,0,0,0,0,715,7,400
2900,광주광역시,2902,서구,,화정3동제2투,1327,741,592,114,11,2,11,0,0,0,0,1,0,0,731,10,586
2900,광주광역시,2902,서구,,화정3동제3투,2207,1519,1222,253,19,0,7,1,0,0,0,1,2,1,1506,13,688
2900,광주광역시,2902,서구,화정4동,소계,12094,9992,8436,1268,136,2,65,1,0,1,1,11,2,3,9926,66,2102
2900,광주광역시,2902,서구,,관내사전투표,5955,5955,5168,670,64,1,25,0,0,0,1,5,1,1,5936,19,0
2900,광주광역시,2902,서구,,화정4동제1투,1210,771,606,131,16,1,2,0,0,0,0,0,0,1,757,14,439
2900,광주광역시,2902,서구,,화정4동제2투,1153,801,632,130,17,0,12,1,0,1,0,1,0,0,794,7,352
2900,광주광역시,2902,서구,,화정4동제3투,1027,712,580,108,6,0,10,0,0,0,0,3,0,0,707,5,315
2900,광주광역시,2902,서구,,화정4동제4투,1236,840,708,100,16,0,6,0,0,0,0,1,0,0,831,9,396
2900,광주광역시,2902,서구,,화정4동제5투,1513,913,742,129,17,0,10,0,0,0,0,1,1,1,901,12,600
2900,광주광역시,2902,서구,서창동,소계,3726,2900,2479,342,40,0,8,4,0,0,0,5,1,5,2884,16,826
2900,광주광역시,2902,서구,,관내사전투표,1266,1266,1116,112,19,0,2,2,0,0,0,5,0,1,1257,9,0
2900,광주광역시,2902,서구,,서창동제1투,801,438,379,46,6,0,4,1,0,0,0,0,1,1,438,0,363
2900,광주광역시,2902,서구,,서창동제2투,329,229,208,14,3,0,0,0,0,0,0,0,0,2,227,2,100
2900,광주광역시,2902,서구,,서창동제3투,1330,967,776,170,12,0,2,1,0,0,0,0,0,1,962,5,363
2900,광주광역시,2902,서구,금호1동,소계,14582,11515,9908,1312,144,1,48,2,0,2,0,12,1,4,11434,81,3067
2900,광주광역시,2902,서구,,관내사전투표,5195,5183,4627,462,50,0,14,0,0,1,0,8,1,2,5165,18,12
2900,광주광역시,2902,서구,,금호1동제1투,1632,1013,825,154,13,0,6,0,0,0,0,1,0,0,999,14,619
2900,광주광역시,2902,서구,,금호1동제2투,2282,1620,1354,222,16,0,12,1,0,1,0,1,0,0,1607,13,662
2900,광주광역시,2902,서구,,금호1동제3투,1747,1087,935,112,16,1,2,1,0,0,0,1,0,2,1070,17,660
2900,광주광역시,2902,서구,,금호1동제4투,2345,1654,1400,195,33,0,11,0,0,0,0,1,0,0,1640,14,691
2900,광주광역시,2902,서구,,금호1동제5투,1381,958,767,167,16,0,3,0,0,0,0,0,0,0,953,5,423
2900,광주광역시,2902,서구,금호2동,소계,20723,17464,15207,1837,227,6,66,3,1,3,0,16,1,1,17368,96,3259
2900,광주광역시,2902,서구,,관내사전투표,9314,9314,8292,845,106,3,26,2,0,1,0,7,0,1,9283,31,0
2900,광주광역시,2902,서구,,금호2동제1투,3060,2035,1726,252,34,0,9,0,0,1,0,0,1,0,2023,12,1025
2900,광주광역시,2902,서구,,금호2동제2투,2400,1688,1430,209,21,1,7,0,0,0,0,3,0,0,1671,17,712
2900,광주광역시,2902,서구,,금호2동제3투,2464,1976,1704,220,22,0,11,0,0,0,0,3,0,0,1960,16,488
2900,광주광역시,2902,서구,,금호2동제4투,2147,1471,1233,182,29,1,9,0,1,0,0,0,0,0,1455,16,676
2900,광주광역시,2902,서구,,금호2동제5투,1338,980,822,129,15,1,4,1,0,1,0,3,0,0,976,4,358
2900,광주광역시,2902,서구,풍암동,소계,25687,20660,17399,2713,286,1,80,4,0,4,2,38,2,8,20537,123,5027
2900,광주광역시,2902,서구,,관내사전투표,10336,10336,8962,1162,123,1,24,1,0,1,1,20,1,5,10301,35,0
2900,광주광역시,2902,서구,,풍암동제1투,1687,1143,931,169,20,0,6,0,0,0,0,3,0,1,1130,13,544
2900,광주광역시,2902,서구,,풍암동제2투,1393,919,788,98,15,0,4,1,0,0,0,2,0,0,908,11,474
2900,광주광역시,2902,서구,,풍암동제3투,1740,1268,1068,161,15,0,6,2,0,0,0,1,0,1,1254,14,472
2900,광주광역시,2902,서구,,풍암동제4투,1902,1368,1060,257,31,0,5,0,0,3,1,1,0,0,1358,10,534
2900,광주광역시,2902,서구,,풍암동제5투,1654,1149,959,155,16,0,8,0,0,0,0,5,0,1,1144,5,505
2900,광주광역시,2902,서구,,풍암동제6투,2373,1366,1106,208,26,0,14,0,0,0,0,2,0,0,1356,10,1007
2900,광주광역시,2902,서구,,풍암동제7투,2342,1349,1131,173,20,0,10,0,0,0,0,3,1,0,1338,11,993
2900,광주광역시,2902,서구,,풍암동제8투,2260,1762,1394,330,20,0,3,0,0,0,0,1,0,0,1748,14,498
2900,광주광역시,2902,서구,동천동,소계,11609,9696,8391,1051,129,6,46,1,0,1,1,15,1,7,9649,47,1913
2900,광주광역시,2902,서구,,관내사전투표,5209,5207,4616,487,56,1,17,1,0,0,0,11,0,0,5189,18,2
2900,광주광역시,2902,서구,,동천동제1투,1437,1013,881,95,14,2,9,0,0,0,0,2,1,4,1008,5,424
2900,광주광역시,2902,서구,,동천동제2투,1729,1287,1110,139,21,1,6,0,0,0,1,1,0,0,1279,8,442
2900,광주광역시,2902,서구,,동천동제3투,1617,1197,938,223,18,1,4,0,0,1,0,1,0,1,1187,10,420
2900,광주광역시,2902,서구,,동천동제4투,1617,992,846,107,20,1,10,0,0,0,0,0,0,2,986,6,625
2900,광주광역시,2902,서구,잘못 투입·구분된 투표지,,0,4,3,1,0,0,0,0,0,0,0,0,0,0,4,0,-4
2900,광주광역시,2903,남구,합계,,180643,148854,124572,19927,2073,63,811,32,17,19,24,171,40,73,147822,1032,31789
2900,광주광역시,2903,남구,거소·선상투표,,620,598,425,61,15,6,6,2,1,2,4,1,4,3,530,68,22
2900,광주광역시,2903,남구,관외사전투표,,25738,25731,21067,3815,398,6,202,7,2,2,4,37,1,11,25552,179,7
2900,광주광역시,2903,남구,재외투표,,595,454,353,59,19,0,2,0,0,0,0,0,0,0,433,21,141
2900,광주광역시,2903,남구,양림동,소계,5608,4614,3925,574,50,1,20,1,0,0,0,8,1,0,4580,34,994
2900,광주광역시,2903,남구,,관내사전투표,3012,3012,2614,333,29,1,12,0,0,0,0,6,1,0,2996,16,0
2900,광주광역시,2903,남구,,양림동제1투,776,418,343,55,8,0,4,0,0,0,0,1,0,0,411,7,358
2900,광주광역시,2903,남구,,양림동제2투,1820,1184,968,186,13,0,4,1,0,0,0,1,0,0,1173,11,636
2900,광주광역시,2903,남구,방림1동,소계,5245,4196,3579,500,55,0,26,0,0,0,0,3,2,1,4166,30,1049
2900,광주광역시,2903,남구,,관내사전투표,2665,2665,2331,277,30,0,14,0,0,0,0,2,2,0,2656,9,0
2900,광주광역시,2903,남구,,방림1동제1투,1535,895,732,136,10,0,3,0,0,0,0,1,0,1,883,12,640
2900,광주광역시,2903,남구,,방림1동제2투,1045,636,516,87,15,0,9,0,0,0,0,0,0,0,627,9,409
2900,광주광역시,2903,남구,방림2동,소계,6311,4991,4321,522,68,2,24,2,0,0,0,8,0,5,4952,39,1320
2900,광주광역시,2903,남구,,관내사전투표,2117,2117,1909,164,19,1,10,0,0,0,0,2,0,1,2106,11,0
2900,광주광역시,2903,남구,,방림2동제1투,966,507,427,57,11,1,3,0,0,0,0,1,0,2,502,5,459
2900,광주광역시,2903,남구,,방림2동제2투,1943,1380,1157,170,24,0,9,2,0,0,0,2,0,1,1365,15,563
2900,광주광역시,2903,남구,,방림2동제3투,1285,987,828,131,14,0,2,0,0,0,0,3,0,1,979,8,298
2900,광주광역시,2903,남구,봉선1동,소계,11156,8852,7442,1137,126,1,53,4,0,2,2,9,4,4,8784,68,2304
2900,광주광역시,2903,남구,,관내사전투표,5504,5503,4720,651,68,1,20,2,0,0,1,7,3,2,5475,28,1
2900,광주광역시,2903,남구,,봉선1동제1투,1220,707,565,97,25,0,11,0,0,0,0,0,0,0,698,9,513
2900,광주광역시,2903,남구,,봉선1동제2투,1220,759,621,110,8,0,7,1,0,0,1,1,0,1,750,9,461
2900,광주광역시,2903,남구,,봉선1동제3투,1777,1051,853,156,15,0,9,0,0,1,0,1,1,1,1037,14,726
2900,광주광역시,2903,남구,,봉선1동제4투,1435,832,683,123,10,0,6,1,0,1,0,0,0,0,824,8,603
2900,광주광역시,2903,남구,봉선2동,소계,18110,14767,11168,3208,216,8,41,3,1,2,4,9,4,7,14671,96,3343
2900,광주광역시,2903,남구,,관내사전투표,7218,7219,5814,1238,86,7,13,3,1,1,1,3,2,7,7176,43,-1
2900,광주광역시,2903,남구,,봉선2동제1투,2489,1667,1204,418,24,0,6,0,0,0,1,1,1,0,1655,12,822
2900,광주광역시,2903,남구,,봉선2동제2투,1496,893,720,145,18,1,2,0,0,0,0,1,0,0,887,6,603
2900,광주광역시,2903,남구,,봉선2동제3투,1768,1251,997,219,20,0,6,0,0,0,2,2,1,0,1247,4,517
2900,광주광역시,2903,남구,,봉선2동제4투,2658,1921,1385,484,28,0,8,0,0,0,0,1,0,0,1906,15,737
2900,광주광역시,2903,남구,,봉선2동제5투,2481,1816,1048,704,40,0,6,0,0,1,0,1,0,0,1800,16,665
2900,광주광역시,2903,남구,사직동,소계,3876,2826,2420,341,25,1,16,0,1,0,0,4,0,3,2811,15,1050
2900,광주광역시,2903,남구,,관내사전투표,1598,1598,1406,162,14,0,4,0,1,0,0,3,0,2,1592,6,0
2900,광주광역시,2903,남구,,사직동제1투,856,423,356,58,2,0,4,0,0,0,0,1,0,1,422,1,433
2900,광주광역시,2903,남구,,사직동제2투,1422,805,658,121,9,1,8,0,0,0,0,0,0,0,797,8,617
2900,광주광역시,2903,남구,월산동,소계,6368,4734,4088,518,53,0,33,1,0,1,0,5,1,3,4703,31,1634
2900,광주광역시,2903,남구,,관내사전투표,2383,2383,2140,196,20,0,12,1,0,0,0,2,0,1,2372,11,0
2900,광주광역시,2903,남구,,월산동제1투,614,337,282,42,4,0,3,0,0,0,0,1,0,0,332,5,277
2900,광주광역시,2903,남구,,월산동제2투,902,522,426,76,10,0,4,0,0,0,0,0,0,1,517,5,380
2900,광주광역시,2903,남구,,월산동제3투,683,328,282,34,4,0,4,0,0,0,0,1,1,0,326,2,355
2900,광주광역시,2903,남구,,월산동제4투,1786,1164,958,170,15,0,10,0,0,1,0,1,0,1,1156,8,622
2900,광주광역시,2903,남구,월산4동,소계,6437,4684,4023,519,59,3,43,0,0,2,1,3,0,2,4655,29,1753
2900,광주광역시,2903,남구,,관내사전투표,2658,2658,2351,241,32,3,17,0,0,1,0,1,0,0,2646,12,0
2900,광주광역시,2903,남구,,월산4동제1투,2603,1359,1118,183,18,0,22,0,0,0,1,2,0,1,1345,14,1244
2900,광주광역시,2903,남구,,월산4동제2투,1176,667,554,95,9,0,4,0,0,1,0,0,0,1,664,3,509
2900,광주광역시,2903,남구,월산5동,소계,5563,4228,3710,409,47,3,23,0,1,1,0,6,0,4,4204,24,1335
2900,광주광역시,2903,남구,,관내사전투표,2609,2609,2364,203,20,2,5,0,0,1,0,5,0,1,2601,8,0
2900,광주광역시,2903,남구,,월산5동제1투,1540,773,647,97,11,1,9,0,1,0,0,1,0,2,769,4,767
2900,광주광역시,2903,남구,,월산5동제2투,1414,846,699,109,16,0,9,0,0,0,0,0,0,1,834,12,568
2900,광주광역시,2903,남구,백운1동,소계,9370,7710,6647,848,97,1,50,3,3,0,1,8,3,5,7666,44,1660
2900,광주광역시,2903,남구,,관내사전투표,4371,4371,3848,428,46,0,18,2,1,0,0,6,2,3,4354,17,0
2900,광주광역시,2903,남구,,백운1동제1투,1622,962,785,133,19,1,11,1,0,0,1,1,0,0,952,10,660
2900,광주광역시,2903,남구,,백운1동제2투,1671,1145,966,143,16,0,8,0,2,0,0,1,0,1,1137,8,526
2900,광주광역시,2903,남구,,백운1동제3투,1706,1232,1048,144,16,0,13,0,0,0,0,0,1,1,1223,9,474
2900,광주광역시,2903,남구,백운2동,소계,5021,3833,3215,476,74,3,27,1,0,1,0,2,0,2,3801,32,1188
2900,광주광역시,2903,남구,,관내사전투표,2211,2211,1884,270,34,2,10,0,0,0,0,1,0,0,2201,10,0
2900,광주광역시,2903,남구,,백운2동제1투,1741,949,765,122,29,0,14,0,0,0,0,1,0,2,933,16,792
2900,광주광역시,2903,남구,,백운2동제2투,1069,673,566,84,11,1,3,1,0,1,0,0,0,0,667,6,396
2900,광주광역시,2903,남구,주월1동,소계,15163,11895,10092,1497,149,11,55,1,2,1,0,23,5,4,11840,55,3268
2900,광주광역시,2903,남구,,관내사전투표,6430,6430,5575,720,65,8,24,1,1,1,0,12,3,3,6413,17,0
2900,광주광역시,2903,남구,,주월1동제1투,1711,1095,923,138,19,0,6,0,0,0,0,1,1,0,1088,7,616
2900,광주광역시,2903,남구,,주월1동제2투,2441,1459,1203,215,12,2,15,0,0,0,0,1,0,0,1448,11,982
2900,광주광역시,2903,남구,,주월1동제3투,1874,1111,935,137,16,0,6,0,0,0,0,4,1,1,1100,11,763
2900,광주광역시,2903,남구,,주월1동제4투,2707,1800,1456,287,37,1,4,0,1,0,0,5,0,0,1791,9,907
2900,광주광역시,2903,남구,주월2동,소계,6314,4930,4314,494,57,1,22,1,1,0,3,8,4,1,4906,24,1384
2900,광주광역시,2903,남구,,관내사전투표,2968,2968,2672,244,23,1,7,0,1,0,1,4,3,0,2956,12,0
2900,광주광역시,2903,남구,,주월2동제1투,886,465,375,66,14,0,2,0,0,0,0,2,0,0,459,6,421
2900,광주광역시,2903,남구,,주월2동제2투,1161,679,573,83,12,0,5,1,0,0,1,0,0,0,675,4,482
2900,광주광역시,2903,남구,,주월2동제3투,1299,818,694,101,8,0,8,0,0,0,1,2,1,1,816,2,481
2900,광주광역시,2903,남구,효덕동,소계,11979,9878,8342,1283,145,4,35,1,0,1,2,9,0,3,9825,53,2101
2900,광주광역시,2903,남구,,관내사전투표,5478,5477,4787,590,61,2,16,1,0,0,0,4,0,1,5462,15,1
2900,광주광역시,2903,남구,,효덕동제1투,2050,1397,1195,161,22,0,9,0,0,0,0,1,0,1,1389,8,653
2900,광주광역시,2903,남구,,효덕동제2투,2195,1522,1167,300,33,1,3,0,0,1,1,1,0,0,1507,15,673
2900,광주광역시,2903,남구,,효덕동제3투,2256,1482,1193,232,29,1,7,0,0,0,1,3,0,1,1467,15,774
2900,광주광역시,2903,남구,송암동,소계,12092,9500,7940,1299,136,1,42,2,2,0,0,9,3,5,9439,61,2592
2900,광주광역시,2903,남구,,관내사전투표,3840,3840,3281,479,47,0,15,0,0,0,0,2,3,1,3828,12,0
2900,광주광역시,2903,남구,,송암동제1투,1803,1135,924,185,11,1,2,0,0,0,0,1,0,0,1124,11,668
2900,광주광역시,2903,남구,,송암동제2투,1436,945,775,127,22,0,9,0,1,0,0,0,0,2,936,9,491
2900,광주광역시,2903,남구,,송암동제3투,1992,1409,1179,189,22,0,3,1,0,0,0,3,0,0,1397,12,583
2900,광주광역시,2903,남구,,송암동제4투,2390,1718,1403,256,30,0,9,1,1,0,0,3,0,1,1704,14,672
2900,광주광역시,2903,남구,,송암동제5투,631,453,378,63,4,0,4,0,0,0,0,0,0,1,450,3,178
2900,광주광역시,2903,남구,대촌동,소계,4893,3890,3470,319,38,2,20,1,2,0,1,9,5,5,3872,18,1003
2900,광주광역시,2903,남구,,관내사전투표,2164,2163,1972,145,19,2,6,1,2,0,0,3,2,2,2154,9,1
2900,광주광역시,2903,남구,,대촌동제1투,1345,820,674,110,16,0,9,0,0,0,1,4,0,0,814,6,525
2900,광주광역시,2903,남구,,대촌동제2투,455,267,234,26,2,0,2,0,0,0,0,0,0,1,265,2,188
2900,광주광역시,2903,남구,,대촌동제3투,929,640,590,38,1,0,3,0,0,0,0,2,3,2,639,1,289
2900,광주광역시,2903,남구,진월동,소계,20184,16538,14026,2048,246,9,71,2,1,4,2,10,3,5,16427,111,3646
2900,광주광역시,2903,남구,,관내사전투표,8041,8041,7027,866,79,2,23,1,0,3,0,3,0,3,8007,34,0
2900,광주광역시,2903,남구,,진월동제1투,2094,1305,1063,193,26,2,9,1,0,0,1,0,2,0,1297,8,789
2900,광주광역시,2903,남구,,진월동제2투,1911,1271,1055,162,29,4,5,0,0,0,0,5,0,0,1260,11,640
2900,광주광역시,2903,남구,,진월동제3투,2205,1675,1364,248,32,0,10,0,0,0,0,0,0,1,1655,20,530
2900,광주광역시,2903,남구,,진월동제4투,1987,1428,1128,258,24,0,7,0,1,0,1,0,0,0,1419,9,559
2900,광주광역시,2903,남구,,진월동제5투,2250,1556,1326,170,33,1,10,0,0,0,0,1,0,0,1541,15,694
2900,광주광역시,2903,남구,,진월동제6투,1696,1262,1063,151,23,0,7,0,0,1,0,1,1,1,1248,14,434
2900,광주광역시,2903,남구,잘못 투입·구분된 투표지,,0,5,5,0,0,0,0,0,0,0,0,0,0,0,5,0,-5
2900,광주광역시,2904,북구,합계,,363088,295658,249976,36421,4550,142,1896,65,26,45,34,350,51,104,293660,1998,67430
2900,광주광역시,2904,북구,거소·선상투표,,851,814,584,135,13,0,25,2,0,0,0,0,2,2,763,51,37
2900,광주광역시,2904,북구,관외사전투표,,44768,44759,36661,6469,770,23,360,11,2,12,4,48,10,11,44381,378,9
2900,광주광역시,2904,북구,재외투표,,1061,831,655,99,26,1,1,0,0,0,1,0,0,0,783,48,230
2900,광주광역시,2904,북구,중흥1동,소계,3844,2853,2426,314,63,1,23,0,0,2,0,3,1,0,2833,20,991
2900,광주광역시,2904,북구,,관내사전투표,1724,1724,1530,149,27,1,5,0,0,1,0,3,0,0,1716,8,0
2900,광주광역시,2904,북구,,중흥1동투표소,2120,1129,896,165,36,0,18,0,0,1,0,0,1,0,1117,12,991
2900,광주광역시,2904,북구,중흥2동,소계,5995,4678,3848,666,91,4,24,0,0,0,1,5,0,1,4640,38,1317
2900,광주광역시,2904,북구,,관내사전투표,2952,2952,2515,368,39,1,10,0,0,0,1,1,0,1,2936,16,0
2900,광주광역시,2904,북구,,중흥2동제1투,1035,636,495,117,12,0,5,0,0,0,0,0,0,0,629,7,399
2900,광주광역시,2904,북구,,중흥2동제2투,1284,693,512,127,26,2,8,0,0,0,0,4,0,0,679,14,591
2900,광주광역시,2904,북구,,중흥2동제3투,724,397,326,54,14,1,1,0,0,0,0,0,0,0,396,1,327
2900,광주광역시,2904,북구,중흥3동,소계,4086,3100,2557,427,50,4,25,3,1,1,1,3,2,2,3076,24,986
2900,광주광역시,2904,북구,,관내사전투표,2025,2025,1723,247,23,2,12,2,1,1,0,2,2,0,2015,10,0
2900,광주광역시,2904,북구,,중흥3동제1투,1143,578,429,109,14,2,9,1,0,0,1,1,0,1,567,11,565
2900,광주광역시,2904,북구,,중흥3동제2투,918,497,405,71,13,0,4,0,0,0,0,0,0,1,494,3,421
2900,광주광역시,2904,북구,중앙동,소계,2881,2081,1780,236,31,3,16,1,0,1,0,0,0,0,2068,13,800
2900,광주광역시,2904,북구,,관내사전투표,1405,1405,1230,136,19,2,9,0,0,1,0,0,0,0,1397,8,0
2900,광주광역시,2904,북구,,중앙동투표소,1476,676,550,100,12,1,7,1,0,0,0,0,0,0,671,5,800
2900,광주광역시,2904,북구,임동,소계,6978,5506,4774,582,81,3,16,3,1,0,1,4,1,3,5469,37,1472
2900,광주광역시,2904,북구,,관내사전투표,3297,3296,2958,277,35,2,6,1,1,0,1,3,1,1,3286,10,1
2900,광주광역시,2904,북구,,임동제1투,1652,943,773,133,20,1,2,1,0,0,0,1,0,2,933,10,709
2900,광주광역시,2904,북구,,임동제2투,2029,1267,1043,172,26,0,8,1,0,0,0,0,0,0,1250,17,762
2900,광주광역시,2904,북구,신안동,소계,9483,6879,5824,821,112,2,55,4,1,0,1,14,0,1,6835,44,2604
2900,광주광역시,2904,북구,,관내사전투표,3865,3865,3380,388,50,1,20,3,0,0,1,10,0,1,3854,11,0
2900,광주광역시,2904,북구,,신안동제1투,2366,1164,963,159,17,1,17,0,0,0,0,3,0,0,1160,4,1202
2900,광주광역시,2904,북구,,신안동제2투,1519,905,754,106,18,0,10,1,0,0,0,1,0,0,890,15,614
2900,광주광역시,2904,북구,,신안동제3투,1733,945,727,168,27,0,8,0,1,0,0,0,0,0,931,14,788
2900,광주광역시,2904,북구,용봉동,소계,25724,19856,16074,3051,379,8,121,5,0,5,2,27,4,8,19684,172,5868
2900,광주광역시,2904,북구,,관내사전투표,8241,8241,6680,1256,189,3,36,3,0,0,0,12,3,3,8185,56,0
2900,광주광역시,2904,북구,,용봉동제1투,2258,1291,1009,224,25,1,9,0,0,1,1,2,0,1,1273,18,967
2900,광주광역시,2904,북구,,용봉동제2투,1853,1207,939,222,21,0,14,0,0,1,0,2,0,0,1199,8,646
2900,광주광역시,2904,북구,,용봉동제3투,1894,1247,995,195,20,1,11,1,0,1,1,3,1,0,1229,18,647
2900,광주광역시,2904,북구,,용봉동제4투,1461,741,505,175,22,1,7,0,0,2,0,2,0,1,715,26,720
2900,광주광역시,2904,북구,,용봉동제5투,2013,1406,1171,192,27,0,8,0,0,0,0,1,0,0,1399,7,607
2900,광주광역시,2904,북구,,용봉동제6투,2246,1643,1405,186,18,1,15,0,0,0,0,2,0,0,1627,16,603
2900,광주광역시,2904,북구,,용봉동제7투,1744,1253,1021,198,16,1,7,0,0,0,0,1,0,1,1245,8,491
2900,광주광역시,2904,북구,,용봉동제8투,1762,1205,990,178,19,0,6,1,0,0,0,2,0,1,1197,8,557
2900,광주광역시,2904,북구,,용봉동제9투,2252,1622,1359,225,22,0,8,0,0,0,0,0,0,1,1615,7,630
2900,광주광역시,2904,북구,운암1동,소계,14012,11820,9930,1597,171,2,50,0,0,1,0,6,0,1,11758,62,2192
2900,광주광역시,2904,북구,,관내사전투표,6606,6608,5714,771,81,1,17,0,0,0,0,1,0,1,6586,22,-2
2900,광주광역시,2904,북구,,운암1동제1투,2020,1318,1068,201,31,0,9,0,0,0,0,1,0,0,1310,8,702
2900,광주광역시,2904,북구,,운암1동제2투,1879,1255,999,225,13,0,9,0,0,1,0,0,0,0,1247,8,624
2900,광주광역시,2904,북구,,운암1동제3투,1359,1051,888,132,15,1,9,0,0,0,0,2,0,0,1047,4,308
2900,광주광역시,2904,북구,,운암1동제4투,2148,1588,1261,268,31,0,6,0,0,0,0,2,0,0,1568,20,560
2900,광주광역시,2904,북구,운암2동,소계,10554,8231,7132,880,110,3,35,1,1,3,2,22,2,3,8194,37,2323
2900,광주광역시,2904,북구,,관내사전투표,5419,5419,4780,523,59,1,18,1,1,2,0,14,0,3,5402,17,0
2900,광주광역시,2904,북구,,운암2동제1투,1122,516,431,69,6,0,7,0,0,0,0,0,1,0,514,2,606
2900,광주광역시,2904,북구,,운암2동제2투,1087,548,469,57,10,1,4,0,0,0,0,2,0,0,543,5,539
2900,광주광역시,2904,북구,,운암2동제3투,1344,789,656,107,20,0,0,0,0,1,0,1,0,0,785,4,555
2900,광주광역시,2904,북구,,운암2동제4투,1582,959,796,124,15,1,6,0,0,0,2,5,1,0,950,9,623
2900,광주광역시,2904,북구,운암3동,소계,9689,7907,6737,959,102,2,39,2,0,1,0,16,1,5,7864,43,1782
2900,광주광역시,2904,북구,,관내사전투표,4859,4857,4220,535,52,0,16,0,0,1,0,9,1,3,4837,20,2
2900,광주광역시,2904,북구,,운암3동제1투,1586,982,819,123,17,1,9,1,0,0,0,4,0,1,975,7,604
2900,광주광역시,2904,북구,,운암3동제2투,1237,760,611,128,11,1,4,0,0,0,0,0,0,0,755,5,477
2900,광주광역시,2904,북구,,운암3동제3투,2007,1308,1087,173,22,0,10,1,0,0,0,3,0,1,1297,11,699
2900,광주광역시,2904,북구,동림동,소계,15512,12311,10664,1300,181,3,75,2,1,1,2,23,2,0,12254,57,3201
2900,광주광역시,2904,북구,,관내사전투표,4951,4951,4425,429,53,0,15,2,0,0,0,11,0,0,4935,16,0
2900,광주광역시,2904,북구,,동림동제1투,2049,1386,1167,160,31,0,15,0,1,0,0,5,1,0,1380,6,663
2900,광주광역시,2904,북구,,동림동제2투,1428,897,735,130,13,1,7,0,0,1,0,1,0,0,888,9,531
2900,광주광역시,2904,북구,,동림동제3투,1828,1341,1132,158,29,2,6,0,0,0,2,4,1,0,1334,7,487
2900,광주광역시,2904,북구,,동림동제4투,2475,1836,1573,213,24,0,18,0,0,0,0,0,0,0,1828,8,639
2900,광주광역시,2904,북구,,동림동제5투,2781,1900,1632,210,31,0,14,0,0,0,0,2,0,0,1889,11,881
2900,광주광역시,2904,북구,우산동,소계,9242,7285,6201,898,98,3,34,0,2,1,0,6,1,3,7247,38,1957
2900,광주광역시,2904,북구,,관내사전투표,4714,4710,4068,541,55,1,20,0,0,1,0,3,1,3,4693,17,4
2900,광주광역시,2904,북구,,우산동제1투,548,266,231,28,1,0,3,0,0,0,0,0,0,0,263,3,282
2900,광주광역시,2904,북구,,우산동제2투,1109,609,519,73,7,0,4,0,1,0,0,1,0,0,605,4,500
2900,광주광역시,2904,북구,,우산동제3투,1002,652,550,79,13,1,1,0,0,0,0,0,0,0,644,8,350
2900,광주광역시,2904,북구,,우산동제4투,951,469,382,66,12,0,2,0,0,0,0,2,0,0,464,5,482
2900,광주광역시,2904,북구,,우산동제5투,918,579,451,111,10,1,4,0,1,0,0,0,0,0,578,1,339
2900,광주광역시,2904,북구,풍향동,소계,3873,3013,2491,435,39,4,15,0,1,1,1,3,0,1,2991,22,860
2900,광주광역시,2904,북구,,관내사전투표,1751,1751,1507,206,18,1,7,0,1,1,0,3,0,1,1745,6,0
2900,광주광역시,2904,북구,,풍향동제1투,1455,916,705,180,12,2,6,0,0,0,0,0,0,0,905,11,539
2900,광주광역시,2904,북구,,풍향동제2투,667,346,279,49,9,1,2,0,0,0,1,0,0,0,341,5,321
2900,광주광역시,2904,북구,문화동,소계,14232,10988,9364,1335,138,3,49,2,0,1,3,8,0,6,10909,79,3244
2900,광주광역시,2904,북구,,관내사전투표,5122,5122,4541,489,39,3,14,1,0,0,1,2,0,3,5093,29,0
2900,광주광역시,2904,북구,,문화동제1투,1645,878,715,124,14,0,8,0,0,0,1,2,0,1,865,13,767
2900,광주광역시,2904,북구,,문화동제2투,872,605,503,88,8,0,3,0,0,0,0,0,0,0,602,3,267
2900,광주광역시,2904,북구,,문화동제3투,1758,1158,953,169,16,0,8,1,0,1,0,1,0,1,1150,8,600
2900,광주광역시,2904,북구,,문화동제4투,1750,1033,827,166,20,0,4,0,0,0,1,1,0,1,1020,13,717
2900,광주광역시,2904,북구,,문화동제5투,1129,730,584,115,19,0,5,0,0,0,0,0,0,0,723,7,399
2900,광주광역시,2904,북구,,문화동제6투,1956,1462,1241,184,22,0,7,0,0,0,0,2,0,0,1456,6,494
2900,광주광역시,2904,북구,문흥1동,소계,12334,10238,8762,1200,121,8,56,1,1,0,1,15,6,1,10172,66,2096
2900,광주광역시,2904,북구,,관내사전투표,6481,6480,5660,683,62,1,32,0,1,0,1,11,4,0,6455,25,1
2900,광주광역시,2904,북구,,문흥1동제1투,1191,746,616,109,9,0,5,0,0,0,0,1,0,0,740,6,445
2900,광주광역시,2904,북구,,문흥1동제2투,1105,644,527,91,11,5,2,0,0,0,0,1,2,1,640,4,461
2900,광주광역시,2904,북구,,문흥1동제3투,1347,899,737,120,19,0,8,1,0,0,0,0,0,0,885,14,448
2900,광주광역시,2904,북구,,문흥1동제4투,1177,806,676,106,8,1,3,0,0,0,0,1,0,0,795,11,371
2900,광주광역시,2904,북구,,문흥1동제5투,1033,663,546,91,12,1,6,0,0,0,0,1,0,0,657,6,370
2900,광주광역시,2904,북구,문흥2동,소계,11848,9308,7937,1094,142,6,57,5,1,0,0,14,0,5,9261,47,2540
2900,광주광역시,2904,북구,,관내사전투표,5183,5183,4600,462,57,4,30,3,0,0,0,8,0,4,5168,15,0
2900,광주광역시,2904,북구,,문흥2동제1투,1200,722,599,103,8,1,7,0,0,0,0,1,0,0,719,3,478
2900,광주광역시,2904,북구,,문흥2동제2투,1176,757,631,102,14,0,2,0,0,0,0,0,0,0,749,8,419
2900,광주광역시,2904,북구,,문흥2동제3투,1473,936,785,114,21,0,6,1,0,0,0,1,0,1,929,7,537
2900,광주광역시,2904,북구,,문흥2동제4투,1431,859,664,165,18,0,5,1,0,0,0,1,0,0,854,5,572
2900,광주광역시,2904,북구,,문흥2동제5투,1385,851,658,148,24,1,7,0,1,0,0,3,0,0,842,9,534
2900,광주광역시,2904,북구,두암1동,소계,6476,5062,4382,542,63,1,31,1,0,0,1,2,1,1,5025,37,1414
2900,광주광역시,2904,북구,,관내사전투표,3162,3162,2794,309,28,0,9,1,0,0,1,2,1,0,3145,17,0
2900,광주광역시,2904,북구,,두암1동제1투,1071,613,482,104,17,0,8,0,0,0,0,0,0,0,611,2,458
2900,광주광역시,2904,북구,,두암1동제2투,1193,638,549,61,10,0,8,0,0,0,0,0,0,0,628,10,555
2900,광주광역시,2904,북구,,두암1동제3투,1050,649,557,68,8,1,6,0,0,0,0,0,0,1,641,8,401
2900,광주광역시,2904,북구,두암2동,소계,12265,9439,8117,1046,129,5,53,2,5,0,1,13,1,5,9377,62,2826
2900,광주광역시,2904,북구,,관내사전투표,5478,5478,4828,514,63,2,21,0,0,0,1,10,1,5,5445,33,0
2900,광주광역시,2904,북구,,두암2동제1투,1324,700,576,95,16,1,6,1,0,0,0,0,0,0,695,5,624
2900,광주광역시,2904,북구,,두암2동제2투,2430,1371,1150,179,15,1,10,0,5,0,0,0,0,0,1360,11,1059
2900,광주광역시,2904,북구,,두암2동제3투,1357,771,630,111,15,1,8,0,0,0,0,1,0,0,766,5,586
2900,광주광역시,2904,북구,,두암2동제4투,1676,1119,933,147,20,0,8,1,0,0,0,2,0,0,1111,8,557
2900,광주광역시,2904,북구,두암3동,소계,10919,8380,7287,874,97,5,44,4,1,3,0,3,2,5,8325,55,2539
2900,광주광역시,2904,북구,,관내사전투표,5002,5002,4466,442,46,2,17,3,1,1,0,1,1,3,4983,19,0
2900,광주광역시,2904,북구,,두암3동제1투,697,247,193,41,5,0,5,0,0,0,0,0,0,1,245,2,450
2900,광주광역시,2904,북구,,두암3동제2투,1239,744,615,103,11,0,4,0,0,0,0,0,0,0,733,11,495
2900,광주광역시,2904,북구,,두암3동제3투,1182,650,545,83,12,1,4,0,0,1,0,1,0,0,647,3,532
2900,광주광역시,2904,북구,,두암3동제4투,1308,773,654,86,9,2,9,0,0,1,0,0,0,1,762,11,535
2900,광주광역시,2904,북구,,두암3동제5투,1491,964,814,119,14,0,5,1,0,0,0,1,1,0,955,9,527
2900,광주광역시,2904,북구,삼각동,소계,10911,8677,7404,982,145,3,62,2,0,2,1,14,2,3,8620,57,2234
2900,광주광역시,2904,북구,,관내사전투표,5042,5039,4408,489,84,0,23,1,0,1,0,9,0,1,5016,23,3
2900,광주광역시,2904,북구,,삼각동제1투,2211,1248,1009,187,23,2,18,0,0,0,1,1,0,0,1241,7,963
2900,광주광역시,2904,북구,,삼각동제2투,1690,1236,1038,154,19,0,11,1,0,0,0,2,0,0,1225,11,454
2900,광주광역시,2904,북구,,삼각동제3투,1968,1154,949,152,19,1,10,0,0,1,0,2,2,2,1138,16,814
2900,광주광역시,2904,북구,일곡동,소계,20874,17012,14491,1987,257,12,107,2,2,2,0,23,4,8,16895,117,3862
2900,광주광역시,2904,북구,,관내사전투표,9049,9048,7935,900,106,2,43,2,1,2,0,10,1,2,9004,44,1
2900,광주광역시,2904,북구,,일곡동제1투,2587,1678,1377,232,35,1,17,0,0,0,0,3,0,3,1668,10,909
2900,광주광역시,2904,북구,,일곡동제2투,1940,1064,854,158,18,5,15,0,0,0,0,2,1,1,1054,10,876
2900,광주광역시,2904,북구,,일곡동제3투,1344,954,812,93,20,2,5,0,0,0,0,3,1,1,937,17,390
2900,광주광역시,2904,북구,,일곡동제4투,1833,1238,1055,144,20,0,8,0,1,0,0,2,0,1,1231,7,595
2900,광주광역시,2904,북구,,일곡동제5투,2071,1604,1349,205,24,0,13,0,0,0,0,2,0,0,1593,11,467
2900,광주광역시,2904,북구,,일곡동제6투,2050,1426,1109,255,34,2,6,0,0,0,0,1,1,0,1408,18,624
2900,광주광역시,2904,북구,매곡동,소계,12260,10412,8981,1139,160,5,60,0,0,1,0,16,1,4,10367,45,1848
2900,광주광역시,2904,북구,,관내사전투표,6848,6848,6037,666,86,3,25,0,0,0,0,12,1,2,6832,16,0
2900,광주광역시,2904,북구,,매곡동제1투,1446,930,781,119,14,0,7,0,0,0,0,0,0,0,921,9,516
2900,광주광역시,2904,북구,,매곡동제2투,1710,1046,841,151,26,2,15,0,0,1,0,1,0,0,1037,9,664
2900,광주광역시,2904,북구,,매곡동제3투,2256,1588,1322,203,34,0,13,0,0,0,0,3,0,2,1577,11,668
2900,광주광역시,2904,북구,오치1동,소계,8232,6222,5107,890,96,3,73,2,0,0,0,4,2,4,6181,41,2010
2900,광주광역시,2904,북구,,관내사전투표,3425,3426,2931,395,42,2,32,0,0,0,0,3,2,3,3410,16,-1
2900,광주광역시,2904,북구,,오치1동제1투,1626,873,684,145,19,0,15,0,0,0,0,1,0,0,864,9,753
2900,광주광역시,2904,북구,,오치1동제2투,1558,949,738,168,13,0,18,2,0,0,0,0,0,1,940,9,609
2900,광주광역시,2904,북구,,오치1동제3투,1623,974,754,182,22,1,8,0,0,0,0,0,0,0,967,7,649
2900,광주광역시,2904,북구,오치2동,소계,11687,9218,7755,1142,165,4,68,3,1,3,3,9,3,9,9165,53,2469
2900,광주광역시,2904,북구,,관내사전투표,5911,5910,5087,654,97,3,32,1,0,0,0,7,2,3,5886,24,1
2900,광주광역시,2904,북구,,오치2동제1투,1340,732,579,120,15,0,8,0,0,0,1,0,0,2,725,7,608
2900,광주광역시,2904,북구,,오치2동제2투,1326,723,608,87,6,1,10,1,1,2,0,0,0,2,718,5,603
2900,광주광역시,2904,북구,,오치2동제3투,1392,738,577,123,19,0,7,1,0,0,0,2,0,1,730,8,654
2900,광주광역시,2904,북구,,오치2동제4투,1718,1115,904,158,28,0,11,0,0,1,2,0,1,1,1106,9,603
2900,광주광역시,2904,북구,석곡동,소계,2240,1840,1604,185,30,1,4,2,0,0,1,2,0,2,1831,9,400
2900,광주광역시,2904,북구,,관내사전투표,1234,1234,1105,102,16,1,0,2,0,0,1,2,0,1,1230,4,0
2900,광주광역시,2904,북구,,석곡동제1투,719,392,315,57,11,0,4,0,0,0,0,0,0,1,388,4,327
2900,광주광역시,2904,북구,,석곡동제2투,287,214,184,26,3,0,0,0,0,0,0,0,0,0,213,1,73
2900,광주광역시,2904,북구,건국동,소계,15544,12200,10565,1305,170,3,79,2,1,0,1,11,1,4,12142,58,3344
2900,광주광역시,2904,북구,,관내사전투표,6729,6728,5968,615,82,2,29,1,1,0,0,7,1,1,6707,21,1
2900,광주광역시,2904,북구,,건국동제1투,3303,2164,1821,265,41,1,22,0,0,0,0,3,0,0,2153,11,1139
2900,광주광역시,2904,북구,,건국동제2투,2345,1555,1306,198,21,0,15,0,0,0,1,0,0,1,1542,13,790
2900,광주광역시,2904,북구,,건국동제3투,1300,682,578,81,10,0,5,1,0,0,0,1,0,2,678,4,618
2900,광주광역시,2904,북구,,건국동제4투,1867,1071,892,146,16,0,8,0,0,0,0,0,0,0,1062,9,796
2900,광주광역시,2904,북구,양산동,소계,26248,20023,17268,2144,292,6,145,2,1,3,4,27,2,4,19898,125,6225
2900,광주광역시,2904,북구,,관내사전투표,8180,8180,7312,708,97,2,23,0,0,1,1,12,1,0,8157,23,0
2900,광주광역시,2904,북구,,양산동제1투,3637,1969,1646,246,31,0,24,0,0,2,1,0,1,0,1951,18,1668
2900,광주광역시,2904,북구,,양산동제2투,2685,1700,1416,222,24,0,20,1,0,0,1,3,0,0,1687,13,985
2900,광주광역시,2904,북구,,양산동제3투,2363,1661,1413,189,24,0,20,0,0,0,0,1,0,1,1648,13,702
2900,광주광역시,2904,북구,,양산동제4투,2425,1654,1396,207,24,2,9,0,1,0,1,3,0,1,1644,10,771
2900,광주광역시,2904,북구,,양산동제5투,2681,1820,1561,182,28,1,20,1,0,0,0,4,0,2,1799,21,861
2900,광주광역시,2904,북구,,양산동제6투,2195,1406,1184,147,34,1,20,0,0,0,0,4,0,0,1390,16,789
2900,광주광역시,2904,북구,,양산동제7투,2082,1633,1340,243,30,0,9,0,0,0,0,0,0,0,1622,11,449
2900,광주광역시,2904,북구,신용동,소계,18465,14709,12608,1687,228,11,94,1,3,1,2,9,0,2,14646,63,3756
2900,광주광역시,2904,북구,,관내사전투표,6063,6061,5290,633,80,2,34,0,1,0,0,1,0,1,6042,19,2
2900,광주광역시,2904,북구,,신용동제1투,2250,1577,1327,197,22,5,13,1,1,0,0,2,0,1,1569,8,673
2900,광주광역시,2904,북구,,신용동제2투,2757,2038,1696,282,33,1,10,0,0,1,0,1,0,0,2024,14,719
2900,광주광역시,2904,북구,,신용동제3투,2375,1626,1379,195,25,3,14,0,1,0,0,1,0,0,1618,8,749
2900,광주광역시,2904,북구,,신용동제4투,3176,2083,1765,247,45,0,16,0,0,0,0,1,0,0,2074,9,1093
2900,광주광역시,2904,북구,,신용동제5투,1844,1324,1151,133,23,0,7,0,0,0,2,3,0,0,1319,5,520
2900,광주광역시,2904,북구,잘못 투입·구분된 투표지,,0,6,6,0,0,0,0,0,0,0,0,0,0,0,6,0,-6
2900,광주광역시,2905,광산구,합계,,326650,264470,224484,30865,4218,133,1915,79,26,31,31,480,51,165,262478,1992,62180
2900,광주광역시,2905,광산구,거소·선상투표,,715,652,447,103,11,0,18,1,1,0,1,1,0,1,584,68,63
2900,광주광역시,2905,광산구,관외사전투표,,35994,35993,29222,5246,649,33,378,19,4,5,2,56,9,28,35651,342,1
2900,광주광역시,2905,광산구,재외투표,,737,542,396,67,25,0,1,0,0,0,0,1,0,0,490,52,195
2900,광주광역시,2905,광산구,송정1동,소계,8911,6977,5978,772,110,4,41,2,0,1,1,14,1,8,6932,45,1934
2900,광주광역시,2905,광산구,,관내사전투표,3895,3895,3410,398,48,2,12,1,0,1,1,5,1,1,3880,15,0
2900,광주광역시,2905,광산구,,송정1동제1투,1656,879,714,123,15,2,7,1,0,0,0,1,0,2,865,14,777
2900,광주광역시,2905,광산구,,송정1동제2투,1293,739,620,88,11,0,10,0,0,0,0,2,0,1,732,7,554
2900,광주광역시,2905,광산구,,송정1동제3투,2067,1464,1234,163,36,0,12,0,0,0,0,6,0,4,1455,9,603
2900,광주광역시,2905,광산구,송정2동,소계,6242,4916,4131,607,99,2,37,1,0,0,1,11,1,2,4892,24,1326
2900,광주광역시,2905,광산구,,관내사전투표,3093,3093,2649,340,64,2,18,1,0,0,0,6,1,2,3083,10,0
2900,광주광역시,2905,광산구,,송정2동제1투,996,477,382,79,9,0,3,0,0,0,0,0,0,0,473,4,519
2900,광주광역시,2905,광산구,,송정2동제2투,892,458,361,78,9,0,8,0,0,0,0,1,0,0,457,1,434
2900,광주광역시,2905,광산구,,송정2동제3투,1261,888,739,110,17,0,8,0,0,0,1,4,0,0,879,9,373
2900,광주광역시,2905,광산구,도산동,소계,11621,9084,7827,960,120,6,75,2,0,1,1,23,3,6,9024,60,2537
2900,광주광역시,2905,광산구,,관내사전투표,4753,4753,4180,441,62,4,25,1,0,1,1,12,1,4,4732,21,0
2900,광주광역시,2905,광산구,,도산동제1투,1759,1103,961,98,15,0,12,1,0,0,0,3,0,1,1091,12,656
2900,광주광역시,2905,광산구,,도산동제2투,2742,1686,1333,269,31,2,25,0,0,0,0,5,0,1,1666,20,1056
2900,광주광역시,2905,광산구,,도산동제3투,2367,1542,1353,152,12,0,13,0,0,0,0,3,2,0,1535,7,825
2900,광주광역시,2905,광산구,신흥동,소계,3711,2836,2451,307,28,1,22,0,1,0,1,3,0,3,2817,19,875
2900,광주광역시,2905,광산구,,관내사전투표,1785,1785,1547,191,20,0,12,0,1,0,0,0,0,3,1774,11,0
2900,광주광역시,2905,광산구,,신흥동제1투,730,388,345,33,2,0,4,0,0,0,1,1,0,0,386,2,342
2900,광주광역시,2905,광산구,,신흥동제2투,1196,663,559,83,6,1,6,0,0,0,0,2,0,0,657,6,533
2900,광주광역시,2905,광산구,어룡동,소계,21368,16263,14070,1646,261,5,115,6,3,5,2,29,3,12,16157,106,5105
2900,광주광역시,2905,광산구,,관내사전투표,6941,6941,6202,559,88,3,32,3,2,3,2,15,0,6,6915,26,0
2900,광주광역시,2905,광산구,,어룡동제1투,2413,1436,1222,151,20,0,23,2,0,0,0,4,1,1,1424,12,977
2900,광주광역시,2905,광산구,,어룡동제2투,1738,1127,938,154,20,0,5,1,0,0,0,1,0,0,1119,8,611
2900,광주광역시,2905,광산구,,어룡동제3투,1417,951,791,110,25,0,8,0,0,0,0,2,1,0,937,14,466
2900,광주광역시,2905,광산구,,어룡동제4투,1245,613,522,59,10,1,10,0,0,0,0,1,1,1,605,8,632
2900,광주광역시,2905,광산구,,어룡동제5투,2962,1979,1693,203,40,1,15,0,0,0,0,3,0,3,1958,21,983
2900,광주광역시,2905,광산구,,어룡동제6투,2317,1621,1354,211,27,0,12,0,1,2,0,3,0,0,1610,11,696
2900,광주광역시,2905,광산구,,어룡동제7투,2335,1595,1348,199,31,0,10,0,0,0,0,0,0,1,1589,6,740
2900,광주광역시,2905,광산구,우산동,소계,22780,17462,14884,1972,280,7,138,5,2,6,2,33,1,8,17338,124,5318
2900,광주광역시,2905,광산구,,관내사전투표,7930,7930,6949,772,98,2,45,2,1,1,0,17,0,2,7889,41,0
2900,광주광역시,2905,광산구,,우산동제1투,2453,1431,1161,204,34,2,15,0,1,0,1,4,0,0,1422,9,1022
2900,광주광역시,2905,광산구,,우산동제2투,2487,1811,1456,293,36,0,9,0,0,1,0,4,0,0,1799,12,676
2900,광주광역시,2905,광산구,,우산동제3투,2768,1657,1397,180,33,1,22,2,0,0,0,1,1,2,1639,18,1111
2900,광주광역시,2905,광산구,,우산동제4투,2100,1350,1161,130,23,0,17,0,0,0,1,2,0,0,1334,16,750
2900,광주광역시,2905,광산구,,우산동제5투,2047,1510,1284,183,25,0,9,1,0,1,0,0,0,0,1503,7,537
2900,광주광역시,2905,광산구,,우산동제6투,1250,729,605,83,16,2,10,0,0,1,0,2,0,1,720,9,521
2900,광주광역시,2905,광산구,,우산동제7투,1745,1044,871,127,15,0,11,0,0,2,0,3,0,3,1032,12,701
2900,광주광역시,2905,광산구,월곡1동,소계,10286,8191,7101,790,134,4,53,5,0,2,0,29,2,2,8122,69,2095
2900,광주광역시,2905,광산구,,관내사전투표,4628,4628,4120,380,56,3,23,1,0,2,0,13,1,1,4600,28,0
2900,광주광역시,2905,광산구,,월곡1동제1투,1085,576,485,66,10,1,7,1,0,0,0,2,0,0,572,4,509
2900,광주광역시,2905,광산구,,월곡1동제2투,832,472,399,56,8,0,2,0,0,0,0,1,0,1,467,5,360
2900,광주광역시,2905,광산구,,월곡1동제3투,2101,1560,1317,170,40,0,10,1,0,0,0,7,1,0,1546,14,541
2900,광주광역시,2905,광산구,,월곡1동제4투,1640,955,780,118,20,0,11,2,0,0,0,6,0,0,937,18,685
2900,광주광역시,2905,광산구,월곡2동,소계,11190,8778,7577,919,131,6,53,0,0,1,1,23,1,6,8718,60,2412
2900,광주광역시,2905,광산구,,관내사전투표,4333,4333,3831,413,40,2,19,0,0,1,1,8,0,1,4316,17,0
2900,광주광역시,2905,광산구,,월곡2동제1투,1018,522,420,73,13,0,3,0,0,0,0,3,0,0,512,10,496
2900,광주광역시,2905,광산구,,월곡2동제2투,1078,624,529,76,10,1,1,0,0,0,0,1,0,1,619,5,454
2900,광주광역시,2905,광산구,,월곡2동제3투,1747,1089,897,142,23,2,11,0,0,0,0,2,0,2,1079,10,658
2900,광주광역시,2905,광산구,,월곡2동제4투,1576,1169,1001,122,23,1,8,0,0,0,0,3,0,0,1158,11,407
2900,광주광역시,2905,광산구,,월곡2동제5투,1438,1041,899,93,22,0,11,0,0,0,0,6,1,2,1034,7,397
2900,광주광역시,2905,광산구,비아동,소계,6601,5266,4603,528,65,4,34,2,0,0,0,4,0,3,5243,23,1335
2900,광주광역시,2905,광산구,,관내사전투표,3485,3484,3079,326,47,3,15,0,0,0,0,2,0,1,3473,11,1
2900,광주광역시,2905,광산구,,비아동제1투,1327,777,649,103,7,0,10,1,0,0,0,0,0,1,771,6,550
2900,광주광역시,2905,광산구,,비아동제2투,1789,1005,875,99,11,1,9,1,0,0,0,2,0,1,999,6,784
2900,광주광역시,2905,광산구,첨단1동,소계,20578,16899,14090,2245,296,4,108,7,0,0,3,17,4,6,16780,119,3679
2900,광주광역시,2905,광산구,,관내사전투표,9064,9059,7725,1080,149,2,37,4,0,0,3,5,3,3,9011,48,5
2900,광주광역시,2905,광산구,,첨단1동제1투,2267,1656,1344,257,25,0,11,1,0,0,0,3,1,0,1642,14,611
2900,광주광역시,2905,광산구,,첨단1동제2투,2057,1459,1189,216,25,1,13,1,0,0,0,5,0,0,1450,9,598
2900,광주광역시,2905,광산구,,첨단1동제3투,2591,1859,1514,277,33,0,11,0,0,0,0,1,0,2,1838,21,732
2900,광주광역시,2905,광산구,,첨단1동제4투,1900,1324,1073,183,41,0,13,1,0,0,0,0,0,1,1312,12,576
2900,광주광역시,2905,광산구,,첨단1동제5투,2699,1542,1245,232,23,1,23,0,0,0,0,3,0,0,1527,15,1157
2900,광주광역시,2905,광산구,첨단2동,소계,29292,22464,19035,2647,408,15,150,2,2,1,4,31,2,13,22310,154,6828
2900,광주광역시,2905,광산구,,관내사전투표,8585,8585,7566,827,111,5,33,1,0,0,1,10,0,3,8557,28,0
2900,광주광역시,2905,광산구,,첨단2동제1투,1322,768,644,97,10,1,4,1,0,0,0,1,1,1,760,8,554
2900,광주광역시,2905,광산구,,첨단2동제2투,2265,1258,1001,178,47,1,15,0,0,0,0,1,0,0,1243,15,1007
2900,광주광역시,2905,광산구,,첨단2동제3투,1797,1165,923,181,28,0,16,0,0,0,2,3,0,1,1154,11,632
2900,광주광역시,2905,광산구,,첨단2동제4투,1754,1147,959,135,28,0,11,0,0,0,0,2,0,0,1135,12,607
2900,광주광역시,2905,광산구,,첨단2동제5투,2503,1978,1681,232,33,3,8,0,0,1,0,1,0,1,1960,18,525
2900,광주광역시,2905,광산구,,첨단2동제6투,1859,1426,1235,135,28,3,7,0,0,0,0,5,0,3,1416,10,433
2900,광주광역시,2905,광산구,,첨단2동제7투,2380,1783,1522,193,41,0,10,0,1,0,0,2,0,0,1769,14,597
2900,광주광역시,2905,광산구,,첨단2동제8투,1726,952,771,130,14,1,19,0,1,0,0,3,0,2,941,11,774
2900,광주광역시,2905,광산구,,첨단2동제9투,2142,1591,1360,173,25,0,13,0,0,0,1,2,1,0,1575,16,551
2900,광주광역시,2905,광산구,,첨단2동제10투,2959,1811,1373,366,43,1,14,0,0,0,0,1,0,2,1800,11,1148
2900,광주광역시,2905,광산구,신가동,소계,13357,10673,9225,1114,162,0,70,3,1,2,3,15,2,3,10600,73,2684
2900,광주광역시,2905,광산구,,관내사전투표,5634,5633,4971,518,74,0,26,3,1,1,2,10,0,0,5606,27,1
2900,광주광역시,2905,광산구,,신가동제1투,2346,1341,1099,182,24,0,15,0,0,1,0,4,0,1,1326,15,1005
2900,광주광역시,2905,광산구,,신가동제2투,1974,1401,1181,173,21,0,10,0,0,0,0,0,0,1,1386,15,573
2900,광주광역시,2905,광산구,,신가동제3투,3403,2298,1974,241,43,0,19,0,0,0,1,1,2,1,2282,16,1105
2900,광주광역시,2905,광산구,운남동,소계,23329,19133,16629,1849,297,7,133,4,1,0,1,60,3,13,18997,136,4196
2900,광주광역시,2905,광산구,,관내사전투표,9266,9266,8226,819,108,2,47,1,0,0,1,25,0,0,9229,37,0
2900,광주광역시,2905,광산구,,운남동제1투,1400,910,765,102,21,0,12,0,0,0,0,5,0,1,906,4,490
2900,광주광역시,2905,광산구,,운남동제2투,1917,1314,1109,143,30,1,10,0,1,0,0,6,1,0,1301,13,603
2900,광주광역시,2905,광산구,,운남동제3투,2647,1728,1475,190,23,1,14,2,0,0,0,5,0,2,1712,16,919
2900,광주광역시,2905,광산구,,운남동제4투,1738,1246,1086,110,28,0,7,0,0,0,0,3,1,3,1238,8,492
2900,광주광역시,2905,광산구,,운남동제5투,1460,1079,906,112,24,0,16,1,0,0,0,1,0,2,1062,17,381
2900,광주광역시,2905,광산구,,운남동제6투,1650,1290,1106,139,18,1,13,0,0,0,0,1,1,1,1280,10,360
2900,광주광역시,2905,광산구,,운남동제7투,1705,1144,958,124,23,1,10,0,0,0,0,4,0,4,1124,20,561
2900,광주광역시,2905,광산구,,운남동제8투,1546,1156,998,110,22,1,4,0,0,0,0,10,0,0,1145,11,390
2900,광주광역시,2905,광산구,신창동,소계,24354,19132,16465,2037,297,9,142,8,2,1,2,36,2,6,19007,125,5222
2900,광주광역시,2905,광산구,,관내사전투표,9728,9728,8563,919,143,3,41,0,0,0,1,17,1,1,9689,39,0
2900,광주광역시,2905,광산구,,신창동제1투,759,449,373,53,8,0,8,0,1,0,0,1,0,0,444,5,310
2900,광주광역시,2905,광산구,,신창동제2투,2604,1713,1467,186,22,1,14,2,0,0,0,4,0,2,1698,15,891
2900,광주광역시,2905,광산구,,신창동제3투,1223,830,675,112,19,1,10,1,0,0,0,5,0,1,824,6,393
2900,광주광역시,2905,광산구,,신창동제4투,2855,1679,1386,213,28,2,23,4,0,0,0,4,0,1,1661,18,1176
2900,광주광역시,2905,광산구,,신창동제5투,3053,1835,1512,244,30,1,23,0,1,1,0,1,0,1,1814,21,1218
2900,광주광역시,2905,광산구,,신창동제6투,1970,1498,1304,149,21,0,7,1,0,0,1,2,1,0,1486,12,472
2900,광주광역시,2905,광산구,,신창동제7투,2162,1400,1185,161,26,1,16,0,0,0,0,2,0,0,1391,9,762
2900,광주광역시,2905,광산구,수완동,소계,46605,36594,30703,4836,561,14,206,2,4,2,3,44,4,15,36394,200,10011
2900,광주광역시,2905,광산구,,관내사전투표,13452,13451,11626,1563,153,3,45,0,4,0,2,14,2,3,13415,36,1
2900,광주광역시,2905,광산구,,수완동제1투,2541,2049,1682,287,41,2,17,0,0,0,1,2,0,1,2033,16,492
2900,광주광역시,2905,광산구,,수완동제2투,2708,2016,1715,240,22,2,15,0,0,0,0,4,0,2,2000,16,692
2900,광주광역시,2905,광산구,,수완동제3투,1980,1318,1119,147,21,0,12,0,0,1,0,1,1,1,1303,15,662
2900,광주광역시,2905,광산구,,수완동제4투,3732,2477,2091,301,44,2,13,0,0,0,0,4,1,2,2458,19,1255
2900,광주광역시,2905,광산구,,수완동제5투,2282,1655,1277,318,34,0,12,0,0,0,0,3,0,0,1644,11,627
2900,광주광역시,2905,광산구,,수완동제6투,3024,2258,1906,285,44,0,11,0,0,0,0,2,0,2,2250,8,766
2900,광주광역시,2905,광산구,,수완동제7투,3097,1960,1680,212,32,0,19,0,0,1,0,3,0,1,1948,12,1137
2900,광주광역시,2905,광산구,,수완동제8투,2641,1927,1498,366,42,4,3,0,0,0,0,2,0,0,1915,12,714
2900,광주광역시,2905,광산구,,수완동제9투,2565,1530,1163,313,28,0,12,0,0,0,0,0,0,1,1517,13,1035
2900,광주광역시,2905,광산구,,수완동제10투,1935,1344,1051,244,24,1,11,0,0,0,0,5,0,0,1336,8,591
2900,광주광역시,2905,광산구,,수완동제11투,2348,1724,1475,188,38,0,12,2,0,0,0,2,0,0,1717,7,624
2900,광주광역시,2905,광산구,,수완동제12투,2213,1393,1127,210,23,0,11,0,0,0,0,0,0,2,1373,20,820
2900,광주광역시,2905,광산구,,수완동제13투,2087,1492,1293,162,15,0,13,0,0,0,0,2,0,0,1485,7,595
2900,광주광역시,2905,광산구,하남동,소계,17459,13457,11626,1432,184,5,89,3,1,1,2,18,6,5,13372,85,4002
2900,광주광역시,2905,광산구,,관내사전투표,6153,6153,5433,576,76,2,21,2,1,1,1,10,0,2,6125,28,0
2900,광주광역시,2905,광산구,,하남동제1투,2509,1296,1110,124,22,1,15,1,0,0,0,1,4,1,1279,17,1213
2900,광주광역시,2905,광산구,,하남동제2투,507,266,222,35,3,0,5,0,0,0,0,0,0,0,265,1,241
2900,광주광역시,2905,광산구,,하남동제3투,2849,2009,1737,203,33,1,18,0,0,0,0,5,0,2,1999,10,840
2900,광주광역시,2905,광산구,,하남동제4투,2898,2029,1708,261,25,1,17,0,0,0,0,1,0,0,2013,16,869
2900,광주광역시,2905,광산구,,하남동제5투,2543,1704,1416,233,25,0,13,0,0,0,1,1,2,0,1691,13,839
2900,광주광역시,2905,광산구,임곡동,소계,2082,1666,1467,151,21,1,7,2,0,0,0,3,0,2,1654,12,416
2900,광주광역시,2905,광산구,,관내사전투표,1267,1267,1140,99,12,1,4,2,0,0,0,2,0,2,1262,5,0
2900,광주광역시,2905,광산구,,임곡동제1투,424,203,172,24,3,0,2,0,0,0,0,0,0,0,201,2,221
2900,광주광역시,2905,광산구,,임곡동제2투,391,196,155,28,6,0,1,0,0,0,0,1,0,0,191,5,195
2900,광주광역시,2905,광산구,동곡동,소계,1682,1354,1174,127,16,0,10,1,1,0,0,5,1,5,1340,14,328
2900,광주광역시,2905,광산구,,관내사전투표,863,863,758,78,7,0,8,0,0,0,0,2,0,1,854,9,0
2900,광주광역시,2905,광산구,,동곡동투표소,819,491,416,49,9,0,2,1,1,0,0,3,1,4,486,5,328
2900,광주광역시,2905,광산구,평동,소계,4178,3316,2926,284,33,3,26,3,2,1,0,12,0,1,3291,25,862
2900,광주광역시,2905,광산구,,관내사전투표,2444,2444,2182,195,25,1,14,3,1,0,0,9,0,1,2431,13,0
2900,광주광역시,2905,광산구,,평동제1투,1040,476,399,49,7,1,10,0,1,1,0,1,0,0,469,7,564
2900,광주광역시,2905,광산구,,평동제2투,694,396,345,40,1,1,2,0,0,0,0,2,0,0,391,5,298
2900,광주광역시,2905,광산구,삼도동,소계,1928,1546,1368,104,10,1,1,1,1,1,0,8,1,13,1509,37,382
2900,광주광역시,2905,광산구,,관내사전투표,1062,1062,938,68,5,1,1,1,1,1,0,6,1,10,1033,29,0
2900,광주광역시,2905,광산구,,삼도동제1투,508,254,220,22,4,0,0,0,0,0,0,1,0,2,249,5,254
2900,광주광역시,2905,광산구,,삼도동제2투,358,230,210,14,1,0,0,0,0,0,0,1,0,1,227,3,128
2900,광주광역시,2905,광산구,본량동,소계,1650,1274,1087,122,20,2,8,0,0,1,1,4,5,4,1254,20,376
2900,광주광역시,2905,광산구,,관내사전투표,830,830,729,68,8,2,4,0,0,0,1,3,3,0,818,12,0
2900,광주광역시,2905,광산구,,본량동제1투,543,297,244,31,8,0,3,0,0,0,0,1,1,3,291,6,246
2900,광주광역시,2905,광산구,,본량동제2투,277,147,114,23,4,0,1,0,0,1,0,0,1,1,145,2,130
2900,광주광역시,2905,광산구,잘못 투입·구분된 투표지,,0,2,2,0,0,0,0,0,0,0,0,0,0,0,2,0,-23000,대전광역시,3001,동구,합계,,192350,142804,65555,70069,3603,103,1606,34,28,41,111,157,44,82,141433,1371,49546
3000,대전광역시,3001,동구,거소·선상투표,,371,343,115,175,7,1,10,2,0,1,2,0,0,0,313,30,28
3000,대전광역시,3001,동구,관외사전투표,,17542,17542,8804,7731,511,22,226,2,5,5,8,20,4,13,17351,191,0
3000,대전광역시,3001,동구,재외투표,,567,410,256,102,11,0,2,0,0,0,0,0,0,0,371,39,157
3000,대전광역시,3001,동구,중앙동,소계,4652,3324,1421,1776,54,4,30,1,0,1,3,1,1,3,3295,29,1328
3000,대전광역시,3001,동구,,관내사전투표,1860,1860,928,874,34,2,12,0,0,0,1,0,0,0,1851,9,0
3000,대전광역시,3001,동구,,중앙동제1투,1346,704,250,428,8,0,7,0,0,0,1,1,1,0,696,8,642
3000,대전광역시,3001,동구,,중앙동제2투,1446,760,243,474,12,2,11,1,0,1,1,0,0,3,748,12,686
3000,대전광역시,3001,동구,신인동,소계,11111,8661,3860,4397,233,3,87,2,0,2,3,11,1,3,8602,59,2450
3000,대전광역시,3001,동구,,관내사전투표,4453,4453,2150,2128,112,2,26,0,0,0,1,7,0,2,4428,25,0
3000,대전광역시,3001,동구,,신인동제1투,1927,1180,469,641,31,0,22,1,0,2,0,2,1,1,1170,10,747
3000,대전광역시,3001,동구,,신인동제2투,2082,1268,464,746,35,1,13,0,0,0,0,0,0,0,1259,9,814
3000,대전광역시,3001,동구,,신인동제3투,1713,1122,469,581,38,0,18,1,0,0,2,1,0,0,1110,12,591
3000,대전광역시,3001,동구,,신인동제4투,936,638,308,301,17,0,8,0,0,0,0,1,0,0,635,3,298
3000,대전광역시,3001,동구,효동,소계,16846,12138,6009,5575,321,7,105,3,1,4,7,16,4,1,12053,85,4708
3000,대전광역시,3001,동구,,관내사전투표,4614,4614,2579,1852,121,3,30,1,1,1,0,6,1,1,4596,18,0
3000,대전광역시,3001,동구,,효동제1투,1751,1138,395,700,20,1,10,1,0,0,0,1,0,0,1128,10,613
3000,대전광역시,3001,동구,,효동제2투,1842,1229,558,611,32,0,10,0,0,0,2,1,0,0,1214,15,613
3000,대전광역시,3001,동구,,효동제3투,3080,1651,732,829,41,1,22,0,0,0,3,4,3,0,1635,16,1429
3000,대전광역시,3001,동구,,효동제4투,3067,1886,964,820,60,1,22,1,0,2,1,2,0,0,1873,13,1181
3000,대전광역시,3001,동구,,효동제5투,2492,1620,781,763,47,1,11,0,0,1,1,2,0,0,1607,13,872
3000,대전광역시,3001,동구,판암1동,소계,9576,7089,3193,3505,213,4,79,3,3,1,6,8,2,4,7021,68,2487
3000,대전광역시,3001,동구,,관내사전투표,3243,3243,1572,1527,84,1,29,2,1,0,2,3,1,0,3222,21,0
3000,대전광역시,3001,동구,,판암1동제1투,1858,1102,466,557,30,3,15,0,1,1,3,4,1,3,1084,18,756
3000,대전광역시,3001,동구,,판암1동제2투,2400,1440,582,768,50,0,19,0,1,0,0,1,0,1,1422,18,960
3000,대전광역시,3001,동구,,판암1동제3투,2075,1304,573,653,49,0,16,1,0,0,1,0,0,0,1293,11,771
3000,대전광역시,3001,동구,판암2동,소계,8210,6022,2623,3104,125,2,77,4,0,3,2,8,2,3,5953,69,2188
3000,대전광역시,3001,동구,,관내사전투표,3057,3057,1477,1470,55,1,26,1,0,2,0,2,1,3,3038,19,0
3000,대전광역시,3001,동구,,판암2동제1투,1375,769,294,434,15,0,13,1,0,0,1,0,0,0,758,11,606
3000,대전광역시,3001,동구,,판암2동제2투,1637,936,360,511,19,1,18,2,0,0,1,3,1,0,916,20,701
3000,대전광역시,3001,동구,,판암2동제3투,2141,1260,492,689,36,0,20,0,0,1,0,3,0,0,1241,19,881
3000,대전광역시,3001,동구,용운동,소계,16468,12094,5667,5859,301,5,120,1,1,2,17,13,4,7,11997,97,4374
3000,대전광역시,3001,동구,,관내사전투표,4855,4854,2564,2132,100,2,25,0,0,1,1,4,2,3,4834,20,1
3000,대전광역시,3001,동구,,용운동제1투,1588,837,303,470,27,1,16,0,1,1,3,1,0,1,824,13,751
3000,대전광역시,3001,동구,,용운동제2투,1987,1139,418,654,23,1,18,1,0,0,7,1,1,1,1125,14,848
3000,대전광역시,3001,동구,,용운동제3투,2997,1864,797,967,49,1,25,0,0,0,1,4,0,1,1845,19,1133
3000,대전광역시,3001,동구,,용운동제4투,2409,1606,693,833,39,0,18,0,0,0,2,2,1,1,1589,17,803
3000,대전광역시,3001,동구,,용운동제5투,2632,1794,892,803,63,0,18,0,0,0,3,1,0,0,1780,14,838
3000,대전광역시,3001,동구,대동,소계,10282,7325,3188,3739,196,3,90,1,1,1,5,6,3,7,7240,85,2957
3000,대전광역시,3001,동구,,관내사전투표,2538,2539,1215,1211,57,1,23,1,0,1,0,2,2,2,2515,24,-1
3000,대전광역시,3001,동구,,대동제1투,2279,1370,572,731,31,1,13,0,0,0,3,1,0,1,1353,17,909
3000,대전광역시,3001,동구,,대동제2투,1537,845,311,457,27,1,26,0,0,0,1,0,0,3,826,19,692
3000,대전광역시,3001,동구,,대동제3투,2098,1246,476,698,38,0,13,0,0,0,1,3,1,0,1230,16,852
3000,대전광역시,3001,동구,,대동제4투,1830,1325,614,642,43,0,15,0,1,0,0,0,0,1,1316,9,505
3000,대전광역시,3001,동구,자양동,소계,9265,6264,2683,3218,166,10,86,0,0,3,7,7,4,4,6188,76,3001
3000,대전광역시,3001,동구,,관내사전투표,3051,3050,1434,1440,84,7,43,0,0,0,3,3,2,2,3018,32,1
3000,대전광역시,3001,동구,,자양동제1투,1909,921,378,476,26,1,16,0,0,1,3,4,0,1,906,15,988
3000,대전광역시,3001,동구,,자양동제2투,2183,1056,418,569,31,2,15,0,0,0,1,0,2,1,1039,17,1127
3000,대전광역시,3001,동구,,자양동제3투,2122,1237,453,733,25,0,12,0,0,2,0,0,0,0,1225,12,885
3000,대전광역시,3001,동구,가양1동,소계,11405,8255,3613,4253,183,4,84,1,3,2,9,8,4,7,8171,84,3150
3000,대전광역시,3001,동구,,관내사전투표,3789,3786,1860,1776,84,2,28,0,0,0,1,2,0,1,3754,32,3
3000,대전광역시,3001,동구,,가양1동제1투,1711,1018,403,562,20,1,14,0,0,0,4,4,1,2,1011,7,693
3000,대전광역시,3001,동구,,가양1동제2투,1219,713,264,415,10,0,10,0,0,0,0,2,0,2,703,10,506
3000,대전광역시,3001,동구,,가양1동제3투,2758,1610,662,846,49,0,18,0,2,2,3,0,2,2,1586,24,1148
3000,대전광역시,3001,동구,,가양1동제4투,1928,1128,424,654,20,1,14,1,1,0,1,0,1,0,1117,11,800
3000,대전광역시,3001,동구,가양2동,소계,14205,9754,4404,4899,211,13,111,3,0,1,13,10,2,3,9670,84,4451
3000,대전광역시,3001,동구,,관내사전투표,3738,3738,1905,1687,76,5,33,2,0,1,4,1,1,1,3716,22,0
3000,대전광역시,3001,동구,,가양2동제1투,2646,1675,697,914,26,2,11,1,0,0,4,2,1,1,1659,16,971
3000,대전광역시,3001,동구,,가양2동제2투,1671,884,391,441,22,0,13,0,0,0,1,4,0,1,873,11,787
3000,대전광역시,3001,동구,,가양2동제3투,1801,1004,411,532,33,1,15,0,0,0,1,2,0,0,995,9,797
3000,대전광역시,3001,동구,,가양2동제4투,2349,1417,592,755,30,4,19,0,0,0,2,1,0,0,1403,14,932
3000,대전광역시,3001,동구,,가양2동제5투,2000,1036,408,570,24,1,20,0,0,0,1,0,0,0,1024,12,964
3000,대전광역시,3001,동구,용전동,소계,16364,10899,4968,5331,302,7,132,7,4,3,10,17,5,5,10791,108,5465
3000,대전광역시,3001,동구,,관내사전투표,4134,4134,2128,1818,103,2,32,3,1,0,3,8,2,1,4101,33,0
3000,대전광역시,3001,동구,,용전동제1투,2782,1664,722,834,64,1,21,0,1,3,0,1,0,3,1650,14,1118
3000,대전광역시,3001,동구,,용전동제2투,3042,1637,693,844,41,2,30,0,1,0,0,2,2,1,1616,21,1405
3000,대전광역시,3001,동구,,용전동제3투,3599,1811,751,958,49,1,30,0,1,0,3,3,1,0,1797,14,1788
3000,대전광역시,3001,동구,,용전동제4투,2807,1653,674,877,45,1,19,4,0,0,4,3,0,0,1627,26,1154
3000,대전광역시,3001,동구,성남동,소계,9404,6943,3222,3389,164,4,72,2,4,4,5,2,0,1,6869,74,2461
3000,대전광역시,3001,동구,,관내사전투표,2815,2815,1450,1264,60,2,17,0,0,0,2,2,0,0,2797,18,0
3000,대전광역시,3001,동구,,성남동제1투,2675,1659,725,840,34,1,28,2,1,1,0,0,0,0,1632,27,1016
3000,대전광역시,3001,동구,,성남동제2투,1585,979,386,525,30,1,17,0,1,3,2,0,0,1,966,13,606
3000,대전광역시,3001,동구,,성남동제3투,2329,1490,661,760,40,0,10,0,2,0,1,0,0,0,1474,16,839
3000,대전광역시,3001,동구,홍도동,소계,9063,6300,2778,3197,170,8,83,0,1,1,4,7,0,7,6256,44,2763
3000,대전광역시,3001,동구,,관내사전투표,2839,2839,1403,1307,66,7,32,0,0,0,2,2,0,6,2825,14,0
3000,대전광역시,3001,동구,,홍도동제1투,1417,872,330,492,29,0,11,0,0,0,2,2,0,1,867,5,545
3000,대전광역시,3001,동구,,홍도동제2투,2048,1217,500,655,34,1,15,0,1,0,0,2,0,0,1208,9,831
3000,대전광역시,3001,동구,,홍도동제3투,2759,1372,545,743,41,0,25,0,0,1,0,1,0,0,1356,16,1387
3000,대전광역시,3001,동구,삼성동,소계,10748,7745,3409,3987,155,3,87,1,3,3,8,7,2,6,7671,74,3003
3000,대전광역시,3001,동구,,관내사전투표,2872,2872,1450,1320,50,1,23,1,2,2,2,4,1,2,2858,14,0
3000,대전광역시,3001,동구,,삼성동제1투,1269,824,295,490,11,0,11,0,0,0,1,0,0,2,810,14,445
3000,대전광역시,3001,동구,,삼성동제2투,1392,795,299,462,13,0,8,0,0,0,4,1,0,1,788,7,597
3000,대전광역시,3001,동구,,삼성동제3투,2733,1853,817,946,50,2,20,0,1,1,1,1,0,0,1839,14,880
3000,대전광역시,3001,동구,,삼성동제4투,2482,1401,548,769,31,0,25,0,0,0,0,1,1,1,1376,25,1081
3000,대전광역시,3001,동구,대청동,소계,1935,1451,481,913,30,1,17,1,0,0,0,5,1,1,1450,1,484
3000,대전광역시,3001,동구,,관내사전투표,576,576,225,330,11,0,7,0,0,0,0,2,1,0,576,0,0
3000,대전광역시,3001,동구,,대청동제1투,691,455,131,307,8,0,4,1,0,0,0,3,0,1,455,0,236
3000,대전광역시,3001,동구,,대청동제2투,668,420,125,276,11,1,6,0,0,0,0,0,0,0,419,1,248
3000,대전광역시,3001,동구,산내동,소계,14336,10243,4859,4919,250,2,108,0,2,4,2,11,5,7,10169,74,4093
3000,대전광역시,3001,동구,,관내사전투표,3776,3776,2048,1599,79,0,23,0,0,0,1,7,1,2,3760,16,0
3000,대전광역시,3001,동구,,산내동제1투,3181,1771,820,869,40,0,24,0,0,0,0,1,0,2,1756,15,1410
3000,대전광역시,3001,동구,,산내동제2투,682,355,131,205,4,0,7,0,0,0,0,0,1,0,348,7,327
3000,대전광역시,3001,동구,,산내동제3투,2484,1712,816,810,57,0,13,0,0,0,1,0,2,1,1700,12,772
3000,대전광역시,3001,동구,,산내동제4투,1655,1036,413,562,27,1,19,0,2,2,0,1,0,0,1027,9,619
3000,대전광역시,3001,동구,,산내동제5투,718,449,142,281,15,0,6,0,0,0,0,0,0,1,445,4,269
3000,대전광역시,3001,동구,,산내동제6투,1840,1144,489,593,28,1,16,0,0,2,0,2,1,1,1133,11,696
3000,대전광역시,3001,동구,잘못 투입·구분된 투표지,,0,2,2,0,0,0,0,0,0,0,0,0,0,0,2,0,-2
3000,대전광역시,3002,중구,합계,,199637,151200,66698,77459,3782,68,1412,38,19,47,98,174,45,74,149914,1286,48437
3000,대전광역시,3002,중구,거소·선상투표,,412,380,161,145,2,1,5,1,1,0,1,1,1,0,319,61,32
3000,대전광역시,3002,중구,관외사전투표,,18543,18541,9140,8423,522,9,238,5,4,3,6,20,7,12,18389,152,2
3000,대전광역시,3002,중구,재외투표,,762,547,323,156,22,0,0,1,1,0,1,0,0,0,504,43,215
3000,대전광역시,3002,중구,은행선화동,소계,12126,7909,3515,3965,240,5,96,0,0,2,4,8,1,6,7842,67,4217
3000,대전광역시,3002,중구,,관내사전투표,2953,2952,1501,1320,83,2,22,0,0,0,1,4,0,1,2934,18,1
3000,대전광역시,3002,중구,,은행선화동제1투,3078,1707,765,839,50,2,30,0,0,0,1,1,1,2,1691,16,1371
3000,대전광역시,3002,중구,,은행선화동제2투,2753,1517,568,840,64,1,21,0,0,0,2,0,0,1,1497,20,1236
3000,대전광역시,3002,중구,,은행선화동제3투,2439,1386,545,784,28,0,16,0,0,1,0,2,0,2,1378,8,1053
3000,대전광역시,3002,중구,,은행선화동제4투,903,347,136,182,15,0,7,0,0,1,0,1,0,0,342,5,556
3000,대전광역시,3002,중구,목동,소계,10020,7963,4172,3435,232,5,61,4,1,1,0,4,1,3,7919,44,2057
3000,대전광역시,3002,중구,,관내사전투표,3727,3727,2194,1407,90,3,18,1,1,0,0,1,0,0,3715,12,0
3000,대전광역시,3002,중구,,목동제1투,1625,1118,528,537,32,1,10,0,0,0,0,1,0,1,1110,8,507
3000,대전광역시,3002,중구,,목동제2투,2429,1531,704,730,59,1,17,3,0,0,0,0,0,1,1515,16,898
3000,대전광역시,3002,중구,,목동제3투,2239,1587,746,761,51,0,16,0,0,1,0,2,1,1,1579,8,652
3000,대전광역시,3002,중구,중촌동,소계,10163,7680,3497,3805,184,7,75,1,0,3,3,11,5,2,7593,87,2483
3000,대전광역시,3002,중구,,관내사전투표,2870,2869,1470,1309,47,3,19,1,0,0,0,4,2,2,2857,12,1
3000,대전광역시,3002,중구,,중촌동제1투,1172,690,241,407,22,0,9,0,0,1,1,0,0,0,681,9,482
3000,대전광역시,3002,중구,,중촌동제2투,1400,1013,462,494,26,2,10,0,0,0,0,3,2,0,999,14,387
3000,대전광역시,3002,중구,,중촌동제3투,2075,1352,546,721,41,0,16,0,0,0,1,1,1,0,1327,25,723
3000,대전광역시,3002,중구,,중촌동제4투,1567,1040,509,462,37,1,15,0,0,2,1,2,0,0,1029,11,527
3000,대전광역시,3002,중구,,중촌동제5투,1079,716,269,412,11,1,6,0,0,0,0,1,0,0,700,16,363
3000,대전광역시,3002,중구,대흥동,소계,10782,7645,3514,3765,200,3,74,1,0,4,7,8,1,5,7582,63,3137
3000,대전광역시,3002,중구,,관내사전투표,3233,3233,1675,1421,87,3,23,0,0,3,1,3,1,2,3219,14,0
3000,대전광역시,3002,중구,,대흥동제1투,3217,1644,678,878,38,0,24,0,0,0,4,2,0,2,1626,18,1573
3000,대전광역시,3002,중구,,대흥동제2투,1933,1109,457,590,24,0,15,1,0,0,0,2,0,1,1090,19,824
3000,대전광역시,3002,중구,,대흥동제3투,2399,1659,704,876,51,0,12,0,0,1,2,1,0,0,1647,12,740
3000,대전광역시,3002,중구,문창동,소계,4117,2948,1240,1563,66,1,32,0,0,0,5,8,2,2,2919,29,1169
3000,대전광역시,3002,중구,,관내사전투표,1218,1218,588,573,29,1,12,0,0,0,1,2,1,1,1208,10,0
3000,대전광역시,3002,중구,,문창동제1투,1265,697,259,397,17,0,8,0,0,0,2,5,1,0,689,8,568
3000,대전광역시,3002,중구,,문창동제2투,1634,1033,393,593,20,0,12,0,0,0,2,1,0,1,1022,11,601
3000,대전광역시,3002,중구,석교동,소계,12777,8783,3649,4715,194,2,95,4,1,8,10,14,6,5,8703,80,3994
3000,대전광역시,3002,중구,,관내사전투표,3281,3281,1553,1606,65,1,23,2,0,1,2,6,1,4,3264,17,0
3000,대전광역시,3002,중구,,석교동제1투,1855,1023,394,582,12,0,13,0,0,2,3,2,2,0,1010,13,832
3000,대전광역시,3002,중구,,석교동제2투,1795,1010,364,590,29,0,15,1,0,0,0,0,1,0,1000,10,785
3000,대전광역시,3002,중구,,석교동제3투,1678,890,332,498,30,0,8,0,0,5,2,1,2,1,879,11,788
3000,대전광역시,3002,중구,,석교동제4투,2105,1304,505,734,25,0,18,1,1,0,3,2,0,0,1289,15,801
3000,대전광역시,3002,중구,,석교동제5투,2063,1275,501,705,33,1,18,0,0,0,0,3,0,0,1261,14,788
3000,대전광역시,3002,중구,대사동,소계,4714,3343,1311,1855,109,0,32,2,1,1,2,5,0,0,3318,25,1371
3000,대전광역시,3002,중구,,관내사전투표,1663,1663,712,875,47,0,16,0,0,1,1,3,0,0,1655,8,0
3000,대전광역시,3002,중구,,대사동제1투,1476,818,297,484,17,0,8,0,1,0,1,2,0,0,810,8,658
3000,대전광역시,3002,중구,,대사동제2투,1575,862,302,496,45,0,8,2,0,0,0,0,0,0,853,9,713
3000,대전광역시,3002,중구,부사동,소계,5484,3794,1591,2017,88,6,35,3,0,2,1,5,0,1,3749,45,1690
3000,대전광역시,3002,중구,,관내사전투표,1599,1599,751,786,36,3,12,1,0,1,0,0,0,0,1590,9,0
3000,대전광역시,3002,중구,,부사동제1투,1832,1094,410,635,20,1,11,1,0,0,0,4,0,0,1082,12,738
3000,대전광역시,3002,중구,,부사동제2투,2053,1101,430,596,32,2,12,1,0,1,1,1,0,1,1077,24,952
3000,대전광역시,3002,중구,용두동,소계,8153,6144,2810,3022,183,8,56,1,2,2,4,5,2,1,6096,48,2009
3000,대전광역시,3002,중구,,관내사전투표,3081,3081,1558,1395,88,2,15,1,2,1,0,3,0,1,3066,15,0
3000,대전광역시,3002,중구,,용두동제1투,1694,1088,443,586,36,2,11,0,0,0,3,0,0,0,1081,7,606
3000,대전광역시,3002,중구,,용두동제2투,1389,749,324,390,18,2,6,0,0,0,1,0,1,0,742,7,640
3000,대전광역시,3002,중구,,용두동제3투,1989,1226,485,651,41,2,24,0,0,1,0,2,1,0,1207,19,763
3000,대전광역시,3002,중구,오류동,소계,8794,6733,2800,3634,162,4,54,3,1,3,11,8,2,2,6684,49,2061
3000,대전광역시,3002,중구,,관내사전투표,3219,3218,1506,1602,74,0,12,1,0,1,0,4,1,1,3202,16,1
3000,대전광역시,3002,중구,,오류동제1투,2154,1204,491,638,33,0,22,2,0,1,1,2,1,0,1191,13,950
3000,대전광역시,3002,중구,,오류동제2투,1855,1348,446,846,27,2,9,0,1,0,6,0,0,1,1338,10,507
3000,대전광역시,3002,중구,,오류동제3투,1566,963,357,548,28,2,11,0,0,1,4,2,0,0,953,10,603
3000,대전광역시,3002,중구,태평1동,소계,9968,7700,3551,3858,165,4,52,2,1,3,6,5,2,5,7654,46,2268
3000,대전광역시,3002,중구,,관내사전투표,2978,2977,1499,1392,49,1,13,2,0,1,2,3,0,3,2965,12,1
3000,대전광역시,3002,중구,,태평1동제1투,1836,1217,559,601,38,0,10,0,0,0,1,1,0,2,1212,5,619
3000,대전광역시,3002,중구,,태평1동제2투,1707,981,349,590,22,1,9,0,1,0,2,1,1,0,976,5,726
3000,대전광역시,3002,중구,,태평1동제3투,2049,1515,691,756,35,1,12,0,0,2,1,0,1,0,1499,16,534
3000,대전광역시,3002,중구,,태평1동제4투,1398,1010,453,519,21,1,8,0,0,0,0,0,0,0,1002,8,388
3000,대전광역시,3002,중구,태평2동,소계,18278,14000,5730,7782,297,2,74,2,0,2,9,13,1,5,13917,83,4278
3000,대전광역시,3002,중구,,관내사전투표,4858,4858,2335,2392,88,0,17,1,0,1,0,6,0,1,4841,17,0
3000,대전광역시,3002,중구,,태평2동제1투,1334,773,264,475,14,1,9,0,0,0,2,2,0,0,767,6,561
3000,대전광역시,3002,중구,,태평2동제2투,1740,1191,445,696,26,0,14,0,0,0,0,0,0,1,1182,9,549
3000,대전광역시,3002,중구,,태평2동제3투,2298,1516,592,878,25,0,6,0,0,0,2,1,0,0,1504,12,782
3000,대전광역시,3002,중구,,태평2동제4투,2520,1688,696,938,34,0,4,1,0,0,4,0,0,2,1679,9,832
3000,대전광역시,3002,중구,,태평2동제5투,2438,1787,601,1106,50,0,9,0,0,1,0,2,0,0,1769,18,651
3000,대전광역시,3002,중구,,태평2동제6투,3090,2187,797,1297,60,1,15,0,0,0,1,2,1,1,2175,12,903
3000,대전광역시,3002,중구,유천1동,소계,6624,4845,2013,2594,147,2,49,1,0,2,4,4,1,0,4817,28,1779
3000,대전광역시,3002,중구,,관내사전투표,2685,2684,1178,1380,92,0,17,1,0,0,2,3,0,0,2673,11,1
3000,대전광역시,3002,중구,,유천1동제1투,2401,1340,527,731,34,2,26,0,0,2,2,1,1,0,1326,14,1061
3000,대전광역시,3002,중구,,유천1동제2투,1538,821,308,483,21,0,6,0,0,0,0,0,0,0,818,3,717
3000,대전광역시,3002,중구,유천2동,소계,10847,7934,3263,4373,150,1,64,2,0,0,3,14,3,4,7877,57,2913
3000,대전광역시,3002,중구,,관내사전투표,3021,3021,1436,1490,52,0,26,0,0,0,0,3,1,1,3009,12,0
3000,대전광역시,3002,중구,,유천2동제1투,1306,761,285,432,15,0,6,2,0,0,0,5,1,0,746,15,545
3000,대전광역시,3002,중구,,유천2동제2투,1829,1032,415,573,23,1,7,0,0,0,0,1,1,1,1022,10,797
3000,대전광역시,3002,중구,,유천2동제3투,2124,1255,480,725,27,0,13,0,0,0,0,1,0,0,1246,9,869
3000,대전광역시,3002,중구,,유천2동제4투,2567,1865,647,1153,33,0,12,0,0,0,3,4,0,2,1854,11,702
3000,대전광역시,3002,중구,문화1동,소계,15583,12044,5005,6552,281,4,80,1,1,2,1,12,3,7,11949,95,3539
3000,대전광역시,3002,중구,,관내사전투표,4128,4128,1911,2099,78,2,10,0,0,0,1,5,0,5,4111,17,0
3000,대전광역시,3002,중구,,문화1동제1투,2990,2051,808,1147,42,0,22,1,1,0,0,3,0,1,2025,26,939
3000,대전광역시,3002,중구,,문화1동제2투,1210,800,342,418,20,0,15,0,0,0,0,1,1,0,797,3,410
3000,대전광역시,3002,중구,,문화1동제3투,1894,1231,512,649,40,1,13,0,0,1,0,2,0,0,1218,13,663
3000,대전광역시,3002,중구,,문화1동제4투,2761,2048,761,1205,51,0,7,0,0,1,0,1,1,0,2027,21,713
3000,대전광역시,3002,중구,,문화1동제5투,2600,1786,671,1034,50,1,13,0,0,0,0,0,1,1,1771,15,814
3000,대전광역시,3002,중구,문화2동,소계,10619,7849,3349,4147,198,1,73,2,0,3,8,10,3,3,7797,52,2770
3000,대전광역시,3002,중구,,관내사전투표,3616,3616,1630,1858,89,0,21,0,0,0,2,3,2,1,3606,10,0
3000,대전광역시,3002,중구,,문화2동제1투,1281,743,308,391,20,1,10,0,0,2,1,1,1,0,735,8,538
3000,대전광역시,3002,중구,,문화2동제2투,2216,1443,572,790,43,0,15,0,0,0,3,6,0,1,1430,13,773
3000,대전광역시,3002,중구,,문화2동제3투,1837,1057,420,588,20,0,18,1,0,1,0,0,0,0,1048,9,780
3000,대전광역시,3002,중구,,문화2동제4투,1669,990,419,520,26,0,9,1,0,0,2,0,0,1,978,12,679
3000,대전광역시,3002,중구,산성동,소계,20871,14414,6062,7651,340,3,167,2,5,6,12,19,4,11,14282,132,6457
3000,대전광역시,3002,중구,,관내사전투표,4272,4272,2020,2107,88,2,25,2,0,0,0,8,1,3,4256,16,0
3000,대전광역시,3002,중구,,산성동제1투,1639,954,359,523,34,0,19,0,2,2,2,1,2,2,946,8,685
3000,대전광역시,3002,중구,,산성동제2투,1859,1125,453,615,26,0,11,0,0,0,2,0,0,0,1107,18,734
3000,대전광역시,3002,중구,,산성동제3투,2451,1381,581,721,30,1,22,0,1,0,0,3,1,1,1361,20,1070
3000,대전광역시,3002,중구,,산성동제4투,2275,1647,624,938,47,0,20,0,0,0,2,2,0,1,1634,13,628
3000,대전광역시,3002,중구,,산성동제5투,2067,1246,466,711,24,0,23,0,1,1,0,0,0,0,1226,20,821
3000,대전광역시,3002,중구,,산성동제6투,2779,1701,719,882,48,0,23,0,1,0,5,4,0,0,1682,19,1078
3000,대전광역시,3002,중구,,산성동제7투,2753,1646,699,875,31,0,23,0,0,3,1,1,0,0,1633,13,1107
3000,대전광역시,3002,중구,,산성동제8투,776,442,141,279,12,0,1,0,0,0,0,0,0,4,437,5,334
3000,대전광역시,3002,중구,잘못 투입·구분된 투표지,,0,4,2,2,0,0,0,0,0,0,0,0,0,0,4,0,-4
3000,대전광역시,3003,서구,합계,,399599,304873,139877,150031,8427,173,2718,70,42,70,159,267,61,118,302013,2860,94726
3000,대전광역시,3003,서구,거소·선상투표,,712,667,264,281,11,0,15,1,0,0,0,0,2,4,578,89,45
3000,대전광역시,3003,서구,관외사전투표,,36299,36291,17625,16596,1107,36,424,12,7,4,13,37,6,24,35891,400,8
3000,대전광역시,3003,서구,재외투표,,1470,1084,629,306,31,0,5,0,0,0,0,1,0,0,972,112,386
3000,대전광역시,3003,서구,복수동,소계,15925,11929,5772,5626,279,6,97,0,0,2,7,17,3,12,11821,108,3996
3000,대전광역시,3003,서구,,관내사전투표,5028,5028,2698,2158,94,3,27,0,0,1,2,10,0,4,4997,31,0
3000,대전광역시,3003,서구,,복수동제1투,2722,1847,761,1007,42,0,11,0,0,0,3,0,2,3,1829,18,875
3000,대전광역시,3003,서구,,복수동제2투,3080,2162,966,1087,52,0,14,0,0,1,1,6,1,2,2130,32,918
3000,대전광역시,3003,서구,,복수동제3투,2263,1440,676,683,51,1,16,0,0,0,0,1,0,2,1430,10,823
3000,대전광역시,3003,서구,,복수동제4투,2832,1452,671,691,40,2,29,0,0,0,1,0,0,1,1435,17,1380
3000,대전광역시,3003,서구,도마1동,소계,12620,8663,3471,4799,187,7,94,2,0,3,12,12,3,2,8592,71,3957
3000,대전광역시,3003,서구,,관내사전투표,3718,3718,1571,2030,63,3,27,1,0,2,2,1,0,0,3700,18,0
3000,대전광역시,3003,서구,,도마1동제1투,1586,872,319,507,15,0,18,1,0,0,1,2,0,0,863,9,714
3000,대전광역시,3003,서구,,도마1동제2투,1416,850,332,468,28,1,3,0,0,0,2,1,0,2,837,13,566
3000,대전광역시,3003,서구,,도마1동제3투,1392,779,276,468,15,2,8,0,0,1,2,1,1,0,774,5,613
3000,대전광역시,3003,서구,,도마1동제4투,2118,1131,459,598,39,0,15,0,0,0,3,5,0,0,1119,12,987
3000,대전광역시,3003,서구,,도마1동제5투,2390,1313,514,728,27,1,23,0,0,0,2,2,2,0,1299,14,1077
3000,대전광역시,3003,서구,도마2동,소계,14059,9952,4113,5393,206,7,117,1,1,4,13,10,3,3,9871,81,4107
3000,대전광역시,3003,서구,,관내사전투표,3715,3715,1740,1852,71,2,19,0,0,2,5,3,2,1,3697,18,0
3000,대전광역시,3003,서구,,도마2동제1투,2025,1093,457,579,18,0,19,1,0,0,4,4,0,0,1082,11,932
3000,대전광역시,3003,서구,,도마2동제2투,1431,803,286,477,12,2,15,0,0,0,1,0,0,0,793,10,628
3000,대전광역시,3003,서구,,도마2동제3투,1826,983,360,569,21,0,17,0,0,1,1,1,0,1,971,12,843
3000,대전광역시,3003,서구,,도마2동제4투,2458,1459,523,849,39,3,24,0,0,0,1,2,1,0,1442,17,999
3000,대전광역시,3003,서구,,도마2동제5투,2604,1899,747,1067,45,0,23,0,1,1,1,0,0,1,1886,13,705
3000,대전광역시,3003,서구,정림동,소계,13153,10097,4664,4980,251,3,101,3,2,0,6,8,8,2,10028,69,3056
3000,대전광역시,3003,서구,,관내사전투표,4731,4731,2435,2135,99,0,34,0,0,0,4,2,2,2,4713,18,0
3000,대전광역시,3003,서구,,정림동제1투,1855,1161,488,598,38,1,15,1,1,0,1,2,1,0,1146,15,694
3000,대전광역시,3003,서구,,정림동제2투,1594,1109,423,635,33,0,12,0,0,0,0,0,2,0,1105,4,485
3000,대전광역시,3003,서구,,정림동제3투,1431,805,308,439,24,1,21,1,0,0,0,3,0,0,797,8,626
3000,대전광역시,3003,서구,,정림동제4투,1617,962,411,513,21,0,6,0,1,0,0,1,0,0,953,9,655
3000,대전광역시,3003,서구,,정림동제5투,1925,1329,599,660,36,1,13,1,0,0,1,0,3,0,1314,15,596
3000,대전광역시,3003,서구,변동,소계,12586,8595,3717,4471,212,6,100,3,1,3,5,6,1,2,8527,68,3991
3000,대전광역시,3003,서구,,관내사전투표,3093,3093,1574,1405,82,2,12,1,0,1,0,1,1,1,3080,13,0
3000,대전광역시,3003,서구,,변동제1투,1947,1047,390,601,28,0,12,1,1,0,1,2,0,0,1036,11,900
3000,대전광역시,3003,서구,,변동제2투,3632,2212,897,1202,49,2,32,0,0,1,3,0,0,1,2187,25,1420
3000,대전광역시,3003,서구,,변동제3투,1672,930,349,528,19,1,23,1,0,1,0,2,0,0,924,6,742
3000,대전광역시,3003,서구,,변동제4투,2242,1313,507,735,34,1,21,0,0,0,1,1,0,0,1300,13,929
3000,대전광역시,3003,서구,용문동,소계,11389,7832,3251,4127,275,3,92,1,0,1,3,10,1,2,7766,66,3557
3000,대전광역시,3003,서구,,관내사전투표,3973,3973,1853,1882,160,3,36,0,0,1,0,7,1,1,3944,29,0
3000,대전광역시,3003,서구,,용문동제1투,3542,1678,590,991,49,0,28,0,0,0,1,1,0,1,1661,17,1864
3000,대전광역시,3003,서구,,용문동제2투,2376,1404,505,819,43,0,21,1,0,0,2,1,0,0,1392,12,972
3000,대전광역시,3003,서구,,용문동제3투,1498,777,303,435,23,0,7,0,0,0,0,1,0,0,769,8,721
3000,대전광역시,3003,서구,탄방동,소계,19574,13644,6087,6905,382,10,109,4,1,3,6,13,0,3,13523,121,5930
3000,대전광역시,3003,서구,,관내사전투표,3952,3952,1980,1837,88,4,15,1,1,0,1,5,0,1,3933,19,0
3000,대전광역시,3003,서구,,탄방동제1투,3218,1694,700,874,60,0,30,1,0,1,0,1,0,1,1668,26,1524
3000,대전광역시,3003,서구,,탄방동제2투,3664,2089,905,1077,66,1,19,0,0,0,2,0,0,0,2070,19,1575
3000,대전광역시,3003,서구,,탄방동제3투,1588,1176,501,609,44,2,8,0,0,1,0,3,0,1,1169,7,412
3000,대전광역시,3003,서구,,탄방동제4투,1522,1133,486,597,28,1,6,0,0,0,0,1,0,0,1119,14,389
3000,대전광역시,3003,서구,,탄방동제5투,3032,1947,791,1060,53,1,11,1,0,0,3,1,0,0,1921,26,1085
3000,대전광역시,3003,서구,,탄방동제6투,2598,1653,724,851,43,1,20,1,0,1,0,2,0,0,1643,10,945
3000,대전광역시,3003,서구,둔산1동,소계,14127,12227,5077,6674,318,5,56,0,3,4,5,5,3,2,12152,75,1900
3000,대전광역시,3003,서구,,관내사전투표,6450,6450,3242,2934,187,3,38,0,1,2,2,3,1,2,6415,35,0
3000,대전광역시,3003,서구,,둔산1동제1투,2112,1487,428,1007,35,0,5,0,0,1,2,0,0,0,1478,9,625
3000,대전광역시,3003,서구,,둔산1동제2투,1827,1441,465,923,35,1,5,0,1,0,0,1,0,0,1431,10,386
3000,대전광역시,3003,서구,,둔산1동제3투,1970,1442,501,890,31,0,5,0,1,0,0,1,2,0,1431,11,528
3000,대전광역시,3003,서구,,둔산1동제4투,1768,1407,441,920,30,1,3,0,0,1,1,0,0,0,1397,10,361
3000,대전광역시,3003,서구,둔산2동,소계,23858,18503,8695,8925,595,9,108,4,1,2,9,12,5,2,18367,136,5355
3000,대전광역시,3003,서구,,관내사전투표,5295,5294,2852,2221,164,4,15,2,0,0,0,1,1,0,5260,34,1
3000,대전광역시,3003,서구,,둔산2동제1투,2769,2033,870,1069,57,2,13,0,0,0,2,0,1,0,2014,19,736
3000,대전광역시,3003,서구,,둔산2동제2투,2815,2056,917,1024,70,0,24,0,0,0,2,2,1,0,2040,16,759
3000,대전광역시,3003,서구,,둔산2동제3투,2886,2153,925,1117,70,2,19,0,0,0,2,3,0,0,2138,15,733
3000,대전광역시,3003,서구,,둔산2동제4투,2500,1920,767,1091,39,0,9,2,0,1,1,2,1,0,1913,7,580
3000,대전광역시,3003,서구,,둔산2동제5투,2480,1847,889,863,67,0,11,0,1,0,1,3,1,0,1836,11,633
3000,대전광역시,3003,서구,,둔산2동제6투,2406,1834,896,829,78,0,4,0,0,0,1,1,0,1,1810,24,572
3000,대전광역시,3003,서구,,둔산2동제7투,2707,1366,579,711,50,1,13,0,0,1,0,0,0,1,1356,10,1341
3000,대전광역시,3003,서구,둔산3동,소계,16108,13165,5543,7191,267,6,57,1,3,3,7,8,2,3,13091,74,2943
3000,대전광역시,3003,서구,,관내사전투표,6115,6115,2935,3026,109,4,14,1,1,0,1,4,0,1,6096,19,0
3000,대전광역시,3003,서구,,둔산3동제1투,1731,1241,499,707,22,1,3,0,0,0,2,0,0,0,1234,7,490
3000,대전광역시,3003,서구,,둔산3동제2투,2170,1603,591,964,29,0,6,0,0,0,0,0,2,1,1593,10,567
3000,대전광역시,3003,서구,,둔산3동제3투,1730,1329,397,883,33,0,4,0,1,0,0,2,0,0,1320,9,401
3000,대전광역시,3003,서구,,둔산3동제4투,2947,1985,757,1137,55,0,16,0,0,1,2,1,0,0,1969,16,962
3000,대전광역시,3003,서구,,둔산3동제5투,1415,892,364,474,19,1,14,0,1,2,2,1,0,1,879,13,523
3000,대전광역시,3003,서구,괴정동,소계,15349,9494,4382,4541,284,6,158,1,1,1,2,7,2,4,9389,105,5855
3000,대전광역시,3003,서구,,관내사전투표,3427,3427,1763,1499,95,2,41,0,0,1,0,1,1,3,3406,21,0
3000,대전광역시,3003,서구,,괴정동제1투,3249,1592,657,833,32,0,40,0,0,0,1,3,1,1,1568,24,1657
3000,대전광역시,3003,서구,,괴정동제2투,3375,1605,704,796,55,4,26,1,0,0,0,3,0,0,1589,16,1770
3000,대전광역시,3003,서구,,괴정동제3투,2916,1483,653,729,55,0,20,0,1,0,1,0,0,0,1459,24,1433
3000,대전광역시,3003,서구,,괴정동제4투,2382,1387,605,684,47,0,31,0,0,0,0,0,0,0,1367,20,995
3000,대전광역시,3003,서구,가장동,소계,9419,7241,3076,3881,151,1,64,2,0,1,1,3,1,3,7184,57,2178
3000,대전광역시,3003,서구,,관내사전투표,3045,3045,1444,1518,54,1,16,0,0,0,1,0,0,0,3034,11,0
3000,대전광역시,3003,서구,,가장동제1투,2886,1766,699,972,39,0,26,0,0,1,0,2,1,2,1742,24,1120
3000,대전광역시,3003,서구,,가장동제2투,2046,1507,588,851,36,0,15,2,0,0,0,0,0,0,1492,15,539
3000,대전광역시,3003,서구,,가장동제3투,1442,923,345,540,22,0,7,0,0,0,0,1,0,1,916,7,519
3000,대전광역시,3003,서구,내동,소계,17167,12813,5528,6714,320,6,109,10,1,4,8,14,2,2,12718,95,4354
3000,대전광역시,3003,서구,,관내사전투표,4543,4543,2273,2115,102,1,15,3,0,1,3,6,1,0,4520,23,0
3000,대전광역시,3003,서구,,내동제1투,1993,1235,512,653,35,1,21,1,0,0,0,1,1,0,1225,10,758
3000,대전광역시,3003,서구,,내동제2투,2200,1192,476,654,31,1,16,1,0,1,1,0,0,0,1181,11,1008
3000,대전광역시,3003,서구,,내동제3투,3137,1989,798,1086,48,1,25,5,1,0,2,4,0,1,1971,18,1148
3000,대전광역시,3003,서구,,내동제4투,2688,2069,789,1195,52,2,10,0,0,1,2,1,0,1,2053,16,619
3000,대전광역시,3003,서구,,내동제5투,2606,1785,680,1011,52,0,22,0,0,1,0,2,0,0,1768,17,821
3000,대전광역시,3003,서구,갈마1동,소계,17533,11965,5294,6073,325,3,122,1,2,5,10,17,1,6,11859,106,5568
3000,대전광역시,3003,서구,,관내사전투표,5121,5121,2465,2479,121,1,30,0,0,1,1,5,0,1,5104,17,0
3000,대전광역시,3003,서구,,갈마1동제1투,1740,1207,462,685,35,1,12,0,0,0,1,1,0,1,1198,9,533
3000,대전광역시,3003,서구,,갈마1동제2투,1806,1016,397,564,31,0,12,0,0,1,0,1,0,0,1006,10,790
3000,대전광역시,3003,서구,,갈마1동제3투,3377,1660,729,814,57,0,29,0,1,2,4,4,0,1,1641,19,1717
3000,대전광역시,3003,서구,,갈마1동제4투,2629,1470,613,771,38,0,18,0,0,1,3,5,0,0,1449,21,1159
3000,대전광역시,3003,서구,,갈마1동제5투,2860,1491,628,760,43,1,21,1,1,0,1,1,1,3,1461,30,1369
3000,대전광역시,3003,서구,갈마2동,소계,19830,12885,6099,6079,358,8,186,3,3,3,10,10,1,7,12767,118,6945
3000,대전광역시,3003,서구,,관내사전투표,5515,5514,2813,2440,152,4,60,2,0,0,0,4,0,2,5477,37,1
3000,대전광역시,3003,서구,,갈마2동제1투,3342,1336,619,605,45,1,32,1,2,1,2,2,0,3,1313,23,2006
3000,대전광역시,3003,서구,,갈마2동제2투,2685,1680,743,844,56,1,20,0,0,0,2,1,1,0,1668,12,1005
3000,대전광역시,3003,서구,,갈마2동제3투,2521,1584,720,789,36,1,18,0,1,2,0,2,0,0,1569,15,937
3000,대전광역시,3003,서구,,갈마2동제4투,2672,1296,575,638,33,0,29,0,0,0,3,0,0,1,1279,17,1376
3000,대전광역시,3003,서구,,갈마2동제5투,3095,1475,629,763,36,1,27,0,0,0,3,1,0,1,1461,14,1620
3000,대전광역시,3003,서구,월평1동,소계,10697,7422,3398,3574,223,4,103,0,3,1,10,5,2,0,7323,99,3275
3000,대전광역시,3003,서구,,관내사전투표,3678,3678,1885,1621,105,4,27,0,0,1,0,2,0,0,3645,33,0
3000,대전광역시,3003,서구,,월평1동제1투,2247,1231,508,636,39,0,24,0,1,0,6,1,0,0,1215,16,1016
3000,대전광역시,3003,서구,,월평1동제2투,2553,1464,587,766,50,0,22,0,2,0,3,0,1,0,1431,33,1089
3000,대전광역시,3003,서구,,월평1동제3투,2219,1049,418,551,29,0,30,0,0,0,1,2,1,0,1032,17,1170
3000,대전광역시,3003,서구,월평2동,소계,12327,9694,4112,5109,287,5,61,2,2,7,6,4,1,7,9603,91,2633
3000,대전광역시,3003,서구,,관내사전투표,4978,4978,2385,2394,132,3,19,0,1,2,3,3,0,4,4946,32,0
3000,대전광역시,3003,서구,,월평2동제1투,1405,729,299,376,23,1,16,0,0,1,1,0,1,0,718,11,676
3000,대전광역시,3003,서구,,월평2동제2투,2101,1505,560,863,64,0,4,1,0,3,0,0,0,1,1496,9,596
3000,대전광역시,3003,서구,,월평2동제3투,1640,980,376,528,28,0,17,0,0,1,1,1,0,2,954,26,660
3000,대전광역시,3003,서구,,월평2동제4투,2203,1502,492,948,40,1,5,1,1,0,1,0,0,0,1489,13,701
3000,대전광역시,3003,서구,월평3동,소계,14903,12194,5446,6219,354,4,53,2,1,5,4,7,0,2,12097,97,2709
3000,대전광역시,3003,서구,,관내사전투표,5139,5139,2615,2341,139,1,12,0,1,2,1,2,0,0,5114,25,0
3000,대전광역시,3003,서구,,월평3동제1투,1433,952,373,528,29,0,5,1,0,0,0,1,0,1,938,14,481
3000,대전광역시,3003,서구,,월평3동제2투,1585,1125,502,555,42,1,9,0,0,0,2,1,0,0,1112,13,460
3000,대전광역시,3003,서구,,월평3동제3투,2470,1783,726,969,60,1,7,0,0,0,0,1,0,0,1764,19,687
3000,대전광역시,3003,서구,,월평3동제4투,2504,1964,710,1175,46,0,10,1,0,3,1,1,0,0,1947,17,540
3000,대전광역시,3003,서구,,월평3동제5투,1772,1231,520,651,38,1,10,0,0,0,0,1,0,1,1222,9,541
3000,대전광역시,3003,서구,만년동,소계,10109,8233,3787,4021,255,10,40,2,3,2,2,6,2,3,8133,100,1876
3000,대전광역시,3003,서구,,관내사전투표,4141,4141,2096,1868,129,4,12,0,0,0,0,2,2,0,4113,28,0
3000,대전광역시,3003,서구,,만년동제1투,2720,1717,729,878,48,1,15,1,3,1,0,2,0,2,1680,37,1003
3000,대전광역시,3003,서구,,만년동제2투,1437,1065,496,504,33,4,9,1,0,1,1,0,0,1,1050,15,372
3000,대전광역시,3003,서구,,만년동제3투,1811,1310,466,771,45,1,4,0,0,0,1,2,0,0,1290,20,501
3000,대전광역시,3003,서구,가수원동,소계,29594,22097,10486,10603,644,8,145,2,1,5,10,18,3,3,21928,169,7497
3000,대전광역시,3003,서구,,관내사전투표,5851,5851,2984,2632,163,3,25,0,0,1,3,7,2,0,5820,31,0
3000,대전광역시,3003,서구,,가수원동제1투,1717,986,395,538,24,0,17,0,0,0,0,2,0,0,976,10,731
3000,대전광역시,3003,서구,,가수원동제2투,2021,1277,500,725,29,0,9,0,0,0,1,0,0,1,1265,12,744
3000,대전광역시,3003,서구,,가수원동제3투,2201,1297,556,661,42,0,21,2,0,1,3,0,0,0,1286,11,904
3000,대전광역시,3003,서구,,가수원동제4투,3220,2236,1120,1019,64,0,14,0,0,2,1,2,0,0,2222,14,984
3000,대전광역시,3003,서구,,가수원동제5투,2793,2029,938,994,63,2,8,0,0,1,0,2,0,1,2009,20,764
3000,대전광역시,3003,서구,,가수원동제6투,1793,1336,704,581,36,0,4,0,1,0,0,0,1,1,1328,8,457
3000,대전광역시,3003,서구,,가수원동제7투,3282,2401,1137,1153,76,0,9,0,0,0,1,2,0,0,2378,23,881
3000,대전광역시,3003,서구,,가수원동제8투,4031,2712,1267,1323,80,3,19,0,0,0,1,1,0,0,2694,18,1319
3000,대전광역시,3003,서구,,가수원동제9투,2685,1972,885,977,67,0,19,0,0,0,0,2,0,0,1950,22,713
3000,대전광역시,3003,서구,관저1동,소계,12711,9884,4919,4489,296,5,66,2,0,0,2,6,0,6,9791,93,2827
3000,대전광역시,3003,서구,,관내사전투표,4980,4980,2690,2105,139,3,18,0,0,0,0,2,0,3,4960,20,0
3000,대전광역시,3003,서구,,관저1동제1투,2930,1674,791,758,61,1,26,2,0,0,0,2,0,3,1644,30,1256
3000,대전광역시,3003,서구,,관저1동제2투,1674,1178,434,694,27,0,4,0,0,0,1,0,0,0,1160,18,496
3000,대전광역시,3003,서구,,관저1동제3투,3127,2052,1004,932,69,1,18,0,0,0,1,2,0,0,2027,25,1075
3000,대전광역시,3003,서구,관저2동,소계,34688,25928,13543,11145,760,12,214,8,1,4,7,26,5,6,25731,197,8760
3000,대전광역시,3003,서구,,관내사전투표,10152,10152,5835,3974,229,8,49,2,0,1,2,8,4,1,10113,39,0
3000,대전광역시,3003,서구,,관저2동제1투,1643,1050,400,596,37,0,9,0,1,0,0,0,0,0,1043,7,593
3000,대전광역시,3003,서구,,관저2동제2투,3125,2124,1069,928,72,2,26,1,0,0,0,2,0,1,2101,23,1001
3000,대전광역시,3003,서구,,관저2동제3투,2575,1606,831,688,49,0,20,0,0,1,0,1,0,1,1591,15,969
3000,대전광역시,3003,서구,,관저2동제4투,3087,1946,980,855,62,1,21,0,0,1,2,5,0,1,1928,18,1141
3000,대전광역시,3003,서구,,관저2동제5투,2888,1864,862,900,67,0,16,2,0,1,1,1,0,0,1850,14,1024
3000,대전광역시,3003,서구,,관저2동제6투,2680,1712,861,756,60,0,13,0,0,0,1,2,0,1,1694,18,968
3000,대전광역시,3003,서구,,관저2동제7투,2823,1702,896,709,55,0,21,0,0,0,0,3,0,0,1684,18,1121
3000,대전광역시,3003,서구,,관저2동제8투,2523,1666,811,751,63,0,16,1,0,0,1,2,1,0,1646,20,857
3000,대전광역시,3003,서구,,관저2동제9투,3192,2106,998,988,66,1,23,2,0,0,0,2,0,1,2081,25,1086
3000,대전광역시,3003,서구,기성동,소계,3392,2367,893,1308,49,3,22,3,5,3,1,5,4,8,2304,63,1025
3000,대전광역시,3003,서구,,관내사전투표,1361,1361,558,696,33,3,11,2,5,2,1,2,1,4,1318,43,0
3000,대전광역시,3003,서구,,기성동제1투,512,270,96,166,4,0,2,0,0,0,0,1,0,0,269,1,242
3000,대전광역시,3003,서구,,기성동제2투,708,300,109,172,3,0,4,1,0,0,0,0,1,3,293,7,408
3000,대전광역시,3003,서구,,기성동제3투,811,436,130,274,9,0,5,0,0,1,0,2,2,1,424,12,375
3000,대전광역시,3003,서구,잘못 투입·구분된 투표지,,0,7,6,1,0,0,0,0,0,0,0,0,0,0,7,0,-7
3000,대전광역시,3004,유성구,합계,,288686,231027,108701,111342,6492,126,1599,44,31,44,124,187,63,63,228816,2211,57659
3000,대전광역시,3004,유성구,거소·선상투표,,550,522,209,230,9,1,10,1,0,0,0,0,2,2,464,58,28
3000,대전광역시,3004,유성구,관외사전투표,,30486,30481,14465,14335,955,18,288,4,6,4,9,30,10,14,30138,343,5
3000,대전광역시,3004,유성구,재외투표,,1484,1104,569,363,41,0,4,0,0,0,0,1,0,0,978,126,380
3000,대전광역시,3004,유성구,진잠동,소계,18256,13248,6400,6218,329,8,142,1,1,2,8,17,11,4,13141,107,5008
3000,대전광역시,3004,유성구,,관내사전투표,4508,4508,2468,1870,96,4,29,0,1,1,1,5,2,2,4479,29,0
3000,대전광역시,3004,유성구,,진잠동제1투,2797,1402,592,731,35,0,25,0,0,1,0,1,1,1,1387,15,1395
3000,대전광역시,3004,유성구,,진잠동제2투,2236,1538,729,740,38,0,13,0,0,0,0,4,1,0,1525,13,698
3000,대전광역시,3004,유성구,,진잠동제3투,2120,1464,656,730,47,1,12,0,0,0,2,2,1,0,1451,13,656
3000,대전광역시,3004,유성구,,진잠동제4투,749,338,89,223,6,0,12,0,0,0,0,2,0,0,332,6,411
3000,대전광역시,3004,유성구,,진잠동제5투,319,227,57,167,3,0,0,0,0,0,0,0,0,0,227,0,92
3000,대전광역시,3004,유성구,,진잠동제6투,473,307,112,177,6,0,4,0,0,0,0,0,0,1,300,7,166
3000,대전광역시,3004,유성구,,진잠동제7투,2593,1811,913,802,49,3,29,0,0,0,1,2,1,0,1800,11,782
3000,대전광역시,3004,유성구,,진잠동제8투,2461,1653,784,778,49,0,18,1,0,0,4,1,5,0,1640,13,808
3000,대전광역시,3004,유성구,온천1동,소계,23916,16854,7298,8680,480,8,161,5,2,2,9,16,4,7,16672,182,7062
3000,대전광역시,3004,유성구,,관내사전투표,7944,7941,3842,3758,224,3,45,2,0,0,4,6,1,2,7887,54,3
3000,대전광역시,3004,유성구,,온천1동제1투,3193,1740,696,968,34,0,23,0,0,0,1,2,0,0,1724,16,1453
3000,대전광역시,3004,유성구,,온천1동제2투,3724,2115,747,1229,66,2,35,1,1,1,1,4,2,3,2092,23,1609
3000,대전광역시,3004,유성구,,온천1동제3투,3380,1845,689,1054,42,1,22,0,0,0,2,0,0,0,1810,35,1535
3000,대전광역시,3004,유성구,,온천1동제4투,3448,1943,828,970,80,1,24,0,0,1,1,3,1,2,1911,32,1505
3000,대전광역시,3004,유성구,,온천1동제5투,2227,1270,496,701,34,1,12,2,1,0,0,1,0,0,1248,22,957
3000,대전광역시,3004,유성구,온천2동,소계,27453,20909,8892,10961,609,14,136,4,3,1,10,26,4,9,20669,240,6544
3000,대전광역시,3004,유성구,,관내사전투표,6216,6216,3071,2870,182,2,13,1,1,0,0,13,0,3,6156,60,0
3000,대전광역시,3004,유성구,,온천2동제1투,2709,1559,621,846,46,0,25,0,0,0,2,0,1,2,1543,16,1150
3000,대전광역시,3004,유성구,,온천2동제2투,2497,1619,592,955,37,3,13,0,0,0,1,0,1,0,1602,17,878
3000,대전광역시,3004,유성구,,온천2동제3투,2199,1343,481,761,43,1,16,1,0,0,0,0,1,1,1305,38,856
3000,대전광역시,3004,유성구,,온천2동제4투,1444,1024,408,568,32,1,4,0,0,0,3,1,0,0,1017,7,420
3000,대전광역시,3004,유성구,,온천2동제5투,1550,1168,476,635,33,1,6,2,0,1,1,3,0,0,1158,10,382
3000,대전광역시,3004,유성구,,온천2동제6투,1820,1289,532,683,44,3,6,0,1,0,0,2,0,0,1271,18,531
3000,대전광역시,3004,유성구,,온천2동제7투,2782,1891,757,1059,34,0,14,0,0,0,0,5,0,0,1869,22,891
3000,대전광역시,3004,유성구,,온천2동제8투,2232,1655,732,813,69,2,12,0,1,0,2,0,1,1,1633,22,577
3000,대전광역시,3004,유성구,,온천2동제9투,2150,1727,651,990,46,0,20,0,0,0,1,0,0,1,1709,18,423
3000,대전광역시,3004,유성구,,온천2동제10투,1854,1418,571,781,43,1,7,0,0,0,0,2,0,1,1406,12,436
3000,대전광역시,3004,유성구,노은1동,소계,17366,14091,6832,6647,383,6,79,3,3,4,5,7,8,4,13981,110,3275
3000,대전광역시,3004,유성구,,관내사전투표,7450,7450,3955,3215,187,4,23,1,1,1,2,3,6,1,7399,51,0
3000,대전광역시,3004,유성구,,노은1동제1투,2151,1356,653,624,45,1,12,1,0,3,0,1,0,1,1341,15,795
3000,대전광역시,3004,유성구,,노은1동제2투,2174,1586,657,863,43,1,10,0,0,0,0,2,1,0,1577,9,588
3000,대전광역시,3004,유성구,,노은1동제3투,2995,1969,921,938,68,0,17,1,2,0,2,0,1,0,1950,19,1026
3000,대전광역시,3004,유성구,,노은1동제4투,2596,1730,646,1007,40,0,17,0,0,0,1,1,0,2,1714,16,866
3000,대전광역시,3004,유성구,노은2동,소계,15939,12596,6129,5911,380,7,58,2,0,2,10,2,2,1,12504,92,3343
3000,대전광역시,3004,유성구,,관내사전투표,4445,4445,2451,1844,109,3,14,1,0,0,0,1,0,1,4424,21,0
3000,대전광역시,3004,유성구,,노은2동제1투,2804,2042,867,1082,61,2,8,0,0,1,5,0,1,0,2027,15,762
3000,대전광역시,3004,유성구,,노은2동제2투,2986,2164,1001,1052,81,2,13,0,0,0,2,0,1,0,2152,12,822
3000,대전광역시,3004,유성구,,노은2동제3투,2161,1420,608,734,46,0,6,1,0,0,1,0,0,0,1396,24,741
3000,대전광역시,3004,유성구,,노은2동제4투,2234,1475,652,746,45,0,14,0,0,1,1,1,0,0,1460,15,759
3000,대전광역시,3004,유성구,,노은2동제5투,1309,1050,550,453,38,0,3,0,0,0,1,0,0,0,1045,5,259
3000,대전광역시,3004,유성구,신성동,소계,18643,15010,6438,7894,371,8,96,3,2,4,13,8,2,2,14841,169,3633
3000,대전광역시,3004,유성구,,관내사전투표,6962,6962,3613,3064,164,5,37,2,0,1,3,5,1,1,6896,66,0
3000,대전광역시,3004,유성구,,신성동제1투,1471,868,339,470,24,1,15,0,0,1,3,1,0,0,854,14,603
3000,대전광역시,3004,유성구,,신성동제2투,2623,1927,694,1146,55,1,5,0,1,0,1,0,0,0,1903,24,696
3000,대전광역시,3004,유성구,,신성동제3투,2227,1463,604,761,43,0,23,0,0,0,0,2,1,0,1434,29,764
3000,대전광역시,3004,유성구,,신성동제4투,1778,1212,467,692,33,0,3,1,0,1,4,0,0,1,1202,10,566
3000,대전광역시,3004,유성구,,신성동제5투,1632,1063,340,666,31,1,6,0,1,1,1,0,0,0,1047,16,569
3000,대전광역시,3004,유성구,,신성동제6투,1950,1515,381,1095,21,0,7,0,0,0,1,0,0,0,1505,10,435
3000,대전광역시,3004,유성구,전민동,소계,19699,16025,7630,7705,443,9,75,1,0,4,18,7,3,3,15898,127,3674
3000,대전광역시,3004,유성구,,관내사전투표,7070,7070,3899,2934,172,5,20,1,0,0,2,3,1,0,7037,33,0
3000,대전광역시,3004,유성구,,전민동제1투,1985,1297,581,630,53,0,11,0,0,1,2,2,1,0,1281,16,688
3000,대전광역시,3004,유성구,,전민동제2투,2544,1612,613,895,54,1,17,0,0,0,4,1,0,0,1585,27,932
3000,대전광역시,3004,유성구,,전민동제3투,1870,1379,577,747,36,1,4,0,0,0,2,0,1,1,1369,10,491
3000,대전광역시,3004,유성구,,전민동제4투,1851,1380,545,781,34,0,5,0,0,0,3,1,0,2,1371,9,471
3000,대전광역시,3004,유성구,,전민동제5투,2247,1641,655,907,53,1,9,0,0,3,2,0,0,0,1630,11,606
3000,대전광역시,3004,유성구,,전민동제6투,2132,1646,760,811,41,1,9,0,0,0,3,0,0,0,1625,21,486
3000,대전광역시,3004,유성구,구즉동,소계,20140,14906,7971,6122,485,14,138,4,2,4,8,16,6,2,14772,134,5234
3000,대전광역시,3004,유성구,,관내사전투표,6429,6429,3803,2338,196,5,46,3,0,1,2,5,2,1,6402,27,0
3000,대전광역시,3004,유성구,,구즉동제1투,1227,664,301,319,18,1,8,0,0,0,1,2,1,0,651,13,563
3000,대전광역시,3004,유성구,,구즉동제2투,275,173,53,112,5,0,0,0,0,0,0,0,1,0,171,2,102
3000,대전광역시,3004,유성구,,구즉동제3투,1830,998,412,504,40,0,21,0,1,0,2,2,0,0,982,16,832
3000,대전광역시,3004,유성구,,구즉동제4투,2659,1752,896,753,61,2,21,0,0,1,0,2,0,0,1736,16,907
3000,대전광역시,3004,유성구,,구즉동제5투,2485,1605,792,717,51,3,19,0,1,0,2,0,1,0,1586,19,880
3000,대전광역시,3004,유성구,,구즉동제6투,2405,1556,835,624,58,3,10,0,0,1,0,5,1,0,1537,19,849
3000,대전광역시,3004,유성구,,구즉동제7투,2830,1729,879,755,56,0,13,1,0,1,1,0,0,1,1707,22,1101
3000,대전광역시,3004,유성구,관평동,소계,20577,16813,8313,7754,500,9,76,3,1,4,7,6,1,7,16681,132,3764
3000,대전광역시,3004,유성구,,관내사전투표,7762,7762,4318,3147,210,5,30,0,0,1,1,3,1,3,7719,43,0
3000,대전광역시,3004,유성구,,관평동제1투,2209,1682,846,749,55,1,9,1,0,0,3,0,0,2,1666,16,527
3000,대전광역시,3004,유성구,,관평동제2투,2457,1826,870,879,52,2,7,0,0,1,0,2,0,0,1813,13,631
3000,대전광역시,3004,유성구,,관평동제3투,2488,1780,839,837,73,0,9,2,1,1,0,0,0,0,1762,18,708
3000,대전광역시,3004,유성구,,관평동제4투,2597,1886,606,1208,40,0,9,0,0,0,3,1,0,1,1868,18,711
3000,대전광역시,3004,유성구,,관평동제5투,3064,1877,834,934,70,1,12,0,0,1,0,0,0,1,1853,24,1187
3000,대전광역시,3004,유성구,원신흥동,소계,20698,16178,7630,7884,400,3,116,4,3,3,5,15,3,1,16067,111,4520
3000,대전광역시,3004,유성구,,관내사전투표,6742,6742,3446,3097,136,1,23,3,0,0,3,8,0,0,6717,25,0
3000,대전광역시,3004,유성구,,원신흥동제1투,2849,2033,927,1006,55,0,31,0,0,1,1,2,0,0,2023,10,816
3000,대전광역시,3004,유성구,,원신흥동제2투,2507,1908,783,1039,61,1,6,1,3,0,1,0,0,0,1895,13,599
3000,대전광역시,3004,유성구,,원신흥동제3투,1905,1246,474,719,31,0,10,0,0,0,0,0,0,0,1234,12,659
3000,대전광역시,3004,유성구,,원신흥동제4투,3380,2058,972,970,59,1,28,0,0,1,0,2,2,0,2035,23,1322
3000,대전광역시,3004,유성구,,원신흥동제5투,3315,2191,1028,1053,58,0,18,0,0,1,0,3,1,1,2163,28,1124
3000,대전광역시,3004,유성구,노은3동,소계,25788,20797,10632,9310,561,11,89,4,5,7,10,25,4,6,20664,133,4991
3000,대전광역시,3004,유성구,,관내사전투표,8607,8607,4877,3478,180,1,25,1,0,0,0,10,1,5,8578,29,0
3000,대전광역시,3004,유성구,,노은3동제1투,1989,1540,754,714,46,0,8,0,2,0,0,2,0,0,1526,14,449
3000,대전광역시,3004,유성구,,노은3동제2투,2958,2019,980,954,40,1,16,3,0,0,1,3,3,0,2001,18,939
3000,대전광역시,3004,유성구,,노은3동제3투,1809,1340,594,673,39,1,8,0,1,1,4,3,0,1,1325,15,469
3000,대전광역시,3004,유성구,,노은3동제4투,1796,1313,510,753,29,1,2,0,1,4,0,0,0,0,1300,13,483
3000,대전광역시,3004,유성구,,노은3동제5투,2398,1882,920,871,64,2,3,0,1,0,2,1,0,0,1864,18,516
3000,대전광역시,3004,유성구,,노은3동제6투,1885,1252,649,526,48,4,10,0,0,1,1,4,0,0,1243,9,633
3000,대전광역시,3004,유성구,,노은3동제7투,2360,1557,782,689,59,1,11,0,0,0,2,2,0,0,1546,11,803
3000,대전광역시,3004,유성구,,노은3동제8투,1986,1287,566,652,56,0,6,0,0,1,0,0,0,0,1281,6,699
3000,대전광역시,3004,유성구,학하동,소계,12502,9536,4219,4928,209,7,68,1,0,1,5,4,2,1,9445,91,2966
3000,대전광역시,3004,유성구,,관내사전투표,4141,4140,2070,1933,82,2,17,0,0,0,0,3,0,0,4107,33,1
3000,대전광역시,3004,유성구,,학하동제1투,2023,1204,439,697,37,3,15,0,0,1,2,1,0,0,1195,9,819
3000,대전광역시,3004,유성구,,학하동제2투,2116,1445,662,734,31,0,10,0,0,0,1,0,0,0,1438,7,671
3000,대전광역시,3004,유성구,,학하동제3투,2134,1284,501,698,36,2,17,1,0,0,0,0,1,0,1256,28,850
3000,대전광역시,3004,유성구,,학하동제4투,2088,1463,547,866,23,0,9,0,0,0,2,0,1,1,1449,14,625
3000,대전광역시,3004,유성구,상대동,소계,15189,11952,5072,6397,337,3,63,4,3,2,7,7,1,0,11896,56,3237
3000,대전광역시,3004,유성구,,관내사전투표,4217,4217,2106,1981,101,1,12,1,0,1,1,3,0,0,4207,10,0
3000,대전광역시,3004,유성구,,상대동제1투,2602,1577,717,777,47,1,18,1,1,0,2,2,0,0,1566,11,1025
3000,대전광역시,3004,유성구,,상대동제2투,2682,1890,778,1014,74,0,12,1,1,0,0,0,0,0,1880,10,792
3000,대전광역시,3004,유성구,,상대동제3투,2408,1868,563,1237,46,0,5,1,0,0,2,2,0,0,1856,12,540
3000,대전광역시,3004,유성구,,상대동제4투,3280,2400,908,1388,69,1,16,0,1,1,2,0,1,0,2387,13,880
3000,대전광역시,3004,유성구,잘못 투입·구분된 투표지,,0,5,2,3,0,0,0,0,0,0,0,0,0,0,5,0,-5
3000,대전광역시,3005,대덕구,합계,,152905,115404,54119,55159,3141,96,1258,37,18,25,96,173,45,58,114225,1179,37501
3000,대전광역시,3005,대덕구,거소·선상투표,,270,247,102,98,6,1,3,0,0,0,0,1,0,0,211,36,23
3000,대전광역시,3005,대덕구,관외사전투표,,13738,13736,6893,6008,434,9,190,10,2,2,6,16,4,9,13583,153,2
3000,대전광역시,3005,대덕구,재외투표,,425,297,175,77,11,0,1,0,0,0,0,0,0,0,264,33,128
3000,대전광역시,3005,대덕구,오정동,소계,11345,7910,3372,4141,186,6,91,2,2,2,6,13,5,3,7829,81,3435
3000,대전광역시,3005,대덕구,,관내사전투표,2576,2576,1281,1198,59,3,13,2,1,0,1,7,1,0,2566,10,0
3000,대전광역시,3005,대덕구,,오정동제1투,1605,1003,385,558,23,0,15,0,1,0,0,1,3,1,987,16,602
3000,대전광역시,3005,대덕구,,오정동제2투,911,542,207,304,15,0,8,0,0,1,0,1,0,0,536,6,369
3000,대전광역시,3005,대덕구,,오정동제3투,1542,797,312,429,21,1,13,0,0,1,0,2,0,1,780,17,745
3000,대전광역시,3005,대덕구,,오정동제4투,1364,712,273,399,21,0,10,0,0,0,1,1,0,1,706,6,652
3000,대전광역시,3005,대덕구,,오정동제5투,1998,1434,578,788,31,2,18,0,0,0,2,1,0,0,1420,14,564
3000,대전광역시,3005,대덕구,,오정동제6투,1349,846,336,465,16,0,14,0,0,0,2,0,1,0,834,12,503
3000,대전광역시,3005,대덕구,대화동,소계,6021,4052,1799,1960,100,6,62,3,1,1,6,17,2,8,3965,87,1969
3000,대전광역시,3005,대덕구,,관내사전투표,1710,1710,831,771,43,4,16,3,0,1,1,8,0,1,1679,31,0
3000,대전광역시,3005,대덕구,,대화동제1투,1462,701,274,355,19,2,5,0,1,0,3,3,2,6,670,31,761
3000,대전광역시,3005,대덕구,,대화동제2투,1003,572,248,281,14,0,18,0,0,0,0,0,0,0,561,11,431
3000,대전광역시,3005,대덕구,,대화동제3투,1846,1069,446,553,24,0,23,0,0,0,2,6,0,1,1055,14,777
3000,대전광역시,3005,대덕구,회덕동,소계,9689,7127,3148,3636,180,5,65,3,3,2,4,12,3,2,7063,64,2562
3000,대전광역시,3005,대덕구,,관내사전투표,2233,2233,1141,999,48,1,18,0,2,0,0,7,0,1,2217,16,0
3000,대전광역시,3005,대덕구,,회덕동제1투,1536,1120,490,568,33,1,13,2,0,0,0,0,0,0,1107,13,416
3000,대전광역시,3005,대덕구,,회덕동제2투,1793,1136,439,635,34,1,12,0,0,1,2,2,0,0,1126,10,657
3000,대전광역시,3005,대덕구,,회덕동제3투,1469,810,351,411,25,2,11,1,1,1,0,1,0,0,804,6,659
3000,대전광역시,3005,대덕구,,회덕동제4투,2248,1538,649,826,33,0,10,0,0,0,2,1,2,0,1523,15,710
3000,대전광역시,3005,대덕구,,회덕동제5투,410,290,78,197,7,0,1,0,0,0,0,1,1,1,286,4,120
3000,대전광역시,3005,대덕구,비래동,소계,13138,9741,4486,4772,253,8,93,3,0,5,6,19,2,8,9655,86,3397
3000,대전광역시,3005,대덕구,,관내사전투표,3727,3727,1946,1636,93,1,25,1,0,1,2,6,0,2,3713,14,0
3000,대전광역시,3005,대덕구,,비래동제1투,1876,1162,478,616,29,2,19,1,0,0,2,0,0,1,1148,14,714
3000,대전광역시,3005,대덕구,,비래동제2투,1674,1027,439,524,26,3,20,0,0,2,0,2,0,3,1019,8,647
3000,대전광역시,3005,대덕구,,비래동제3투,1992,1264,540,653,31,0,16,1,0,1,0,5,1,0,1248,16,728
3000,대전광역시,3005,대덕구,,비래동제4투,2117,1401,584,743,36,1,8,0,0,0,1,5,0,2,1380,21,716
3000,대전광역시,3005,대덕구,,비래동제5투,1752,1160,499,600,38,1,5,0,0,1,1,1,1,0,1147,13,592
3000,대전광역시,3005,대덕구,송촌동,소계,20285,15468,7528,7188,421,7,145,4,3,2,6,19,4,5,15332,136,4817
3000,대전광역시,3005,대덕구,,관내사전투표,6470,6470,3539,2712,136,2,43,3,1,0,0,3,1,1,6441,29,0
3000,대전광역시,3005,대덕구,,송촌동제1투,2281,1615,738,783,51,1,17,0,1,0,0,6,0,1,1598,17,666
3000,대전광역시,3005,대덕구,,송촌동제2투,2324,1447,631,734,47,0,16,0,0,0,4,0,0,0,1432,15,877
3000,대전광역시,3005,대덕구,,송촌동제3투,2251,1483,714,688,51,1,12,0,0,1,1,2,1,1,1472,11,768
3000,대전광역시,3005,대덕구,,송촌동제4투,2460,1738,790,849,63,2,10,0,0,0,0,5,0,0,1719,19,722
3000,대전광역시,3005,대덕구,,송촌동제5투,2234,1305,516,714,31,1,23,1,1,1,1,0,0,2,1291,14,929
3000,대전광역시,3005,대덕구,,송촌동제6투,2265,1410,600,708,42,0,24,0,0,0,0,3,2,0,1379,31,855
3000,대전광역시,3005,대덕구,중리동,소계,15352,10409,4727,5165,227,9,136,3,1,3,10,11,3,6,10301,108,4943
3000,대전광역시,3005,대덕구,,관내사전투표,3430,3430,1793,1513,69,4,22,0,0,0,0,3,1,2,3407,23,0
3000,대전광역시,3005,대덕구,,중리동제1투,1677,990,380,565,23,0,9,0,0,1,1,1,0,1,981,9,687
3000,대전광역시,3005,대덕구,,중리동제2투,1352,821,378,401,18,0,13,1,0,0,0,0,0,1,812,9,531
3000,대전광역시,3005,대덕구,,중리동제3투,2062,1189,538,563,35,1,26,0,0,1,3,1,0,0,1168,21,873
3000,대전광역시,3005,대덕구,,중리동제4투,1770,1139,463,625,21,2,13,2,0,0,0,1,0,0,1127,12,631
3000,대전광역시,3005,대덕구,,중리동제5투,1791,977,399,509,26,0,16,0,0,0,4,3,1,2,960,17,814
3000,대전광역시,3005,대덕구,,중리동제6투,1674,932,380,505,14,1,16,0,1,0,1,1,1,0,920,12,742
3000,대전광역시,3005,대덕구,,중리동제7투,1596,931,396,484,21,1,21,0,0,1,1,1,0,0,926,5,665
3000,대전광역시,3005,대덕구,법1동,소계,10121,7554,3467,3704,216,7,68,2,1,1,4,16,4,1,7491,63,2567
3000,대전광역시,3005,대덕구,,관내사전투표,3053,3052,1601,1338,66,2,21,1,0,0,1,3,0,0,3033,19,1
3000,대전광역시,3005,대덕구,,법1동제1투,2487,1674,683,897,65,0,13,0,0,0,0,5,1,0,1664,10,813
3000,대전광역시,3005,대덕구,,법1동제2투,2182,1483,591,807,46,1,14,0,0,1,0,4,1,0,1465,18,699
3000,대전광역시,3005,대덕구,,법1동제3투,2399,1345,592,662,39,4,20,1,1,0,3,4,2,1,1329,16,1054
3000,대전광역시,3005,대덕구,법2동,소계,12842,9987,4459,5031,271,9,92,3,2,4,10,14,3,6,9904,83,2855
3000,대전광역시,3005,대덕구,,관내사전투표,4018,4018,1924,1932,97,3,25,2,1,1,7,6,1,2,4001,17,0
3000,대전광역시,3005,대덕구,,법2동제1투,1624,983,409,502,23,4,25,1,0,0,1,1,2,0,968,15,641
3000,대전광역시,3005,대덕구,,법2동제2투,2284,1635,619,929,45,2,13,0,0,1,1,6,0,1,1617,18,649
3000,대전광역시,3005,대덕구,,법2동제3투,2524,1701,744,875,54,0,13,0,0,0,1,0,0,1,1688,13,823
3000,대전광역시,3005,대덕구,,법2동제4투,537,269,94,162,7,0,1,0,0,2,0,0,0,0,266,3,268
3000,대전광역시,3005,대덕구,,법2동제5투,1855,1381,669,631,45,0,15,0,1,0,0,1,0,2,1364,17,474
3000,대전광역시,3005,대덕구,신탄진동,소계,11289,8312,3758,4114,241,7,84,0,0,1,18,10,5,1,8239,73,2977
3000,대전광역시,3005,대덕구,,관내사전투표,3415,3415,1698,1563,96,3,29,0,0,1,4,0,2,1,3397,18,0
3000,대전광역시,3005,대덕구,,신탄진동제1투,1812,908,365,477,28,2,12,0,0,0,2,4,1,0,891,17,904
3000,대전광역시,3005,대덕구,,신탄진동제2투,1892,1255,509,684,31,0,11,0,0,0,6,4,0,0,1245,10,637
3000,대전광역시,3005,대덕구,,신탄진동제3투,2212,1339,539,719,34,2,25,0,0,0,4,2,1,0,1326,13,873
3000,대전광역시,3005,대덕구,,신탄진동제4투,349,234,78,145,4,0,1,0,0,0,0,0,1,0,229,5,115
3000,대전광역시,3005,대덕구,,신탄진동제5투,1609,1161,569,526,48,0,6,0,0,0,2,0,0,0,1151,10,448
3000,대전광역시,3005,대덕구,석봉동,소계,11816,8861,4439,3987,263,8,73,2,1,1,9,9,4,1,8797,64,2955
3000,대전광역시,3005,대덕구,,관내사전투표,3359,3359,1865,1363,85,2,22,0,0,0,2,3,2,0,3344,15,0
3000,대전광역시,3005,대덕구,,석봉동제1투,1833,1000,458,480,32,3,11,0,0,0,1,1,2,0,988,12,833
3000,대전광역시,3005,대덕구,,석봉동제2투,1153,676,246,384,26,1,5,1,0,1,4,0,0,0,668,8,477
3000,대전광역시,3005,대덕구,,석봉동제3투,3344,2403,1152,1133,72,0,22,1,0,0,2,3,0,0,2385,18,941
3000,대전광역시,3005,대덕구,,석봉동제4투,2127,1423,718,627,48,2,13,0,1,0,0,2,0,1,1412,11,704
3000,대전광역시,3005,대덕구,덕암동,소계,11145,7885,3788,3666,206,9,100,2,2,1,10,13,3,5,7805,80,3260
3000,대전광역시,3005,대덕구,,관내사전투표,3273,3273,1733,1394,83,4,26,1,1,1,1,3,0,2,3249,24,0
3000,대전광역시,3005,대덕구,,덕암동제1투,2132,1121,550,489,40,1,14,0,1,0,3,5,0,0,1103,18,1011
3000,대전광역시,3005,대덕구,,덕암동제2투,2747,1679,742,847,43,0,26,1,0,0,2,3,0,0,1664,15,1068
3000,대전광역시,3005,대덕구,,덕암동제3투,2386,1428,614,725,30,4,26,0,0,0,2,2,3,3,1409,19,958
3000,대전광역시,3005,대덕구,,덕암동제4투,607,384,149,211,10,0,8,0,0,0,2,0,0,0,380,4,223
3000,대전광역시,3005,대덕구,목상동,소계,5429,3815,1975,1612,126,5,55,0,0,0,1,3,3,3,3783,32,1614
3000,대전광역시,3005,대덕구,,관내사전투표,1873,1873,1037,743,67,3,8,0,0,0,0,3,1,1,1863,10,0
3000,대전광역시,3005,대덕구,,목상동제1투,1872,941,453,428,27,1,20,0,0,0,1,0,1,0,931,10,931
3000,대전광역시,3005,대덕구,,목상동제2투,1684,1001,485,441,32,1,27,0,0,0,0,0,1,2,989,12,683
3000,대전광역시,3005,대덕구,잘못 투입·구분된 투표지,,0,3,3,0,0,0,0,0,0,0,0,0,0,0,3,0,-33100,울산광역시,3101,중구,합계,,182051,143171,54075,81399,3852,75,1702,44,19,38,156,394,50,65,141869,1302,38880
3100,울산광역시,3101,중구,거소·선상투표,,302,281,77,143,4,1,18,0,1,1,0,0,0,0,245,36,21
3100,울산광역시,3101,중구,관외사전투표,,13967,13965,5568,7529,425,11,177,7,1,5,11,31,6,20,13791,174,2
3100,울산광역시,3101,중구,재외투표,,600,411,199,152,16,0,3,1,0,0,0,0,0,0,371,40,189
3100,울산광역시,3101,중구,학성동,소계,9915,7450,2411,4632,156,3,114,4,1,3,16,25,4,1,7370,80,2465
3100,울산광역시,3101,중구,,관내사전투표,3531,3531,1246,2142,65,2,34,0,0,1,2,15,2,0,3509,22,0
3100,울산광역시,3101,중구,,학성동제1투,2177,1282,402,794,35,0,26,1,0,1,5,0,1,0,1265,17,895
3100,울산광역시,3101,중구,,학성동제2투,1320,827,232,539,17,0,16,2,0,0,4,0,0,0,810,17,493
3100,울산광역시,3101,중구,,학성동제3투,1413,912,272,580,20,0,18,0,1,1,4,5,0,1,902,10,501
3100,울산광역시,3101,중구,,학성동제4투,1474,898,259,577,19,1,20,1,0,0,1,5,1,0,884,14,576
3100,울산광역시,3101,중구,반구1동,소계,13836,10466,4117,5698,309,6,160,4,1,2,16,40,2,8,10363,103,3370
3100,울산광역시,3101,중구,,관내사전투표,4548,4546,2054,2269,129,4,41,3,1,1,3,20,1,1,4527,19,2
3100,울산광역시,3101,중구,,반구1동제1투,2227,1362,470,780,43,1,37,0,0,0,0,3,0,1,1335,27,865
3100,울산광역시,3101,중구,,반구1동제2투,2220,1414,486,819,54,0,27,0,0,0,4,3,1,0,1394,20,806
3100,울산광역시,3101,중구,,반구1동제3투,2688,1719,531,1072,41,1,34,1,0,0,5,8,0,5,1698,21,969
3100,울산광역시,3101,중구,,반구1동제4투,2153,1425,576,758,42,0,21,0,0,1,4,6,0,1,1409,16,728
3100,울산광역시,3101,중구,반구2동,소계,7283,5477,1908,3238,157,4,85,3,1,0,6,16,1,5,5424,53,1806
3100,울산광역시,3101,중구,,관내사전투표,2472,2472,933,1404,72,2,34,2,0,0,2,7,0,3,2459,13,0
3100,울산광역시,3101,중구,,반구2동제1투,1505,891,281,549,32,0,13,0,0,0,0,2,0,0,877,14,614
3100,울산광역시,3101,중구,,반구2동제2투,1759,1102,353,666,34,1,28,0,0,0,2,6,1,2,1093,9,657
3100,울산광역시,3101,중구,,반구2동제3투,1547,1012,341,619,19,1,10,1,1,0,2,1,0,0,995,17,535
3100,울산광역시,3101,중구,복산1동,소계,3896,3021,1047,1822,81,1,31,3,2,1,2,4,3,1,2998,23,875
3100,울산광역시,3101,중구,,관내사전투표,1669,1669,658,947,35,1,10,3,2,1,1,2,2,1,1663,6,0
3100,울산광역시,3101,중구,,복산1동제1투,1546,962,279,621,33,0,11,0,0,0,1,2,1,0,948,14,584
3100,울산광역시,3101,중구,,복산1동제2투,681,390,110,254,13,0,10,0,0,0,0,0,0,0,387,3,291
3100,울산광역시,3101,중구,복산2동,소계,8695,6697,2631,3690,200,2,83,2,1,1,9,22,2,3,6646,51,1998
3100,울산광역시,3101,중구,,관내사전투표,3082,3082,1360,1579,79,0,28,2,0,1,2,12,0,2,3065,17,0
3100,울산광역시,3101,중구,,복산2동제1투,1460,927,328,552,23,1,12,0,0,0,1,2,1,0,920,7,533
3100,울산광역시,3101,중구,,복산2동제2투,2702,1767,647,1001,73,1,22,0,1,0,2,2,1,0,1750,17,935
3100,울산광역시,3101,중구,,복산2동제3투,1451,921,296,558,25,0,21,0,0,0,4,6,0,1,911,10,530
3100,울산광역시,3101,중구,성안동,소계,15916,12090,5267,6230,304,5,152,2,2,3,4,37,4,7,12017,73,3826
3100,울산광역시,3101,중구,,관내사전투표,5593,5593,2646,2718,138,1,43,2,1,1,1,17,2,2,5572,21,0
3100,울산광역시,3101,중구,,성안동제1투,2539,1567,632,845,39,2,32,0,0,0,0,5,0,1,1556,11,972
3100,울산광역시,3101,중구,,성안동제2투,2275,1422,553,798,28,0,26,0,0,1,0,4,0,1,1411,11,853
3100,울산광역시,3101,중구,,성안동제3투,2798,1756,709,937,49,2,24,0,0,1,0,8,2,2,1734,22,1042
3100,울산광역시,3101,중구,,성안동제4투,2711,1752,727,932,50,0,27,0,1,0,3,3,0,1,1744,8,959
3100,울산광역시,3101,중구,중앙동,소계,10452,7520,2127,5070,115,3,83,2,0,4,15,20,3,0,7442,78,2932
3100,울산광역시,3101,중구,,관내사전투표,2939,2939,939,1897,53,0,15,2,0,1,3,3,2,0,2915,24,0
3100,울산광역시,3101,중구,,중앙동제1투,2117,1231,326,858,14,2,8,0,0,0,3,2,0,0,1213,18,886
3100,울산광역시,3101,중구,,중앙동제2투,1964,1278,317,883,22,1,28,0,0,1,2,9,1,0,1264,14,686
3100,울산광역시,3101,중구,,중앙동제3투,1374,825,217,569,9,0,15,0,0,1,4,1,0,0,816,9,549
3100,울산광역시,3101,중구,,중앙동제4투,2058,1247,328,863,17,0,17,0,0,1,3,5,0,0,1234,13,811
3100,울산광역시,3101,중구,우정동,소계,14314,11193,3744,6988,244,4,93,2,0,4,7,30,4,2,11122,71,3121
3100,울산광역시,3101,중구,,관내사전투표,4191,4190,1550,2503,75,0,26,1,0,1,2,12,3,1,4174,16,1
3100,울산광역시,3101,중구,,우정동제1투,2979,1863,528,1256,49,0,14,0,0,1,2,2,0,0,1852,11,1116
3100,울산광역시,3101,중구,,우정동제2투,1594,1031,324,654,27,1,10,0,0,0,0,2,1,1,1020,11,563
3100,울산광역시,3101,중구,,우정동제3투,2911,2154,728,1340,46,1,19,1,0,1,1,5,0,0,2142,12,757
3100,울산광역시,3101,중구,,우정동제4투,2639,1955,614,1235,47,2,24,0,0,1,2,9,0,0,1934,21,684
3100,울산광역시,3101,중구,태화동,소계,23334,18582,7286,10375,534,12,157,2,2,6,18,26,2,5,18425,157,4752
3100,울산광역시,3101,중구,,관내사전투표,6215,6215,2826,3144,169,3,37,1,0,2,0,5,0,1,6188,27,0
3100,울산광역시,3101,중구,,태화동제1투,1958,1209,401,733,34,1,18,0,0,1,4,0,0,0,1192,17,749
3100,울산광역시,3101,중구,,태화동제2투,1936,1269,414,768,47,1,13,0,0,0,1,4,1,0,1249,20,667
3100,울산광역시,3101,중구,,태화동제3투,2517,1795,581,1117,36,5,30,0,0,0,2,5,0,0,1776,19,722
3100,울산광역시,3101,중구,,태화동제4투,2226,1712,617,994,49,0,18,1,0,0,2,4,1,0,1686,26,514
3100,울산광역시,3101,중구,,태화동제5투,2259,1685,548,1047,42,1,17,0,1,2,8,3,0,3,1672,13,574
3100,울산광역시,3101,중구,,태화동제6투,2315,1796,653,1040,68,0,14,0,0,0,1,1,0,0,1777,19,519
3100,울산광역시,3101,중구,,태화동제7투,2243,1697,713,907,60,0,5,0,1,1,0,3,0,1,1691,6,546
3100,울산광역시,3101,중구,,태화동제8투,1665,1204,533,625,29,1,5,0,0,0,0,1,0,0,1194,10,461
3100,울산광역시,3101,중구,다운동,소계,19192,14677,5139,8787,367,6,175,1,3,3,12,42,9,6,14550,127,4515
3100,울산광역시,3101,중구,,관내사전투표,4887,4886,1932,2784,93,0,32,1,1,0,2,12,2,0,4859,27,1
3100,울산광역시,3101,중구,,다운동제1투,2698,1834,602,1140,42,1,19,0,0,0,2,8,1,1,1816,18,864
3100,울산광역시,3101,중구,,다운동제2투,2107,1360,417,857,43,0,30,0,0,0,0,1,0,0,1348,12,747
3100,울산광역시,3101,중구,,다운동제3투,1992,1321,433,802,35,0,22,0,0,1,3,1,2,2,1301,20,671
3100,울산광역시,3101,중구,,다운동제4투,2390,1595,483,1010,57,1,28,0,0,0,2,3,2,2,1588,7,795
3100,울산광역시,3101,중구,,다운동제5투,2489,1787,562,1135,37,0,17,0,0,1,2,8,1,0,1763,24,702
3100,울산광역시,3101,중구,,다운동제6투,2629,1894,710,1059,60,4,27,0,2,1,1,9,1,1,1875,19,735
3100,울산광역시,3101,중구,병영1동,소계,17584,13633,5205,7674,407,6,139,4,1,2,24,39,7,3,13511,122,3951
3100,울산광역시,3101,중구,,관내사전투표,5630,5630,2405,2975,156,3,33,2,1,0,5,15,1,1,5597,33,0
3100,울산광역시,3101,중구,,병영1동제1투,1774,1073,330,668,36,0,19,0,0,0,5,3,0,0,1061,12,701
3100,울산광역시,3101,중구,,병영1동제2투,1872,1139,323,737,30,1,21,0,0,0,4,7,1,1,1125,14,733
3100,울산광역시,3101,중구,,병영1동제3투,2185,1420,439,880,42,0,24,0,0,0,2,7,2,1,1397,23,765
3100,울산광역시,3101,중구,,병영1동제4투,1535,960,255,655,11,1,17,0,0,0,5,1,3,0,948,12,575
3100,울산광역시,3101,중구,,병영1동제5투,2222,1622,689,830,69,1,13,0,0,2,0,4,0,0,1608,14,600
3100,울산광역시,3101,중구,,병영1동제6투,2366,1789,764,929,63,0,12,2,0,0,3,2,0,0,1775,14,577
3100,울산광역시,3101,중구,병영2동,소계,14588,10837,4400,5807,291,8,181,5,3,0,11,42,2,3,10753,84,3751
3100,울산광역시,3101,중구,,관내사전투표,3678,3678,1684,1839,77,2,41,1,0,0,1,13,0,2,3660,18,0
3100,울산광역시,3101,중구,,병영2동제1투,1822,1155,391,668,43,2,31,2,0,0,4,3,0,0,1144,11,667
3100,울산광역시,3101,중구,,병영2동제2투,1203,733,257,420,16,0,23,0,0,0,2,6,0,0,724,9,470
3100,울산광역시,3101,중구,,병영2동제3투,1157,707,215,458,11,2,12,0,0,0,2,2,0,0,702,5,450
3100,울산광역시,3101,중구,,병영2동제4투,1420,866,257,550,21,0,19,1,1,0,0,6,0,0,855,11,554
3100,울산광역시,3101,중구,,병영2동제5투,2047,1399,549,753,42,1,30,1,1,0,2,7,0,1,1387,12,648
3100,울산광역시,3101,중구,,병영2동제6투,3261,2299,1047,1119,81,1,25,0,1,0,0,5,2,0,2281,18,962
3100,울산광역시,3101,중구,약사동,소계,8177,6869,2947,3564,242,3,51,2,0,3,5,20,1,1,6839,30,1308
3100,울산광역시,3101,중구,,관내사전투표,3850,3850,1860,1784,146,1,24,2,0,2,2,14,0,1,3836,14,0
3100,울산광역시,3101,중구,,약사동제1투,2343,1683,620,981,52,1,14,0,0,0,3,5,0,0,1676,7,660
3100,울산광역시,3101,중구,,약사동제2투,1984,1336,467,799,44,1,13,0,0,1,0,1,1,0,1327,9,648
3100,울산광역시,3101,중구,잘못 투입·구분된 투표지,,0,2,2,0,0,0,0,0,0,0,0,0,0,0,2,0,-2
3100,울산광역시,3102,남구,합계,,268213,209589,77783,121304,5251,81,2274,58,34,43,189,444,54,86,207601,1988,58624
3100,울산광역시,3102,남구,거소·선상투표,,446,419,116,215,6,2,11,1,0,0,1,0,1,0,353,66,27
3100,울산광역시,3102,남구,관외사전투표,,20560,20554,7849,11496,560,13,265,6,8,7,17,34,10,18,20283,271,6
3100,울산광역시,3102,남구,재외투표,,880,617,305,212,22,0,3,1,0,0,0,0,0,0,543,74,263
3100,울산광역시,3102,남구,신정1동,소계,15485,11494,3528,7458,214,2,147,6,4,1,16,24,3,5,11408,86,3991
3100,울산광역시,3102,남구,,관내사전투표,4845,4845,1632,3053,83,2,37,3,1,0,1,12,1,1,4826,19,0
3100,울산광역시,3102,남구,,신정1동제1투,2745,1548,416,1042,33,0,34,1,0,1,6,0,2,2,1537,11,1197
3100,울산광역시,3102,남구,,신정1동제2투,2516,1443,405,949,24,0,31,2,3,0,6,5,0,1,1426,17,1073
3100,울산광역시,3102,남구,,신정1동제3투,2494,1654,526,1039,36,0,25,0,0,0,1,3,0,0,1630,24,840
3100,울산광역시,3102,남구,,신정1동제4투,2885,2004,549,1375,38,0,20,0,0,0,2,4,0,1,1989,15,881
3100,울산광역시,3102,남구,신정2동,소계,17125,13434,4424,8475,281,5,105,3,1,0,16,17,3,2,13332,102,3691
3100,울산광역시,3102,남구,,관내사전투표,4634,4634,1798,2679,92,4,32,0,0,0,2,5,1,1,4614,20,0
3100,울산광역시,3102,남구,,신정2동제1투,2297,1335,383,883,33,0,16,0,1,0,4,3,2,0,1325,10,962
3100,울산광역시,3102,남구,,신정2동제2투,2543,1841,643,1109,40,0,20,1,0,0,0,3,0,0,1816,25,702
3100,울산광역시,3102,남구,,신정2동제3투,2350,1719,525,1122,33,0,12,1,0,0,4,2,0,1,1700,19,631
3100,울산광역시,3102,남구,,신정2동제4투,2905,2057,582,1386,44,1,16,1,0,0,5,3,0,0,2038,19,848
3100,울산광역시,3102,남구,,신정2동제5투,2396,1848,493,1296,39,0,9,0,0,0,1,1,0,0,1839,9,548
3100,울산광역시,3102,남구,신정3동,소계,13162,9911,3451,6016,221,1,114,2,3,3,15,15,1,3,9845,66,3251
3100,울산광역시,3102,남구,,관내사전투표,4155,4155,1589,2419,76,0,36,1,0,0,2,4,0,0,4127,28,0
3100,울산광역시,3102,남구,,신정3동제1투,2934,1717,498,1116,41,0,35,0,0,1,2,6,1,2,1702,15,1217
3100,울산광역시,3102,남구,,신정3동제2투,3306,2478,929,1439,76,1,15,1,1,1,4,2,0,0,2469,9,828
3100,울산광역시,3102,남구,,신정3동제3투,2767,1561,435,1042,28,0,28,0,2,1,7,3,0,1,1547,14,1206
3100,울산광역시,3102,남구,신정4동,소계,15629,12153,4642,6946,324,2,102,3,3,2,4,25,3,4,12060,93,3476
3100,울산광역시,3102,남구,,관내사전투표,5157,5157,2106,2848,130,0,33,1,1,2,0,9,3,1,5134,23,0
3100,울산광역시,3102,남구,,신정4동제1투,3150,2259,886,1252,76,0,15,1,0,0,1,4,0,1,2236,23,891
3100,울산광역시,3102,남구,,신정4동제2투,2412,1509,426,1012,31,1,22,0,1,0,2,3,0,0,1498,11,903
3100,울산광역시,3102,남구,,신정4동제3투,1442,984,320,612,24,0,10,1,0,0,0,4,0,1,972,12,458
3100,울산광역시,3102,남구,,신정4동제4투,1254,716,261,413,20,0,9,0,0,0,1,3,0,0,707,9,538
3100,울산광역시,3102,남구,,신정4동제5투,2214,1528,643,809,43,1,13,0,1,0,0,2,0,1,1513,15,686
3100,울산광역시,3102,남구,신정5동,소계,7978,5908,2073,3549,138,1,85,0,1,3,5,11,2,3,5871,37,2070
3100,울산광역시,3102,남구,,관내사전투표,2966,2966,1165,1673,73,1,28,0,1,1,3,4,1,1,2951,15,0
3100,울산광역시,3102,남구,,신정5동제1투,2453,1468,419,970,37,0,26,0,0,1,0,3,0,0,1456,12,985
3100,울산광역시,3102,남구,,신정5동제2투,2559,1474,489,906,28,0,31,0,0,1,2,4,1,2,1464,10,1085
3100,울산광역시,3102,남구,달동,소계,21521,15423,5553,9023,389,8,216,5,3,2,21,36,2,5,15263,160,6098
3100,울산광역시,3102,남구,,관내사전투표,5547,5547,2213,3101,125,3,42,3,0,2,5,10,0,3,5507,40,0
3100,울산광역시,3102,남구,,달동제1투,4364,2566,863,1539,60,2,61,0,1,0,3,3,1,0,2533,33,1798
3100,울산광역시,3102,남구,,달동제2투,2966,1756,515,1119,53,0,35,0,0,0,3,9,1,1,1736,20,1210
3100,울산광역시,3102,남구,,달동제3투,1597,1002,334,616,25,0,11,0,1,0,3,3,0,1,994,8,595
3100,울산광역시,3102,남구,,달동제4투,1650,873,258,562,13,0,21,0,0,0,3,1,0,0,858,15,777
3100,울산광역시,3102,남구,,달동제5투,2640,1716,623,977,58,1,29,0,1,0,2,5,0,0,1696,20,924
3100,울산광역시,3102,남구,,달동제6투,2757,1963,747,1109,55,2,17,2,0,0,2,5,0,0,1939,24,794
3100,울산광역시,3102,남구,삼산동,소계,39644,28730,11373,15955,724,8,324,10,2,4,14,77,4,12,28507,223,10914
3100,울산광역시,3102,남구,,관내사전투표,11050,11050,4811,5804,243,3,84,3,1,0,4,32,1,6,10992,58,0
3100,울산광역시,3102,남구,,삼산동제1투,2960,1871,640,1133,44,0,21,0,0,0,3,9,0,0,1850,21,1089
3100,울산광역시,3102,남구,,삼산동제2투,2779,1751,570,1099,35,1,24,1,0,3,0,6,0,0,1739,12,1028
3100,울산광역시,3102,남구,,삼산동제3투,2639,1650,500,1056,47,1,22,0,0,0,3,3,0,0,1632,18,989
3100,울산광역시,3102,남구,,삼산동제4투,3443,1549,532,925,31,1,38,1,0,0,0,4,0,0,1532,17,1894
3100,울산광역시,3102,남구,,삼산동제5투,3431,2202,897,1174,72,0,24,3,0,0,4,2,1,3,2180,22,1229
3100,울산광역시,3102,남구,,삼산동제6투,3309,2309,953,1240,64,1,28,0,0,0,0,5,0,1,2292,17,1000
3100,울산광역시,3102,남구,,삼산동제7투,3723,2556,1134,1276,87,0,32,1,0,0,0,9,0,0,2539,17,1167
3100,울산광역시,3102,남구,,삼산동제8투,2526,1484,459,942,45,0,17,0,0,1,0,3,1,1,1469,15,1042
3100,울산광역시,3102,남구,,삼산동제9투,3784,2308,877,1306,56,1,34,1,1,0,0,4,1,1,2282,26,1476
3100,울산광역시,3102,남구,삼호동,소계,16822,12836,4658,7516,321,6,153,1,2,4,17,36,3,7,12724,112,3986
3100,울산광역시,3102,남구,,관내사전투표,5687,5687,2342,3107,120,2,48,0,1,2,4,19,0,2,5647,40,0
3100,울산광역시,3102,남구,,삼호동제1투,2577,1717,564,1064,47,0,23,0,1,0,1,1,0,2,1703,14,860
3100,울산광역시,3102,남구,,삼호동제2투,2235,1446,432,916,38,1,29,0,0,1,4,6,1,0,1428,18,789
3100,울산광역시,3102,남구,,삼호동제3투,1464,881,263,570,22,0,11,1,0,0,2,6,0,0,875,6,583
3100,울산광역시,3102,남구,,삼호동제4투,2345,1443,452,901,35,3,31,0,0,1,1,1,2,2,1429,14,902
3100,울산광역시,3102,남구,,삼호동제5투,2514,1662,605,958,59,0,11,0,0,0,5,3,0,1,1642,20,852
3100,울산광역시,3102,남구,무거동,소계,24358,19064,7350,10713,521,6,189,8,3,3,14,34,5,3,18849,215,5294
3100,울산광역시,3102,남구,,관내사전투표,6243,6239,2699,3286,149,1,41,1,0,1,2,15,1,0,6196,43,4
3100,울산광역시,3102,남구,,무거동제1투,2674,1828,641,1069,53,1,20,2,1,0,2,1,1,0,1791,37,846
3100,울산광역시,3102,남구,,무거동제2투,1757,1235,406,753,30,1,17,0,0,0,1,3,0,1,1212,23,522
3100,울산광역시,3102,남구,,무거동제3투,2710,1949,732,1108,56,0,16,2,0,2,1,3,1,0,1921,28,761
3100,울산광역시,3102,남구,,무거동제4투,2449,1716,709,906,46,0,23,0,0,0,4,3,0,1,1692,24,733
3100,울산광역시,3102,남구,,무거동제5투,2841,1994,555,1346,36,3,26,1,1,0,1,4,1,0,1974,20,847
3100,울산광역시,3102,남구,,무거동제6투,2886,1991,799,1060,84,0,19,2,0,0,2,3,1,1,1971,20,895
3100,울산광역시,3102,남구,,무거동제7투,2798,2112,809,1185,67,0,27,0,1,0,1,2,0,0,2092,20,686
3100,울산광역시,3102,남구,옥동,소계,20081,16563,6260,9551,447,9,123,0,1,4,13,27,1,7,16443,120,3518
3100,울산광역시,3102,남구,,관내사전투표,6442,6442,2779,3438,150,2,25,0,0,0,3,12,1,3,6413,29,0
3100,울산광역시,3102,남구,,옥동제1투,2866,1971,661,1194,59,1,27,0,0,0,0,6,0,1,1949,22,895
3100,울산광역시,3102,남구,,옥동제2투,2224,1725,584,1068,41,0,10,0,0,1,2,2,0,1,1709,16,499
3100,울산광역시,3102,남구,,옥동제3투,2312,1726,611,1021,49,2,21,0,0,0,1,1,0,0,1706,20,586
3100,울산광역시,3102,남구,,옥동제4투,2067,1679,672,918,53,1,15,0,0,1,4,3,0,0,1667,12,388
3100,울산광역시,3102,남구,,옥동제5투,2273,1599,489,1012,65,0,17,0,1,2,2,2,0,1,1591,8,674
3100,울산광역시,3102,남구,,옥동제6투,1897,1421,464,900,30,3,8,0,0,0,1,1,0,1,1408,13,476
3100,울산광역시,3102,남구,야음장생포동,소계,8261,6087,1966,3812,134,4,74,6,0,1,12,14,5,2,6030,57,2174
3100,울산광역시,3102,남구,,관내사전투표,2639,2639,997,1523,55,3,17,1,0,1,2,8,1,2,2610,29,0
3100,울산광역시,3102,남구,,야음장생포동제1투,1079,579,111,428,17,1,10,2,0,0,2,2,0,0,573,6,500
3100,울산광역시,3102,남구,,야음장생포동제2투,1501,816,234,533,17,0,15,1,0,0,4,2,0,0,806,10,685
3100,울산광역시,3102,남구,,야음장생포동제3투,2250,1473,500,890,35,0,27,1,0,0,4,2,3,0,1462,11,777
3100,울산광역시,3102,남구,,야음장생포동제4투,792,580,124,438,10,0,5,1,0,0,0,0,1,0,579,1,212
3100,울산광역시,3102,남구,대현동,소계,21937,17097,6861,9408,428,9,168,1,0,4,12,52,8,5,16956,141,4840
3100,울산광역시,3102,남구,,관내사전투표,6314,6314,2819,3269,122,4,36,0,0,0,4,20,2,1,6277,37,0
3100,울산광역시,3102,남구,,대현동제1투,2575,1795,670,1030,59,0,11,0,0,1,1,6,1,0,1779,16,780
3100,울산광역시,3102,남구,,대현동제2투,2515,1872,685,1088,55,1,18,0,0,0,0,8,0,2,1857,15,643
3100,울산광역시,3102,남구,,대현동제3투,2724,1857,638,1116,54,1,18,0,0,1,1,4,2,1,1836,21,867
3100,울산광역시,3102,남구,,대현동제4투,2680,1754,672,985,49,1,24,1,0,0,2,4,0,0,1738,16,926
3100,울산광역시,3102,남구,,대현동제5투,2887,1995,785,1091,48,2,33,0,0,1,4,6,2,1,1973,22,892
3100,울산광역시,3102,남구,,대현동제6투,2242,1510,592,829,41,0,28,0,0,1,0,4,1,0,1496,14,732
3100,울산광역시,3102,남구,수암동,소계,13440,11151,4323,6334,305,3,75,3,1,3,2,13,2,6,11070,81,2289
3100,울산광역시,3102,남구,,관내사전투표,5153,5153,2121,2850,121,1,26,2,1,3,1,5,0,1,5132,21,0
3100,울산광역시,3102,남구,,수암동제1투,2069,1402,556,778,43,0,6,0,0,0,1,2,0,2,1388,14,667
3100,울산광역시,3102,남구,,수암동제2투,1745,1169,413,691,33,0,12,0,0,0,0,4,1,0,1154,15,576
3100,울산광역시,3102,남구,,수암동제3투,2480,1880,674,1104,70,0,15,1,0,0,0,0,1,2,1867,13,600
3100,울산광역시,3102,남구,,수암동제4투,1993,1547,559,911,38,2,16,0,0,0,0,2,0,1,1529,18,446
3100,울산광역시,3102,남구,선암동,소계,10884,8147,3050,4625,216,2,120,2,2,2,10,29,1,4,8063,84,2737
3100,울산광역시,3102,남구,,관내사전투표,2488,2488,1066,1298,50,0,35,0,2,1,0,11,0,0,2463,25,0
3100,울산광역시,3102,남구,,선암동제1투,1849,1058,329,659,25,0,22,0,0,0,5,4,1,2,1047,11,791
3100,울산광역시,3102,남구,,선암동제2투,3206,2219,803,1275,72,0,31,0,0,0,2,9,0,1,2193,26,987
3100,울산광역시,3102,남구,,선암동제3투,1471,1077,370,656,23,1,14,0,0,1,0,2,0,0,1067,10,394
3100,울산광역시,3102,남구,,선암동제4투,1870,1305,482,737,46,1,18,2,0,0,3,3,0,1,1293,12,565
3100,울산광역시,3102,남구,잘못 투입·구분된 투표지,,0,1,1,0,0,0,0,0,0,0,0,0,0,0,1,0,-1
3100,울산광역시,3103,동구,합계,,127599,98491,44506,47065,3427,64,1597,88,17,30,71,473,32,46,97416,1075,29108
3100,울산광역시,3103,동구,거소·선상투표,,299,257,90,100,7,1,3,0,2,0,1,2,0,0,206,51,42
3100,울산광역시,3103,동구,관외사전투표,,7760,7757,3328,3850,252,6,152,11,3,3,3,34,3,3,7648,109,3
3100,울산광역시,3103,동구,재외투표,,289,205,131,48,7,0,0,1,0,0,0,1,0,0,188,17,84
3100,울산광역시,3103,동구,방어동,소계,30294,21082,9440,10244,630,13,416,18,1,6,15,82,8,9,20882,200,9212
3100,울산광역시,3103,동구,,관내사전투표,6629,6629,3240,3080,149,5,69,3,1,1,3,31,3,1,6586,43,0
3100,울산광역시,3103,동구,,방어동제1투,3443,1893,780,977,63,0,44,1,0,2,2,2,1,1,1873,20,1550
3100,울산광역시,3103,동구,,방어동제2투,2097,1244,432,725,34,0,34,0,0,0,3,2,1,0,1231,13,853
3100,울산광역시,3103,동구,,방어동제3투,2011,1221,484,641,36,1,23,2,0,0,1,5,1,4,1198,23,790
3100,울산광역시,3103,동구,,방어동제4투,1867,1187,464,634,45,1,30,5,0,0,1,0,0,1,1181,6,680
3100,울산광역시,3103,동구,,방어동제5투,2805,1762,799,837,56,0,37,0,0,2,2,10,0,1,1744,18,1043
3100,울산광역시,3103,동구,,방어동제6투,3388,2137,977,987,75,2,60,0,0,0,0,12,0,0,2113,24,1251
3100,울산광역시,3103,동구,,방어동제7투,2816,1765,784,833,67,3,44,2,0,0,0,7,1,1,1742,23,1051
3100,울산광역시,3103,동구,,방어동제8투,2848,1563,693,759,40,0,44,1,0,0,3,6,1,0,1547,16,1285
3100,울산광역시,3103,동구,,방어동제9투,2390,1681,787,771,65,1,31,4,0,1,0,7,0,0,1667,14,709
3100,울산광역시,3103,동구,일산동,소계,5858,4527,1885,2365,121,4,63,7,0,4,4,20,3,1,4477,50,1331
3100,울산광역시,3103,동구,,관내사전투표,2607,2607,1172,1292,70,3,26,2,0,2,1,16,2,0,2586,21,0
3100,울산광역시,3103,동구,,일산동제1투,1447,824,312,458,23,0,13,3,0,2,0,1,1,0,813,11,623
3100,울산광역시,3103,동구,,일산동제2투,1804,1096,401,615,28,1,24,2,0,0,3,3,0,1,1078,18,708
3100,울산광역시,3103,동구,화정동,소계,14828,11161,5083,5323,399,8,158,7,0,6,8,40,5,9,11046,115,3667
3100,울산광역시,3103,동구,,관내사전투표,4365,4365,2180,1947,139,4,51,2,0,3,1,16,2,1,4346,19,0
3100,울산광역시,3103,동구,,화정동제1투,3180,2402,1163,1048,115,1,36,1,0,0,0,6,0,3,2373,29,778
3100,울산광역시,3103,동구,,화정동제2투,2058,1172,411,681,43,1,15,0,0,0,4,2,0,1,1158,14,886
3100,울산광역시,3103,동구,,화정동제3투,2113,1293,552,640,39,2,25,0,0,1,2,10,3,1,1275,18,820
3100,울산광역시,3103,동구,,화정동제4투,1376,859,363,433,25,0,12,1,0,2,1,2,0,2,841,18,517
3100,울산광역시,3103,동구,,화정동제5투,1736,1070,414,574,38,0,19,3,0,0,0,4,0,1,1053,17,666
3100,울산광역시,3103,동구,대송동,소계,9278,7006,3264,3231,257,4,118,6,4,0,6,32,2,5,6929,77,2272
3100,울산광역시,3103,동구,,관내사전투표,3009,3009,1545,1296,97,2,26,3,2,0,1,18,0,2,2992,17,0
3100,울산광역시,3103,동구,,대송동제1투,1540,986,435,475,43,1,18,0,0,0,1,3,0,0,976,10,554
3100,울산광역시,3103,동구,,대송동제2투,2393,1597,692,767,62,1,36,3,1,0,3,6,2,0,1573,24,796
3100,울산광역시,3103,동구,,대송동제3투,2336,1414,592,693,55,0,38,0,1,0,1,5,0,3,1388,26,922
3100,울산광역시,3103,동구,전하1동,소계,11085,8528,3803,4118,334,7,121,5,1,3,11,36,1,1,8441,87,2557
3100,울산광역시,3103,동구,,관내사전투표,3626,3626,1780,1636,121,0,39,2,1,2,4,14,1,0,3600,26,0
3100,울산광역시,3103,동구,,전하1동제1투,1431,885,337,471,39,1,13,0,0,0,4,5,0,0,870,15,546
3100,울산광역시,3103,동구,,전하1동제2투,2347,1474,596,771,55,2,29,0,0,1,0,4,0,0,1458,16,873
3100,울산광역시,3103,동구,,전하1동제3투,1970,1326,575,637,53,2,25,3,0,0,3,8,0,0,1306,20,644
3100,울산광역시,3103,동구,,전하1동제4투,1711,1217,515,603,66,2,15,0,0,0,0,5,0,1,1207,10,494
3100,울산광역시,3103,동구,전하2동,소계,16167,13245,6008,6337,525,6,157,8,2,2,8,51,3,6,13113,132,2922
3100,울산광역시,3103,동구,,관내사전투표,5976,5975,2967,2688,197,1,47,4,2,0,0,28,1,0,5935,40,1
3100,울산광역시,3103,동구,,전하2동제1투,1569,1005,354,583,31,0,21,1,0,0,0,1,0,1,992,13,564
3100,울산광역시,3103,동구,,전하2동제2투,1572,920,335,500,39,2,21,1,0,1,4,2,0,1,906,14,652
3100,울산광역시,3103,동구,,전하2동제3투,1328,859,334,460,31,0,18,0,0,0,3,3,0,0,849,10,469
3100,울산광역시,3103,동구,,전하2동제4투,2113,1635,690,823,76,0,15,0,0,1,1,7,2,1,1616,19,478
3100,울산광역시,3103,동구,,전하2동제5투,1435,1121,530,506,52,2,14,0,0,0,0,3,0,2,1109,12,314
3100,울산광역시,3103,동구,,전하2동제6투,2174,1730,798,777,99,1,21,2,0,0,0,7,0,1,1706,24,444
3100,울산광역시,3103,동구,남목1동,소계,7173,5651,2515,2765,178,2,89,2,0,0,2,42,3,2,5600,51,1522
3100,울산광역시,3103,동구,,관내사전투표,2615,2615,1301,1172,71,1,30,1,0,0,0,20,1,1,2598,17,0
3100,울산광역시,3103,동구,,남목1동제1투,1181,732,252,416,30,0,19,0,0,0,1,6,1,0,725,7,449
3100,울산광역시,3103,동구,,남목1동제2투,1555,1086,408,599,33,0,20,1,0,0,0,11,1,1,1074,12,469
3100,울산광역시,3103,동구,,남목1동제3투,1822,1218,554,578,44,1,20,0,0,0,1,5,0,0,1203,15,604
3100,울산광역시,3103,동구,남목2동,소계,15272,11859,5590,5395,460,8,189,12,2,3,7,65,1,5,11737,122,3413
3100,울산광역시,3103,동구,,관내사전투표,4669,4669,2352,2066,145,3,42,2,1,1,2,27,0,1,4642,27,0
3100,울산광역시,3103,동구,,남목2동제1투,1559,943,345,511,33,1,23,2,0,0,3,6,0,0,924,19,616
3100,울산광역시,3103,동구,,남목2동제2투,1206,760,308,389,39,0,13,0,0,0,0,1,1,1,752,8,446
3100,울산광역시,3103,동구,,남목2동제3투,3337,2304,1124,979,90,0,54,5,0,1,1,14,0,2,2270,34,1033
3100,울산광역시,3103,동구,,남목2동제4투,2292,1602,744,707,78,1,37,2,1,1,1,8,0,1,1581,21,690
3100,울산광역시,3103,동구,,남목2동제5투,2209,1581,717,743,75,3,20,1,0,0,0,9,0,0,1568,13,628
3100,울산광역시,3103,동구,남목3동,소계,9296,7212,3368,3289,257,5,131,11,2,3,6,68,3,5,7148,64,2084
3100,울산광역시,3103,동구,,관내사전투표,3122,3122,1664,1281,97,1,25,2,0,2,3,38,0,3,3116,6,0
3100,울산광역시,3103,동구,,남목3동제1투,1889,1172,521,545,45,0,30,2,0,0,3,12,1,1,1160,12,717
3100,울산광역시,3103,동구,,남목3동제2투,1849,1212,497,597,52,2,34,3,1,0,0,6,1,0,1193,19,637
3100,울산광역시,3103,동구,,남목3동제3투,1887,1283,587,569,54,1,35,3,1,1,0,12,0,1,1264,19,604
3100,울산광역시,3103,동구,,남목3동제4투,549,423,99,297,9,1,7,1,0,0,0,0,1,0,415,8,126
3100,울산광역시,3103,동구,잘못 투입·구분된 투표지,,0,1,1,0,0,0,0,0,0,0,0,0,0,0,1,0,-1
3100,울산광역시,3104,북구,합계,,175732,138319,64692,64597,5072,79,1806,67,15,21,113,491,44,53,137050,1269,37413
3100,울산광역시,3104,북구,거소·선상투표,,251,235,73,112,7,1,8,1,0,1,0,1,2,1,207,28,16
3100,울산광역시,3104,북구,관외사전투표,,13645,13639,5759,6984,432,9,195,7,2,5,8,43,4,13,13461,178,6
3100,울산광역시,3104,북구,재외투표,,406,293,151,87,16,0,1,0,0,0,0,0,0,0,255,38,113
3100,울산광역시,3104,북구,농소1동,소계,25371,19024,8563,9289,616,16,281,10,4,1,25,66,9,5,18885,139,6347
3100,울산광역시,3104,북구,,관내사전투표,5145,5145,2553,2338,154,8,49,3,0,0,3,15,1,0,5124,21,0
3100,울산광역시,3104,북구,,농소1동제1투,2001,1282,482,706,48,2,23,1,1,0,2,1,0,0,1266,16,719
3100,울산광역시,3104,북구,,농소1동제2투,1703,1055,286,698,21,1,15,0,2,0,5,9,3,0,1040,15,648
3100,울산광역시,3104,북구,,농소1동제3투,3161,2206,938,1104,82,0,42,2,1,0,5,10,5,1,2190,16,955
3100,울산광역시,3104,북구,,농소1동제4투,1219,785,291,446,22,0,10,1,0,0,1,3,0,0,774,11,434
3100,울산광역시,3104,북구,,농소1동제5투,1199,793,318,420,23,2,18,1,0,0,0,2,0,2,786,7,406
3100,울산광역시,3104,북구,,농소1동제6투,2599,1869,884,880,59,1,26,0,0,0,5,6,0,0,1861,8,730
3100,울산광역시,3104,북구,,농소1동제7투,1859,1493,726,673,61,1,22,0,0,0,0,3,0,0,1486,7,366
3100,울산광역시,3104,북구,,농소1동제8투,2663,1561,628,824,41,1,39,0,0,1,2,4,0,2,1542,19,1102
3100,울산광역시,3104,북구,,농소1동제9투,3822,2835,1457,1200,105,0,37,2,0,0,2,13,0,0,2816,19,987
3100,울산광역시,3104,북구,농소2동,소계,31679,24278,11896,10798,913,17,342,7,5,2,17,61,6,7,24071,207,7401
3100,울산광역시,3104,북구,,관내사전투표,8255,8255,4510,3324,269,7,78,2,1,1,5,16,2,0,8215,40,0
3100,울산광역시,3104,북구,,농소2동제1투,3105,1959,873,931,82,1,41,0,0,0,1,5,1,0,1935,24,1146
3100,울산광역시,3104,북구,,농소2동제2투,1480,920,331,521,30,0,21,1,0,1,0,4,0,0,909,11,560
3100,울산광역시,3104,북구,,농소2동제3투,1699,1113,399,641,39,1,18,1,0,0,3,0,0,0,1102,11,586
3100,울산광역시,3104,북구,,농소2동제4투,2028,1308,472,736,50,2,23,0,2,0,0,5,1,0,1291,17,720
3100,울산광역시,3104,북구,,농소2동제5투,2033,1309,585,626,62,1,19,0,1,0,0,3,0,2,1299,10,724
3100,울산광역시,3104,북구,,농소2동제6투,3669,2614,1244,1173,106,2,46,1,1,0,4,4,1,2,2584,30,1055
3100,울산광역시,3104,북구,,농소2동제7투,3022,2199,1096,961,80,1,25,1,0,0,0,8,0,1,2173,26,823
3100,울산광역시,3104,북구,,농소2동제8투,3654,2514,1352,974,111,1,42,0,0,0,3,10,0,1,2494,20,1140
3100,울산광역시,3104,북구,,농소2동제9투,2734,2087,1034,911,84,1,29,1,0,0,1,6,1,1,2069,18,647
3100,울산광역시,3104,북구,농소3동,소계,26705,20494,10228,9033,715,10,210,9,1,5,20,89,6,9,20335,159,6211
3100,울산광역시,3104,북구,,관내사전투표,7306,7306,4110,2836,228,2,55,3,1,0,6,28,2,3,7274,32,0
3100,울산광역시,3104,북구,,농소3동제1투,2430,1615,706,804,54,3,18,0,0,0,1,9,0,0,1595,20,815
3100,울산광역시,3104,북구,,농소3동제2투,3293,2134,964,1002,102,1,27,3,0,0,5,10,2,3,2119,15,1159
3100,울산광역시,3104,북구,,농소3동제3투,2185,1460,633,720,55,2,16,0,0,0,1,7,0,1,1435,25,725
3100,울산광역시,3104,북구,,농소3동제4투,2417,1544,643,792,49,0,23,0,0,4,3,13,0,1,1528,16,873
3100,울산광역시,3104,북구,,농소3동제5투,1639,1038,496,459,41,1,17,0,0,1,1,5,2,1,1024,14,601
3100,울산광역시,3104,북구,,농소3동제6투,2764,1996,1035,848,61,0,24,2,0,0,0,8,0,0,1978,18,768
3100,울산광역시,3104,북구,,농소3동제7투,2895,2095,946,1040,63,0,24,0,0,0,0,6,0,0,2079,16,800
3100,울산광역시,3104,북구,,농소3동제8투,1776,1306,695,532,62,1,6,1,0,0,3,3,0,0,1303,3,470
3100,울산광역시,3104,북구,강동동,소계,11566,8687,3845,4404,249,0,104,4,0,0,4,20,2,3,8635,52,2879
3100,울산광역시,3104,북구,,관내사전투표,3815,3815,1886,1770,97,0,33,1,0,0,0,11,0,0,3798,17,0
3100,울산광역시,3104,북구,,강동동제1투,2452,1423,648,695,44,0,23,0,0,0,1,2,0,2,1415,8,1029
3100,울산광역시,3104,북구,,강동동제2투,944,593,147,421,10,0,6,1,0,0,0,1,0,1,587,6,351
3100,울산광역시,3104,북구,,강동동제3투,494,337,65,257,6,0,2,0,0,0,1,3,0,0,334,3,157
3100,울산광역시,3104,북구,,강동동제4투,391,263,52,204,3,0,2,0,0,0,0,0,0,0,261,2,128
3100,울산광역시,3104,북구,,강동동제5투,3470,2256,1047,1057,89,0,38,2,0,0,2,3,2,0,2240,16,1214
3100,울산광역시,3104,북구,효문동,소계,21872,16498,7293,8048,665,6,221,6,0,3,18,83,7,6,16356,142,5374
3100,울산광역시,3104,북구,,관내사전투표,5552,5551,2870,2333,219,2,54,1,0,0,2,32,1,4,5518,33,1
3100,울산광역시,3104,북구,,효문동제1투,1255,732,235,457,21,0,9,1,0,0,0,2,0,0,725,7,523
3100,울산광역시,3104,북구,,효문동제2투,1427,1046,494,456,63,0,10,0,0,1,2,6,1,0,1033,13,381
3100,울산광역시,3104,북구,,효문동제3투,1975,1540,609,847,44,0,12,0,0,0,5,8,0,0,1525,15,435
3100,울산광역시,3104,북구,,효문동제4투,3623,2426,888,1373,80,2,40,1,0,0,3,12,2,0,2401,25,1197
3100,울산광역시,3104,북구,,효문동제5투,2876,1680,655,880,71,2,42,1,0,2,2,5,3,2,1665,15,1196
3100,울산광역시,3104,북구,,효문동제6투,2090,1459,688,642,74,0,27,1,0,0,3,10,0,0,1445,14,631
3100,울산광역시,3104,북구,,효문동제7투,3074,2064,854,1060,93,0,27,1,0,0,1,8,0,0,2044,20,1010
3100,울산광역시,3104,북구,송정동,소계,27933,22359,10791,10095,906,15,246,8,2,3,12,68,7,5,22158,201,5574
3100,울산광역시,3104,북구,,관내사전투표,9194,9194,4990,3708,325,4,80,4,1,0,1,30,3,0,9146,48,0
3100,울산광역시,3104,북구,,송정동제1투,2096,1523,581,827,75,1,16,0,0,0,2,4,0,1,1507,16,573
3100,울산광역시,3104,북구,,송정동제2투,1625,1179,592,496,60,1,12,3,0,0,2,1,0,0,1167,12,446
3100,울산광역시,3104,북구,,송정동제3투,2080,1383,538,748,50,1,15,0,0,0,0,5,0,0,1357,26,697
3100,울산광역시,3104,북구,,송정동제4투,2202,1419,562,730,72,2,24,0,1,0,1,4,0,1,1397,22,783
3100,울산광역시,3104,북구,,송정동제5투,2320,1497,612,770,46,1,34,0,0,2,3,5,3,1,1477,20,823
3100,울산광역시,3104,북구,,송정동제6투,1993,1406,668,635,62,2,21,0,0,1,0,2,0,1,1392,14,587
3100,울산광역시,3104,북구,,송정동제7투,3199,2425,1203,1054,113,2,21,0,0,0,3,9,0,0,2405,20,774
3100,울산광역시,3104,북구,,송정동제8투,3224,2333,1045,1127,103,1,23,1,0,0,0,8,1,1,2310,23,891
3100,울산광역시,3104,북구,양정동,소계,8005,6393,3097,2824,280,1,78,6,1,0,6,30,0,2,6325,68,1612
3100,울산광역시,3104,북구,,관내사전투표,2946,2946,1665,1093,119,0,23,4,0,0,0,16,0,2,2922,24,0
3100,울산광역시,3104,북구,,양정동제1투,1972,1492,673,699,76,0,15,1,0,0,3,8,0,0,1475,17,480
3100,울산광역시,3104,북구,,양정동제2투,1371,848,351,419,34,1,21,1,1,0,3,3,0,0,834,14,523
3100,울산광역시,3104,북구,,양정동제3투,1716,1107,408,613,51,0,19,0,0,0,0,3,0,0,1094,13,609
3100,울산광역시,3104,북구,염포동,소계,8299,6414,2994,2920,273,4,120,9,0,1,3,30,1,2,6357,57,1885
3100,울산광역시,3104,북구,,관내사전투표,3143,3143,1668,1275,122,3,35,7,0,0,1,10,1,0,3122,21,0
3100,울산광역시,3104,북구,,염포동제1투,906,620,254,308,24,0,17,0,0,1,0,5,0,0,609,11,286
3100,울산광역시,3104,북구,,염포동제2투,909,547,195,301,23,0,12,1,0,0,2,3,0,1,538,9,362
3100,울산광역시,3104,북구,,염포동제3투,2142,1438,608,690,86,0,31,0,0,0,0,9,0,1,1425,13,704
3100,울산광역시,3104,북구,,염포동제4투,1199,666,269,346,18,1,25,1,0,0,0,3,0,0,663,3,533
3100,울산광역시,3104,북구,잘못 투입·구분된 투표지,,0,5,2,3,0,0,0,0,0,0,0,0,0,0,5,0,-5
3100,울산광역시,3105,울주군,합계,,188615,145891,56078,81956,3690,76,1855,51,24,53,156,378,54,83,144454,1437,42724
3100,울산광역시,3105,울주군,거소·선상투표,,483,457,125,242,7,1,9,0,2,1,1,0,5,1,394,63,26
3100,울산광역시,3105,울주군,관외사전투표,,17955,17953,7224,9665,518,16,227,7,3,7,12,43,4,10,17736,217,2
3100,울산광역시,3105,울주군,재외투표,,695,426,219,146,14,0,3,0,0,0,0,0,0,0,382,44,269
3100,울산광역시,3105,울주군,온산읍,소계,16564,11207,4314,6240,245,6,210,2,2,1,16,35,3,8,11082,125,5357
3100,울산광역시,3105,울주군,,관내사전투표,4178,4177,1839,2142,90,1,52,1,1,0,4,14,1,3,4148,29,1
3100,울산광역시,3105,울주군,,온산읍제1투,1988,961,259,634,18,0,28,0,0,0,4,4,0,0,947,14,1027
3100,울산광역시,3105,울주군,,온산읍제2투,1899,1137,455,606,28,2,27,1,0,0,2,1,0,0,1122,15,762
3100,울산광역시,3105,울주군,,온산읍제3투,1998,1097,346,683,22,1,32,0,0,0,3,0,0,2,1089,8,901
3100,울산광역시,3105,울주군,,온산읍제4투,2059,1097,410,610,27,0,20,0,1,0,1,3,0,1,1073,24,962
3100,울산광역시,3105,울주군,,온산읍제5투,1594,834,336,454,17,0,15,0,0,1,0,1,0,1,825,9,760
3100,울산광역시,3105,울주군,,온산읍제6투,2220,1464,584,769,40,2,35,0,0,0,1,10,1,1,1443,21,756
3100,울산광역시,3105,울주군,,온산읍제7투,628,440,85,342,3,0,1,0,0,0,1,2,1,0,435,5,188
3100,울산광역시,3105,울주군,언양읍,소계,22239,16918,6229,9802,395,11,217,6,3,5,22,60,11,3,16764,154,5321
3100,울산광역시,3105,울주군,,관내사전투표,7562,7562,2937,4319,144,4,72,4,2,1,5,22,3,1,7514,48,0
3100,울산광역시,3105,울주군,,언양읍제1투,1772,954,275,617,22,1,16,1,0,1,2,3,1,0,939,15,818
3100,울산광역시,3105,울주군,,언양읍제2투,2209,1441,551,798,45,2,18,1,0,0,4,10,1,0,1430,11,768
3100,울산광역시,3105,울주군,,언양읍제3투,961,619,160,424,10,0,13,0,0,0,2,2,1,0,612,7,342
3100,울산광역시,3105,울주군,,언양읍제4투,2244,1437,507,851,31,2,22,0,0,1,2,4,0,1,1421,16,807
3100,울산광역시,3105,울주군,,언양읍제5투,864,521,114,376,8,0,8,0,0,0,2,0,0,0,508,13,343
3100,울산광역시,3105,울주군,,언양읍제6투,2064,1309,462,768,35,0,21,0,0,0,3,5,2,0,1296,13,755
3100,울산광역시,3105,울주군,,언양읍제7투,2302,1458,556,811,42,0,17,0,1,0,0,10,2,1,1440,18,844
3100,울산광역시,3105,울주군,,언양읍제8투,2261,1617,667,838,58,2,30,0,0,2,2,4,1,0,1604,13,644
3100,울산광역시,3105,울주군,온양읍,소계,21670,15756,6333,8541,439,12,222,3,2,11,11,38,5,8,15625,131,5914
3100,울산광역시,3105,울주군,,관내사전투표,5647,5647,2492,2907,141,7,53,2,1,3,2,15,2,2,5627,20,0
3100,울산광역시,3105,울주군,,온양읍제1투,1324,786,194,559,11,2,8,0,0,0,0,2,0,1,777,9,538
3100,울산광역시,3105,울주군,,온양읍제2투,2510,1630,584,944,44,0,30,0,0,2,4,1,1,2,1612,18,880
3100,울산광역시,3105,울주군,,온양읍제3투,2090,1155,401,693,20,1,16,0,0,0,3,4,1,0,1139,16,935
3100,울산광역시,3105,울주군,,온양읍제4투,2481,1698,687,906,63,1,19,0,0,0,2,6,0,0,1684,14,783
3100,울산광역시,3105,울주군,,온양읍제5투,2481,1651,659,891,46,1,31,0,0,3,0,3,1,1,1636,15,830
3100,울산광역시,3105,울주군,,온양읍제6투,3123,1946,801,996,73,0,38,1,0,1,0,4,0,2,1916,30,1177
3100,울산광역시,3105,울주군,,온양읍제7투,2014,1243,515,645,41,0,27,0,1,2,0,3,0,0,1234,9,771
3100,울산광역시,3105,울주군,범서읍,소계,49266,38769,17183,19657,1077,9,369,12,1,7,28,106,10,15,38474,295,10497
3100,울산광역시,3105,울주군,,관내사전투표,14577,14577,7369,6586,364,1,99,6,0,1,3,45,4,5,14483,94,0
3100,울산광역시,3105,울주군,,범서읍제1투,2551,1797,770,912,51,0,23,0,0,0,3,12,1,1,1773,24,754
3100,울산광역시,3105,울주군,,범서읍제2투,2207,1489,477,934,28,1,22,1,0,0,3,2,0,0,1468,21,718
3100,울산광역시,3105,울주군,,범서읍제3투,1248,889,232,627,13,0,8,1,0,0,0,2,1,0,884,5,359
3100,울산광역시,3105,울주군,,범서읍제4투,2870,1903,768,1017,58,0,35,0,0,0,1,4,1,1,1885,18,967
3100,울산광역시,3105,울주군,,범서읍제5투,3724,2578,1070,1363,89,1,26,1,0,0,4,6,0,0,2560,18,1146
3100,울산광역시,3105,울주군,,범서읍제6투,2104,1522,655,792,42,0,15,0,0,2,0,5,1,1,1513,9,582
3100,울산광역시,3105,울주군,,범서읍제7투,2246,1653,539,1018,51,0,16,0,0,1,4,0,0,1,1630,23,593
3100,울산광역시,3105,울주군,,범서읍제8투,2791,1899,825,976,48,0,30,2,0,0,1,5,0,2,1889,10,892
3100,울산광역시,3105,울주군,,범서읍제9투,2657,1792,725,976,40,0,24,0,1,0,6,7,1,0,1780,12,865
3100,울산광역시,3105,울주군,,범서읍제10투,2172,1544,642,827,30,0,16,1,0,0,2,10,0,3,1531,13,628
3100,울산광역시,3105,울주군,,범서읍제11투,1667,1030,467,495,43,0,12,0,0,2,0,1,0,0,1020,10,637
3100,울산광역시,3105,울주군,,범서읍제12투,2383,1585,734,756,63,2,12,0,0,1,0,4,0,0,1572,13,798
3100,울산광역시,3105,울주군,,범서읍제13투,3313,2441,1052,1278,78,4,15,0,0,0,0,3,1,0,2431,10,872
3100,울산광역시,3105,울주군,,범서읍제14투,2756,2070,858,1100,79,0,16,0,0,0,1,0,0,1,2055,15,686
3100,울산광역시,3105,울주군,서생면,소계,6512,4829,1239,3406,80,2,52,1,0,0,5,7,3,3,4798,31,1683
3100,울산광역시,3105,울주군,,관내사전투표,1994,1994,594,1340,29,2,13,1,0,0,1,2,0,3,1985,9,0
3100,울산광역시,3105,울주군,,서생면제1투,1517,914,174,696,21,0,9,0,0,0,2,2,2,0,906,8,603
3100,울산광역시,3105,울주군,,서생면제2투,961,616,121,468,10,0,10,0,0,0,0,1,0,0,610,6,345
3100,울산광역시,3105,울주군,,서생면제3투,2040,1305,350,902,20,0,20,0,0,0,2,2,1,0,1297,8,735
3100,울산광역시,3105,울주군,웅촌면,소계,6837,5132,1688,3179,113,3,64,3,3,1,6,15,2,6,5083,49,1705
3100,울산광역시,3105,울주군,,관내사전투표,2250,2250,892,1254,50,2,20,2,0,1,0,7,0,3,2231,19,0
3100,울산광역시,3105,울주군,,웅촌면제1투,1642,1002,253,700,21,0,10,1,2,0,2,2,1,1,993,9,640
3100,울산광역시,3105,울주군,,웅촌면제2투,1064,665,157,482,6,0,10,0,0,0,1,0,0,0,656,9,399
3100,울산광역시,3105,울주군,,웅촌면제3투,1881,1215,386,743,36,1,24,0,1,0,3,6,1,2,1203,12,666
3100,울산광역시,3105,울주군,두동면,소계,3558,2570,739,1716,54,0,22,0,0,1,2,8,1,2,2545,25,988
3100,울산광역시,3105,울주군,,관내사전투표,1245,1245,419,773,26,0,7,0,0,1,1,4,0,1,1232,13,0
3100,울산광역시,3105,울주군,,두동면제1투,1564,885,258,585,24,0,8,0,0,0,1,2,0,1,879,6,679
3100,울산광역시,3105,울주군,,두동면제2투,749,440,62,358,4,0,7,0,0,0,0,2,1,0,434,6,309
3100,울산광역시,3105,울주군,두서면,소계,2853,2207,616,1460,41,2,20,0,1,6,3,6,3,15,2173,34,646
3100,울산광역시,3105,울주군,,관내사전투표,1128,1128,374,691,12,0,9,0,1,2,0,4,2,10,1105,23,0
3100,울산광역시,3105,울주군,,두서면제1투,1171,763,182,531,23,1,7,0,0,4,3,2,1,1,755,8,408
3100,울산광역시,3105,울주군,,두서면제2투,554,316,60,238,6,1,4,0,0,0,0,0,0,4,313,3,238
3100,울산광역시,3105,울주군,상북면,소계,6922,5231,1592,3382,105,2,55,5,2,3,12,16,3,3,5180,51,1691
3100,울산광역시,3105,울주군,,관내사전투표,2840,2840,1018,1703,58,1,17,4,1,1,4,11,2,2,2822,18,0
3100,울산광역시,3105,울주군,,상북면제1투,1605,926,272,599,21,1,14,0,1,1,0,1,0,0,910,16,679
3100,울산광역시,3105,울주군,,상북면제2투,909,547,111,408,4,0,8,0,0,1,7,1,0,0,540,7,362
3100,울산광역시,3105,울주군,,상북면제3투,1568,918,191,672,22,0,16,1,0,0,1,3,1,1,908,10,650
3100,울산광역시,3105,울주군,삼동면,소계,1642,1357,373,922,29,0,13,1,0,1,3,4,1,0,1347,10,285
3100,울산광역시,3105,울주군,,관내사전투표,720,720,241,444,17,0,9,0,0,0,1,2,1,0,715,5,0
3100,울산광역시,3105,울주군,,삼동면제1투,551,357,80,267,4,0,2,1,0,1,0,1,0,0,356,1,194
3100,울산광역시,3105,울주군,,삼동면제2투,371,280,52,211,8,0,2,0,0,0,2,1,0,0,276,4,91
3100,울산광역시,3105,울주군,청량읍,소계,14226,10742,3999,6137,292,7,165,7,1,7,13,21,2,4,10655,87,3484
3100,울산광역시,3105,울주군,,관내사전투표,3867,3867,1592,2106,81,2,47,1,0,2,3,8,1,2,3845,22,0
3100,울산광역시,3105,울주군,,청량읍제1투,1033,577,139,409,6,0,15,0,0,0,0,0,1,1,571,6,456
3100,울산광역시,3105,울주군,,청량읍제2투,1450,954,297,591,26,1,22,0,0,0,0,4,0,0,941,13,496
3100,울산광역시,3105,울주군,,청량읍제3투,2374,1678,538,1046,47,0,26,2,0,2,2,3,0,0,1666,12,696
3100,울산광역시,3105,울주군,,청량읍제4투,2562,1822,756,949,64,3,25,1,1,1,5,1,0,0,1806,16,740
3100,울산광역시,3105,울주군,,청량읍제5투,2940,1844,677,1036,68,1,30,3,0,2,3,5,0,1,1826,18,1096
3100,울산광역시,3105,울주군,삼남읍,소계,17193,12335,4204,7460,281,5,207,4,4,2,22,19,1,5,12214,121,4858
3100,울산광역시,3105,울주군,,관내사전투표,5126,5126,1998,2913,108,0,53,1,0,1,5,9,0,2,5090,36,0
3100,울산광역시,3105,울주군,,삼남읍제1투,2725,1498,454,934,36,1,43,0,0,1,6,3,0,0,1478,20,1227
3100,울산광역시,3105,울주군,,삼남읍제2투,2276,1288,376,833,26,1,31,0,0,0,4,4,1,1,1277,11,988
3100,울산광역시,3105,울주군,,삼남읍제3투,2938,1796,559,1126,46,0,39,1,2,0,5,1,0,1,1780,16,1142
3100,울산광역시,3105,울주군,,삼남읍제4투,1579,921,218,640,19,0,25,2,1,0,1,0,0,1,907,14,658
3100,울산광역시,3105,울주군,,삼남읍제5투,2549,1706,599,1014,46,3,16,0,1,0,1,2,0,0,1682,24,843
3100,울산광역시,3105,울주군,잘못 투입·구분된 투표지,,0,2,1,1,0,0,0,0,0,0,0,0,0,0,2,0,-25100,세종특별자치시,5101,세종특별자치시,합계,,288895,231832,119349,101491,6780,100,1594,50,23,48,121,181,66,88,229891,1941,57063
5100,세종특별자치시,5101,세종특별자치시,거소·선상투표,,552,514,214,200,13,2,10,5,2,1,2,0,2,2,453,61,38
5100,세종특별자치시,5101,세종특별자치시,관외사전투표,,32177,32171,16187,14397,909,18,248,7,4,5,14,30,15,20,31854,317,6
5100,세종특별자치시,5101,세종특별자치시,재외투표,,1559,1202,677,360,39,0,1,1,0,0,1,0,0,0,1079,123,357
5100,세종특별자치시,5101,세종특별자치시,조치원읍,소계,31032,20910,9666,10152,576,18,231,4,4,5,24,25,10,10,20725,185,10122
5100,세종특별자치시,5101,세종특별자치시,,관내사전투표,6248,6245,3215,2774,142,8,42,0,0,2,1,15,0,1,6200,45,3
5100,세종특별자치시,5101,세종특별자치시,,조치원읍제1투,1912,1033,377,600,29,0,13,0,0,0,3,0,1,0,1023,10,879
5100,세종특별자치시,5101,세종특별자치시,,조치원읍제2투,1412,784,306,439,14,0,13,0,0,0,0,0,1,0,773,11,628
5100,세종특별자치시,5101,세종특별자치시,,조치원읍제3투,2177,1205,475,673,17,1,18,0,0,0,3,1,2,2,1192,13,972
5100,세종특별자치시,5101,세종특별자치시,,조치원읍제4투,3484,1970,875,984,50,1,23,0,2,0,0,1,1,2,1939,31,1514
5100,세종특별자치시,5101,세종특별자치시,,조치원읍제5투,2397,1552,730,748,45,3,14,0,1,0,0,0,0,1,1542,10,845
5100,세종특별자치시,5101,세종특별자치시,,조치원읍제6투,798,424,183,217,7,1,9,1,0,0,1,0,0,0,419,5,374
5100,세종특별자치시,5101,세종특별자치시,,조치원읍제7투,1777,905,363,490,21,2,13,0,1,0,2,3,0,2,897,8,872
5100,세종특별자치시,5101,세종특별자치시,,조치원읍제8투,2495,1562,742,716,65,0,20,0,0,1,2,0,3,0,1549,13,933
5100,세종특별자치시,5101,세종특별자치시,,조치원읍제9투,2314,1385,592,697,51,1,21,1,0,2,3,2,1,0,1371,14,929
5100,세종특별자치시,5101,세종특별자치시,,조치원읍제10투,2693,1597,676,828,49,0,24,2,0,0,4,1,1,0,1585,12,1096
5100,세종특별자치시,5101,세종특별자치시,,조치원읍제11투,3325,2248,1132,986,86,1,21,0,0,0,5,2,0,2,2235,13,1077
5100,세종특별자치시,5101,세종특별자치시,연기면,소계,3557,2819,1349,1346,63,1,38,2,0,0,2,1,0,1,2803,16,738
5100,세종특별자치시,5101,세종특별자치시,,관내사전투표,2077,2077,1083,908,50,1,25,1,0,0,1,1,0,0,2070,7,0
5100,세종특별자치시,5101,세종특별자치시,,연기면투표소,1480,742,266,438,13,0,13,1,0,0,1,0,0,1,733,9,738
5100,세종특별자치시,5101,세종특별자치시,연동면,소계,2668,1993,728,1181,34,0,13,1,0,1,7,3,3,2,1973,20,675
5100,세종특별자치시,5101,세종특별자치시,,관내사전투표,929,929,365,525,19,0,7,1,0,0,2,1,0,2,922,7,0
5100,세종특별자치시,5101,세종특별자치시,,연동면제1투,900,531,178,329,5,0,4,0,0,1,2,2,2,0,523,8,369
5100,세종특별자치시,5101,세종특별자치시,,연동면제2투,839,533,185,327,10,0,2,0,0,0,3,0,1,0,528,5,306
5100,세종특별자치시,5101,세종특별자치시,부강면,소계,5312,3881,1719,1968,92,2,55,1,0,0,3,4,1,2,3847,34,1431
5100,세종특별자치시,5101,세종특별자치시,,관내사전투표,2250,2250,1097,1052,51,1,28,1,0,0,2,1,0,1,2234,16,0
5100,세종특별자치시,5101,세종특별자치시,,부강면제1투,2190,1145,453,621,31,1,19,0,0,0,0,2,1,1,1129,16,1045
5100,세종특별자치시,5101,세종특별자치시,,부강면제2투,872,486,169,295,10,0,8,0,0,0,1,1,0,0,484,2,386
5100,세종특별자치시,5101,세종특별자치시,금남면,소계,7412,5422,2131,3050,127,4,49,1,1,0,1,4,7,2,5377,45,1990
5100,세종특별자치시,5101,세종특별자치시,,관내사전투표,2680,2679,1195,1386,57,2,14,0,0,0,1,1,3,0,2659,20,1
5100,세종특별자치시,5101,세종특별자치시,,금남면제1투,2165,1170,440,658,36,0,22,0,0,0,0,1,1,2,1160,10,995
5100,세종특별자치시,5101,세종특별자치시,,금남면제2투,872,533,162,347,14,1,4,1,0,0,0,0,1,0,530,3,339
5100,세종특별자치시,5101,세종특별자치시,,금남면제3투,946,594,207,362,11,0,5,0,0,0,0,2,1,0,588,6,352
5100,세종특별자치시,5101,세종특별자치시,,금남면제4투,749,446,127,297,9,1,4,0,1,0,0,0,1,0,440,6,303
5100,세종특별자치시,5101,세종특별자치시,전의면,소계,4791,3452,1368,1909,87,1,42,2,0,1,2,4,3,2,3421,31,1339
5100,세종특별자치시,5101,세종특별자치시,,관내사전투표,1660,1660,771,821,37,1,16,0,0,0,1,1,1,0,1649,11,0
5100,세종특별자치시,5101,세종특별자치시,,전의면제1투,1275,692,231,419,18,0,10,1,0,0,0,1,0,1,681,11,583
5100,세종특별자치시,5101,세종특별자치시,,전의면제2투,1329,734,243,446,19,0,12,1,0,0,0,2,1,1,725,9,595
5100,세종특별자치시,5101,세종특별자치시,,전의면제3투,527,366,123,223,13,0,4,0,0,1,1,0,1,0,366,0,161
5100,세종특별자치시,5101,세종특별자치시,전동면,소계,2960,1981,731,1161,46,0,14,0,1,1,4,0,1,6,1965,16,979
5100,세종특별자치시,5101,세종특별자치시,,관내사전투표,990,990,407,538,24,0,6,0,1,1,1,0,0,5,983,7,0
5100,세종특별자치시,5101,세종특별자치시,,전동면제1투,875,480,160,291,15,0,3,0,0,0,2,0,1,0,472,8,395
5100,세종특별자치시,5101,세종특별자치시,,전동면제2투,423,282,90,183,6,0,3,0,0,0,0,0,0,0,282,0,141
5100,세종특별자치시,5101,세종특별자치시,,전동면제3투,672,229,74,149,1,0,2,0,0,0,1,0,0,1,228,1,443
5100,세종특별자치시,5101,세종특별자치시,소정면,소계,1907,1374,496,810,37,0,14,1,0,0,2,1,0,0,1361,13,533
5100,세종특별자치시,5101,세종특별자치시,,관내사전투표,750,749,299,416,21,0,6,0,0,0,0,1,0,0,743,6,1
5100,세종특별자치시,5101,세종특별자치시,,소정면투표소,1157,625,197,394,16,0,8,1,0,0,2,0,0,0,618,7,532
5100,세종특별자치시,5101,세종특별자치시,장군면,소계,5705,3931,1796,1974,73,3,36,0,0,1,5,7,1,1,3897,34,1774
5100,세종특별자치시,5101,세종특별자치시,,관내사전투표,2094,2093,1069,950,42,1,13,0,0,1,1,3,0,1,2081,12,1
5100,세종특별자치시,5101,세종특별자치시,,장군면제1투,1576,799,330,434,6,1,14,0,0,0,0,2,0,0,787,12,777
5100,세종특별자치시,5101,세종특별자치시,,장군면제2투,1627,779,315,425,20,1,8,0,0,0,4,1,0,0,774,5,848
5100,세종특별자치시,5101,세종특별자치시,,장군면제3투,408,260,82,165,5,0,1,0,0,0,0,1,1,0,255,5,148
5100,세종특별자치시,5101,세종특별자치시,연서면,소계,7349,5581,2620,2737,101,2,51,1,0,3,6,8,4,4,5537,44,1768
5100,세종특별자치시,5101,세종특별자치시,,관내사전투표,3254,3252,1681,1469,55,1,21,0,0,2,1,4,2,3,3239,13,2
5100,세종특별자치시,5101,세종특별자치시,,연서면제1투,716,401,161,221,6,0,6,0,0,0,1,0,0,0,395,6,315
5100,세종특별자치시,5101,세종특별자치시,,연서면제2투,451,301,110,176,5,0,4,0,0,0,0,1,1,1,298,3,150
5100,세종특별자치시,5101,세종특별자치시,,연서면제3투,624,357,116,220,7,0,6,0,0,1,0,1,0,0,351,6,267
5100,세종특별자치시,5101,세종특별자치시,,연서면제4투,2304,1270,552,651,28,1,14,1,0,0,4,2,1,0,1254,16,1034
5100,세종특별자치시,5101,세종특별자치시,한솔동,소계,12258,10184,5599,4140,311,0,46,3,0,2,5,5,0,3,10114,70,2074
5100,세종특별자치시,5101,세종특별자치시,,관내사전투표,5150,5149,3124,1872,111,0,19,2,0,0,2,3,0,0,5133,16,1
5100,세종특별자치시,5101,세종특별자치시,,한솔동제1투,1842,1336,696,567,50,0,11,0,0,0,0,1,0,0,1325,11,506
5100,세종특별자치시,5101,세종특별자치시,,한솔동제2투,1565,1161,575,514,47,0,6,0,0,1,1,1,0,0,1145,16,404
5100,세종특별자치시,5101,세종특별자치시,,한솔동제3투,1481,1118,528,524,45,0,6,0,0,1,0,0,0,3,1107,11,363
5100,세종특별자치시,5101,세종특별자치시,,한솔동제4투,2220,1420,676,663,58,0,4,1,0,0,2,0,0,0,1404,16,800
5100,세종특별자치시,5101,세종특별자치시,도담동,소계,20920,16618,8589,7238,535,11,83,5,3,5,4,10,1,8,16492,126,4302
5100,세종특별자치시,5101,세종특별자치시,,관내사전투표,7580,7580,4419,2883,202,5,23,4,1,0,3,4,0,2,7546,34,0
5100,세종특별자치시,5101,세종특별자치시,,도담동제1투,1501,927,467,397,34,1,12,0,0,0,0,1,0,1,913,14,574
5100,세종특별자치시,5101,세종특별자치시,,도담동제2투,1862,1210,494,629,49,2,12,0,0,1,1,1,1,3,1193,17,652
5100,세종특별자치시,5101,세종특별자치시,,도담동제3투,2326,1572,807,688,48,0,9,0,0,2,0,1,0,0,1555,17,754
5100,세종특별자치시,5101,세종특별자치시,,도담동제4투,1758,1225,562,604,38,0,5,1,2,1,0,0,0,0,1213,12,533
5100,세종특별자치시,5101,세종특별자치시,,도담동제5투,2595,1866,834,947,63,2,7,0,0,1,0,0,0,1,1855,11,729
5100,세종특별자치시,5101,세종특별자치시,,도담동제6투,1890,1406,652,666,66,0,9,0,0,0,0,1,0,1,1395,11,484
5100,세종특별자치시,5101,세종특별자치시,,도담동제7투,1408,832,354,424,35,1,6,0,0,0,0,2,0,0,822,10,576
5100,세종특별자치시,5101,세종특별자치시,아름동,소계,15034,12542,7361,4594,433,2,52,2,0,1,3,7,7,3,12465,77,2492
5100,세종특별자치시,5101,세종특별자치시,,관내사전투표,6302,6302,3972,2087,190,1,15,1,0,0,2,3,3,1,6275,27,0
5100,세종특별자치시,5101,세종특별자치시,,아름동제1투,2113,1478,802,585,67,0,8,0,0,0,0,0,0,0,1462,16,635
5100,세종특별자치시,5101,세종특별자치시,,아름동제2투,1767,1220,672,485,46,0,8,0,0,0,0,0,2,0,1213,7,547
5100,세종특별자치시,5101,세종특별자치시,,아름동제3투,2300,1567,807,677,49,0,14,1,0,0,0,1,1,2,1552,15,733
5100,세종특별자치시,5101,세종특별자치시,,아름동제4투,2552,1975,1108,760,81,1,7,0,0,1,1,3,1,0,1963,12,577
5100,세종특별자치시,5101,세종특별자치시,종촌동,소계,19385,15674,8662,6362,445,4,86,2,1,7,6,10,2,3,15590,84,3711
5100,세종특별자치시,5101,세종특별자치시,,관내사전투표,7980,7980,4710,2986,207,3,31,1,1,2,2,4,1,1,7949,31,0
5100,세종특별자치시,5101,세종특별자치시,,종촌동제1투,2272,1436,771,604,35,0,11,0,0,0,2,2,0,1,1426,10,836
5100,세종특별자치시,5101,세종특별자치시,,종촌동제2투,1168,732,369,330,24,0,6,0,0,0,1,0,0,0,730,2,436
5100,세종특별자치시,5101,세종특별자치시,,종촌동제3투,2275,1670,904,688,66,0,4,0,0,3,1,0,1,0,1667,3,605
5100,세종특별자치시,5101,세종특별자치시,,종촌동제4투,1809,1345,689,603,39,0,6,0,0,0,0,1,0,1,1339,6,464
5100,세종특별자치시,5101,세종특별자치시,,종촌동제5투,2171,1381,638,673,38,1,14,0,0,1,0,0,0,0,1365,16,790
5100,세종특별자치시,5101,세종특별자치시,,종촌동제6투,1710,1130,581,478,36,0,14,1,0,1,0,3,0,0,1114,16,580
5100,세종특별자치시,5101,세종특별자치시,고운동,소계,19800,15230,8489,6058,452,6,105,2,1,4,9,9,0,6,15141,89,4570
5100,세종특별자치시,5101,세종특별자치시,,관내사전투표,5916,5916,3649,2090,128,5,20,0,0,2,1,3,0,2,5900,16,0
5100,세종특별자치시,5101,세종특별자치시,,고운동제1투,3096,2169,1077,993,63,0,15,0,0,0,1,1,0,1,2151,18,927
5100,세종특별자치시,5101,세종특별자치시,,고운동제2투,2318,1554,817,645,60,1,16,0,0,0,0,2,0,2,1543,11,764
5100,세종특별자치시,5101,세종특별자치시,,고운동제3투,3318,2196,1176,908,60,0,23,0,0,1,3,0,0,0,2171,25,1122
5100,세종특별자치시,5101,세종특별자치시,,고운동제4투,2704,1783,958,703,81,0,23,2,0,0,2,2,0,0,1771,12,921
5100,세종특별자치시,5101,세종특별자치시,,고운동제5투,2448,1612,812,719,60,0,8,0,1,1,2,1,0,1,1605,7,836
5100,세종특별자치시,5101,세종특별자치시,보람동,소계,12687,10415,5632,4295,330,3,52,2,2,4,2,6,3,2,10333,82,2272
5100,세종특별자치시,5101,세종특별자치시,,관내사전투표,5807,5807,3399,2174,157,2,28,1,2,0,0,1,1,1,5766,41,0
5100,세종특별자치시,5101,세종특별자치시,,보람동제1투,2435,1660,772,792,62,0,7,1,0,3,0,2,0,1,1640,20,775
5100,세종특별자치시,5101,세종특별자치시,,보람동제2투,1803,1207,576,566,45,1,10,0,0,1,0,2,2,0,1203,4,596
5100,세종특별자치시,5101,세종특별자치시,,보람동제3투,2642,1741,885,763,66,0,7,0,0,0,2,1,0,0,1724,17,901
5100,세종특별자치시,5101,세종특별자치시,새롬동,소계,23050,18210,9557,7854,545,5,110,2,1,0,7,15,0,3,18099,111,4840
5100,세종특별자치시,5101,세종특별자치시,,관내사전투표,8022,8022,4683,3050,199,0,34,1,1,0,3,8,0,3,7982,40,0
5100,세종특별자치시,5101,세종특별자치시,,새롬동제1투,1805,1171,501,610,32,0,13,1,0,0,2,0,0,0,1159,12,634
5100,세종특별자치시,5101,세종특별자치시,,새롬동제2투,2717,1901,876,937,65,2,10,0,0,0,1,1,0,0,1892,9,816
5100,세종특별자치시,5101,세종특별자치시,,새롬동제3투,2733,1885,930,884,51,0,12,0,0,0,0,2,0,0,1879,6,848
5100,세종특별자치시,5101,세종특별자치시,,새롬동제4투,2497,1693,819,774,61,2,15,0,0,0,1,1,0,0,1673,20,804
5100,세종특별자치시,5101,세종특별자치시,,새롬동제5투,2707,1859,904,852,69,1,17,0,0,0,0,1,0,0,1844,15,848
5100,세종특별자치시,5101,세종특별자치시,,새롬동제6투,2569,1679,844,747,68,0,9,0,0,0,0,2,0,0,1670,9,890
5100,세종특별자치시,5101,세종특별자치시,대평동,소계,8285,6768,3497,2972,206,2,27,0,0,0,2,7,0,2,6715,53,1517
5100,세종특별자치시,5101,세종특별자치시,,관내사전투표,4002,4000,2260,1605,97,1,9,0,0,0,0,2,0,1,3975,25,2
5100,세종특별자치시,5101,세종특별자치시,,대평동제1투,2076,1419,610,725,57,1,7,0,0,0,0,2,0,1,1403,16,657
5100,세종특별자치시,5101,세종특별자치시,,대평동제2투,2207,1349,627,642,52,0,11,0,0,0,2,3,0,0,1337,12,858
5100,세종특별자치시,5101,세종특별자치시,소담동,소계,13183,10787,5926,4392,320,4,61,1,0,0,3,6,4,2,10719,68,2396
5100,세종특별자치시,5101,세종특별자치시,,관내사전투표,5364,5364,3216,1958,143,3,18,0,0,0,1,3,4,1,5347,17,0
5100,세종특별자치시,5101,세종특별자치시,,소담동제1투,3242,2335,1114,1114,70,0,11,1,0,0,1,0,0,1,2312,23,907
5100,세종특별자치시,5101,세종특별자치시,,소담동제2투,2355,1559,800,686,47,0,12,0,0,0,0,0,0,0,1545,14,796
5100,세종특별자치시,5101,세종특별자치시,,소담동제3투,2222,1529,796,634,60,1,20,0,0,0,1,3,0,0,1515,14,693
5100,세종특별자치시,5101,세종특별자치시,다정동,소계,18638,14980,8046,6199,503,4,89,3,1,4,6,6,0,0,14861,119,3658
5100,세종특별자치시,5101,세종특별자치시,,관내사전투표,7924,7923,4548,3044,246,2,31,2,0,0,1,2,0,0,7876,47,1
5100,세종특별자치시,5101,세종특별자치시,,다정동제1투,2759,1942,995,862,48,0,17,0,0,4,1,1,0,0,1928,14,817
5100,세종특별자치시,5101,세종특별자치시,,다정동제2투,2609,1617,801,683,84,2,19,0,0,0,2,1,0,0,1592,25,992
5100,세종특별자치시,5101,세종특별자치시,,다정동제3투,2917,1947,953,893,72,0,11,1,0,0,1,2,0,0,1933,14,970
5100,세종특별자치시,5101,세종특별자치시,,다정동제4투,2429,1551,749,717,53,0,11,0,1,0,1,0,0,0,1532,19,878
5100,세종특별자치시,5101,세종특별자치시,해밀동,소계,5477,4589,2670,1726,140,2,19,0,1,1,1,5,1,1,4567,22,888
5100,세종특별자치시,5101,세종특별자치시,,관내사전투표,2836,2836,1755,987,69,0,11,0,0,0,1,2,1,0,2826,10,0
5100,세종특별자치시,5101,세종특별자치시,,해밀동투표소,2641,1753,915,739,71,2,8,0,1,1,0,3,0,1,1741,12,888
5100,세종특별자치시,5101,세종특별자치시,반곡동,소계,13197,10594,5631,4415,363,6,62,2,1,2,0,8,1,3,10494,100,2603
5100,세종특별자치시,5101,세종특별자치시,,관내사전투표,5452,5452,3140,2076,165,2,32,1,0,1,0,4,1,1,5423,29,0
5100,세종특별자치시,5101,세종특별자치시,,반곡동제1투,2623,1670,761,814,56,1,9,1,1,1,0,1,0,0,1645,25,953
5100,세종특별자치시,5101,세종특별자치시,,반곡동제2투,1674,1077,533,481,39,2,7,0,0,0,0,2,0,0,1064,13,597
5100,세종특별자치시,5101,세종특별자치시,,반곡동제3투,1707,1269,666,543,39,0,8,0,0,0,0,0,0,0,1256,13,438
5100,세종특별자치시,5101,세종특별자치시,,반곡동제4투,1741,1126,531,501,64,1,6,0,0,0,0,1,0,2,1106,20,615
5100,세종특별자치시,5101,세종특별자치시,잘못 투입·구분된 투표지,,0,10,8,1,0,0,0,0,0,0,0,0,0,0,9,1,-104100,경기도,4101,수원시장안구,합계,,234723,183882,91842,83470,4755,122,1320,27,27,38,170,188,46,68,182073,1809,50841
4100,경기도,4101,수원시장안구,거소·선상투표,,581,551,198,236,14,4,8,1,2,0,2,0,3,1,469,82,30
4100,경기도,4101,수원시장안구,관외사전투표,,21961,21953,11147,9698,575,22,201,4,0,3,6,35,4,13,21708,245,8
4100,경기도,4101,수원시장안구,재외투표,,1172,856,496,270,28,0,1,0,0,0,1,0,0,0,796,60,316
4100,경기도,4101,수원시장안구,파장동,소계,19438,14541,7257,6610,374,8,112,3,1,2,20,13,1,4,14405,136,4897
4100,경기도,4101,수원시장안구,,관내사전투표,5784,5785,3181,2392,135,6,33,0,0,1,4,3,0,0,5755,30,-1
4100,경기도,4101,수원시장안구,,파장동제1투,1503,813,346,415,20,0,15,0,0,0,1,2,0,0,799,14,690
4100,경기도,4101,수원시장안구,,파장동제2투,2279,1433,673,686,37,0,14,0,0,0,2,3,0,1,1416,17,846
4100,경기도,4101,수원시장안구,,파장동제3투,2258,1285,581,631,40,1,12,1,0,0,4,1,0,0,1271,14,973
4100,경기도,4101,수원시장안구,,파장동제4투,1742,1047,479,512,29,0,9,1,0,0,2,0,1,0,1033,14,695
4100,경기도,4101,수원시장안구,,파장동제5투,1956,1038,472,502,29,1,16,1,0,0,3,1,0,0,1025,13,918
4100,경기도,4101,수원시장안구,,파장동제6투,2033,1601,786,726,54,0,8,0,1,0,0,2,0,3,1580,21,432
4100,경기도,4101,수원시장안구,,파장동제7투,1883,1539,739,746,30,0,5,0,0,1,4,1,0,0,1526,13,344
4100,경기도,4101,수원시장안구,율천동,소계,32061,25400,12734,11416,702,19,130,7,3,9,21,13,7,10,25071,329,6661
4100,경기도,4101,수원시장안구,,관내사전투표,7749,7749,4161,3316,152,4,25,1,1,2,1,4,2,3,7672,77,0
4100,경기도,4101,수원시장안구,,율천동제1투,2617,1747,710,915,61,2,11,1,0,0,3,1,1,1,1706,41,870
4100,경기도,4101,수원시장안구,,율천동제2투,2720,1636,736,795,49,1,12,0,1,2,4,0,1,3,1604,32,1084
4100,경기도,4101,수원시장안구,,율천동제3투,2018,1678,806,770,71,0,3,1,0,2,1,1,1,0,1656,22,340
4100,경기도,4101,수원시장안구,,율천동제4투,2964,2318,1301,913,60,3,16,0,1,0,1,0,0,2,2297,21,646
4100,경기도,4101,수원시장안구,,율천동제5투,2346,1658,793,779,55,0,5,0,0,0,3,0,1,0,1636,22,688
4100,경기도,4101,수원시장안구,,율천동제6투,2637,1877,978,804,44,5,15,0,0,2,1,0,1,0,1850,27,760
4100,경기도,4101,수원시장안구,,율천동제7투,2020,1474,730,638,64,0,18,0,0,0,3,2,0,0,1455,19,546
4100,경기도,4101,수원시장안구,,율천동제8투,604,356,110,219,8,0,1,0,0,0,0,0,0,0,338,18,248
4100,경기도,4101,수원시장안구,,율천동제9투,3536,2769,1344,1303,76,3,11,1,0,0,3,2,0,1,2744,25,767
4100,경기도,4101,수원시장안구,,율천동제10투,2850,2138,1065,964,62,1,13,3,0,1,1,3,0,0,2113,25,712
4100,경기도,4101,수원시장안구,정자1동,소계,21770,16986,8594,7681,415,10,110,2,1,2,11,23,6,7,16862,124,4784
4100,경기도,4101,수원시장안구,,관내사전투표,5956,5941,3289,2458,129,3,23,1,0,0,3,8,3,3,5920,21,15
4100,경기도,4101,수원시장안구,,정자1동제1투,2118,1272,578,619,35,3,18,0,0,0,3,0,0,1,1257,15,846
4100,경기도,4101,수원시장안구,,정자1동제2투,1591,874,412,418,19,0,10,0,0,0,1,2,2,0,864,10,717
4100,경기도,4101,수원시장안구,,정자1동제3투,3142,2106,980,1015,57,1,19,1,0,1,2,7,0,2,2085,21,1036
4100,경기도,4101,수원시장안구,,정자1동제4투,2967,2075,996,981,50,1,23,0,1,1,2,3,0,0,2058,17,892
4100,경기도,4101,수원시장안구,,정자1동제5투,3039,2379,1206,1075,62,1,10,0,0,0,0,3,0,0,2357,22,660
4100,경기도,4101,수원시장안구,,정자1동제6투,2957,2339,1133,1115,63,1,7,0,0,0,0,0,1,1,2321,18,618
4100,경기도,4101,수원시장안구,정자2동,소계,25440,18869,9329,8639,474,16,154,0,3,4,25,32,5,8,18689,180,6571
4100,경기도,4101,수원시장안구,,관내사전투표,5239,5239,2758,2288,98,5,39,0,0,0,10,11,1,1,5211,28,0
4100,경기도,4101,수원시장안구,,정자2동제1투,2107,1154,480,604,34,2,16,0,0,0,2,0,0,0,1138,16,953
4100,경기도,4101,수원시장안구,,정자2동제2투,2458,1633,785,768,47,0,11,0,1,0,1,5,0,1,1619,14,825
4100,경기도,4101,수원시장안구,,정자2동제3투,2464,1445,675,691,35,1,8,0,1,0,2,7,1,1,1422,23,1019
4100,경기도,4101,수원시장안구,,정자2동제4투,2584,1607,730,788,40,3,21,0,0,1,3,3,0,1,1590,17,977
4100,경기도,4101,수원시장안구,,정자2동제5투,2347,1761,870,789,51,3,14,0,1,1,4,3,0,1,1737,24,586
4100,경기도,4101,수원시장안구,,정자2동제6투,2718,1891,937,858,45,1,16,0,0,1,2,0,3,1,1864,27,827
4100,경기도,4101,수원시장안구,,정자2동제7투,2029,1538,791,670,50,0,17,0,0,1,1,1,0,1,1532,6,491
4100,경기도,4101,수원시장안구,,정자2동제8투,3494,2601,1303,1183,74,1,12,0,0,0,0,2,0,1,2576,25,893
4100,경기도,4101,수원시장안구,정자3동,소계,30237,24776,13461,10187,771,10,119,2,7,3,15,19,3,8,24605,171,5461
4100,경기도,4101,수원시장안구,,관내사전투표,8387,8387,4976,3122,220,3,20,0,4,0,3,7,1,1,8357,30,0
4100,경기도,4101,수원시장안구,,정자3동제1투,1938,1328,661,609,36,0,12,0,0,0,0,1,0,1,1320,8,610
4100,경기도,4101,수원시장안구,,정자3동제2투,1947,1505,708,729,43,0,5,0,0,0,0,1,0,1,1487,18,442
4100,경기도,4101,수원시장안구,,정자3동제3투,2562,1893,1036,756,73,0,14,1,1,1,0,3,0,1,1886,7,669
4100,경기도,4101,수원시장안구,,정자3동제4투,2261,1756,936,716,67,2,11,0,0,1,3,1,0,0,1737,19,505
4100,경기도,4101,수원시장안구,,정자3동제5투,3288,2495,1311,1063,91,2,11,0,0,1,2,0,0,0,2481,14,793
4100,경기도,4101,수원시장안구,,정자3동제6투,3281,2573,1340,1122,71,0,6,0,0,0,4,1,0,3,2547,26,708
4100,경기도,4101,수원시장안구,,정자3동제7투,1882,1377,687,608,48,0,12,0,2,0,0,1,2,0,1360,17,505
4100,경기도,4101,수원시장안구,,정자3동제8투,2849,2160,1210,838,75,0,17,1,0,0,3,2,0,1,2147,13,689
4100,경기도,4101,수원시장안구,,정자3동제9투,1842,1302,596,624,47,3,11,0,0,0,0,2,0,0,1283,19,540
4100,경기도,4101,수원시장안구,영화동,소계,16587,11394,5377,5553,218,7,117,2,3,4,9,15,3,7,11315,79,5193
4100,경기도,4101,수원시장안구,,관내사전투표,4467,4467,2282,2063,71,1,25,0,2,0,2,4,0,1,4451,16,0
4100,경기도,4101,수원시장안구,,영화동제1투,2313,1193,547,588,25,0,15,0,0,0,2,2,0,2,1181,12,1120
4100,경기도,4101,수원시장안구,,영화동제2투,2338,1272,532,680,18,2,17,1,0,0,1,1,0,1,1253,19,1066
4100,경기도,4101,수원시장안구,,영화동제3투,2778,1689,741,858,38,1,28,0,0,1,1,4,1,1,1674,15,1089
4100,경기도,4101,수원시장안구,,영화동제4투,2262,1364,605,689,33,3,16,0,1,2,1,2,1,1,1354,10,898
4100,경기도,4101,수원시장안구,,영화동제5투,2429,1409,670,675,33,0,16,1,0,1,2,2,1,1,1402,7,1020
4100,경기도,4101,수원시장안구,송죽동,소계,15320,11135,5645,5000,266,9,79,1,0,4,7,9,2,1,11023,112,4185
4100,경기도,4101,수원시장안구,,관내사전투표,4369,4369,2443,1781,93,2,24,1,0,0,2,1,0,1,4348,21,0
4100,경기도,4101,수원시장안구,,송죽동제1투,2224,1324,629,603,48,3,16,0,0,0,1,0,1,0,1301,23,900
4100,경기도,4101,수원시장안구,,송죽동제2투,2387,1501,719,728,24,1,10,0,0,1,0,2,1,0,1486,15,886
4100,경기도,4101,수원시장안구,,송죽동제3투,1764,1064,519,495,20,0,11,0,0,0,2,1,0,0,1048,16,700
4100,경기도,4101,수원시장안구,,송죽동제4투,2467,1432,630,724,36,3,15,0,0,3,2,2,0,0,1415,17,1035
4100,경기도,4101,수원시장안구,,송죽동제5투,2109,1445,705,669,45,0,3,0,0,0,0,3,0,0,1425,20,664
4100,경기도,4101,수원시장안구,조원1동,소계,21846,15739,7759,7268,381,8,146,2,2,2,25,12,10,0,15615,124,6107
4100,경기도,4101,수원시장안구,,관내사전투표,5623,5623,3063,2372,115,2,41,0,1,0,3,6,4,0,5607,16,0
4100,경기도,4101,수원시장안구,,조원1동제1투,2998,1573,801,688,44,0,23,0,0,1,3,1,1,0,1562,11,1425
4100,경기도,4101,수원시장안구,,조원1동제2투,2351,1455,754,632,29,1,17,1,0,0,4,1,0,0,1439,16,896
4100,경기도,4101,수원시장안구,,조원1동제3투,1990,1145,571,512,24,0,22,0,0,0,0,0,0,0,1129,16,845
4100,경기도,4101,수원시장안구,,조원1동제4투,2211,1398,648,684,31,2,14,1,1,0,2,1,2,0,1386,12,813
4100,경기도,4101,수원시장안구,,조원1동제5투,2583,1688,634,971,44,1,8,0,0,1,4,1,2,0,1666,22,895
4100,경기도,4101,수원시장안구,,조원1동제6투,1756,1226,571,601,29,2,11,0,0,0,6,1,0,0,1221,5,530
4100,경기도,4101,수원시장안구,,조원1동제7투,2334,1631,717,808,65,0,10,0,0,0,3,1,1,0,1605,26,703
4100,경기도,4101,수원시장안구,조원2동,소계,15062,12477,5765,6162,362,5,59,2,2,2,20,4,0,3,12386,91,2585
4100,경기도,4101,수원시장안구,,관내사전투표,6460,6460,3195,3039,157,1,23,0,0,0,6,4,0,0,6425,35,0
4100,경기도,4101,수원시장안구,,조원2동제1투,2545,1755,735,941,45,1,11,0,0,0,4,0,0,2,1739,16,790
4100,경기도,4101,수원시장안구,,조원2동제2투,2123,1482,639,754,60,1,7,1,1,1,3,0,0,0,1467,15,641
4100,경기도,4101,수원시장안구,,조원2동제3투,2153,1537,703,743,61,2,9,0,1,1,4,0,0,1,1525,12,616
4100,경기도,4101,수원시장안구,,조원2동제4투,1781,1243,493,685,39,0,9,1,0,0,3,0,0,0,1230,13,538
4100,경기도,4101,수원시장안구,연무동,소계,13248,9203,4080,4748,175,4,84,1,3,3,8,13,2,6,9127,76,4045
4100,경기도,4101,수원시장안구,,관내사전투표,3280,3281,1633,1546,53,2,20,0,1,2,0,6,0,1,3264,17,-1
4100,경기도,4101,수원시장안구,,연무동제1투,1144,590,249,303,21,0,8,0,0,0,0,0,0,1,582,8,554
4100,경기도,4101,수원시장안구,,연무동제2투,1757,999,403,555,18,1,13,0,0,0,0,0,0,1,991,8,758
4100,경기도,4101,수원시장안구,,연무동제3투,2110,1318,523,729,24,0,17,1,0,1,4,2,2,1,1304,14,792
4100,경기도,4101,수원시장안구,,연무동제4투,2217,1329,567,719,18,0,11,0,1,0,0,1,0,0,1317,12,888
4100,경기도,4101,수원시장안구,,연무동제5투,2740,1686,705,896,41,1,15,0,1,0,4,4,0,2,1669,17,1054
4100,경기도,4101,수원시장안구,잘못 투입·구분된 투표지,,0,2,0,2,0,0,0,0,0,0,0,0,0,0,2,0,-2
4100,경기도,4102,수원시권선구,합계,,311536,235055,121028,103154,5754,121,1981,55,42,63,187,218,48,99,232750,2305,76481
4100,경기도,4102,수원시권선구,거소·선상투표,,559,539,238,183,9,1,14,5,3,0,2,0,1,2,458,81,20
4100,경기도,4102,수원시권선구,관외사전투표,,29036,29032,15147,12397,785,14,299,9,6,7,7,46,6,18,28741,291,4
4100,경기도,4102,수원시권선구,재외투표,,1227,883,520,249,23,0,4,0,0,0,1,0,0,0,797,86,344
4100,경기도,4102,수원시권선구,세류1동,소계,8564,6657,3156,3187,177,3,48,2,3,4,8,8,0,1,6597,60,1907
4100,경기도,4102,수원시권선구,,관내사전투표,2997,2997,1534,1350,75,1,12,1,0,0,4,4,0,0,2981,16,0
4100,경기도,4102,수원시권선구,,세류1동제1투,1343,998,448,497,28,1,9,0,0,1,1,1,0,0,986,12,345
4100,경기도,4102,수원시권선구,,세류1동제2투,2057,1144,511,555,32,1,17,0,3,1,2,3,0,0,1125,19,913
4100,경기도,4102,수원시권선구,,세류1동제3투,2167,1518,663,785,42,0,10,1,0,2,1,0,0,1,1505,13,649
4100,경기도,4102,수원시권선구,세류2동,소계,19233,12248,6019,5626,279,9,151,2,3,7,16,14,2,4,12132,116,6985
4100,경기도,4102,수원시권선구,,관내사전투표,4189,4189,2248,1791,85,4,25,0,2,1,2,7,2,0,4167,22,0
4100,경기도,4102,수원시권선구,,세류2동제1투,2712,1312,590,662,21,0,22,1,0,3,1,1,0,0,1301,11,1400
4100,경기도,4102,수원시권선구,,세류2동제2투,2142,1288,589,622,35,2,19,0,0,0,0,2,0,0,1269,19,854
4100,경기도,4102,수원시권선구,,세류2동제3투,2392,1132,509,547,26,0,26,0,0,0,4,0,0,2,1114,18,1260
4100,경기도,4102,수원시권선구,,세류2동제4투,2881,1501,736,683,38,1,23,0,0,1,1,2,0,2,1487,14,1380
4100,경기도,4102,수원시권선구,,세류2동제5투,2718,1540,757,690,42,1,19,1,1,1,5,2,0,0,1519,21,1178
4100,경기도,4102,수원시권선구,,세류2동제6투,2199,1286,590,631,32,1,17,0,0,1,3,0,0,0,1275,11,913
4100,경기도,4102,수원시권선구,세류3동,소계,15572,10405,5119,4820,218,11,110,0,1,0,12,9,1,4,10305,100,5167
4100,경기도,4102,수원시권선구,,관내사전투표,4167,4167,2185,1857,61,6,30,0,1,0,1,4,1,0,4146,21,0
4100,경기도,4102,수원시권선구,,세류3동제1투,2975,1647,711,860,37,1,19,0,0,0,3,0,0,1,1632,15,1328
4100,경기도,4102,수원시권선구,,세류3동제2투,2333,1211,608,530,31,1,14,0,0,0,4,1,0,1,1190,21,1122
4100,경기도,4102,수원시권선구,,세류3동제3투,2963,1815,848,858,49,2,26,0,0,0,1,2,0,1,1787,28,1148
4100,경기도,4102,수원시권선구,,세류3동제4투,3134,1565,767,715,40,1,21,0,0,0,3,2,0,1,1550,15,1569
4100,경기도,4102,수원시권선구,평동,소계,31017,22629,11413,10149,563,10,221,5,2,4,20,15,3,8,22413,216,8388
4100,경기도,4102,수원시권선구,,관내사전투표,7041,7041,3846,2947,149,5,46,2,0,0,3,1,0,4,7003,38,0
4100,경기도,4102,수원시권선구,,평동제1투,1491,869,321,511,18,0,10,0,0,0,0,1,0,0,861,8,622
4100,경기도,4102,수원시권선구,,평동제2투,1778,1009,425,508,31,0,16,0,0,0,2,2,2,1,987,22,769
4100,경기도,4102,수원시권선구,,평동제3투,2389,1428,675,683,30,0,11,0,0,0,3,2,0,0,1404,24,961
4100,경기도,4102,수원시권선구,,평동제4투,2255,1364,676,608,39,3,13,0,0,1,1,2,0,1,1344,20,891
4100,경기도,4102,수원시권선구,,평동제5투,2851,1833,853,880,53,0,24,1,1,0,1,0,0,0,1813,20,1018
4100,경기도,4102,수원시권선구,,평동제6투,3317,2168,1165,894,48,0,27,0,1,1,2,2,1,0,2141,27,1149
4100,경기도,4102,수원시권선구,,평동제7투,2526,1727,791,834,53,0,22,1,0,1,4,0,0,1,1707,20,799
4100,경기도,4102,수원시권선구,,평동제8투,3135,2207,1150,955,61,1,19,1,0,0,1,2,0,1,2191,16,928
4100,경기도,4102,수원시권선구,,평동제9투,4234,2983,1511,1329,81,1,33,0,0,1,3,3,0,0,2962,21,1251
4100,경기도,4102,수원시권선구,서둔동,소계,28982,19526,10053,8520,473,10,217,8,3,5,22,20,9,7,19347,179,9456
4100,경기도,4102,수원시권선구,,관내사전투표,4869,4870,2748,1965,93,1,26,1,1,0,1,4,0,1,4841,29,-1
4100,경기도,4102,수원시권선구,,서둔동제1투,1581,898,401,436,36,1,8,1,1,1,0,5,1,1,892,6,683
4100,경기도,4102,수원시권선구,,서둔동제2투,1817,1180,552,553,39,1,14,1,0,0,3,0,1,0,1164,16,637
4100,경기도,4102,수원시권선구,,서둔동제3투,3201,1963,965,904,37,3,29,2,0,0,0,2,2,1,1945,18,1238
4100,경기도,4102,수원시권선구,,서둔동제4투,1721,888,427,408,23,0,14,1,0,1,2,2,1,0,879,9,833
4100,경기도,4102,수원시권선구,,서둔동제5투,2938,1800,863,841,42,1,30,0,0,0,0,0,1,1,1779,21,1138
4100,경기도,4102,수원시권선구,,서둔동제6투,3379,2130,1073,943,57,1,23,0,0,1,6,2,1,2,2109,21,1249
4100,경기도,4102,수원시권선구,,서둔동제7투,2374,1762,836,828,58,0,11,0,1,0,2,1,0,0,1737,25,612
4100,경기도,4102,수원시권선구,,서둔동제8투,3345,1906,1016,789,37,0,35,1,0,1,3,3,0,1,1886,20,1439
4100,경기도,4102,수원시권선구,,서둔동제9투,3757,2129,1172,853,51,2,27,1,0,1,5,1,2,0,2115,14,1628
4100,경기도,4102,수원시권선구,구운동,소계,19046,13965,7106,6232,295,6,134,4,8,5,16,12,2,5,13825,140,5081
4100,경기도,4102,수원시권선구,,관내사전투표,4641,4641,2635,1845,85,2,31,1,4,1,2,5,0,0,4611,30,0
4100,경기도,4102,수원시권선구,,구운동제1투,2145,1215,608,533,26,0,25,1,0,2,3,0,0,1,1199,16,930
4100,경기도,4102,수원시권선구,,구운동제2투,2548,1788,810,901,42,1,7,1,2,0,1,0,0,1,1766,22,760
4100,경기도,4102,수원시권선구,,구운동제3투,1957,1236,570,594,32,2,18,1,0,2,0,0,0,0,1219,17,721
4100,경기도,4102,수원시권선구,,구운동제4투,2744,1838,884,875,36,1,19,0,0,0,0,2,0,2,1819,19,906
4100,경기도,4102,수원시권선구,,구운동제5투,2688,2017,951,972,50,0,15,0,2,0,4,0,1,1,1996,21,671
4100,경기도,4102,수원시권선구,,구운동제6투,2323,1230,648,512,24,0,19,0,0,0,6,5,1,0,1215,15,1093
4100,경기도,4102,수원시권선구,권선1동,소계,19304,13229,6272,6306,313,7,131,4,0,5,7,9,5,6,13065,164,6075
4100,경기도,4102,수원시권선구,,관내사전투표,4114,4114,2126,1847,83,1,22,3,0,1,1,4,1,1,4090,24,0
4100,경기도,4102,수원시권선구,,권선1동제1투,2120,1430,562,796,32,2,20,0,0,0,1,0,0,1,1414,16,690
4100,경기도,4102,수원시권선구,,권선1동제2투,3134,1721,781,839,43,0,19,0,0,0,2,2,3,1,1690,31,1413
4100,경기도,4102,수원시권선구,,권선1동제3투,3220,1756,790,861,50,1,25,0,0,1,0,0,1,0,1729,27,1464
4100,경기도,4102,수원시권선구,,권선1동제4투,2194,1234,578,586,26,1,17,0,0,0,2,0,0,1,1211,23,960
4100,경기도,4102,수원시권선구,,권선1동제5투,2320,1356,649,630,34,2,16,0,0,1,0,2,0,2,1336,20,964
4100,경기도,4102,수원시권선구,,권선1동제6투,2202,1618,786,747,45,0,12,1,0,2,1,1,0,0,1595,23,584
4100,경기도,4102,수원시권선구,권선2동,소계,34669,27486,13318,13002,699,12,151,5,4,6,22,16,4,10,27249,237,7183
4100,경기도,4102,수원시권선구,,관내사전투표,9233,9230,4913,4027,192,4,26,1,0,2,5,7,1,2,9180,50,3
4100,경기도,4102,수원시권선구,,권선2동제1투,2054,1408,575,756,41,2,8,1,0,2,0,0,0,1,1386,22,646
4100,경기도,4102,수원시권선구,,권선2동제2투,2665,1910,819,981,59,1,19,2,0,0,6,3,0,3,1893,17,755
4100,경기도,4102,수원시권선구,,권선2동제3투,1772,1268,566,640,37,0,9,0,0,0,2,1,0,0,1255,13,504
4100,경기도,4102,수원시권선구,,권선2동제4투,1892,1221,567,584,38,0,14,0,0,0,2,0,1,0,1206,15,671
4100,경기도,4102,수원시권선구,,권선2동제5투,2021,1392,690,643,41,0,7,0,1,0,0,0,0,0,1382,10,629
4100,경기도,4102,수원시권선구,,권선2동제6투,2432,1639,770,772,60,0,11,0,1,0,3,2,0,0,1619,20,793
4100,경기도,4102,수원시권선구,,권선2동제7투,2680,1957,870,1003,44,0,13,0,2,0,1,0,1,1,1935,22,723
4100,경기도,4102,수원시권선구,,권선2동제8투,2599,1876,782,1020,37,2,9,0,0,0,1,1,0,0,1852,24,723
4100,경기도,4102,수원시권선구,,권선2동제9투,2650,2049,969,995,54,2,14,0,0,1,0,1,0,0,2036,13,601
4100,경기도,4102,수원시권선구,,권선2동제10투,2351,1793,954,762,48,0,9,0,0,1,1,1,1,2,1779,14,558
4100,경기도,4102,수원시권선구,,권선2동제11투,2320,1743,843,819,48,1,12,1,0,0,1,0,0,1,1726,17,577
4100,경기도,4102,수원시권선구,곡선동,소계,25840,18023,9205,7967,460,8,160,1,3,5,11,16,6,7,17849,174,7817
4100,경기도,4102,수원시권선구,,관내사전투표,6498,6498,3691,2588,121,5,35,0,1,3,0,3,1,4,6452,46,0
4100,경기도,4102,수원시권선구,,곡선동제1투,1592,1030,518,460,28,0,10,0,0,0,1,1,0,0,1018,12,562
4100,경기도,4102,수원시권선구,,곡선동제2투,2554,2039,950,978,73,1,10,0,0,1,0,3,0,2,2018,21,515
4100,경기도,4102,수원시권선구,,곡선동제3투,2576,1320,628,625,30,0,23,0,0,0,2,0,0,1,1309,11,1256
4100,경기도,4102,수원시권선구,,곡선동제4투,2546,1900,946,860,55,1,14,0,1,0,3,1,2,0,1883,17,646
4100,경기도,4102,수원시권선구,,곡선동제5투,2941,1115,541,483,37,0,22,1,1,0,2,3,0,0,1090,25,1826
4100,경기도,4102,수원시권선구,,곡선동제6투,2823,1087,562,457,20,0,26,0,0,1,1,2,2,0,1071,16,1736
4100,경기도,4102,수원시권선구,,곡선동제7투,1659,1044,421,571,25,1,13,0,0,0,1,1,0,0,1033,11,615
4100,경기도,4102,수원시권선구,,곡선동제8투,1159,892,420,422,33,0,3,0,0,0,0,2,1,0,881,11,267
4100,경기도,4102,수원시권선구,,곡선동제9투,1492,1098,528,523,38,0,4,0,0,0,1,0,0,0,1094,4,394
4100,경기도,4102,수원시권선구,입북동,소계,12238,9740,5372,3978,204,3,81,2,1,3,9,8,2,7,9670,70,2498
4100,경기도,4102,수원시권선구,,관내사전투표,3208,3208,1962,1159,52,0,18,1,0,0,1,3,0,1,3197,11,0
4100,경기도,4102,수원시권선구,,입북동제1투,1905,1304,652,600,25,1,12,0,0,0,3,2,1,1,1297,7,601
4100,경기도,4102,수원시권선구,,입북동제2투,2854,2068,1027,927,48,1,33,1,0,1,1,2,0,4,2045,23,786
4100,경기도,4102,수원시권선구,,입북동제3투,2250,1564,862,629,36,1,12,0,0,1,3,1,1,0,1546,18,686
4100,경기도,4102,수원시권선구,,입북동제4투,2021,1596,869,663,43,0,6,0,1,1,1,0,0,1,1585,11,425
4100,경기도,4102,수원시권선구,금곡동,소계,34055,26533,14220,11230,641,14,137,4,1,6,23,30,0,12,26318,215,7522
4100,경기도,4102,수원시권선구,,관내사전투표,9396,9396,5570,3559,163,5,36,1,0,1,0,9,0,3,9347,49,0
4100,경기도,4102,수원시권선구,,금곡동제1투,2958,2042,1004,939,65,1,6,0,0,0,7,0,0,2,2024,18,916
4100,경기도,4102,수원시권선구,,금곡동제2투,3102,1889,883,902,45,3,23,1,0,2,4,3,0,1,1867,22,1213
4100,경기도,4102,수원시권선구,,금곡동제3투,4001,2555,1296,1145,65,1,13,0,0,0,4,2,0,3,2529,26,1446
4100,경기도,4102,수원시권선구,,금곡동제4투,2603,1901,894,935,46,0,9,0,0,1,3,0,0,1,1889,12,702
4100,경기도,4102,수원시권선구,,금곡동제5투,2879,2142,1025,1007,64,0,9,0,1,1,2,8,0,0,2117,25,737
4100,경기도,4102,수원시권선구,,금곡동제6투,1972,1336,711,552,36,1,18,1,0,0,1,3,0,0,1323,13,636
4100,경기도,4102,수원시권선구,,금곡동제7투,2307,1767,1012,663,55,1,9,0,0,1,1,4,0,0,1746,21,540
4100,경기도,4102,수원시권선구,,금곡동제8투,2366,1605,842,694,40,2,10,0,0,0,0,0,0,1,1589,16,761
4100,경기도,4102,수원시권선구,,금곡동제9투,2471,1900,983,834,62,0,4,1,0,0,1,1,0,1,1887,13,571
4100,경기도,4102,수원시권선구,호매실동,소계,32194,24158,13870,9306,615,13,123,4,4,6,11,15,7,8,23982,176,8036
4100,경기도,4102,수원시권선구,,관내사전투표,9322,9321,5891,3160,189,4,20,2,2,2,1,7,2,5,9285,36,1
4100,경기도,4102,수원시권선구,,호매실동제1투,2478,1511,726,706,42,1,9,1,1,1,1,1,3,0,1492,19,967
4100,경기도,4102,수원시권선구,,호매실동제2투,2629,1767,879,795,56,1,16,0,0,0,1,0,0,0,1748,19,862
4100,경기도,4102,수원시권선구,,호매실동제3투,2306,1470,906,460,67,0,16,0,0,1,1,0,0,0,1451,19,836
4100,경기도,4102,수원시권선구,,호매실동제4투,2896,1705,904,732,46,1,12,0,0,2,0,0,0,0,1697,8,1191
4100,경기도,4102,수원시권선구,,호매실동제5투,3635,2404,1343,963,59,2,13,1,0,0,3,4,1,0,2389,15,1231
4100,경기도,4102,수원시권선구,,호매실동제6투,3058,2015,1156,768,59,4,9,0,0,0,0,2,0,0,1998,17,1043
4100,경기도,4102,수원시권선구,,호매실동제7투,3854,2543,1338,1085,58,0,20,0,1,0,4,1,1,2,2510,33,1311
4100,경기도,4102,수원시권선구,,호매실동제8투,2016,1422,727,637,39,0,8,0,0,0,0,0,0,1,1412,10,594
4100,경기도,4102,수원시권선구,잘못 투입·구분된 투표지,,0,2,0,2,0,0,0,0,0,0,0,0,0,0,2,0,-2
4100,경기도,4103,수원시팔달구,합계,,161747,119627,58024,56051,3003,63,1046,30,14,24,97,128,28,39,118547,1080,42120
4100,경기도,4103,수원시팔달구,거소·선상투표,,270,254,114,100,7,1,7,0,1,0,0,0,0,0,230,24,16
4100,경기도,4103,수원시팔달구,관외사전투표,,16517,16517,8606,7108,445,8,151,10,3,3,7,31,2,8,16382,135,0
4100,경기도,4103,수원시팔달구,재외투표,,834,605,380,157,17,0,0,0,0,0,0,0,0,0,554,51,229
4100,경기도,4103,수원시팔달구,행궁동,소계,9207,6191,2787,3124,144,4,67,2,0,2,8,4,0,2,6144,47,3016
4100,경기도,4103,수원시팔달구,,관내사전투표,2730,2730,1343,1283,58,2,21,0,0,0,2,2,0,1,2712,18,0
4100,경기도,4103,수원시팔달구,,행궁동제1투,2240,1152,478,603,34,1,15,0,0,2,1,1,0,1,1136,16,1088
4100,경기도,4103,수원시팔달구,,행궁동제2투,1630,1030,436,554,20,0,12,0,0,0,2,1,0,0,1025,5,600
4100,경기도,4103,수원시팔달구,,행궁동제3투,2607,1279,530,684,32,1,19,2,0,0,3,0,0,0,1271,8,1328
4100,경기도,4103,수원시팔달구,매교동,소계,5530,3852,1843,1826,89,2,44,2,1,2,6,5,1,3,3824,28,1678
4100,경기도,4103,수원시팔달구,,관내사전투표,2093,2095,1079,931,43,0,22,1,1,1,0,1,0,2,2081,14,-2
4100,경기도,4103,수원시팔달구,,매교동투표소,3437,1757,764,895,46,2,22,1,0,1,6,4,1,1,1743,14,1680
4100,경기도,4103,수원시팔달구,매산동,소계,8433,5465,2421,2813,123,4,47,1,0,0,5,8,1,3,5426,39,2968
4100,경기도,4103,수원시팔달구,,관내사전투표,1745,1744,911,778,34,0,5,0,0,0,1,7,0,2,1738,6,1
4100,경기도,4103,수원시팔달구,,매산동제1투,2992,1222,560,591,26,1,26,1,0,0,2,0,0,1,1208,14,1770
4100,경기도,4103,수원시팔달구,,매산동제2투,2574,1922,715,1123,54,3,11,0,0,0,0,0,1,0,1907,15,652
4100,경기도,4103,수원시팔달구,,매산동제3투,1122,577,235,321,9,0,5,0,0,0,2,1,0,0,573,4,545
4100,경기도,4103,수원시팔달구,고등동,소계,15388,11280,5491,5257,306,5,102,1,3,1,8,12,5,4,11195,85,4108
4100,경기도,4103,수원시팔달구,,관내사전투표,5171,5171,2771,2210,112,2,37,1,1,0,4,4,3,3,5148,23,0
4100,경기도,4103,수원시팔달구,,고등동제1투,2246,1562,686,783,60,0,20,0,0,0,0,3,0,0,1552,10,684
4100,경기도,4103,수원시팔달구,,고등동제2투,2806,1807,843,854,66,1,16,0,0,1,1,2,0,1,1785,22,999
4100,경기도,4103,수원시팔달구,,고등동제3투,2426,1151,519,581,18,0,14,0,1,0,1,2,1,0,1137,14,1275
4100,경기도,4103,수원시팔달구,,고등동제4투,2739,1589,672,829,50,2,15,0,1,0,2,1,1,0,1573,16,1150
4100,경기도,4103,수원시팔달구,화서1동,소계,17656,12522,6273,5707,297,7,119,4,3,0,10,23,2,5,12450,72,5134
4100,경기도,4103,수원시팔달구,,관내사전투표,4597,4596,2574,1881,77,0,31,2,2,0,1,11,1,3,4583,13,1
4100,경기도,4103,수원시팔달구,,화서1동제1투,2402,1333,622,645,34,0,17,0,0,0,1,3,0,0,1322,11,1069
4100,경기도,4103,수원시팔달구,,화서1동제2투,2624,1537,696,781,40,1,10,0,1,0,2,0,0,1,1532,5,1087
4100,경기도,4103,수원시팔달구,,화서1동제3투,2922,1727,766,863,53,3,20,0,0,0,2,5,0,0,1712,15,1195
4100,경기도,4103,수원시팔달구,,화서1동제4투,1951,1101,452,585,31,0,18,1,0,0,3,1,0,1,1092,9,850
4100,경기도,4103,수원시팔달구,,화서1동제5투,3160,2228,1163,952,62,3,23,1,0,0,1,3,1,0,2209,19,932
4100,경기도,4103,수원시팔달구,화서2동,소계,19160,15356,7710,7001,419,7,88,3,2,2,13,7,3,1,15256,100,3804
4100,경기도,4103,수원시팔달구,,관내사전투표,5830,5830,3344,2307,129,3,16,1,0,0,1,2,2,0,5805,25,0
4100,경기도,4103,수원시팔달구,,화서2동제1투,1892,1356,572,718,34,2,19,0,1,0,1,0,0,0,1347,9,536
4100,경기도,4103,수원시팔달구,,화서2동제2투,1968,1339,572,711,32,1,10,0,0,0,2,0,0,0,1328,11,629
4100,경기도,4103,수원시팔달구,,화서2동제3투,1788,1313,611,626,52,0,8,0,0,0,2,0,0,0,1299,14,475
4100,경기도,4103,수원시팔달구,,화서2동제4투,2647,1902,925,887,59,1,12,1,0,0,2,1,0,1,1889,13,745
4100,경기도,4103,수원시팔달구,,화서2동제5투,2191,1534,640,822,43,0,8,1,0,2,3,2,0,0,1521,13,657
4100,경기도,4103,수원시팔달구,,화서2동제6투,2844,2082,1046,930,70,0,15,0,1,0,2,2,1,0,2067,15,762
4100,경기도,4103,수원시팔달구,지동,소계,9253,6442,2977,3211,102,4,78,1,0,3,8,8,3,3,6398,44,2811
4100,경기도,4103,수원시팔달구,,관내사전투표,3023,3023,1467,1466,38,1,24,0,0,0,3,6,1,2,3008,15,0
4100,경기도,4103,수원시팔달구,,지동제1투,2010,1091,517,523,23,1,18,0,0,1,0,0,0,0,1083,8,919
4100,경기도,4103,수원시팔달구,,지동제2투,1214,697,280,379,15,2,8,0,0,1,1,0,1,0,687,10,517
4100,경기도,4103,수원시팔달구,,지동제3투,1373,757,328,403,8,0,12,0,0,0,0,2,0,1,754,3,616
4100,경기도,4103,수원시팔달구,,지동제4투,1633,874,385,440,18,0,16,1,0,1,4,0,1,0,866,8,759
4100,경기도,4103,수원시팔달구,우만1동,소계,16525,11380,5553,5278,254,11,120,3,1,2,14,10,5,2,11253,127,5145
4100,경기도,4103,수원시팔달구,,관내사전투표,3745,3744,1960,1640,85,4,25,2,1,1,0,3,3,1,3725,19,1
4100,경기도,4103,수원시팔달구,,우만1동제1투,2395,1325,617,619,41,1,19,0,0,0,1,3,1,0,1302,23,1070
4100,경기도,4103,수원시팔달구,,우만1동제2투,2800,1597,741,773,37,0,18,0,0,0,5,0,0,0,1574,23,1203
4100,경기도,4103,수원시팔달구,,우만1동제3투,2211,1376,649,667,24,1,20,0,0,0,1,2,0,0,1364,12,835
4100,경기도,4103,수원시팔달구,,우만1동제4투,2532,1430,732,624,30,1,16,0,0,1,1,1,0,1,1407,23,1102
4100,경기도,4103,수원시팔달구,,우만1동제5투,1331,847,402,390,10,4,11,1,0,0,6,0,1,0,825,22,484
4100,경기도,4103,수원시팔달구,,우만1동제6투,1511,1061,452,565,27,0,11,0,0,0,0,1,0,0,1056,5,450
4100,경기도,4103,수원시팔달구,우만2동,소계,13403,10587,4834,5245,322,5,56,1,0,4,8,8,2,1,10486,101,2816
4100,경기도,4103,수원시팔달구,,관내사전투표,4747,4747,2375,2182,134,3,18,1,0,1,1,3,0,0,4718,29,0
4100,경기도,4103,수원시팔달구,,우만2동제1투,2429,1405,597,710,51,0,15,0,0,1,3,2,1,1,1381,24,1024
4100,경기도,4103,수원시팔달구,,우만2동제2투,2017,1336,528,717,49,2,11,0,0,2,2,2,1,0,1314,22,681
4100,경기도,4103,수원시팔달구,,우만2동제3투,2148,1562,644,854,44,0,6,0,0,0,1,1,0,0,1550,12,586
4100,경기도,4103,수원시팔달구,,우만2동제4투,2062,1537,690,782,44,0,6,0,0,0,1,0,0,0,1523,14,525
4100,경기도,4103,수원시팔달구,인계동,소계,29571,19171,9032,9223,477,5,167,2,0,5,10,12,4,7,18944,227,10400
4100,경기도,4103,수원시팔달구,,관내사전투표,4587,4586,2413,1985,116,0,32,0,0,0,2,2,0,1,4551,35,1
4100,경기도,4103,수원시팔달구,,인계동제1투,3532,1888,760,1031,48,1,13,0,0,0,0,1,1,1,1856,32,1644
4100,경기도,4103,수원시팔달구,,인계동제2투,3460,1971,938,948,44,0,16,1,0,1,2,1,0,0,1951,20,1489
4100,경기도,4103,수원시팔달구,,인계동제3투,3300,1895,907,895,46,2,29,0,0,0,1,1,0,1,1882,13,1405
4100,경기도,4103,수원시팔달구,,인계동제4투,3058,2065,878,1093,54,0,10,1,0,0,3,0,1,0,2040,25,993
4100,경기도,4103,수원시팔달구,,인계동제5투,3235,2410,1154,1152,69,0,8,0,0,0,1,2,0,2,2388,22,825
4100,경기도,4103,수원시팔달구,,인계동제6투,3024,1354,596,664,32,2,20,0,0,1,0,0,1,0,1316,38,1670
4100,경기도,4103,수원시팔달구,,인계동제7투,2835,1436,673,691,29,0,20,0,0,3,1,2,1,1,1421,15,1399
4100,경기도,4103,수원시팔달구,,인계동제8투,2540,1566,713,764,39,0,19,0,0,0,0,3,0,1,1539,27,974
4100,경기도,4103,수원시팔달구,잘못 투입·구분된 투표지,,0,5,3,1,1,0,0,0,0,0,0,0,0,0,5,0,-5
4100,경기도,4104,수원시영통구,합계,,295828,239154,114418,114252,6385,131,1216,45,15,46,121,151,40,71,236891,2263,56674
4100,경기도,4104,수원시영통구,거소·선상투표,,369,345,130,141,4,0,8,2,0,0,0,1,1,1,288,57,24
4100,경기도,4104,수원시영통구,관외사전투표,,30790,30781,14779,14551,821,28,232,6,0,6,10,17,4,20,30474,307,9
4100,경기도,4104,수원시영통구,재외투표,,1970,1423,766,465,49,3,4,0,0,0,1,1,0,0,1289,134,547
4100,경기도,4104,수원시영통구,매탄1동,소계,13765,10601,4830,5306,284,4,58,1,1,2,7,9,1,4,10507,94,3164
4100,경기도,4104,수원시영통구,,관내사전투표,4187,4188,2041,1996,104,2,14,0,0,1,1,5,0,1,4165,23,-1
4100,경기도,4104,수원시영통구,,매탄1동제1투,1268,792,332,410,25,1,7,0,1,0,1,2,0,1,780,12,476
4100,경기도,4104,수원시영통구,,매탄1동제2투,1893,1382,536,779,39,0,9,0,0,1,1,1,0,1,1367,15,511
4100,경기도,4104,수원시영통구,,매탄1동제3투,1673,1253,589,617,33,0,2,0,0,0,1,1,1,0,1244,9,420
4100,경기도,4104,수원시영통구,,매탄1동제4투,1982,1418,666,690,43,1,6,1,0,0,0,0,0,0,1407,11,564
4100,경기도,4104,수원시영통구,,매탄1동제5투,1336,790,351,403,21,0,7,0,0,0,2,0,0,1,785,5,546
4100,경기도,4104,수원시영통구,,매탄1동제6투,1426,778,315,411,19,0,13,0,0,0,1,0,0,0,759,19,648
4100,경기도,4104,수원시영통구,매탄2동,소계,11675,8718,4195,4136,222,5,62,1,2,2,6,11,2,3,8647,71,2957
4100,경기도,4104,수원시영통구,,관내사전투표,3643,3643,1926,1596,78,2,16,1,0,0,1,6,0,0,3626,17,0
4100,경기도,4104,수원시영통구,,매탄2동제1투,2209,1256,563,617,35,3,20,0,0,1,3,1,0,1,1244,12,953
4100,경기도,4104,수원시영통구,,매탄2동제2투,2202,1269,550,642,35,0,15,0,2,0,2,0,1,2,1249,20,933
4100,경기도,4104,수원시영통구,,매탄2동제3투,2165,1523,676,781,40,0,6,0,0,1,0,3,1,0,1508,15,642
4100,경기도,4104,수원시영통구,,매탄2동제4투,1456,1027,480,500,34,0,5,0,0,0,0,1,0,0,1020,7,429
4100,경기도,4104,수원시영통구,매탄3동,소계,26054,19770,9791,9039,550,20,114,8,2,4,8,16,2,11,19565,205,6284
4100,경기도,4104,수원시영통구,,관내사전투표,7274,7273,3982,3032,178,5,28,2,0,0,0,4,0,1,7232,41,1
4100,경기도,4104,수원시영통구,,매탄3동제1투,3396,2579,1297,1168,79,1,6,2,0,0,1,3,0,1,2558,21,817
4100,경기도,4104,수원시영통구,,매탄3동제2투,2899,1867,889,894,48,0,9,0,0,1,1,2,0,2,1846,21,1032
4100,경기도,4104,수원시영통구,,매탄3동제3투,2695,1793,857,834,48,3,18,1,0,1,3,1,0,0,1766,27,902
4100,경기도,4104,수원시영통구,,매탄3동제4투,2575,1691,762,817,68,2,8,0,0,0,1,5,0,3,1666,25,884
4100,경기도,4104,수원시영통구,,매탄3동제5투,2609,1666,769,790,46,3,21,1,0,2,1,1,1,2,1637,29,943
4100,경기도,4104,수원시영통구,,매탄3동제6투,2456,1723,729,906,52,3,7,2,2,0,0,0,0,2,1703,20,733
4100,경기도,4104,수원시영통구,,매탄3동제7투,2150,1178,506,598,31,3,17,0,0,0,1,0,1,0,1157,21,972
4100,경기도,4104,수원시영통구,매탄4동,소계,16449,12053,5942,5538,327,8,92,2,0,2,15,15,3,3,11947,106,4396
4100,경기도,4104,수원시영통구,,관내사전투표,4682,4682,2504,2011,112,3,20,0,0,1,0,6,0,2,4659,23,0
4100,경기도,4104,수원시영통구,,매탄4동제1투,2311,1295,589,622,35,2,19,0,0,0,3,3,1,0,1274,21,1016
4100,경기도,4104,수원시영통구,,매탄4동제2투,2274,1489,709,711,43,0,14,0,0,0,0,1,0,0,1478,11,785
4100,경기도,4104,수원시영통구,,매탄4동제3투,2198,1273,586,604,45,1,19,0,0,0,1,1,0,0,1257,16,925
4100,경기도,4104,수원시영통구,,매탄4동제4투,2520,1688,825,774,52,1,9,0,0,1,5,1,1,1,1670,18,832
4100,경기도,4104,수원시영통구,,매탄4동제5투,2464,1626,729,816,40,1,11,2,0,0,6,3,1,0,1609,17,838
4100,경기도,4104,수원시영통구,원천동,소계,27301,20666,9091,10724,511,9,107,6,1,4,22,12,6,6,20499,167,6635
4100,경기도,4104,수원시영통구,,관내사전투표,7098,7098,3592,3253,166,5,28,3,0,1,2,2,1,4,7057,41,0
4100,경기도,4104,수원시영통구,,원천동제1투,3139,2223,1125,995,67,1,10,0,0,0,2,3,0,1,2204,19,916
4100,경기도,4104,수원시영통구,,원천동제2투,2870,1739,674,978,42,1,11,0,0,2,3,2,0,1,1714,25,1131
4100,경기도,4104,수원시영통구,,원천동제3투,3857,2092,938,1019,61,1,31,2,0,0,4,5,2,0,2063,29,1765
4100,경기도,4104,수원시영통구,,원천동제4투,1713,1055,462,541,30,0,2,0,0,0,4,0,0,0,1039,16,658
4100,경기도,4104,수원시영통구,,원천동제5투,1775,1268,496,715,39,0,8,0,1,0,1,0,0,0,1260,8,507
4100,경기도,4104,수원시영통구,,원천동제6투,3066,2331,860,1408,41,0,7,0,0,1,3,0,1,0,2321,10,735
4100,경기도,4104,수원시영통구,,원천동제7투,3783,2860,944,1815,65,1,10,1,0,0,3,0,2,0,2841,19,923
4100,경기도,4104,수원시영통구,영통1동,소계,24157,19408,9838,8755,528,7,93,5,1,4,4,8,3,5,19251,157,4749
4100,경기도,4104,수원시영통구,,관내사전투표,7152,7151,3991,2923,167,3,25,2,1,0,1,3,1,1,7118,33,1
4100,경기도,4104,수원시영통구,,영통1동제1투,2501,1622,846,691,46,0,12,1,0,1,1,0,0,0,1598,24,879
4100,경기도,4104,수원시영통구,,영통1동제2투,3243,2221,1044,1039,79,2,19,2,0,1,1,0,1,0,2188,33,1022
4100,경기도,4104,수원시영통구,,영통1동제3투,2569,1889,850,959,57,1,9,0,0,1,0,1,0,0,1878,11,680
4100,경기도,4104,수원시영통구,,영통1동제4투,2879,2260,1165,1011,58,0,7,0,0,0,0,1,1,3,2246,14,619
4100,경기도,4104,수원시영통구,,영통1동제5투,3319,2479,1091,1280,65,1,16,0,0,1,0,1,0,1,2456,23,840
4100,경기도,4104,수원시영통구,,영통1동제6투,2494,1786,851,852,56,0,5,0,0,0,1,2,0,0,1767,19,708
4100,경기도,4104,수원시영통구,영통2동,소계,21173,16757,8298,7740,425,4,71,2,0,1,11,4,6,2,16564,193,4416
4100,경기도,4104,수원시영통구,,관내사전투표,6148,6147,3344,2575,156,0,21,1,0,0,4,2,2,1,6106,41,1
4100,경기도,4104,수원시영통구,,영통2동제1투,2623,1836,872,873,53,2,11,1,0,0,0,1,1,0,1814,22,787
4100,경기도,4104,수원시영통구,,영통2동제2투,3588,2723,1351,1258,70,0,8,0,0,1,2,0,2,1,2693,30,865
4100,경기도,4104,수원시영통구,,영통2동제3투,2872,1984,953,947,48,1,10,0,0,0,1,0,1,0,1961,23,888
4100,경기도,4104,수원시영통구,,영통2동제4투,2149,1200,442,665,31,0,12,0,0,0,2,1,0,0,1153,47,949
4100,경기도,4104,수원시영통구,,영통2동제5투,3793,2867,1336,1422,67,1,9,0,0,0,2,0,0,0,2837,30,926
4100,경기도,4104,수원시영통구,광교1동,소계,37488,30656,13611,15795,879,11,81,3,0,9,4,16,7,3,30419,237,6832
4100,경기도,4104,수원시영통구,,관내사전투표,9398,9398,4649,4476,196,6,23,0,0,1,0,5,1,0,9357,41,0
4100,경기도,4104,수원시영통구,,광교1동제1투,3019,2055,831,1100,81,0,5,0,0,0,1,2,1,0,2021,34,964
4100,경기도,4104,수원시영통구,,광교1동제2투,2658,2099,918,1079,77,1,4,0,0,2,0,1,0,0,2082,17,559
4100,경기도,4104,수원시영통구,,광교1동제3투,2734,1944,787,1064,63,0,8,2,0,1,0,0,0,0,1925,19,790
4100,경기도,4104,수원시영통구,,광교1동제4투,2504,2050,846,1109,76,1,6,1,0,0,0,0,0,0,2039,11,454
4100,경기도,4104,수원시영통구,,광교1동제5투,3388,2712,1099,1508,81,0,6,0,0,0,1,0,2,0,2697,15,676
4100,경기도,4104,수원시영통구,,광교1동제6투,3734,2542,1109,1315,77,0,11,0,0,0,0,1,0,0,2513,29,1192
4100,경기도,4104,수원시영통구,,광교1동제7투,1567,1250,509,689,36,1,3,0,0,0,0,1,0,1,1240,10,317
4100,경기도,4104,수원시영통구,,광교1동제8투,2629,1943,867,966,64,0,10,0,0,0,1,4,1,1,1914,29,686
4100,경기도,4104,수원시영통구,,광교1동제9투,3017,2410,1033,1277,73,1,3,0,0,2,1,0,0,0,2390,20,607
4100,경기도,4104,수원시영통구,,광교1동제10투,2840,2253,963,1212,55,1,2,0,0,3,0,2,2,1,2241,12,587
4100,경기도,4104,수원시영통구,광교2동,소계,20267,16346,7644,8076,404,6,71,3,4,5,13,13,1,5,16245,101,3921
4100,경기도,4104,수원시영통구,,관내사전투표,4752,4752,2401,2211,94,1,11,1,0,1,2,6,1,1,4730,22,0
4100,경기도,4104,수원시영통구,,광교2동제1투,2479,1861,797,997,38,1,11,0,0,1,1,3,0,0,1849,12,618
4100,경기도,4104,수원시영통구,,광교2동제2투,2663,1875,962,823,50,0,12,1,2,1,4,3,0,1,1859,16,788
4100,경기도,4104,수원시영통구,,광교2동제3투,3180,2284,985,1186,72,3,13,0,1,0,1,0,0,0,2261,23,896
4100,경기도,4104,수원시영통구,,광교2동제4투,2651,2104,1067,962,50,0,11,0,1,2,3,1,0,1,2098,6,547
4100,경기도,4104,수원시영통구,,광교2동제5투,2078,1538,795,673,46,1,7,1,0,0,1,0,0,1,1525,13,540
4100,경기도,4104,수원시영통구,,광교2동제6투,2464,1932,637,1224,54,0,6,0,0,0,1,0,0,1,1923,9,532
4100,경기도,4104,수원시영통구,영통3동,소계,24341,19371,9364,9126,534,11,92,3,2,4,11,11,2,0,19160,211,4970
4100,경기도,4104,수원시영통구,,관내사전투표,5914,5904,3101,2578,156,4,10,1,0,0,0,5,2,0,5857,47,10
4100,경기도,4104,수원시영통구,,영통3동제1투,3410,1988,738,1109,61,1,24,0,0,1,1,1,0,0,1936,52,1422
4100,경기도,4104,수원시영통구,,영통3동제2투,3283,2466,958,1414,64,0,7,1,0,1,2,0,0,0,2447,19,817
4100,경기도,4104,수원시영통구,,영통3동제3투,1824,1428,686,663,47,0,8,0,0,0,4,1,0,0,1409,19,396
4100,경기도,4104,수원시영통구,,영통3동제4투,2505,2019,1027,908,48,0,10,0,0,1,1,1,0,0,1996,23,486
4100,경기도,4104,수원시영통구,,영통3동제5투,2650,2097,1076,939,51,2,11,0,2,0,0,0,0,0,2081,16,553
4100,경기도,4104,수원시영통구,,영통3동제6투,2079,1512,770,664,44,2,11,1,0,0,2,1,0,0,1495,17,567
4100,경기도,4104,수원시영통구,,영통3동제7투,2676,1957,1008,851,63,2,11,0,0,1,1,2,0,0,1939,18,719
4100,경기도,4104,수원시영통구,망포1동,소계,19740,15367,7511,7225,417,7,68,2,1,3,4,8,0,5,15251,116,4373
4100,경기도,4104,수원시영통구,,관내사전투표,5061,5061,2763,2136,113,0,22,0,1,0,0,3,0,0,5038,23,0
4100,경기도,4104,수원시영통구,,망포1동제1투,2745,2058,878,1090,66,2,6,0,0,0,0,2,0,2,2046,12,687
4100,경기도,4104,수원시영통구,,망포1동제2투,1909,1350,650,648,29,1,6,0,0,2,0,0,0,1,1337,13,559
4100,경기도,4104,수원시영통구,,망포1동제3투,2194,1287,604,620,31,0,10,1,0,0,1,1,0,0,1268,19,907
4100,경기도,4104,수원시영통구,,망포1동제4투,2501,1709,715,914,50,1,10,1,0,1,1,0,0,2,1695,14,792
4100,경기도,4104,수원시영통구,,망포1동제5투,2237,1504,703,739,45,2,4,0,0,0,0,2,0,0,1495,9,733
4100,경기도,4104,수원시영통구,,망포1동제6투,3093,2398,1198,1078,83,1,10,0,0,0,2,0,0,0,2372,26,695
4100,경기도,4104,수원시영통구,망포2동,소계,20289,16889,8627,7633,430,8,63,1,1,0,5,9,2,3,16782,107,3400
4100,경기도,4104,수원시영통구,,관내사전투표,7190,7191,4038,2941,161,3,17,0,0,0,1,3,2,0,7166,25,-1
4100,경기도,4104,수원시영통구,,망포2동제1투,2090,1466,649,736,49,2,11,1,0,0,0,1,0,2,1451,15,624
4100,경기도,4104,수원시영통구,,망포2동제2투,2019,1466,625,773,38,0,9,0,0,0,0,2,0,0,1447,19,553
4100,경기도,4104,수원시영통구,,망포2동제3투,3012,2410,1196,1121,68,1,6,0,0,0,1,2,0,0,2395,15,602
4100,경기도,4104,수원시영통구,,망포2동제4투,3973,2974,1430,1436,73,1,10,0,0,0,3,1,0,0,2954,20,999
4100,경기도,4104,수원시영통구,,망포2동제5투,2005,1382,689,626,41,1,10,0,1,0,0,0,0,1,1369,13,623
4100,경기도,4104,수원시영통구,잘못 투입·구분된 투표지,,0,3,1,2,0,0,0,0,0,0,0,0,0,0,3,0,-3
4100,경기도,4105,성남시수정구,합계,,207998,161006,86224,68806,3128,57,904,22,19,38,109,318,19,66,159710,1296,46992
4100,경기도,4105,성남시수정구,거소·선상투표,,312,273,146,104,2,0,1,0,0,0,1,1,0,1,256,17,39
4100,경기도,4105,성남시수정구,관외사전투표,,22462,22459,12010,9547,471,11,141,4,2,8,7,64,0,10,22275,184,3
4100,경기도,4105,성남시수정구,재외투표,,1184,891,492,294,21,0,5,0,0,0,0,0,0,0,812,79,293
4100,경기도,4105,성남시수정구,신흥1동,소계,11750,8098,4880,2923,154,2,47,0,2,2,5,21,1,4,8041,57,3652
4100,경기도,4105,성남시수정구,,관내사전투표,3840,3839,2482,1247,64,2,9,0,1,2,2,10,1,2,3822,17,1
4100,경기도,4105,성남시수정구,,신흥1동제1투,2298,1189,693,453,24,0,5,0,0,0,1,3,0,0,1179,10,1109
4100,경기도,4105,성남시수정구,,신흥1동제2투,1786,938,537,357,17,0,10,0,1,0,0,4,0,2,928,10,848
4100,경기도,4105,성남시수정구,,신흥1동제3투,1801,983,548,383,27,0,16,0,0,0,0,1,0,0,975,8,818
4100,경기도,4105,성남시수정구,,신흥1동제4투,2025,1149,620,483,22,0,7,0,0,0,2,3,0,0,1137,12,876
4100,경기도,4105,성남시수정구,신흥2동,소계,13283,10455,4908,5154,238,3,49,1,1,3,7,12,1,0,10377,78,2828
4100,경기도,4105,성남시수정구,,관내사전투표,3487,3487,1825,1571,55,0,16,0,0,0,1,8,1,0,3477,10,0
4100,경기도,4105,성남시수정구,,신흥2동제1투,1591,908,537,342,22,1,1,0,0,0,0,2,0,0,905,3,683
4100,경기도,4105,성남시수정구,,신흥2동제2투,2659,1796,803,915,42,0,11,0,0,0,3,2,0,0,1776,20,863
4100,경기도,4105,성남시수정구,,신흥2동제3투,2646,2066,838,1144,50,1,11,0,0,3,2,0,0,0,2049,17,580
4100,경기도,4105,성남시수정구,,신흥2동제4투,2900,2198,905,1182,69,1,10,1,1,0,1,0,0,0,2170,28,702
4100,경기도,4105,성남시수정구,신흥3동,소계,10226,7184,4047,2902,113,3,44,1,0,0,7,15,1,3,7136,48,3042
4100,경기도,4105,성남시수정구,,관내사전투표,3816,3818,2203,1521,49,1,13,0,0,0,1,8,0,1,3797,21,-2
4100,경기도,4105,성남시수정구,,신흥3동제1투,2240,1190,672,477,19,0,7,0,0,0,4,3,0,0,1182,8,1050
4100,경기도,4105,성남시수정구,,신흥3동제2투,1714,893,486,362,21,0,10,1,0,0,1,3,0,0,884,9,821
4100,경기도,4105,성남시수정구,,신흥3동제3투,2456,1283,686,542,24,2,14,0,0,0,1,1,1,2,1273,10,1173
4100,경기도,4105,성남시수정구,태평1동,소계,13383,9884,5663,3853,195,3,47,2,0,2,4,20,2,4,9795,89,3499
4100,경기도,4105,성남시수정구,,관내사전투표,4880,4880,2933,1794,99,2,14,1,0,0,0,11,1,0,4855,25,0
4100,경기도,4105,성남시수정구,,태평1동제1투,2347,1347,711,576,27,0,6,1,0,1,1,4,0,3,1330,17,1000
4100,경기도,4105,성남시수정구,,태평1동제2투,2201,1362,723,582,28,1,10,0,0,0,1,1,0,0,1346,16,839
4100,경기도,4105,성남시수정구,,태평1동제3투,1939,1087,599,439,18,0,12,0,0,1,1,1,0,1,1072,15,852
4100,경기도,4105,성남시수정구,,태평1동제4투,2016,1208,697,462,23,0,5,0,0,0,1,3,1,0,1192,16,808
4100,경기도,4105,성남시수정구,태평2동,소계,11674,8086,4720,3052,144,2,62,0,0,2,11,21,1,6,8021,65,3588
4100,경기도,4105,성남시수정구,,관내사전투표,2935,2935,1838,1009,44,1,22,0,0,1,2,9,0,1,2927,8,0
4100,경기도,4105,성남시수정구,,태평2동제1투,1913,997,566,385,19,0,8,0,0,0,0,3,0,1,982,15,916
4100,경기도,4105,성남시수정구,,태평2동제2투,2346,1491,827,600,28,0,12,0,0,0,5,4,0,0,1476,15,855
4100,경기도,4105,성남시수정구,,태평2동제3투,1195,653,392,239,13,0,4,0,0,0,0,0,1,2,651,2,542
4100,경기도,4105,성남시수정구,,태평2동제4투,1661,1000,539,417,16,1,8,0,0,0,3,1,0,1,986,14,661
4100,경기도,4105,성남시수정구,,태평2동제5투,1624,1010,558,402,24,0,8,0,0,1,1,4,0,1,999,11,614
4100,경기도,4105,성남시수정구,태평3동,소계,11464,8430,4894,3227,140,2,62,2,0,1,8,25,4,3,8368,62,3034
4100,경기도,4105,성남시수정구,,관내사전투표,3833,3833,2367,1359,55,1,15,2,0,1,2,9,3,2,3816,17,0
4100,경기도,4105,성남시수정구,,태평3동제1투,1929,1226,652,517,37,0,8,0,0,0,1,3,0,0,1218,8,703
4100,경기도,4105,성남시수정구,,태평3동제2투,1721,998,572,383,14,1,12,0,0,0,0,5,1,0,988,10,723
4100,경기도,4105,성남시수정구,,태평3동제3투,1835,1063,588,419,21,0,15,0,0,0,5,4,0,0,1052,11,772
4100,경기도,4105,성남시수정구,,태평3동제4투,2146,1310,715,549,13,0,12,0,0,0,0,4,0,1,1294,16,836
4100,경기도,4105,성남시수정구,태평4동,소계,9872,6826,3973,2550,133,2,66,0,2,1,2,18,2,3,6752,74,3046
4100,경기도,4105,성남시수정구,,관내사전투표,2986,2986,1811,1055,58,2,20,0,2,0,0,12,1,2,2963,23,0
4100,경기도,4105,성남시수정구,,태평4동제1투,1591,844,466,336,17,0,10,0,0,1,1,1,0,1,833,11,747
4100,경기도,4105,성남시수정구,,태평4동제2투,1992,1036,598,382,20,0,17,0,0,0,1,3,1,0,1022,14,956
4100,경기도,4105,성남시수정구,,태평4동제3투,1516,797,439,329,15,0,3,0,0,0,0,1,0,0,787,10,719
4100,경기도,4105,성남시수정구,,태평4동제4투,1787,1163,659,448,23,0,16,0,0,0,0,1,0,0,1147,16,624
4100,경기도,4105,성남시수정구,수진1동,소계,10446,7073,4155,2635,126,5,46,1,2,3,6,13,4,2,6998,75,3373
4100,경기도,4105,성남시수정구,,관내사전투표,3094,3094,1911,1082,46,3,13,0,0,3,2,9,1,0,3070,24,0
4100,경기도,4105,성남시수정구,,수진1동제1투,1843,910,536,329,22,0,6,0,1,0,0,0,2,1,897,13,933
4100,경기도,4105,성남시수정구,,수진1동제2투,2018,1213,685,477,23,0,10,1,0,0,2,1,1,0,1200,13,805
4100,경기도,4105,성남시수정구,,수진1동제3투,1688,843,470,332,15,0,9,0,1,0,2,2,0,1,832,11,845
4100,경기도,4105,성남시수정구,,수진1동제4투,1803,1013,553,415,20,2,8,0,0,0,0,1,0,0,999,14,790
4100,경기도,4105,성남시수정구,수진2동,소계,12380,9234,5155,3784,144,3,52,1,1,4,5,24,0,2,9175,59,3146
4100,경기도,4105,성남시수정구,,관내사전투표,3583,3583,2200,1292,46,2,9,0,0,2,1,13,0,0,3565,18,0
4100,경기도,4105,성남시수정구,,수진2동제1투,1949,1132,590,498,19,0,9,0,0,0,2,5,0,1,1124,8,817
4100,경기도,4105,성남시수정구,,수진2동제2투,2021,1229,691,499,14,1,13,0,1,0,0,1,0,0,1220,9,792
4100,경기도,4105,성남시수정구,,수진2동제3투,1134,653,361,262,14,0,6,0,0,0,1,2,0,0,646,7,481
4100,경기도,4105,성남시수정구,,수진2동제4투,1475,1000,540,419,21,0,10,0,0,1,0,2,0,1,994,6,475
4100,경기도,4105,성남시수정구,,수진2동제5투,2218,1637,773,814,30,0,5,1,0,1,1,1,0,0,1626,11,581
4100,경기도,4105,성남시수정구,단대동,소계,11161,8386,4565,3512,162,3,44,4,1,1,14,9,0,4,8319,67,2775
4100,경기도,4105,성남시수정구,,관내사전투표,3316,3316,1954,1269,55,0,12,2,0,0,3,5,0,3,3303,13,0
4100,경기도,4105,성남시수정구,,단대동제1투,2160,1338,680,595,35,1,4,0,1,0,5,2,0,0,1323,15,822
4100,경기도,4105,성남시수정구,,단대동제2투,2531,1792,875,859,34,0,8,1,0,0,0,1,0,0,1778,14,739
4100,경기도,4105,성남시수정구,,단대동제3투,1681,1022,574,402,18,1,12,0,0,1,4,1,0,0,1013,9,659
4100,경기도,4105,성남시수정구,,단대동제4투,1473,918,482,387,20,1,8,1,0,0,2,0,0,1,902,16,555
4100,경기도,4105,성남시수정구,산성동,소계,5010,3885,2314,1421,85,2,22,0,0,1,1,11,0,3,3860,25,1125
4100,경기도,4105,성남시수정구,,관내사전투표,2112,2112,1285,752,46,1,10,0,0,1,1,8,0,0,2104,8,0
4100,경기도,4105,성남시수정구,,산성동제1투,2411,1569,928,573,35,0,11,0,0,0,0,2,0,3,1552,17,842
4100,경기도,4105,성남시수정구,,산성동제2투,487,204,101,96,4,1,1,0,0,0,0,1,0,0,204,0,283
4100,경기도,4105,성남시수정구,양지동,소계,8936,6929,4086,2586,126,7,52,1,1,0,5,21,0,2,6887,42,2007
4100,경기도,4105,성남시수정구,,관내사전투표,3676,3676,2271,1293,57,6,16,1,1,0,3,8,0,1,3657,19,0
4100,경기도,4105,성남시수정구,,양지동제1투,2028,1210,686,472,34,1,9,0,0,0,0,1,0,0,1203,7,818
4100,경기도,4105,성남시수정구,,양지동제2투,1849,1169,662,458,17,0,16,0,0,0,0,8,0,1,1162,7,680
4100,경기도,4105,성남시수정구,,양지동제3투,1383,874,467,363,18,0,11,0,0,0,2,4,0,0,865,9,509
4100,경기도,4105,성남시수정구,복정동,소계,8975,6750,3673,2801,173,1,35,2,1,2,6,3,0,4,6701,49,2225
4100,경기도,4105,성남시수정구,,관내사전투표,3224,3224,1916,1214,69,1,9,1,1,0,1,1,0,2,3215,9,0
4100,경기도,4105,성남시수정구,,복정동제1투,1662,1004,479,477,29,0,4,0,0,0,1,1,0,1,992,12,658
4100,경기도,4105,성남시수정구,,복정동제2투,2106,1250,639,550,32,0,13,1,0,1,3,0,0,0,1239,11,856
4100,경기도,4105,성남시수정구,,복정동제3투,1983,1272,639,560,43,0,9,0,0,1,1,1,0,1,1255,17,711
4100,경기도,4105,성남시수정구,신촌동,소계,3253,2481,1111,1274,48,0,17,0,2,1,0,2,0,0,2455,26,772
4100,경기도,4105,성남시수정구,,관내사전투표,1201,1201,572,602,14,0,3,0,0,0,0,2,0,0,1193,8,0
4100,경기도,4105,성남시수정구,,신촌동투표소,2052,1280,539,672,34,0,14,0,2,1,0,0,0,0,1262,18,772
4100,경기도,4105,성남시수정구,고등동,소계,7795,6392,3026,3130,126,2,36,0,0,2,2,11,2,2,6339,53,1403
4100,경기도,4105,성남시수정구,,관내사전투표,2569,2569,1316,1177,38,0,14,0,0,0,0,10,0,2,2557,12,0
4100,경기도,4105,성남시수정구,,고등동제1투,2450,1803,904,818,38,2,16,0,0,0,0,1,2,0,1781,22,647
4100,경기도,4105,성남시수정구,,고등동제2투,2776,2020,806,1135,50,0,6,0,0,2,2,0,0,0,2001,19,756
4100,경기도,4105,성남시수정구,시흥동,소계,2500,1927,757,1113,33,0,8,0,0,0,2,5,0,1,1919,8,573
4100,경기도,4105,성남시수정구,,관내사전투표,976,976,440,506,15,0,5,0,0,0,1,5,0,1,973,3,0
4100,경기도,4105,성남시수정구,,시흥동투표소,1524,951,317,607,18,0,3,0,0,0,1,0,0,0,946,5,573
4100,경기도,4105,성남시수정구,위례동,소계,31932,25361,11648,12944,493,6,68,3,4,5,16,22,1,12,25222,139,6571
4100,경기도,4105,성남시수정구,,관내사전투표,9265,9266,4662,4397,139,2,16,0,0,2,1,11,0,1,9231,35,-1
4100,경기도,4105,성남시수정구,,위례동제1투,2235,1681,597,1038,33,0,2,1,0,0,5,1,0,0,1677,4,554
4100,경기도,4105,성남시수정구,,위례동제2투,2764,2159,788,1312,43,1,5,0,1,0,1,0,0,0,2151,8,605
4100,경기도,4105,성남시수정구,,위례동제3투,3026,2259,1023,1159,62,0,4,0,0,0,3,0,0,0,2251,8,767
4100,경기도,4105,성남시수정구,,위례동제4투,1833,1126,499,587,26,0,5,0,0,0,0,0,0,1,1118,8,707
4100,경기도,4105,성남시수정구,,위례동제5투,2410,1750,674,1014,44,0,8,1,0,0,0,0,0,0,1741,9,660
4100,경기도,4105,성남시수정구,,위례동제6투,1462,969,538,385,24,0,5,1,0,0,2,4,0,2,961,8,493
4100,경기도,4105,성남시수정구,,위례동제7투,2059,1413,659,691,37,0,6,0,1,1,0,1,1,0,1397,16,646
4100,경기도,4105,성남시수정구,,위례동제8투,3344,2210,1304,819,31,3,10,0,2,2,4,5,0,8,2188,22,1134
4100,경기도,4105,성남시수정구,,위례동제9투,1821,1372,494,829,30,0,4,0,0,0,0,0,0,0,1357,15,449
4100,경기도,4105,성남시수정구,,위례동제10투,1713,1156,410,713,24,0,3,0,0,0,0,0,0,0,1150,6,557
4100,경기도,4105,성남시수정구,잘못 투입·구분된 투표지,,0,2,1,0,1,0,0,0,0,0,0,0,0,0,2,0,-2
4100,경기도,4106,성남시중원구,합계,,186278,142368,80857,56072,2799,65,861,28,15,25,94,322,38,69,141245,1123,43910
4100,경기도,4106,성남시중원구,거소·선상투표,,351,312,156,112,4,0,5,0,0,0,1,0,0,0,278,34,39
4100,경기도,4106,성남시중원구,관외사전투표,,21259,21249,12206,8148,483,10,151,7,2,3,8,66,8,9,21101,148,10
4100,경기도,4106,성남시중원구,재외투표,,739,547,349,139,15,0,3,0,0,0,0,0,0,0,506,41,192
4100,경기도,4106,성남시중원구,성남동,소계,26681,18868,10502,7653,364,6,98,4,2,2,16,36,4,11,18698,170,7813
4100,경기도,4106,성남시중원구,,관내사전투표,6126,6126,3738,2224,95,4,14,1,0,1,3,11,1,4,6096,30,0
4100,경기도,4106,성남시중원구,,성남동제1투,2700,1504,802,643,26,0,11,0,0,0,3,3,1,0,1489,15,1196
4100,경기도,4106,성남시중원구,,성남동제2투,2978,1936,1083,769,44,1,10,0,0,1,0,8,0,1,1917,19,1042
4100,경기도,4106,성남시중원구,,성남동제3투,2519,1754,865,826,40,0,8,0,0,0,1,2,1,2,1745,9,765
4100,경기도,4106,성남시중원구,,성남동제4투,2612,1642,893,684,32,0,13,1,1,0,1,2,0,2,1629,13,970
4100,경기도,4106,성남시중원구,,성남동제5투,3212,2087,1112,874,40,1,18,2,0,0,4,3,1,0,2055,32,1125
4100,경기도,4106,성남시중원구,,성남동제6투,3258,2010,1067,858,42,0,15,0,1,0,3,2,0,1,1989,21,1248
4100,경기도,4106,성남시중원구,,성남동제7투,3276,1809,942,775,45,0,9,0,0,0,1,5,0,1,1778,31,1467
4100,경기도,4106,성남시중원구,중앙동,소계,9613,7057,3919,2905,115,3,34,0,3,1,8,15,3,5,7011,46,2556
4100,경기도,4106,성남시중원구,,관내사전투표,3158,3158,1863,1216,39,2,11,0,0,1,1,8,2,3,3146,12,0
4100,경기도,4106,성남시중원구,,중앙동제1투,2208,1300,642,605,24,0,10,0,0,0,2,0,0,2,1285,15,908
4100,경기도,4106,성남시중원구,,중앙동제2투,1819,1032,592,394,22,1,7,0,3,0,2,5,0,0,1026,6,787
4100,경기도,4106,성남시중원구,,중앙동제3투,518,85,50,33,1,0,0,0,0,0,0,1,0,0,85,0,433
4100,경기도,4106,성남시중원구,,중앙동제4투,1910,1482,772,657,29,0,6,0,0,0,3,1,1,0,1469,13,428
4100,경기도,4106,성남시중원구,금광1동,소계,5743,4145,2383,1611,81,5,23,0,2,0,1,12,2,2,4122,23,1598
4100,경기도,4106,성남시중원구,,관내사전투표,1857,1857,1136,668,33,2,6,0,1,0,0,5,1,0,1852,5,0
4100,경기도,4106,성남시중원구,,금광1동제1투,1249,533,259,246,10,2,3,0,1,0,0,0,0,0,521,12,716
4100,경기도,4106,성남시중원구,,금광1동제2투,1298,794,463,297,18,0,5,0,0,0,1,4,1,1,790,4,504
4100,경기도,4106,성남시중원구,,금광1동제3투,1339,961,525,400,20,1,9,0,0,0,0,3,0,1,959,2,378
4100,경기도,4106,성남시중원구,금광2동,소계,19042,13592,7505,5583,278,7,70,1,1,1,7,39,3,5,13500,92,5450
4100,경기도,4106,성남시중원구,,관내사전투표,5571,5571,3334,2073,87,2,25,1,1,1,1,22,2,3,5552,19,0
4100,경기도,4106,성남시중원구,,금광2동제1투,2079,1170,628,484,21,1,7,0,0,0,1,8,0,0,1150,20,909
4100,경기도,4106,성남시중원구,,금광2동제2투,2281,1144,596,496,22,0,11,0,0,0,2,1,1,1,1130,14,1137
4100,경기도,4106,성남시중원구,,금광2동제3투,1711,1015,579,398,17,3,9,0,0,0,0,2,0,0,1008,7,696
4100,경기도,4106,성남시중원구,,금광2동제4투,1847,1093,579,462,29,1,9,0,0,0,1,1,0,1,1083,10,754
4100,경기도,4106,성남시중원구,,금광2동제5투,2585,1345,693,600,30,0,5,0,0,0,2,2,0,0,1332,13,1240
4100,경기도,4106,성남시중원구,,금광2동제6투,2968,2254,1096,1070,72,0,4,0,0,0,0,3,0,0,2245,9,714
4100,경기도,4106,성남시중원구,은행1동,소계,8141,6158,3643,2228,145,6,44,4,1,2,7,18,0,2,6100,58,1983
4100,경기도,4106,성남시중원구,,관내사전투표,2969,2969,1880,981,57,3,16,2,0,0,0,8,0,0,2947,22,0
4100,경기도,4106,성남시중원구,,은행1동제1투,1494,823,494,288,16,2,7,1,1,0,3,3,0,1,816,7,671
4100,경기도,4106,성남시중원구,,은행1동제2투,1798,974,580,337,25,0,12,0,0,0,2,2,0,1,959,15,824
4100,경기도,4106,성남시중원구,,은행1동제3투,1880,1392,689,622,47,1,9,1,0,2,2,5,0,0,1378,14,488
4100,경기도,4106,성남시중원구,은행2동,소계,18476,13566,7863,5175,258,2,97,6,3,5,11,29,4,9,13462,104,4910
4100,경기도,4106,성남시중원구,,관내사전투표,5390,5389,3343,1898,73,0,24,1,2,2,4,13,0,5,5365,24,1
4100,경기도,4106,성남시중원구,,은행2동제1투,1775,954,548,356,19,0,16,0,0,0,2,3,0,0,944,10,821
4100,경기도,4106,성남시중원구,,은행2동제2투,1300,833,501,285,22,0,5,1,0,0,1,2,1,2,820,13,467
4100,경기도,4106,성남시중원구,,은행2동제3투,1658,1083,595,444,24,0,9,0,0,0,1,2,1,1,1077,6,575
4100,경기도,4106,성남시중원구,,은행2동제4투,1452,857,504,304,20,1,10,3,0,0,1,3,0,0,846,11,595
4100,경기도,4106,성남시중원구,,은행2동제5투,1859,1103,617,426,31,1,9,0,1,1,1,3,1,0,1091,12,756
4100,경기도,4106,성남시중원구,,은행2동제6투,2585,1834,921,837,42,0,10,0,0,2,1,2,0,1,1816,18,751
4100,경기도,4106,성남시중원구,,은행2동제7투,2457,1513,834,625,27,0,14,1,0,0,0,1,1,0,1503,10,944
4100,경기도,4106,성남시중원구,상대원1동,소계,19208,13600,7951,5134,253,8,97,1,0,1,6,22,4,7,13484,116,5608
4100,경기도,4106,성남시중원구,,관내사전투표,4586,4586,2823,1634,61,5,25,0,0,0,2,9,1,1,4561,25,0
4100,경기도,4106,성남시중원구,,상대원1동제1투,2897,1523,862,590,36,0,13,0,0,0,0,3,0,0,1504,19,1374
4100,경기도,4106,성남시중원구,,상대원1동제2투,2870,1568,938,569,26,0,15,0,0,0,2,3,1,2,1556,12,1302
4100,경기도,4106,성남시중원구,,상대원1동제3투,1642,929,518,365,27,1,5,0,0,0,0,1,0,1,918,11,713
4100,경기도,4106,성남시중원구,,상대원1동제4투,1717,1301,735,511,34,1,4,0,0,0,0,2,0,0,1287,14,416
4100,경기도,4106,성남시중원구,,상대원1동제5투,2025,1461,847,563,24,0,9,0,0,1,1,0,1,1,1447,14,564
4100,경기도,4106,성남시중원구,,상대원1동제6투,1203,773,399,338,15,0,10,0,0,0,0,1,0,0,763,10,430
4100,경기도,4106,성남시중원구,,상대원1동제7투,2268,1459,829,564,30,1,16,1,0,0,1,3,1,2,1448,11,809
4100,경기도,4106,성남시중원구,상대원2동,소계,11013,7634,4443,2897,123,7,51,0,0,4,9,25,3,3,7565,69,3379
4100,경기도,4106,성남시중원구,,관내사전투표,3829,3829,2274,1421,70,4,18,0,0,2,0,16,2,3,3810,19,0
4100,경기도,4106,성남시중원구,,상대원2동제1투,2706,1332,769,505,12,0,12,0,0,2,4,5,1,0,1310,22,1374
4100,경기도,4106,성남시중원구,,상대원2동제2투,1656,953,516,401,12,1,9,0,0,0,2,0,0,0,941,12,703
4100,경기도,4106,성남시중원구,,상대원2동제3투,2822,1520,884,570,29,2,12,0,0,0,3,4,0,0,1504,16,1302
4100,경기도,4106,성남시중원구,상대원3동,소계,10788,7635,4566,2810,113,3,59,0,0,3,8,18,4,4,7588,47,3153
4100,경기도,4106,성남시중원구,,관내사전투표,3901,3901,2428,1354,50,1,26,0,0,1,0,15,3,4,3882,19,0
4100,경기도,4106,성남시중원구,,상대원3동제1투,2474,1304,762,506,18,1,8,0,0,0,2,1,0,0,1298,6,1170
4100,경기도,4106,성남시중원구,,상대원3동제2투,1911,1035,585,402,25,0,14,0,0,1,1,1,0,0,1029,6,876
4100,경기도,4106,성남시중원구,,상대원3동제3투,2502,1395,791,548,20,1,11,0,0,1,5,1,1,0,1379,16,1107
4100,경기도,4106,성남시중원구,하대원동,소계,16303,12863,7098,5320,249,5,59,1,1,1,5,25,1,7,12772,91,3440
4100,경기도,4106,성남시중원구,,관내사전투표,5560,5560,3225,2182,93,2,18,0,1,0,1,10,0,4,5536,24,0
4100,경기도,4106,성남시중원구,,하대원동제1투,1913,1095,605,446,25,1,5,0,0,0,0,2,0,0,1084,11,818
4100,경기도,4106,성남시중원구,,하대원동제2투,1941,1254,708,501,23,0,11,0,0,0,0,3,0,0,1246,8,687
4100,경기도,4106,성남시중원구,,하대원동제3투,2636,1812,940,792,40,0,12,0,0,1,1,7,1,0,1794,18,824
4100,경기도,4106,성남시중원구,,하대원동제4투,2511,1973,984,924,37,2,6,0,0,0,0,3,0,2,1958,15,538
4100,경기도,4106,성남시중원구,,하대원동제5투,1742,1169,636,475,31,0,7,1,0,0,3,0,0,1,1154,15,573
4100,경기도,4106,성남시중원구,도촌동,소계,18921,15138,8270,6356,318,3,70,4,0,2,7,17,2,5,15054,84,3783
4100,경기도,4106,성남시중원구,,관내사전투표,4927,4927,3020,1789,77,0,12,1,0,0,0,9,1,1,4910,17,0
4100,경기도,4106,성남시중원구,,도촌동제1투,1740,1211,563,604,28,0,9,1,0,0,1,1,0,1,1208,3,529
4100,경기도,4106,성남시중원구,,도촌동제2투,2687,1920,981,872,46,1,10,0,0,0,1,1,0,1,1913,7,767
4100,경기도,4106,성남시중원구,,도촌동제3투,2514,1683,876,738,40,1,9,0,0,0,2,2,0,0,1668,15,831
4100,경기도,4106,성남시중원구,,도촌동제4투,3144,2381,1230,1044,61,0,13,2,0,1,1,1,1,1,2355,26,763
4100,경기도,4106,성남시중원구,,도촌동제5투,2553,1997,997,930,48,1,10,0,0,1,2,2,0,0,1991,6,556
4100,경기도,4106,성남시중원구,,도촌동제6투,1356,1019,603,379,18,0,7,0,0,0,0,1,0,1,1009,10,337
4100,경기도,4106,성남시중원구,잘못 투입·구분된 투표지,,0,4,3,1,0,0,0,0,0,0,0,0,0,0,4,0,-4
4100,경기도,4107,성남시분당구,합계,,404493,335434,140966,183094,7005,105,1007,45,31,82,229,198,42,81,332885,2549,69059
4100,경기도,4107,성남시분당구,거소·선상투표,,586,552,224,239,10,2,4,0,0,1,1,1,1,2,485,67,34
4100,경기도,4107,성남시분당구,관외사전투표,,33494,33487,15227,17068,721,17,148,7,3,6,10,25,5,13,33250,237,7
4100,경기도,4107,성남시분당구,재외투표,,5210,3836,1760,1655,101,1,6,1,0,0,6,1,0,0,3531,305,1374
4100,경기도,4107,성남시분당구,분당동,소계,17687,13868,5835,7568,311,5,47,4,0,4,3,9,1,5,13792,76,3819
4100,경기도,4107,성남시분당구,,관내사전투표,4311,4310,2077,2138,72,1,10,2,0,2,0,1,0,1,4304,6,1
4100,경기도,4107,성남시분당구,,분당동제1투,2239,1600,571,963,49,1,4,0,0,0,1,0,0,1,1590,10,639
4100,경기도,4107,성남시분당구,,분당동제2투,2040,1575,594,924,40,1,6,0,0,0,0,4,0,1,1570,5,465
4100,경기도,4107,성남시분당구,,분당동제3투,2098,1537,486,1012,28,0,3,0,0,1,0,0,0,0,1530,7,561
4100,경기도,4107,성남시분당구,,분당동제4투,2249,1461,687,700,46,0,8,0,0,0,0,2,1,1,1445,16,788
4100,경기도,4107,성남시분당구,,분당동제5투,2367,1775,714,999,36,0,7,2,0,1,1,0,0,1,1761,14,592
4100,경기도,4107,성남시분당구,,분당동제6투,2383,1610,706,832,40,2,9,0,0,0,1,2,0,0,1592,18,773
4100,경기도,4107,성남시분당구,수내1동,소계,14092,11481,4335,6792,212,4,26,0,1,4,5,1,0,2,11382,99,2611
4100,경기도,4107,성남시분당구,,관내사전투표,4769,4770,2153,2505,82,0,10,0,1,0,1,0,0,1,4753,17,-1
4100,경기도,4107,성남시분당구,,수내1동제1투,1788,1274,348,884,15,0,3,0,0,1,3,0,0,0,1254,20,514
4100,경기도,4107,성남시분당구,,수내1동제2투,1616,1261,373,852,19,0,5,0,0,0,0,0,0,0,1249,12,355
4100,경기도,4107,성남시분당구,,수내1동제3투,2833,1857,723,1063,47,0,2,0,0,2,1,1,0,0,1839,18,976
4100,경기도,4107,성남시분당구,,수내1동제4투,1246,903,310,555,17,1,5,0,0,1,0,0,0,0,889,14,343
4100,경기도,4107,성남시분당구,,수내1동제5투,1840,1416,428,933,32,3,1,0,0,0,0,0,0,1,1398,18,424
4100,경기도,4107,성남시분당구,수내2동,소계,7559,6477,2387,3918,125,0,12,1,0,1,1,2,0,2,6449,28,1082
4100,경기도,4107,성남시분당구,,관내사전투표,3024,3024,1345,1600,61,0,3,1,0,1,1,0,0,0,3012,12,0
4100,경기도,4107,성남시분당구,,수내2동제1투,1543,1119,335,756,18,0,4,0,0,0,0,1,0,0,1114,5,424
4100,경기도,4107,성남시분당구,,수내2동제2투,1914,1520,451,1027,29,0,5,0,0,0,0,0,0,1,1513,7,394
4100,경기도,4107,성남시분당구,,수내2동제3투,1078,814,256,535,17,0,0,0,0,0,0,1,0,1,810,4,264
4100,경기도,4107,성남시분당구,수내3동,소계,10055,8151,3610,4272,176,0,28,3,0,1,8,6,0,2,8106,45,1904
4100,경기도,4107,성남시분당구,,관내사전투표,3708,3708,1951,1667,70,0,6,1,0,0,0,3,0,0,3698,10,0
4100,경기도,4107,성남시분당구,,수내3동제1투,1999,1475,534,890,38,0,2,0,0,0,2,1,0,0,1467,8,524
4100,경기도,4107,성남시분당구,,수내3동제2투,2009,1565,493,1031,23,0,4,1,0,1,1,0,0,1,1555,10,444
4100,경기도,4107,성남시분당구,,수내3동제3투,2339,1403,632,684,45,0,16,1,0,0,5,2,0,1,1386,17,936
4100,경기도,4107,성남시분당구,정자1동,소계,22755,17654,5452,11739,283,5,37,0,3,1,10,5,1,5,17541,113,5101
4100,경기도,4107,성남시분당구,,관내사전투표,5868,5868,2265,3475,81,3,8,0,0,0,1,3,1,2,5839,29,0
4100,경기도,4107,성남시분당구,,정자1동제1투,2286,1775,509,1229,25,0,2,0,0,0,2,0,0,2,1769,6,511
4100,경기도,4107,성남시분당구,,정자1동제2투,2083,1481,468,960,34,0,2,0,1,1,1,0,0,1,1468,13,602
4100,경기도,4107,성남시분당구,,정자1동제3투,3594,2107,754,1257,61,1,7,0,0,0,3,0,0,0,2083,24,1487
4100,경기도,4107,성남시분당구,,정자1동제4투,1999,1513,326,1144,25,0,9,0,0,0,1,1,0,0,1506,7,486
4100,경기도,4107,성남시분당구,,정자1동제5투,2089,1454,427,979,27,1,6,0,1,0,0,0,0,0,1441,13,635
4100,경기도,4107,성남시분당구,,정자1동제6투,2932,1973,372,1571,16,0,2,0,0,0,0,1,0,0,1962,11,959
4100,경기도,4107,성남시분당구,,정자1동제7투,1904,1483,331,1124,14,0,1,0,1,0,2,0,0,0,1473,10,421
4100,경기도,4107,성남시분당구,정자2동,소계,13668,11143,5091,5641,246,5,47,3,1,1,10,7,3,7,11062,81,2525
4100,경기도,4107,성남시분당구,,관내사전투표,5159,5158,2603,2406,98,0,13,1,0,1,0,6,0,2,5130,28,1
4100,경기도,4107,성남시분당구,,정자2동제1투,1062,680,267,386,17,1,3,0,0,0,0,0,0,0,674,6,382
4100,경기도,4107,성남시분당구,,정자2동제2투,1543,1090,473,559,32,0,5,1,0,0,3,0,0,0,1073,17,453
4100,경기도,4107,성남시분당구,,정자2동제3투,1554,921,501,373,16,3,12,0,1,0,2,0,2,4,914,7,633
4100,경기도,4107,성남시분당구,,정자2동제4투,1301,950,397,519,19,0,6,0,0,0,2,1,1,0,945,5,351
4100,경기도,4107,성남시분당구,,정자2동제5투,1453,1158,469,643,32,0,4,0,0,0,0,0,0,1,1149,9,295
4100,경기도,4107,성남시분당구,,정자2동제6투,1596,1186,381,755,32,1,4,1,0,0,3,0,0,0,1177,9,410
4100,경기도,4107,성남시분당구,정자3동,소계,12242,10062,4387,5324,243,6,24,0,0,3,8,7,0,3,10005,57,2180
4100,경기도,4107,성남시분당구,,관내사전투표,4189,4189,2059,2031,77,1,7,0,0,0,2,3,0,1,4181,8,0
4100,경기도,4107,성남시분당구,,정자3동제1투,3329,2436,958,1382,71,1,6,0,0,1,3,1,0,1,2424,12,893
4100,경기도,4107,성남시분당구,,정자3동제2투,2019,1404,659,677,40,0,8,0,0,0,2,2,0,1,1389,15,615
4100,경기도,4107,성남시분당구,,정자3동제3투,2705,2033,711,1234,55,4,3,0,0,2,1,1,0,0,2011,22,672
4100,경기도,4107,성남시분당구,서현1동,소계,24321,19651,7672,11370,394,5,59,4,3,3,8,11,2,3,19534,117,4670
4100,경기도,4107,성남시분당구,,관내사전투표,7946,7946,3617,4143,131,0,14,1,0,0,1,7,0,0,7914,32,0
4100,경기도,4107,성남시분당구,,서현1동제1투,3896,2328,971,1240,67,1,18,0,1,0,3,0,0,1,2302,26,1568
4100,경기도,4107,성남시분당구,,서현1동제2투,2955,2092,661,1371,41,2,1,1,0,0,0,0,0,0,2077,15,863
4100,경기도,4107,성남시분당구,,서현1동제3투,3044,2347,824,1448,52,2,7,0,0,0,2,1,1,1,2338,9,697
4100,경기도,4107,성남시분당구,,서현1동제4투,1961,1515,470,993,35,0,6,0,0,1,0,0,0,0,1505,10,446
4100,경기도,4107,성남시분당구,,서현1동제5투,3007,2341,737,1532,41,0,7,2,1,2,2,2,0,1,2327,14,666
4100,경기도,4107,성남시분당구,,서현1동제6투,1512,1082,392,643,27,0,6,0,1,0,0,1,1,0,1071,11,430
4100,경기도,4107,성남시분당구,서현2동,소계,14990,12515,5530,6577,242,5,34,2,1,2,12,12,5,2,12424,91,2475
4100,경기도,4107,성남시분당구,,관내사전투표,4927,4927,2508,2309,63,3,11,1,0,1,3,4,1,1,4905,22,0
4100,경기도,4107,성남시분당구,,서현2동제1투,2791,2115,758,1285,46,0,6,1,0,0,3,0,1,1,2101,14,676
4100,경기도,4107,성남시분당구,,서현2동제2투,2473,1954,747,1134,50,1,3,0,1,1,1,5,1,0,1944,10,519
4100,경기도,4107,성남시분당구,,서현2동제3투,2490,1837,825,936,38,1,8,0,0,0,2,2,0,0,1812,25,653
4100,경기도,4107,성남시분당구,,서현2동제4투,2309,1682,692,913,45,0,6,0,0,0,3,1,2,0,1662,20,627
4100,경기도,4107,성남시분당구,이매1동,소계,18456,15356,5912,9008,277,0,38,4,1,2,11,7,3,6,15269,87,3100
4100,경기도,4107,성남시분당구,,관내사전투표,5290,5289,2353,2829,74,0,6,4,0,0,3,1,0,0,5270,19,1
4100,경기도,4107,성남시분당구,,이매1동제1투,2645,1970,612,1297,40,0,4,0,1,0,0,0,2,3,1959,11,675
4100,경기도,4107,성남시분당구,,이매1동제2투,2358,1907,683,1166,36,0,9,0,0,0,1,0,0,1,1896,11,451
4100,경기도,4107,성남시분당구,,이매1동제3투,1858,1482,467,964,38,0,4,0,0,1,2,3,0,0,1479,3,376
4100,경기도,4107,성남시분당구,,이매1동제4투,2032,1545,541,956,29,0,4,0,0,0,1,0,1,1,1533,12,487
4100,경기도,4107,성남시분당구,,이매1동제5투,1844,1487,551,891,26,0,2,0,0,1,0,3,0,0,1474,13,357
4100,경기도,4107,성남시분당구,,이매1동제6투,2429,1676,705,905,34,0,9,0,0,0,4,0,0,1,1658,18,753
4100,경기도,4107,성남시분당구,이매2동,소계,10172,8607,3141,5250,131,0,21,1,2,2,7,2,2,0,8559,48,1565
4100,경기도,4107,성남시분당구,,관내사전투표,3427,3427,1501,1860,40,0,8,1,0,0,1,1,2,0,3414,13,0
4100,경기도,4107,성남시분당구,,이매2동제1투,1907,1435,470,923,27,0,3,0,0,1,2,0,0,0,1426,9,472
4100,경기도,4107,성남시분당구,,이매2동제2투,2316,1745,593,1098,36,0,5,0,0,0,1,1,0,0,1734,11,571
4100,경기도,4107,성남시분당구,,이매2동제3투,2522,2000,577,1369,28,0,5,0,2,1,3,0,0,0,1985,15,522
4100,경기도,4107,성남시분당구,야탑1동,소계,14990,12442,5592,6460,225,5,40,3,2,2,18,7,0,2,12356,86,2548
4100,경기도,4107,성남시분당구,,관내사전투표,5380,5380,2738,2515,80,3,12,3,1,1,0,5,0,0,5358,22,0
4100,경기도,4107,성남시분당구,,야탑1동제1투,1920,1168,438,676,28,0,7,0,0,0,1,2,0,1,1153,15,752
4100,경기도,4107,성남시분당구,,야탑1동제2투,2543,1875,708,1093,42,0,8,0,0,1,5,0,0,1,1858,17,668
4100,경기도,4107,성남시분당구,,야탑1동제3투,1994,1663,689,923,28,0,5,0,0,0,3,0,0,0,1648,15,331
4100,경기도,4107,성남시분당구,,야탑1동제4투,1814,1416,657,703,31,2,6,0,1,0,5,0,0,0,1405,11,398
4100,경기도,4107,성남시분당구,,야탑1동제5투,1339,940,362,550,16,0,2,0,0,0,4,0,0,0,934,6,399
4100,경기도,4107,성남시분당구,야탑2동,소계,12778,10751,4050,6385,204,2,28,0,1,7,8,2,1,2,10690,61,2027
4100,경기도,4107,성남시분당구,,관내사전투표,4073,4073,1849,2131,73,0,6,0,0,0,1,0,0,0,4060,13,0
4100,경기도,4107,성남시분당구,,야탑2동제1투,1977,1433,366,1032,22,0,3,0,0,2,1,0,0,0,1426,7,544
4100,경기도,4107,성남시분당구,,야탑2동제2투,2891,2276,714,1486,44,1,8,0,1,5,2,0,0,0,2261,15,615
4100,경기도,4107,성남시분당구,,야탑2동제3투,2233,1736,671,1003,40,1,5,0,0,0,2,1,0,1,1724,12,497
4100,경기도,4107,성남시분당구,,야탑2동제4투,1604,1233,450,733,25,0,6,0,0,0,2,1,1,1,1219,14,371
4100,경기도,4107,성남시분당구,야탑3동,소계,20502,16025,7946,7466,371,7,62,1,2,3,17,23,3,6,15907,118,4477
4100,경기도,4107,성남시분당구,,관내사전투표,5361,5356,2947,2255,93,3,17,1,0,2,4,7,2,3,5334,22,5
4100,경기도,4107,성남시분당구,,야탑3동제1투,2801,1779,815,867,43,0,5,0,0,0,2,8,1,2,1743,36,1022
4100,경기도,4107,성남시분당구,,야탑3동제2투,2259,1623,715,851,32,0,10,0,0,0,3,0,0,0,1611,12,636
4100,경기도,4107,성남시분당구,,야탑3동제3투,2468,1874,836,954,63,0,10,0,0,0,2,2,0,0,1867,7,594
4100,경기도,4107,성남시분당구,,야탑3동제4투,1720,992,503,436,21,3,9,0,0,0,2,5,0,0,979,13,728
4100,경기도,4107,성남시분당구,,야탑3동제5투,1601,1221,591,580,36,0,4,0,0,0,0,1,0,0,1212,9,380
4100,경기도,4107,성남시분당구,,야탑3동제6투,2026,1515,693,773,33,0,2,0,2,1,3,0,0,1,1508,7,511
4100,경기도,4107,성남시분당구,,야탑3동제7투,2266,1665,846,750,50,1,5,0,0,0,1,0,0,0,1653,12,601
4100,경기도,4107,성남시분당구,금곡동,소계,20700,16433,6603,9242,356,2,56,2,1,10,16,11,2,2,16303,130,4267
4100,경기도,4107,성남시분당구,,관내사전투표,5158,5155,2507,2503,92,0,16,1,0,1,3,3,1,0,5127,28,3
4100,경기도,4107,성남시분당구,,금곡동제1투,2168,1571,604,897,44,2,6,0,0,1,1,1,0,0,1556,15,597
4100,경기도,4107,성남시분당구,,금곡동제2투,2359,1916,738,1112,47,0,5,0,0,0,2,0,0,0,1904,12,443
4100,경기도,4107,성남시분당구,,금곡동제3투,1639,1054,507,500,21,0,7,1,0,2,3,0,0,1,1042,12,585
4100,경기도,4107,성남시분당구,,금곡동제4투,2583,1912,583,1247,56,0,6,0,0,0,2,3,0,0,1897,15,671
4100,경기도,4107,성남시분당구,,금곡동제5투,1381,1046,386,602,32,0,1,0,1,0,0,3,0,0,1025,21,335
4100,경기도,4107,성남시분당구,,금곡동제6투,3192,2227,819,1335,38,0,10,0,0,3,2,1,0,1,2209,18,965
4100,경기도,4107,성남시분당구,,금곡동제7투,2220,1552,459,1046,26,0,5,0,0,3,3,0,1,0,1543,9,668
4100,경기도,4107,성남시분당구,구미동,소계,22432,17853,7366,9881,372,5,57,1,2,7,22,14,0,6,17733,120,4579
4100,경기도,4107,성남시분당구,,관내사전투표,5619,5619,2609,2876,106,0,9,1,0,0,1,2,0,0,5604,15,0
4100,경기도,4107,성남시분당구,,구미동제1투,1737,1313,539,713,32,0,8,0,0,2,7,1,0,1,1303,10,424
4100,경기도,4107,성남시분당구,,구미동제2투,2211,1712,759,881,44,1,6,0,0,1,3,3,0,1,1699,13,499
4100,경기도,4107,성남시분당구,,구미동제3투,1309,1061,433,593,21,0,4,0,0,0,0,1,0,1,1053,8,248
4100,경기도,4107,성남시분당구,,구미동제4투,2036,1267,295,940,19,0,3,0,0,1,0,0,0,0,1258,9,769
4100,경기도,4107,성남시분당구,,구미동제5투,2286,1756,668,1030,41,1,4,0,1,0,0,1,0,0,1746,10,530
4100,경기도,4107,성남시분당구,,구미동제6투,1848,1365,426,881,28,1,3,0,0,0,4,0,0,1,1344,21,483
4100,경기도,4107,성남시분당구,,구미동제7투,3040,2107,823,1190,49,2,10,0,1,1,5,3,0,0,2084,23,933
4100,경기도,4107,성남시분당구,,구미동제8투,2346,1653,814,777,32,0,10,0,0,2,2,3,0,2,1642,11,693
4100,경기도,4107,성남시분당구,구미1동,소계,15600,13117,5861,6810,286,2,34,1,1,4,8,5,3,3,13018,99,2483
4100,경기도,4107,성남시분당구,,관내사전투표,7038,7038,3571,3273,136,1,7,1,0,1,1,4,2,1,6998,40,0
4100,경기도,4107,성남시분당구,,구미1동제1투,2844,1707,665,953,45,0,13,0,0,3,6,0,1,0,1686,21,1137
4100,경기도,4107,성남시분당구,,구미1동제2투,2809,2104,814,1201,57,1,11,0,0,0,1,1,0,0,2086,18,705
4100,경기도,4107,성남시분당구,,구미1동제3투,1294,995,312,641,27,0,1,0,1,0,0,0,0,2,984,11,299
4100,경기도,4107,성남시분당구,,구미1동제4투,1615,1273,499,742,21,0,2,0,0,0,0,0,0,0,1264,9,342
4100,경기도,4107,성남시분당구,판교동,소계,18313,15412,6540,8391,357,3,25,1,0,4,6,4,4,5,15340,72,2901
4100,경기도,4107,성남시분당구,,관내사전투표,5936,5935,2945,2850,114,1,4,0,0,0,1,3,0,3,5921,14,1
4100,경기도,4107,성남시분당구,,판교동제1투,2241,1610,650,903,36,1,7,1,0,0,2,0,0,1,1601,9,631
4100,경기도,4107,성남시분당구,,판교동제2투,2780,2207,836,1300,56,1,3,0,0,0,0,0,1,0,2197,10,573
4100,경기도,4107,성남시분당구,,판교동제3투,2673,1953,634,1253,52,0,4,0,0,1,2,1,1,0,1948,5,720
4100,경기도,4107,성남시분당구,,판교동제4투,2677,2024,841,1088,66,0,6,0,0,3,1,0,0,1,2006,18,653
4100,경기도,4107,성남시분당구,,판교동제5투,2006,1683,634,997,33,0,1,0,0,0,0,0,2,0,1667,16,323
4100,경기도,4107,성남시분당구,삼평동,소계,17619,14498,6668,7300,356,11,41,2,2,3,12,14,1,1,14411,87,3121
4100,경기도,4107,성남시분당구,,관내사전투표,5720,5719,3026,2525,132,3,10,0,1,0,1,5,1,0,5704,15,1
4100,경기도,4107,성남시분당구,,삼평동제1투,2779,2044,843,1108,59,1,5,0,0,2,2,3,0,0,2023,21,735
4100,경기도,4107,성남시분당구,,삼평동제2투,2153,1566,612,893,37,4,3,0,0,0,6,0,0,0,1555,11,587
4100,경기도,4107,성남시분당구,,삼평동제3투,2693,1871,1028,757,39,2,19,1,1,0,2,6,0,1,1856,15,822
4100,경기도,4107,성남시분당구,,삼평동제4투,1857,1305,470,769,48,1,2,0,0,0,1,0,0,0,1291,14,552
4100,경기도,4107,성남시분당구,,삼평동제5투,2417,1993,689,1248,41,0,2,1,0,1,0,0,0,0,1982,11,424
4100,경기도,4107,성남시분당구,백현동,소계,19978,16375,7491,8336,355,3,54,2,2,3,5,6,2,1,16260,115,3603
4100,경기도,4107,성남시분당구,,관내사전투표,5771,5771,2984,2652,97,2,9,1,1,0,0,1,0,1,5748,23,0
4100,경기도,4107,성남시분당구,,백현동제1투,2954,2299,804,1412,54,0,3,0,0,1,0,0,0,0,2274,25,655
4100,경기도,4107,성남시분당구,,백현동제2투,2738,2033,798,1154,54,1,4,0,0,0,0,0,1,0,2012,21,705
4100,경기도,4107,성남시분당구,,백현동제3투,1991,1492,572,850,51,0,6,0,0,1,0,0,0,0,1480,12,499
4100,경기도,4107,성남시분당구,,백현동제4투,2491,1735,998,662,34,0,20,0,1,0,3,1,0,0,1719,16,756
4100,경기도,4107,성남시분당구,,백현동제5투,2280,1637,976,601,37,0,6,1,0,1,1,4,1,0,1628,9,643
4100,경기도,4107,성남시분당구,,백현동제6투,1753,1408,359,1005,28,0,6,0,0,0,1,0,0,0,1399,9,345
4100,경기도,4107,성남시분당구,운중동,소계,22559,18776,7936,10273,386,3,38,2,3,3,9,10,1,0,18664,112,3783
4100,경기도,4107,성남시분당구,,관내사전투표,5962,5962,2962,2872,107,0,6,2,0,0,1,1,0,0,5951,11,0
4100,경기도,4107,성남시분당구,,운중동제1투,1540,1064,352,677,23,0,2,0,0,1,3,1,0,0,1059,5,476
4100,경기도,4107,성남시분당구,,운중동제2투,1879,1417,505,846,38,1,6,0,0,0,1,2,0,0,1399,18,462
4100,경기도,4107,성남시분당구,,운중동제3투,2908,2135,755,1324,40,1,3,0,0,1,0,1,0,0,2125,10,773
4100,경기도,4107,성남시분당구,,운중동제4투,1480,1178,528,596,33,0,4,0,2,0,0,0,0,0,1163,15,302
4100,경기도,4107,성남시분당구,,운중동제5투,3021,2377,866,1436,46,1,7,0,1,1,2,3,1,0,2364,13,644
4100,경기도,4107,성남시분당구,,운중동제6투,2232,1817,771,984,37,0,4,0,0,0,1,1,0,0,1798,19,415
4100,경기도,4107,성남시분당구,,운중동제7투,1780,1457,570,835,31,0,5,0,0,0,1,1,0,0,1443,14,323
4100,경기도,4107,성남시분당구,,운중동제8투,1757,1369,627,703,31,0,1,0,0,0,0,0,0,0,1362,7,388
4100,경기도,4107,성남시분당구,정자동,소계,13735,10911,4350,6128,265,7,41,0,0,5,8,6,2,1,10813,98,2824
4100,경기도,4107,성남시분당구,,관내사전투표,3627,3627,1701,1807,81,1,9,0,0,0,3,1,0,0,3603,24,0
4100,경기도,4107,성남시분당구,,정자동제1투,1712,1258,400,808,36,0,3,0,0,0,0,0,0,1,1248,10,454
4100,경기도,4107,성남시분당구,,정자동제2투,2635,2046,609,1355,49,1,8,0,0,3,4,3,1,0,2033,13,589
4100,경기도,4107,성남시분당구,,정자동제3투,2372,1763,691,1000,44,1,7,0,0,2,1,0,1,0,1747,16,609
4100,경기도,4107,성남시분당구,,정자동제4투,1721,1082,487,539,27,1,8,0,0,0,0,2,0,0,1064,18,639
4100,경기도,4107,성남시분당구,,정자동제5투,1668,1135,462,619,28,3,6,0,0,0,0,0,0,0,1118,17,533
4100,경기도,4107,성남시분당구,잘못 투입·구분된 투표지,,0,1,0,1,0,0,0,0,0,0,0,0,0,0,1,0,-1
4100,경기도,4108,의정부시,합계,,398960,295029,154851,127348,6788,152,2338,51,33,65,226,592,72,112,292628,2401,103931
4100,경기도,4108,의정부시,거소·선상투표,,831,778,320,307,11,1,32,0,1,3,4,2,0,2,683,95,53
4100,경기도,4108,의정부시,관외사전투표,,30730,30727,16426,12691,725,30,333,9,2,3,7,203,8,24,30461,266,3
4100,경기도,4108,의정부시,재외투표,,1643,1172,717,332,26,1,3,1,0,0,0,1,0,0,1081,91,471
4100,경기도,4108,의정부시,의정부1동,소계,26776,15905,7925,7251,349,9,162,4,2,3,19,32,9,4,15769,136,10871
4100,경기도,4108,의정부시,,관내사전투표,4972,4964,2657,2139,85,2,29,1,0,0,3,11,1,3,4931,33,8
4100,경기도,4108,의정부시,,의정부1동제1투,3930,1912,857,937,49,0,38,2,0,1,5,2,1,1,1893,19,2018
4100,경기도,4108,의정부시,,의정부1동제2투,5476,2334,1116,1094,61,1,25,1,0,0,3,9,2,0,2312,22,3142
4100,경기도,4108,의정부시,,의정부1동제3투,3062,1646,824,753,25,2,21,0,1,1,4,3,3,0,1637,9,1416
4100,경기도,4108,의정부시,,의정부1동제4투,1953,1227,570,600,33,0,12,0,0,0,2,1,1,0,1219,8,726
4100,경기도,4108,의정부시,,의정부1동제5투,3208,1564,773,696,46,1,19,0,0,0,0,2,0,0,1537,27,1644
4100,경기도,4108,의정부시,,의정부1동제6투,4175,2258,1128,1032,50,3,18,0,1,1,2,4,1,0,2240,18,1917
4100,경기도,4108,의정부시,의정부2동,소계,26491,17797,9376,7588,445,14,147,1,1,3,28,31,4,4,17642,155,8694
4100,경기도,4108,의정부시,,관내사전투표,6574,6575,3754,2568,159,3,39,0,0,0,1,11,2,2,6539,36,-1
4100,경기도,4108,의정부시,,의정부2동제1투,2958,1473,746,626,42,3,24,0,1,1,8,0,1,0,1452,21,1485
4100,경기도,4108,의정부시,,의정부2동제2투,2584,1347,629,647,28,1,19,1,0,0,4,4,0,1,1334,13,1237
4100,경기도,4108,의정부시,,의정부2동제3투,3679,1878,920,842,54,1,21,0,0,0,5,6,0,1,1850,28,1801
4100,경기도,4108,의정부시,,의정부2동제4투,3469,1870,913,846,57,1,14,0,0,2,3,7,0,0,1843,27,1599
4100,경기도,4108,의정부시,,의정부2동제5투,4309,2401,1264,1028,58,5,22,0,0,0,2,2,1,0,2382,19,1908
4100,경기도,4108,의정부시,,의정부2동제6투,2918,2253,1150,1031,47,0,8,0,0,0,5,1,0,0,2242,11,665
4100,경기도,4108,의정부시,호원1동,소계,28904,21852,11237,9727,506,6,136,7,3,8,11,25,8,9,21683,169,7052
4100,경기도,4108,의정부시,,관내사전투표,8552,8552,4841,3457,153,2,24,2,0,5,2,13,2,5,8506,46,0
4100,경기도,4108,의정부시,,호원1동제1투,2452,1529,690,751,55,1,17,0,0,0,0,1,0,1,1516,13,923
4100,경기도,4108,의정부시,,호원1동제2투,2915,2158,935,1131,55,0,8,0,0,1,1,1,1,0,2133,25,757
4100,경기도,4108,의정부시,,호원1동제3투,1976,1152,570,514,28,1,18,1,1,0,1,1,1,1,1137,15,824
4100,경기도,4108,의정부시,,호원1동제4투,4151,2413,1277,1005,73,1,22,1,0,1,3,2,1,0,2386,27,1738
4100,경기도,4108,의정부시,,호원1동제5투,2833,1824,893,835,45,1,20,2,1,0,3,3,1,2,1806,18,1009
4100,경기도,4108,의정부시,,호원1동제6투,3408,2462,1173,1199,57,0,12,0,1,1,1,2,1,0,2447,15,946
4100,경기도,4108,의정부시,,호원1동제7투,2617,1762,858,835,40,0,15,1,0,0,0,2,1,0,1752,10,855
4100,경기도,4108,의정부시,호원2동,소계,28198,21591,11121,9697,440,6,124,2,4,0,23,26,4,6,21453,138,6607
4100,경기도,4108,의정부시,,관내사전투표,8440,8436,4802,3417,141,1,31,1,2,0,1,9,2,1,8408,28,4
4100,경기도,4108,의정부시,,호원2동제1투,3949,2413,1173,1127,64,0,15,0,0,0,6,3,2,1,2391,22,1536
4100,경기도,4108,의정부시,,호원2동제2투,2774,1975,894,995,43,3,16,1,0,0,2,3,0,1,1958,17,799
4100,경기도,4108,의정부시,,호원2동제3투,4086,2473,1265,1102,51,1,22,0,2,0,5,4,0,0,2452,21,1613
4100,경기도,4108,의정부시,,호원2동제4투,2589,1822,812,921,46,0,14,0,0,0,2,2,0,0,1797,25,767
4100,경기도,4108,의정부시,,호원2동제5투,3466,2336,1192,1059,49,0,16,0,0,0,2,3,0,1,2322,14,1130
4100,경기도,4108,의정부시,,호원2동제6투,2894,2136,983,1076,46,1,10,0,0,0,5,2,0,2,2125,11,758
4100,경기도,4108,의정부시,장암동,소계,15985,12398,6409,5494,276,3,81,3,0,3,6,14,5,1,12295,103,3587
4100,경기도,4108,의정부시,,관내사전투표,4352,4352,2446,1784,68,2,16,3,0,1,1,6,2,1,4330,22,0
4100,경기도,4108,의정부시,,장암동제1투,2260,1611,775,771,42,0,5,0,0,0,0,0,1,0,1594,17,649
4100,경기도,4108,의정부시,,장암동제2투,2922,1866,950,829,43,1,21,0,0,0,2,1,1,0,1848,18,1056
4100,경기도,4108,의정부시,,장암동제3투,2130,1369,620,691,35,0,10,0,0,0,0,2,0,0,1358,11,761
4100,경기도,4108,의정부시,,장암동제4투,2262,1572,745,733,48,0,21,0,0,0,2,4,0,0,1553,19,690
4100,경기도,4108,의정부시,,장암동제5투,2059,1628,873,686,40,0,8,0,0,2,1,1,1,0,1612,16,431
4100,경기도,4108,의정부시,신곡1동,소계,33293,24584,12887,10686,549,13,197,3,2,1,27,35,4,9,24413,171,8709
4100,경기도,4108,의정부시,,관내사전투표,7768,7768,4451,3089,123,3,46,2,0,0,4,22,0,0,7740,28,0
4100,경기도,4108,의정부시,,신곡1동제1투,3487,2018,953,955,61,3,21,0,0,1,6,2,1,0,2003,15,1469
4100,경기도,4108,의정부시,,신곡1동제2투,2139,1412,623,736,21,3,8,0,0,0,2,0,0,0,1393,19,727
4100,경기도,4108,의정부시,,신곡1동제3투,4411,2655,1282,1239,68,0,31,1,1,0,6,2,0,2,2632,23,1756
4100,경기도,4108,의정부시,,신곡1동제4투,3310,2249,1086,1081,39,1,18,0,0,0,2,4,1,0,2232,17,1061
4100,경기도,4108,의정부시,,신곡1동제5투,3228,2100,1052,950,56,1,23,0,0,0,1,3,1,4,2091,9,1128
4100,경기도,4108,의정부시,,신곡1동제6투,2552,1869,1059,721,49,0,22,0,1,0,0,0,1,2,1855,14,683
4100,경기도,4108,의정부시,,신곡1동제7투,3850,2568,1332,1095,87,2,17,0,0,0,5,1,0,1,2540,28,1282
4100,경기도,4108,의정부시,,신곡1동제8투,2548,1945,1049,820,45,0,11,0,0,0,1,1,0,0,1927,18,603
4100,경기도,4108,의정부시,신곡2동,소계,36884,27914,14258,12527,682,16,167,2,3,5,16,25,2,12,27715,199,8970
4100,경기도,4108,의정부시,,관내사전투표,8644,8644,4713,3691,148,6,33,2,0,1,5,8,1,3,8611,33,0
4100,경기도,4108,의정부시,,신곡2동제1투,2712,1730,696,950,61,0,10,0,0,1,0,2,0,1,1721,9,982
4100,경기도,4108,의정부시,,신곡2동제2투,2945,1967,1051,817,52,1,23,0,1,0,2,2,0,0,1949,18,978
4100,경기도,4108,의정부시,,신곡2동제3투,3637,2472,1265,1077,89,3,9,0,1,1,4,0,0,1,2450,22,1165
4100,경기도,4108,의정부시,,신곡2동제4투,4065,2753,1346,1255,79,3,19,0,0,0,2,4,1,3,2712,41,1312
4100,경기도,4108,의정부시,,신곡2동제5투,3194,1910,958,863,46,0,21,0,0,1,1,2,0,1,1893,17,1284
4100,경기도,4108,의정부시,,신곡2동제6투,3027,2218,1098,1032,62,0,11,0,0,0,1,1,0,1,2206,12,809
4100,경기도,4108,의정부시,,신곡2동제7투,2813,2030,1023,941,37,1,7,0,0,1,0,1,0,0,2011,19,783
4100,경기도,4108,의정부시,,신곡2동제8투,2867,1872,905,884,41,1,21,0,0,0,1,3,0,0,1856,16,995
4100,경기도,4108,의정부시,,신곡2동제9투,2980,2318,1203,1017,67,1,13,0,1,0,0,2,0,2,2306,12,662
4100,경기도,4108,의정부시,송산1동,소계,34168,24097,12731,10311,581,7,182,0,4,8,22,51,6,11,23914,183,10071
4100,경기도,4108,의정부시,,관내사전투표,8094,8094,4609,3223,159,0,37,0,2,1,4,20,2,2,8059,35,0
4100,경기도,4108,의정부시,,송산1동제1투,3003,1692,785,827,39,2,17,0,0,2,0,4,1,0,1677,15,1311
4100,경기도,4108,의정부시,,송산1동제2투,3549,2213,1111,995,55,0,28,0,0,2,1,2,0,1,2195,18,1336
4100,경기도,4108,의정부시,,송산1동제3투,4032,2293,1187,976,51,2,32,0,1,1,4,6,0,1,2261,32,1739
4100,경기도,4108,의정부시,,송산1동제4투,2249,1533,810,657,44,2,8,0,0,1,0,3,0,1,1526,7,716
4100,경기도,4108,의정부시,,송산1동제5투,2374,1280,646,569,34,0,7,0,0,0,6,6,1,3,1272,8,1094
4100,경기도,4108,의정부시,,송산1동제6투,3939,2426,1255,1068,62,0,22,0,0,0,4,1,0,1,2413,13,1513
4100,경기도,4108,의정부시,,송산1동제7투,576,342,149,178,5,0,5,0,0,1,0,0,1,0,339,3,234
4100,경기도,4108,의정부시,,송산1동제8투,4832,3078,1640,1274,89,0,22,0,1,0,3,7,1,2,3039,39,1754
4100,경기도,4108,의정부시,,송산1동제9투,1520,1146,539,544,43,1,4,0,0,0,0,2,0,0,1133,13,374
4100,경기도,4108,의정부시,송산2동,소계,26171,19454,10709,7935,456,14,120,7,3,8,10,45,6,5,19318,136,6717
4100,경기도,4108,의정부시,,관내사전투표,7401,7399,4398,2794,127,3,23,2,0,2,1,17,3,3,7373,26,2
4100,경기도,4108,의정부시,,송산2동제1투,2398,1463,811,589,41,0,8,0,0,0,0,6,0,0,1455,8,935
4100,경기도,4108,의정부시,,송산2동제2투,3393,2126,1163,852,53,1,22,0,0,1,1,11,1,0,2105,21,1267
4100,경기도,4108,의정부시,,송산2동제3투,3102,2135,1071,976,46,2,14,1,1,2,4,3,1,1,2122,13,967
4100,경기도,4108,의정부시,,송산2동제4투,2141,1491,769,643,50,2,10,2,1,0,1,2,0,0,1480,11,650
4100,경기도,4108,의정부시,,송산2동제5투,2547,1633,828,706,61,1,15,0,0,1,1,2,0,0,1615,18,914
4100,경기도,4108,의정부시,,송산2동제6투,2727,1715,880,749,40,3,11,1,1,1,0,3,1,1,1691,24,1012
4100,경기도,4108,의정부시,,송산2동제7투,2462,1492,789,626,38,2,17,1,0,1,2,1,0,0,1477,15,970
4100,경기도,4108,의정부시,자금동,소계,21579,15370,7946,6754,346,11,154,3,0,0,8,16,4,4,15246,124,6209
4100,경기도,4108,의정부시,,관내사전투표,5204,5202,2896,2123,105,4,36,2,0,0,0,5,1,1,5173,29,2
4100,경기도,4108,의정부시,,자금동제1투,2580,1229,578,573,32,2,27,0,0,0,2,0,1,1,1216,13,1351
4100,경기도,4108,의정부시,,자금동제2투,2904,2040,1022,934,49,0,17,0,0,0,1,4,0,0,2027,13,864
4100,경기도,4108,의정부시,,자금동제3투,2404,1383,675,629,37,0,16,1,0,0,3,2,1,0,1364,19,1021
4100,경기도,4108,의정부시,,자금동제4투,2090,1303,642,601,21,3,18,0,0,0,0,2,0,0,1287,16,787
4100,경기도,4108,의정부시,,자금동제5투,2655,1743,906,754,39,2,17,0,0,0,0,2,1,1,1722,21,912
4100,경기도,4108,의정부시,,자금동제6투,3742,2470,1227,1140,63,0,23,0,0,0,2,1,0,1,2457,13,1272
4100,경기도,4108,의정부시,녹양동,소계,17160,12445,6396,5519,298,8,114,3,2,2,13,13,3,3,12374,71,4715
4100,경기도,4108,의정부시,,관내사전투표,5707,5706,3152,2333,137,5,39,2,0,1,3,8,3,2,5685,21,1
4100,경기도,4108,의정부시,,녹양동제1투,3026,1611,740,802,39,1,13,0,0,0,2,2,0,0,1599,12,1415
4100,경기도,4108,의정부시,,녹양동제2투,2986,1884,931,859,46,1,25,0,0,0,5,2,0,0,1869,15,1102
4100,경기도,4108,의정부시,,녹양동제3투,3796,2280,1082,1085,59,1,28,0,1,1,3,1,0,1,2262,18,1516
4100,경기도,4108,의정부시,,녹양동제4투,1645,964,491,440,17,0,9,1,1,0,0,0,0,0,959,5,681
4100,경기도,4108,의정부시,흥선동,소계,15988,10744,5619,4601,255,2,112,1,2,7,17,15,3,4,10638,106,5244
4100,경기도,4108,의정부시,,관내사전투표,4600,4602,2604,1844,82,0,28,1,0,2,4,10,1,2,4578,24,-2
4100,경기도,4108,의정부시,,흥선동제1투,1652,936,463,409,30,1,15,0,0,1,0,0,0,0,919,17,716
4100,경기도,4108,의정부시,,흥선동제2투,3315,1612,791,711,45,1,26,0,1,1,6,3,1,0,1586,26,1703
4100,경기도,4108,의정부시,,흥선동제3투,1980,1077,526,499,27,0,7,0,1,1,2,1,0,1,1065,12,903
4100,경기도,4108,의정부시,,흥선동제4투,2169,1342,688,579,40,0,15,0,0,0,4,1,0,1,1328,14,827
4100,경기도,4108,의정부시,,흥선동제5투,2272,1175,547,559,31,0,21,0,0,2,1,0,1,0,1162,13,1097
4100,경기도,4108,의정부시,가능동,소계,20902,13848,7114,6163,285,7,124,1,2,3,8,21,5,5,13738,110,7054
4100,경기도,4108,의정부시,,관내사전투표,5949,5951,3293,2495,89,1,31,1,1,0,2,9,3,1,5926,25,-2
4100,경기도,4108,의정부시,,가능동제1투,2559,1294,599,621,37,5,15,0,0,0,1,1,0,2,1281,13,1265
4100,경기도,4108,의정부시,,가능동제2투,3219,1759,831,858,40,0,10,0,1,2,2,0,0,1,1745,14,1460
4100,경기도,4108,의정부시,,가능동제3투,2165,1140,578,497,26,0,20,0,0,1,0,4,1,0,1127,13,1025
4100,경기도,4108,의정부시,,가능동제4투,3278,1855,890,890,39,0,21,0,0,0,2,1,0,0,1843,12,1423
4100,경기도,4108,의정부시,,가능동제5투,3732,1849,923,802,54,1,27,0,0,0,1,6,1,1,1816,33,1883
4100,경기도,4108,의정부시,송산3동,소계,33257,24349,13658,9763,558,4,150,4,2,8,7,37,1,9,24201,148,8908
4100,경기도,4108,의정부시,,관내사전투표,9171,9171,5526,3394,160,2,34,2,1,1,1,14,1,1,9137,34,0
4100,경기도,4108,의정부시,,송산3동제1투,2823,1623,822,709,43,1,20,0,0,1,2,1,0,1,1600,23,1200
4100,경기도,4108,의정부시,,송산3동제2투,2769,2093,1083,927,55,0,11,0,0,0,1,4,0,0,2081,12,676
4100,경기도,4108,의정부시,,송산3동제3투,3898,2434,1268,1072,54,0,14,1,0,1,1,2,0,2,2415,19,1464
4100,경기도,4108,의정부시,,송산3동제4투,3885,2545,1447,986,71,0,13,0,0,3,0,4,0,3,2527,18,1340
4100,경기도,4108,의정부시,,송산3동제5투,4089,2692,1469,1107,77,0,20,1,0,0,0,6,0,0,2680,12,1397
4100,경기도,4108,의정부시,,송산3동제6투,3408,2022,1140,785,57,1,15,0,1,0,2,3,0,0,2004,18,1386
4100,경기도,4108,의정부시,,송산3동제7투,3214,1769,903,783,41,0,23,0,0,2,0,3,0,2,1757,12,1445
4100,경기도,4108,의정부시,잘못 투입·구분된 투표지,,0,4,2,2,0,0,0,0,0,0,0,0,0,0,4,0,-4
4100,경기도,4109,안양시만안구,합계,,209083,162812,82650,73147,3901,72,1111,39,17,40,145,134,46,68,161370,1442,46271
4100,경기도,4109,안양시만안구,거소·선상투표,,371,350,143,138,10,1,11,1,1,1,0,1,0,4,311,39,21
4100,경기도,4109,안양시만안구,관외사전투표,,17671,17669,9444,7384,476,12,151,9,1,2,5,26,4,8,17522,147,2
4100,경기도,4109,안양시만안구,재외투표,,987,696,400,208,32,0,3,0,0,1,0,0,0,0,644,52,291
4100,경기도,4109,안양시만안구,안양1동,소계,9861,7778,3756,3629,223,3,52,2,1,1,9,7,0,2,7685,93,2083
4100,경기도,4109,안양시만안구,,관내사전투표,3379,3379,1802,1432,83,3,23,1,1,0,1,4,0,0,3350,29,0
4100,경기도,4109,안양시만안구,,안양1동제1투,1711,1197,507,622,40,0,11,0,0,0,3,1,0,1,1185,12,514
4100,경기도,4109,안양시만안구,,안양1동제2투,2943,2213,969,1115,76,0,11,1,0,1,4,2,0,1,2180,33,730
4100,경기도,4109,안양시만안구,,안양1동제3투,1828,989,478,460,24,0,7,0,0,0,1,0,0,0,970,19,839
4100,경기도,4109,안양시만안구,안양2동,소계,16950,12221,6173,5511,281,4,102,1,1,4,21,9,3,4,12114,107,4729
4100,경기도,4109,안양시만안구,,관내사전투표,4963,4964,2764,2061,80,0,23,0,1,1,5,3,1,0,4939,25,-1
4100,경기도,4109,안양시만안구,,안양2동제1투,2850,1574,767,722,37,1,17,1,0,1,4,3,1,0,1554,20,1276
4100,경기도,4109,안양시만안구,,안양2동제2투,2053,1111,561,482,30,1,11,0,0,1,6,1,0,2,1095,16,942
4100,경기도,4109,안양시만안구,,안양2동제3투,2346,1394,686,642,28,1,12,0,0,0,1,1,1,2,1374,20,952
4100,경기도,4109,안양시만안구,,안양2동제4투,1528,1110,526,515,42,1,13,0,0,0,3,0,0,0,1100,10,418
4100,경기도,4109,안양시만안구,,안양2동제5투,3210,2068,869,1089,64,0,26,0,0,1,2,1,0,0,2052,16,1142
4100,경기도,4109,안양시만안구,안양3동,소계,13840,10198,5221,4535,253,3,67,0,0,7,5,6,4,2,10103,95,3642
4100,경기도,4109,안양시만안구,,관내사전투표,4550,4550,2596,1793,108,0,16,0,0,2,2,5,3,1,4526,24,0
4100,경기도,4109,안양시만안구,,안양3동제1투,2091,1131,555,513,26,1,12,0,0,2,1,0,1,0,1111,20,960
4100,경기도,4109,안양시만안구,,안양3동제2투,2216,1399,660,681,34,1,10,0,0,0,0,0,0,0,1386,13,817
4100,경기도,4109,안양시만안구,,안양3동제3투,2952,1643,758,791,42,1,23,0,0,3,2,1,0,1,1622,21,1309
4100,경기도,4109,안양시만안구,,안양3동제4투,2031,1475,652,757,43,0,6,0,0,0,0,0,0,0,1458,17,556
4100,경기도,4109,안양시만안구,안양4동,소계,6468,5002,2444,2351,111,3,35,1,0,1,3,2,2,2,4955,47,1466
4100,경기도,4109,안양시만안구,,관내사전투표,2743,2743,1447,1208,57,2,9,0,0,1,0,1,0,1,2726,17,0
4100,경기도,4109,안양시만안구,,안양4동제1투,2090,1175,539,572,28,1,15,0,0,0,2,0,1,0,1158,17,915
4100,경기도,4109,안양시만안구,,안양4동제2투,1635,1084,458,571,26,0,11,1,0,0,1,1,1,1,1071,13,551
4100,경기도,4109,안양시만안구,안양5동,소계,8677,6324,3054,3014,129,3,56,3,2,1,6,8,2,2,6280,44,2353
4100,경기도,4109,안양시만안구,,관내사전투표,2909,2909,1514,1313,44,1,15,2,0,0,1,5,1,2,2898,11,0
4100,경기도,4109,안양시만안구,,안양5동제1투,2429,1450,636,743,37,0,11,1,1,1,1,3,0,0,1434,16,979
4100,경기도,4109,안양시만안구,,안양5동제2투,828,469,214,240,9,0,4,0,0,0,0,0,0,0,467,2,359
4100,경기도,4109,안양시만안구,,안양5동제3투,2511,1496,690,718,39,2,26,0,1,0,4,0,1,0,1481,15,1015
4100,경기도,4109,안양시만안구,안양6동,소계,20060,14311,7207,6501,354,6,99,2,3,1,13,6,4,3,14199,112,5749
4100,경기도,4109,안양시만안구,,관내사전투표,5147,5143,2891,2117,93,1,18,0,1,0,1,2,1,2,5127,16,4
4100,경기도,4109,안양시만안구,,안양6동제1투,4442,2658,1320,1209,79,0,27,0,1,0,4,1,0,0,2641,17,1784
4100,경기도,4109,안양시만안구,,안양6동제2투,2226,1550,718,767,32,2,7,0,0,0,1,1,1,0,1529,21,676
4100,경기도,4109,안양시만안구,,안양6동제3투,4009,2358,1081,1145,76,1,23,1,0,1,4,0,2,0,2334,24,1651
4100,경기도,4109,안양시만안구,,안양6동제4투,2419,1425,661,683,38,2,15,1,1,0,1,1,0,0,1403,22,994
4100,경기도,4109,안양시만안구,,안양6동제5투,1817,1177,536,580,36,0,9,0,0,0,2,1,0,1,1165,12,640
4100,경기도,4109,안양시만안구,안양7동,소계,11856,9542,4778,4419,209,2,43,2,0,1,9,4,1,2,9470,72,2314
4100,경기도,4109,안양시만안구,,관내사전투표,4145,4145,2266,1743,91,0,17,0,0,0,2,3,0,0,4122,23,0
4100,경기도,4109,안양시만안구,,안양7동제1투,3308,2408,1085,1230,53,0,10,2,0,0,2,0,0,2,2384,24,900
4100,경기도,4109,안양시만안구,,안양7동제2투,2946,2063,964,1035,39,1,9,0,0,1,0,1,1,0,2051,12,883
4100,경기도,4109,안양시만안구,,안양7동제3투,1457,926,463,411,26,1,7,0,0,0,5,0,0,0,913,13,531
4100,경기도,4109,안양시만안구,안양8동,소계,9229,6730,3386,3064,150,4,54,3,0,4,5,6,3,2,6681,49,2499
4100,경기도,4109,안양시만안구,,관내사전투표,3228,3227,1758,1358,67,1,18,1,0,2,2,4,1,0,3212,15,1
4100,경기도,4109,안양시만안구,,안양8동제1투,2054,1163,499,612,27,0,10,1,0,1,1,1,1,0,1153,10,891
4100,경기도,4109,안양시만안구,,안양8동제2투,2387,1426,700,656,36,2,18,1,0,0,1,1,1,1,1417,9,961
4100,경기도,4109,안양시만안구,,안양8동제3투,1560,914,429,438,20,1,8,0,0,1,1,0,0,1,899,15,646
4100,경기도,4109,안양시만안구,안양9동,소계,13327,9918,4845,4674,218,6,57,3,5,1,10,10,4,6,9839,79,3409
4100,경기도,4109,안양시만안구,,관내사전투표,4144,4144,2245,1767,78,2,15,1,1,1,1,4,1,4,4120,24,0
4100,경기도,4109,안양시만안구,,안양9동제1투,1454,909,389,474,20,0,7,1,0,0,4,1,0,1,897,12,545
4100,경기도,4109,안양시만안구,,안양9동제2투,2236,1462,646,743,39,1,14,1,0,0,2,1,0,0,1447,15,774
4100,경기도,4109,안양시만안구,,안양9동제3투,2274,1269,588,611,33,2,11,0,4,0,2,3,1,0,1255,14,1005
4100,경기도,4109,안양시만안구,,안양9동제4투,3219,2134,977,1079,48,1,10,0,0,0,1,1,2,1,2120,14,1085
4100,경기도,4109,안양시만안구,석수1동,소계,15317,12442,6063,5924,289,7,52,3,1,3,13,3,3,3,12364,78,2875
4100,경기도,4109,안양시만안구,,관내사전투표,4963,4963,2694,2153,82,3,10,2,0,1,2,2,3,0,4952,11,0
4100,경기도,4109,안양시만안구,,석수1동제1투,2723,1778,785,894,66,0,15,0,0,1,4,0,0,1,1766,12,945
4100,경기도,4109,안양시만안구,,석수1동제2투,2333,1450,618,770,30,3,9,0,0,0,4,0,0,0,1434,16,883
4100,경기도,4109,안양시만안구,,석수1동제3투,2150,1724,814,839,45,0,7,1,1,1,1,1,0,1,1711,13,426
4100,경기도,4109,안양시만안구,,석수1동제4투,3148,2527,1152,1268,66,1,11,0,0,0,2,0,0,1,2501,26,621
4100,경기도,4109,안양시만안구,석수2동,소계,24833,19439,9962,8638,494,7,127,3,1,5,19,17,4,7,19284,155,5394
4100,경기도,4109,안양시만안구,,관내사전투표,7350,7350,4151,2965,158,3,33,0,0,0,1,7,1,1,7320,30,0
4100,경기도,4109,안양시만안구,,석수2동제1투,1319,813,407,355,29,0,9,0,0,2,2,0,1,2,807,6,506
4100,경기도,4109,안양시만안구,,석수2동제2투,2470,1736,749,917,36,1,7,1,0,0,1,1,1,0,1714,22,734
4100,경기도,4109,안양시만안구,,석수2동제3투,1685,1021,446,512,28,0,9,1,0,1,2,3,0,0,1002,19,664
4100,경기도,4109,안양시만안구,,석수2동제4투,2104,1535,711,746,41,0,11,0,1,1,3,3,0,1,1518,17,569
4100,경기도,4109,안양시만안구,,석수2동제5투,1840,1147,547,533,33,0,16,0,0,0,4,1,0,0,1134,13,693
4100,경기도,4109,안양시만안구,,석수2동제6투,2139,1309,647,583,45,2,15,0,0,0,1,1,0,0,1294,15,830
4100,경기도,4109,안양시만안구,,석수2동제7투,3114,2353,1171,1075,64,0,14,1,0,1,4,1,1,2,2334,19,761
4100,경기도,4109,안양시만안구,,석수2동제8투,2812,2175,1133,952,60,1,13,0,0,0,1,0,0,1,2161,14,637
4100,경기도,4109,안양시만안구,석수3동,소계,10467,7890,4203,3341,181,3,56,2,1,1,8,8,3,7,7814,76,2577
4100,경기도,4109,안양시만안구,,관내사전투표,3690,3690,2120,1465,58,1,19,0,1,0,3,6,2,1,3676,14,0
4100,경기도,4109,안양시만안구,,석수3동제1투,2450,1498,727,687,49,1,17,0,0,1,0,1,1,1,1485,13,952
4100,경기도,4109,안양시만안구,,석수3동제2투,2129,1415,681,670,39,0,6,0,0,0,1,0,0,5,1402,13,714
4100,경기도,4109,안양시만안구,,석수3동제3투,2198,1287,675,519,35,1,14,2,0,0,4,1,0,0,1251,36,911
4100,경기도,4109,안양시만안구,박달1동,소계,12619,9272,4896,4005,180,3,57,1,0,2,13,12,5,6,9180,92,3347
4100,경기도,4109,안양시만안구,,관내사전투표,4482,4481,2522,1834,70,0,7,1,0,1,4,3,2,2,4446,35,1
4100,경기도,4109,안양시만안구,,박달1동제1투,2447,1346,664,615,32,0,11,0,0,0,1,1,2,1,1327,19,1101
4100,경기도,4109,안양시만안구,,박달1동제2투,1610,867,432,383,17,3,9,0,0,1,3,1,1,0,850,17,743
4100,경기도,4109,안양시만안구,,박달1동제3투,1782,1009,489,472,16,0,14,0,0,0,3,3,0,1,998,11,773
4100,경기도,4109,안양시만안구,,박달1동제4투,2298,1569,789,701,45,0,16,0,0,0,2,4,0,2,1559,10,729
4100,경기도,4109,안양시만안구,박달2동,소계,16550,13030,6675,5811,311,5,89,3,0,4,6,9,4,8,12925,105,3520
4100,경기도,4109,안양시만안구,,관내사전투표,5372,5372,3035,2157,108,2,42,1,0,0,0,1,0,1,5347,25,0
4100,경기도,4109,안양시만안구,,박달2동제1투,2296,1367,607,680,43,1,19,1,0,0,2,1,1,1,1356,11,929
4100,경기도,4109,안양시만안구,,박달2동제2투,1793,1362,671,627,37,1,5,0,0,0,2,2,0,1,1346,16,431
4100,경기도,4109,안양시만안구,,박달2동제3투,2217,1474,692,727,31,0,7,0,0,2,0,0,0,4,1463,11,743
4100,경기도,4109,안양시만안구,,박달2동제4투,2550,1671,860,731,42,1,7,1,0,1,1,2,2,1,1649,22,879
4100,경기도,4109,안양시만안구,,박달2동제5투,2322,1784,810,889,50,0,9,0,0,1,1,3,1,0,1764,20,538
4100,경기도,4109,안양시만안구,잘못 투입·구분된 투표지,,0,0,0,0,0,0,0,0,0,0,0,0,0,0,0,0,0
4100,경기도,4110,안양시동안구,합계,,262895,216629,105221,102552,5574,72,1015,47,25,42,144,115,40,67,214914,1715,46266
4100,경기도,4110,안양시동안구,거소·선상투표,,366,355,118,167,2,1,7,0,0,0,1,0,0,1,297,58,11
4100,경기도,4110,안양시동안구,관외사전투표,,22030,22022,10928,10145,555,13,152,6,2,5,13,18,6,5,21848,174,8
4100,경기도,4110,안양시동안구,재외투표,,1924,1404,780,454,55,0,1,0,0,0,0,1,0,0,1291,113,520
4100,경기도,4110,안양시동안구,비산1동,소계,17373,14270,6807,6927,342,0,56,3,3,2,9,4,1,7,14161,109,3103
4100,경기도,4110,안양시동안구,,관내사전투표,5192,5192,2797,2255,97,0,11,1,1,0,1,1,0,2,5166,26,0
4100,경기도,4110,안양시동안구,,비산1동제1투,1737,1133,551,518,39,0,10,0,0,0,1,1,0,0,1120,13,604
4100,경기도,4110,안양시동안구,,비산1동제2투,783,608,306,273,20,0,1,0,0,0,1,0,1,1,603,5,175
4100,경기도,4110,안양시동안구,,비산1동제3투,726,534,237,264,23,0,4,0,0,0,0,0,0,0,528,6,192
4100,경기도,4110,안양시동안구,,비산1동제4투,2977,2238,1076,1059,59,0,15,0,0,1,3,0,0,2,2215,23,739
4100,경기도,4110,안양시동안구,,비산1동제5투,2451,1882,720,1111,27,0,1,0,0,0,0,2,0,1,1862,20,569
4100,경기도,4110,안양시동안구,,비산1동제6투,1784,1363,509,802,34,0,9,0,1,1,2,0,0,0,1358,5,421
4100,경기도,4110,안양시동안구,,비산1동제7투,1723,1320,611,645,43,0,5,2,1,0,1,0,0,1,1309,11,403
4100,경기도,4110,안양시동안구,비산2동,소계,11477,9683,4778,4555,238,5,34,2,0,0,8,4,1,3,9628,55,1794
4100,경기도,4110,안양시동안구,,관내사전투표,4621,4621,2501,1993,91,3,12,2,0,0,1,2,0,3,4608,13,0
4100,경기도,4110,안양시동안구,,비산2동제1투,1945,1377,594,723,41,0,4,0,0,0,1,1,0,0,1364,13,568
4100,경기도,4110,안양시동안구,,비산2동제2투,2605,1960,916,951,62,1,10,0,0,0,5,1,1,0,1947,13,645
4100,경기도,4110,안양시동안구,,비산2동제3투,2306,1725,767,888,44,1,8,0,0,0,1,0,0,0,1709,16,581
4100,경기도,4110,안양시동안구,비산3동,소계,10205,7659,3793,3574,151,1,60,3,0,1,6,7,1,7,7604,55,2546
4100,경기도,4110,안양시동안구,,관내사전투표,3419,3419,1874,1439,65,0,19,2,0,0,0,2,0,0,3401,18,0
4100,경기도,4110,안양시동안구,,비산3동제1투,1934,1311,624,629,21,0,10,1,0,1,4,2,0,6,1298,13,623
4100,경기도,4110,안양시동안구,,비산3동제2투,2324,1365,575,713,42,1,17,0,0,0,2,1,1,1,1353,12,959
4100,경기도,4110,안양시동안구,,비산3동제3투,2528,1564,720,793,23,0,14,0,0,0,0,2,0,0,1552,12,964
4100,경기도,4110,안양시동안구,부흥동,소계,13348,11167,5547,5149,308,4,43,1,1,2,11,6,3,3,11078,89,2181
4100,경기도,4110,안양시동안구,,관내사전투표,5429,5429,2954,2286,141,1,17,0,0,0,6,2,3,1,5411,18,0
4100,경기도,4110,안양시동안구,,부흥동제1투,1335,881,387,456,25,0,3,0,0,0,1,0,0,1,873,8,454
4100,경기도,4110,안양시동안구,,부흥동제2투,1482,1124,476,598,26,0,6,1,0,0,1,0,0,0,1108,16,358
4100,경기도,4110,안양시동안구,,부흥동제3투,1281,778,338,401,22,0,4,0,0,1,1,0,0,0,767,11,503
4100,경기도,4110,안양시동안구,,부흥동제4투,2194,1702,786,816,60,3,6,0,1,1,1,1,0,0,1675,27,492
4100,경기도,4110,안양시동안구,,부흥동제5투,1627,1253,606,592,34,0,7,0,0,0,1,3,0,1,1244,9,374
4100,경기도,4110,안양시동안구,달안동,소계,9513,7618,3710,3555,222,3,43,1,2,2,8,6,1,4,7557,61,1895
4100,경기도,4110,안양시동안구,,관내사전투표,3633,3633,1959,1529,105,0,13,1,1,1,2,1,1,2,3615,18,0
4100,경기도,4110,안양시동안구,,달안동제1투,2025,1274,533,670,38,0,14,0,1,0,1,1,0,2,1260,14,751
4100,경기도,4110,안양시동안구,,달안동제2투,1786,1151,503,587,37,0,6,0,0,0,3,2,0,0,1138,13,635
4100,경기도,4110,안양시동안구,,달안동제3투,2069,1560,715,769,42,3,10,0,0,1,2,2,0,0,1544,16,509
4100,경기도,4110,안양시동안구,관양1동,소계,27373,20661,10060,9788,474,7,116,6,4,0,25,12,4,8,20504,157,6712
4100,경기도,4110,안양시동안구,,관내사전투표,6659,6659,3604,2861,118,3,28,1,0,0,4,4,2,3,6628,31,0
4100,경기도,4110,안양시동안구,,관양1동제1투,2411,1452,742,653,30,0,10,0,0,0,3,0,0,1,1439,13,959
4100,경기도,4110,안양시동안구,,관양1동제2투,2729,1930,739,1119,40,1,13,1,2,0,4,0,0,0,1919,11,799
4100,경기도,4110,안양시동안구,,관양1동제3투,2397,1420,654,702,34,2,10,2,0,0,1,2,0,0,1407,13,977
4100,경기도,4110,안양시동안구,,관양1동제4투,2357,1485,698,712,43,0,12,0,0,0,3,3,0,2,1473,12,872
4100,경기도,4110,안양시동안구,,관양1동제5투,2746,1862,909,872,44,0,15,2,1,0,1,0,1,1,1846,16,884
4100,경기도,4110,안양시동안구,,관양1동제6투,2445,1659,756,822,48,0,10,0,0,0,1,0,0,0,1637,22,786
4100,경기도,4110,안양시동안구,,관양1동제7투,2795,2122,953,1082,58,0,9,0,0,0,3,2,1,0,2108,14,673
4100,경기도,4110,안양시동안구,,관양1동제8투,2834,2072,1005,965,59,1,9,0,1,0,5,1,0,1,2047,25,762
4100,경기도,4110,안양시동안구,관양2동,소계,15026,11589,5599,5490,315,6,67,2,1,3,9,7,7,3,11509,80,3437
4100,경기도,4110,안양시동안구,,관내사전투표,4647,4644,2511,1972,94,5,22,0,0,0,1,4,3,2,4614,30,3
4100,경기도,4110,안양시동안구,,관양2동제1투,1841,1072,515,497,36,0,9,0,0,2,2,2,1,1,1065,7,769
4100,경기도,4110,안양시동안구,,관양2동제2투,1993,1130,540,526,35,1,11,0,1,0,1,0,0,0,1115,15,863
4100,경기도,4110,안양시동안구,,관양2동제3투,1450,823,343,438,22,0,9,0,0,1,0,0,1,0,814,9,627
4100,경기도,4110,안양시동안구,,관양2동제4투,2578,1875,727,1058,59,0,13,2,0,0,3,1,1,0,1864,11,703
4100,경기도,4110,안양시동안구,,관양2동제5투,2517,2045,963,999,69,0,3,0,0,0,2,0,1,0,2037,8,472
4100,경기도,4110,안양시동안구,부림동,소계,19625,15490,7924,6937,417,3,61,2,1,4,6,6,1,2,15364,126,4135
4100,경기도,4110,안양시동안구,,관내사전투표,5737,5737,3271,2300,125,0,14,1,0,2,0,1,0,0,5714,23,0
4100,경기도,4110,안양시동안구,,부림동제1투,2247,1445,665,705,47,0,8,0,0,0,2,0,0,1,1428,17,802
4100,경기도,4110,안양시동안구,,부림동제2투,1939,1401,693,641,45,0,4,0,0,1,0,0,0,0,1384,17,538
4100,경기도,4110,안양시동안구,,부림동제3투,2405,1833,900,851,54,1,7,1,0,0,2,3,1,1,1821,12,572
4100,경기도,4110,안양시동안구,,부림동제4투,2249,1716,884,763,45,0,6,0,1,1,0,2,0,0,1702,14,533
4100,경기도,4110,안양시동안구,,부림동제5투,2123,1536,676,788,44,1,8,0,0,0,2,0,0,0,1519,17,587
4100,경기도,4110,안양시동안구,,부림동제6투,2925,1822,835,889,57,1,14,0,0,0,0,0,0,0,1796,26,1103
4100,경기도,4110,안양시동안구,평촌동,소계,11131,9386,4550,4451,272,3,38,2,1,2,5,6,1,0,9331,55,1745
4100,경기도,4110,안양시동안구,,관내사전투표,4345,4345,2351,1871,89,2,13,1,1,0,0,2,0,0,4330,15,0
4100,경기도,4110,안양시동안구,,평촌동제1투,2282,1703,778,840,56,0,11,0,0,1,0,0,1,0,1687,16,579
4100,경기도,4110,안양시동안구,,평촌동제2투,1817,1267,540,651,53,0,6,0,0,1,2,3,0,0,1256,11,550
4100,경기도,4110,안양시동안구,,평촌동제3투,2687,2071,881,1089,74,1,8,1,0,0,3,1,0,0,2058,13,616
4100,경기도,4110,안양시동안구,평안동,소계,16474,13847,7032,6266,396,2,43,2,1,2,4,7,3,1,13759,88,2627
4100,경기도,4110,안양시동안구,,관내사전투표,5690,5690,3229,2302,123,1,11,0,0,0,0,2,3,0,5671,19,0
4100,경기도,4110,안양시동안구,,평안동제1투,1746,1156,530,567,39,0,7,0,0,0,0,0,0,0,1143,13,590
4100,경기도,4110,안양시동안구,,평안동제2투,2214,1714,734,899,51,0,6,0,0,0,2,3,0,1,1696,18,500
4100,경기도,4110,안양시동안구,,평안동제3투,1978,1462,668,716,54,0,6,0,0,1,0,1,0,0,1446,16,516
4100,경기도,4110,안양시동안구,,평안동제4투,1971,1526,730,724,58,0,6,0,0,0,0,0,0,0,1518,8,445
4100,경기도,4110,안양시동안구,,평안동제5투,2875,2299,1141,1058,71,1,7,2,1,1,2,1,0,0,2285,14,576
4100,경기도,4110,안양시동안구,귀인동,소계,11241,9483,4382,4776,215,5,28,1,2,0,4,1,2,7,9423,60,1758
4100,경기도,4110,안양시동안구,,관내사전투표,3891,3891,2040,1756,64,3,9,0,0,0,1,1,1,2,3877,14,0
4100,경기도,4110,안양시동안구,,귀인동제1투,2134,1650,612,978,38,1,4,0,2,0,0,0,0,2,1637,13,484
4100,경기도,4110,안양시동안구,,귀인동제2투,2561,1944,757,1102,59,0,2,0,0,0,1,0,1,0,1922,22,617
4100,경기도,4110,안양시동안구,,귀인동제3투,2655,1998,973,940,54,1,13,1,0,0,2,0,0,3,1987,11,657
4100,경기도,4110,안양시동안구,호계1동,소계,13413,11213,5386,5397,298,2,43,3,1,2,3,5,0,1,11141,72,2200
4100,경기도,4110,안양시동안구,,관내사전투표,4103,4103,2206,1777,86,0,9,1,0,0,0,2,0,0,4081,22,0
4100,경기도,4110,안양시동안구,,호계1동제1투,1320,756,328,393,15,0,9,0,1,0,3,0,0,0,749,7,564
4100,경기도,4110,안양시동안구,,호계1동제2투,2208,1802,798,930,49,1,7,0,0,2,0,0,0,1,1788,14,406
4100,경기도,4110,안양시동안구,,호계1동제3투,3076,2441,1087,1261,71,0,9,1,0,0,0,0,0,0,2429,12,635
4100,경기도,4110,안양시동안구,,호계1동제4투,2706,2111,967,1036,77,1,9,1,0,0,0,3,0,0,2094,17,595
4100,경기도,4110,안양시동안구,호계2동,소계,14079,11136,5330,5332,290,5,53,2,3,6,8,11,1,4,11045,91,2943
4100,경기도,4110,안양시동안구,,관내사전투표,3624,3629,1902,1628,69,0,7,1,0,2,1,6,1,0,3617,12,-5
4100,경기도,4110,안양시동안구,,호계2동제1투,2972,2200,1069,1018,80,1,9,0,0,1,4,1,0,1,2184,16,772
4100,경기도,4110,안양시동안구,,호계2동제2투,2558,1910,823,994,53,0,14,0,2,2,1,2,0,1,1892,18,648
4100,경기도,4110,안양시동안구,,호계2동제3투,2702,1904,909,889,52,3,17,1,1,1,1,2,0,1,1877,27,798
4100,경기도,4110,안양시동안구,,호계2동제4투,2223,1493,627,803,36,1,6,0,0,0,1,0,0,1,1475,18,730
4100,경기도,4110,안양시동안구,호계3동,소계,17356,13798,6803,6460,329,3,70,3,2,3,11,3,2,2,13691,107,3558
4100,경기도,4110,안양시동안구,,관내사전투표,6151,6151,3278,2675,145,1,19,3,0,1,3,0,0,1,6126,25,0
4100,경기도,4110,안양시동안구,,호계3동제1투,2425,1602,725,808,40,1,12,0,0,1,3,0,0,1,1591,11,823
4100,경기도,4110,안양시동안구,,호계3동제2투,2670,1736,837,814,39,0,18,0,1,0,1,2,1,0,1713,23,934
4100,경기도,4110,안양시동안구,,호계3동제3투,1693,1167,578,545,23,0,6,0,0,0,0,1,0,0,1153,14,526
4100,경기도,4110,안양시동안구,,호계3동제4투,1916,1360,600,693,38,1,7,0,1,1,3,0,0,0,1344,16,556
4100,경기도,4110,안양시동안구,,호계3동제5투,2501,1782,785,925,44,0,8,0,0,0,1,0,1,0,1764,18,719
4100,경기도,4110,안양시동안구,범계동,소계,12562,10611,4675,5493,329,3,29,2,0,2,3,6,3,2,10547,64,1951
4100,경기도,4110,안양시동안구,,관내사전투표,5002,5002,2571,2236,150,2,11,1,0,1,2,2,2,0,4978,24,0
4100,경기도,4110,안양시동안구,,범계동제1투,2335,1626,637,915,52,0,8,0,0,1,1,1,0,0,1615,11,709
4100,경기도,4110,안양시동안구,,범계동제2투,1804,1290,543,680,47,1,5,0,0,0,0,1,1,1,1279,11,514
4100,경기도,4110,안양시동안구,,범계동제3투,1788,1395,468,867,42,0,4,0,0,0,0,2,0,1,1384,11,393
4100,경기도,4110,안양시동안구,,범계동제4투,1633,1298,456,795,38,0,1,1,0,0,0,0,0,0,1291,7,335
4100,경기도,4110,안양시동안구,신촌동,소계,10232,8631,4119,4176,218,4,38,2,1,1,6,0,2,3,8570,61,1601
4100,경기도,4110,안양시동안구,,관내사전투표,4088,4088,2168,1811,77,2,13,0,0,0,1,0,2,1,4075,13,0
4100,경기도,4110,안양시동안구,,신촌동제1투,2549,1881,813,980,53,2,9,2,1,1,2,0,0,0,1863,18,668
4100,경기도,4110,안양시동안구,,신촌동제2투,2487,1784,783,899,63,0,13,0,0,0,3,0,0,2,1763,21,703
4100,경기도,4110,안양시동안구,,신촌동제3투,1108,878,355,486,25,0,3,0,0,0,0,0,0,0,869,9,230
4100,경기도,4110,안양시동안구,갈산동,소계,8147,6604,2899,3459,148,2,33,4,0,5,4,5,1,4,6564,40,1543
4100,경기도,4110,안양시동안구,,관내사전투표,3021,3021,1453,1487,57,0,7,3,0,0,1,1,0,1,3010,11,0
4100,경기도,4110,안양시동안구,,갈산동제1투,2074,1486,530,875,52,1,10,0,0,2,2,1,1,3,1477,9,588
4100,경기도,4110,안양시동안구,,갈산동제2투,1312,948,352,564,15,0,6,1,0,1,1,0,0,0,940,8,364
4100,경기도,4110,안양시동안구,,갈산동제3투,1740,1149,564,533,24,1,10,0,0,2,0,3,0,0,1137,12,591
4100,경기도,4110,안양시동안구,잘못 투입·구분된 투표지,,0,2,1,1,0,0,0,0,0,0,0,0,0,0,2,0,-2
4100,경기도,4145,부천시,합계,,699678,532995,285227,224331,13249,351,3817,126,76,125,323,515,118,218,528476,4519,166683
4100,경기도,4145,부천시,거소·선상투표,,1170,1089,443,408,19,2,30,0,3,7,0,2,2,3,919,170,81
4100,경기도,4145,부천시,관외사전투표,,50652,50649,27675,20381,1326,44,548,15,12,6,13,99,15,31,50165,484,3
4100,경기도,4145,부천시,재외투표,,3080,2276,1414,567,89,0,8,0,0,0,1,0,0,0,2079,197,804
4100,경기도,4145,부천시,심곡동,소계,53909,36781,19823,15241,884,26,347,10,9,14,29,38,8,14,36443,338,17128
4100,경기도,4145,부천시,,관내사전투표,16751,16749,9560,6563,391,8,97,4,1,3,3,18,2,6,16656,93,2
4100,경기도,4145,부천시,,심곡동제1투,3350,1511,788,631,35,1,23,0,2,0,5,5,0,0,1490,21,1839
4100,경기도,4145,부천시,,심곡동제2투,3902,1895,1013,777,37,5,29,0,0,4,0,0,1,2,1868,27,2007
4100,경기도,4145,부천시,,심곡동제3투,4247,2032,1051,883,43,1,24,2,1,0,1,2,0,0,2008,24,2215
4100,경기도,4145,부천시,,심곡동제4투,2796,1486,748,659,28,3,20,2,0,0,2,2,0,0,1464,22,1310
4100,경기도,4145,부천시,,심곡동제5투,2107,1321,678,558,37,1,22,1,1,0,1,0,0,1,1300,21,786
4100,경기도,4145,부천시,,심곡동제6투,2469,1134,551,513,32,0,18,0,0,1,3,0,1,0,1119,15,1335
4100,경기도,4145,부천시,,심곡동제7투,2361,1290,661,563,36,0,15,0,1,0,1,0,0,1,1278,12,1071
4100,경기도,4145,부천시,,심곡동제8투,1962,1053,555,457,22,1,8,0,1,0,1,0,0,1,1046,7,909
4100,경기도,4145,부천시,,심곡동제9투,2534,1603,815,679,41,2,23,1,0,4,0,6,2,1,1574,29,931
4100,경기도,4145,부천시,,심곡동제10투,2211,1210,633,504,28,1,19,0,0,0,1,0,2,0,1188,22,1001
4100,경기도,4145,부천시,,심곡동제11투,2795,1833,928,808,58,1,16,0,1,0,7,2,0,1,1822,11,962
4100,경기도,4145,부천시,,심곡동제12투,2093,1187,632,487,37,1,11,0,1,0,1,1,0,0,1171,16,906
4100,경기도,4145,부천시,,심곡동제13투,2280,1271,585,630,27,0,14,0,0,2,2,1,0,1,1262,9,1009
4100,경기도,4145,부천시,,심곡동제14투,2051,1206,625,529,32,1,8,0,0,0,1,1,0,0,1197,9,845
4100,경기도,4145,부천시,부천동,소계,74822,55352,30924,21978,1386,46,434,18,3,12,33,63,9,24,54930,422,19470
4100,경기도,4145,부천시,,관내사전투표,24637,24634,14689,9081,544,15,135,4,1,4,5,31,1,8,24518,116,3
4100,경기도,4145,부천시,,부천동제1투,2813,1568,845,638,34,2,21,1,0,1,1,0,0,0,1543,25,1245
4100,경기도,4145,부천시,,부천동제2투,3592,1812,981,737,40,3,27,1,0,0,2,4,0,2,1797,15,1780
4100,경기도,4145,부천시,,부천동제3투,2027,1506,762,661,51,2,10,0,1,0,2,2,0,0,1491,15,521
4100,경기도,4145,부천시,,부천동제4투,1692,1052,560,433,31,2,17,0,1,0,0,1,1,0,1046,6,640
4100,경기도,4145,부천시,,부천동제5투,2888,1747,871,783,44,2,20,1,0,1,2,2,0,1,1727,20,1141
4100,경기도,4145,부천시,,부천동제6투,2580,1673,871,719,53,1,11,0,0,0,1,1,0,0,1657,16,907
4100,경기도,4145,부천시,,부천동제7투,1678,1134,590,493,36,2,2,0,0,0,2,0,0,1,1126,8,544
4100,경기도,4145,부천시,,부천동제8투,2001,1380,708,599,44,2,11,1,0,1,0,0,0,0,1366,14,621
4100,경기도,4145,부천시,,부천동제9투,3005,1753,882,764,67,2,20,0,0,0,2,1,1,1,1740,13,1252
4100,경기도,4145,부천시,,부천동제10투,3369,2180,1124,959,64,2,14,1,0,1,1,0,0,2,2168,12,1189
4100,경기도,4145,부천시,,부천동제11투,2824,1632,876,677,43,2,11,2,0,0,2,2,1,0,1616,16,1192
4100,경기도,4145,부천시,,부천동제12투,2664,1651,849,721,45,1,13,0,0,0,1,2,0,0,1632,19,1013
4100,경기도,4145,부천시,,부천동제13투,2295,1374,713,574,36,2,19,0,0,1,2,0,1,0,1348,26,921
4100,경기도,4145,부천시,,부천동제14투,3514,2182,1173,901,53,0,18,2,0,0,1,5,1,4,2158,24,1332
4100,경기도,4145,부천시,,부천동제15투,2229,1346,793,485,33,0,14,3,0,2,0,0,0,1,1331,15,883
4100,경기도,4145,부천시,,부천동제16투,2683,1664,918,667,41,1,15,0,0,0,2,1,1,1,1647,17,1019
4100,경기도,4145,부천시,,부천동제17투,2761,1754,975,690,48,2,23,1,0,0,1,3,0,1,1744,10,1007
4100,경기도,4145,부천시,,부천동제18투,2273,1365,682,615,33,2,11,1,0,1,2,0,0,1,1348,17,908
4100,경기도,4145,부천시,,부천동제19투,1485,835,431,369,11,0,12,0,0,0,1,3,1,0,828,7,650
4100,경기도,4145,부천시,,부천동제20투,1812,1110,631,412,35,1,10,0,0,0,3,5,1,1,1099,11,702
4100,경기도,4145,부천시,중동,소계,33254,25113,12549,11513,626,19,152,5,4,5,23,18,5,10,24929,184,8141
4100,경기도,4145,부천시,,관내사전투표,10743,10744,5830,4577,230,8,26,2,0,3,4,8,0,7,10695,49,-1
4100,경기도,4145,부천시,,중동제1투,2410,1260,617,582,25,1,16,0,0,2,2,2,1,0,1248,12,1150
4100,경기도,4145,부천시,,중동제2투,2512,1770,839,842,51,1,13,0,1,0,5,1,0,0,1753,17,742
4100,경기도,4145,부천시,,중동제3투,2657,1625,810,715,48,2,24,1,0,0,2,3,0,1,1606,19,1032
4100,경기도,4145,부천시,,중동제4투,2249,1339,656,612,37,1,15,0,0,0,1,0,1,0,1323,16,910
4100,경기도,4145,부천시,,중동제5투,2674,1921,864,966,61,2,10,2,0,0,0,1,2,0,1908,13,753
4100,경기도,4145,부천시,,중동제6투,2189,1592,614,913,49,1,7,0,0,0,3,0,0,0,1587,5,597
4100,경기도,4145,부천시,,중동제7투,2961,1892,810,1008,40,1,8,0,1,0,4,2,0,0,1874,18,1069
4100,경기도,4145,부천시,,중동제8투,2256,1411,728,613,35,0,14,0,1,0,2,0,0,0,1393,18,845
4100,경기도,4145,부천시,,중동제9투,2603,1559,781,685,50,2,19,0,1,0,0,1,1,2,1542,17,1044
4100,경기도,4145,부천시,신중동,소계,102278,78631,39756,35771,1928,48,390,14,14,17,37,55,17,21,78068,563,23647
4100,경기도,4145,부천시,,관내사전투표,31033,31032,17318,12763,674,20,78,3,4,3,7,15,5,10,30900,132,1
4100,경기도,4145,부천시,,신중동제1투,3412,2154,1097,919,65,1,34,0,0,0,0,2,2,3,2123,31,1258
4100,경기도,4145,부천시,,신중동제2투,3065,1936,981,869,46,1,15,0,0,0,0,1,1,0,1914,22,1129
4100,경기도,4145,부천시,,신중동제3투,3149,2165,1043,1033,48,3,17,0,0,1,3,1,0,0,2149,16,984
4100,경기도,4145,부천시,,신중동제4투,2735,1730,842,811,48,3,9,1,1,3,1,3,0,1,1723,7,1005
4100,경기도,4145,부천시,,신중동제5투,2523,1822,879,851,50,1,17,0,1,1,3,0,0,0,1803,19,701
4100,경기도,4145,부천시,,신중동제6투,3293,1708,799,819,50,1,13,0,0,1,1,4,1,1,1690,18,1585
4100,경기도,4145,부천시,,신중동제7투,1740,1404,622,729,37,0,6,0,0,0,0,1,0,0,1395,9,336
4100,경기도,4145,부천시,,신중동제8투,3070,1869,887,889,60,1,10,0,1,0,0,3,0,1,1852,17,1201
4100,경기도,4145,부천시,,신중동제9투,2003,1549,703,780,32,1,11,0,0,3,1,1,0,1,1533,16,454
4100,경기도,4145,부천시,,신중동제10투,3136,1851,907,861,38,1,12,0,0,0,1,3,0,1,1824,27,1285
4100,경기도,4145,부천시,,신중동제11투,2937,2151,1056,989,66,0,15,1,0,0,0,2,2,0,2131,20,786
4100,경기도,4145,부천시,,신중동제12투,2642,1700,779,848,38,1,10,0,0,2,1,1,1,0,1681,19,942
4100,경기도,4145,부천시,,신중동제13투,1876,1386,543,797,31,0,3,0,1,0,1,0,0,0,1376,10,490
4100,경기도,4145,부천시,,신중동제14투,2736,1784,818,901,34,0,9,0,0,0,0,0,0,0,1762,22,952
4100,경기도,4145,부천시,,신중동제15투,2505,1832,832,932,43,3,12,1,0,0,1,1,1,0,1826,6,673
4100,경기도,4145,부천시,,신중동제16투,2556,1779,733,977,39,0,8,1,0,1,0,2,0,0,1761,18,777
4100,경기도,4145,부천시,,신중동제17투,2354,1675,751,855,41,2,8,0,0,0,0,0,1,0,1658,17,679
4100,경기도,4145,부천시,,신중동제18투,1962,1377,553,779,34,0,1,1,0,0,0,2,0,0,1370,7,585
4100,경기도,4145,부천시,,신중동제19투,2989,2064,982,989,53,0,17,1,2,0,1,2,0,0,2047,17,925
4100,경기도,4145,부천시,,신중동제20투,2606,1933,807,1038,54,4,10,1,0,0,3,1,1,0,1919,14,673
4100,경기도,4145,부천시,,신중동제21투,2486,1659,850,732,49,0,16,1,0,0,0,2,1,0,1651,8,827
4100,경기도,4145,부천시,,신중동제22투,2945,2117,1137,888,58,1,9,1,2,0,1,4,0,0,2101,16,828
4100,경기도,4145,부천시,,신중동제23투,1821,1019,509,454,29,0,10,1,0,0,2,0,0,0,1005,14,802
4100,경기도,4145,부천시,,신중동제24투,3121,2263,965,1215,58,1,11,0,0,2,4,0,0,0,2256,7,858
4100,경기도,4145,부천시,,신중동제25투,2327,1419,709,631,41,2,13,1,1,0,3,2,0,2,1405,14,908
4100,경기도,4145,부천시,,신중동제26투,2954,1620,781,739,65,0,9,0,1,0,2,2,0,1,1600,20,1334
4100,경기도,4145,부천시,,신중동제27투,2302,1633,873,683,47,1,7,0,0,0,1,0,1,0,1613,20,669
4100,경기도,4145,부천시,상동,소계,65597,52781,27545,23141,1413,18,215,12,4,13,26,19,5,13,52424,357,12816
4100,경기도,4145,부천시,,관내사전투표,23475,23475,13389,9369,525,8,68,2,0,0,7,14,3,3,23388,87,0
4100,경기도,4145,부천시,,상동제1투,2554,1852,925,833,54,1,11,1,0,3,4,2,0,0,1834,18,702
4100,경기도,4145,부천시,,상동제2투,3910,2423,1218,1077,74,0,18,1,1,1,4,0,0,0,2394,29,1487
4100,경기도,4145,부천시,,상동제3투,2566,1835,930,824,58,2,10,0,0,0,1,0,1,0,1826,9,731
4100,경기도,4145,부천시,,상동제4투,2961,2005,989,909,56,3,16,1,0,2,4,1,0,0,1981,24,956
4100,경기도,4145,부천시,,상동제5투,1735,1088,527,503,35,0,6,2,0,0,0,0,0,0,1073,15,647
4100,경기도,4145,부천시,,상동제6투,3036,2110,1018,980,69,0,10,1,0,0,3,0,1,1,2083,27,926
4100,경기도,4145,부천시,,상동제7투,3393,2309,1048,1162,74,0,7,1,1,0,0,0,0,1,2294,15,1084
4100,경기도,4145,부천시,,상동제8투,2772,2066,988,979,59,2,12,0,0,0,0,0,0,1,2041,25,706
4100,경기도,4145,부천시,,상동제9투,3324,2253,1172,961,82,0,16,3,0,0,2,0,0,1,2237,16,1071
4100,경기도,4145,부천시,,상동제10투,3219,2125,1006,1026,54,0,16,0,0,1,0,1,0,1,2105,20,1094
4100,경기도,4145,부천시,,상동제11투,3268,2274,1173,999,65,0,8,0,2,0,0,0,0,3,2250,24,994
4100,경기도,4145,부천시,,상동제12투,3062,2197,898,1223,59,2,4,0,0,0,1,0,0,0,2187,10,865
4100,경기도,4145,부천시,,상동제13투,3070,2375,1017,1258,74,0,2,0,0,3,0,1,0,0,2355,20,695
4100,경기도,4145,부천시,,상동제14투,3252,2394,1247,1038,75,0,11,0,0,3,0,0,0,2,2376,18,858
4100,경기도,4145,부천시,대산동,소계,65980,48304,25192,20968,1244,25,337,18,4,12,34,39,8,13,47894,410,17676
4100,경기도,4145,부천시,,관내사전투표,19394,19388,11029,7684,408,6,102,6,2,1,6,24,7,4,19279,109,6
4100,경기도,4145,부천시,,대산동제1투,2163,1229,577,580,43,0,12,0,0,0,0,0,0,1,1213,16,934
4100,경기도,4145,부천시,,대산동제2투,2232,1249,581,592,31,1,19,0,0,0,3,1,0,0,1228,21,983
4100,경기도,4145,부천시,,대산동제3투,2084,1114,518,521,38,2,15,1,0,1,4,1,0,0,1101,13,970
4100,경기도,4145,부천시,,대산동제4투,2576,1711,819,822,33,0,13,0,0,2,0,2,0,0,1691,20,865
4100,경기도,4145,부천시,,대산동제5투,3193,1404,704,633,35,1,8,1,0,1,1,0,0,0,1384,20,1789
4100,경기도,4145,부천시,,대산동제6투,2595,1539,750,704,48,1,15,1,1,0,1,1,0,1,1523,16,1056
4100,경기도,4145,부천시,,대산동제7투,2516,1391,669,646,43,3,11,0,0,0,2,0,0,0,1374,17,1125
4100,경기도,4145,부천시,,대산동제8투,2265,1315,640,612,33,0,12,0,0,1,3,1,0,0,1302,13,950
4100,경기도,4145,부천시,,대산동제9투,2142,1366,703,589,47,1,11,0,0,0,0,1,0,0,1352,14,776
4100,경기도,4145,부천시,,대산동제10투,2384,1388,729,590,34,2,14,0,0,0,0,1,0,0,1370,18,996
4100,경기도,4145,부천시,,대산동제11투,2979,1968,958,905,57,0,15,1,0,0,2,0,0,0,1938,30,1011
4100,경기도,4145,부천시,,대산동제12투,2845,1830,907,812,72,2,15,2,0,1,0,3,0,3,1817,13,1015
4100,경기도,4145,부천시,,대산동제13투,2375,1499,715,717,42,1,12,1,0,0,0,0,0,0,1488,11,876
4100,경기도,4145,부천시,,대산동제14투,1789,1444,758,614,51,1,1,0,0,0,1,0,0,1,1427,17,345
4100,경기도,4145,부천시,,대산동제15투,2693,1596,770,746,36,2,19,2,0,1,0,0,1,0,1577,19,1097
4100,경기도,4145,부천시,,대산동제16투,1612,990,514,427,23,0,8,0,0,2,4,0,0,0,978,12,622
4100,경기도,4145,부천시,,대산동제17투,1761,1328,658,601,45,2,7,2,0,1,2,2,0,0,1320,8,433
4100,경기도,4145,부천시,,대산동제18투,2362,1735,849,812,48,0,12,0,1,1,2,0,0,1,1726,9,627
4100,경기도,4145,부천시,,대산동제19투,1565,1088,512,521,36,0,8,0,0,0,3,1,0,1,1082,6,477
4100,경기도,4145,부천시,,대산동제20투,2455,1732,832,840,41,0,8,1,0,0,0,1,0,1,1724,8,723
4100,경기도,4145,부천시,소사본동,소계,44275,32882,17035,14489,766,23,221,5,7,6,37,30,8,14,32641,241,11393
4100,경기도,4145,부천시,,관내사전투표,12876,12877,7237,5268,226,6,55,3,2,1,3,12,4,5,12822,55,-1
4100,경기도,4145,부천시,,소사본동제1투,2401,1364,658,640,25,1,16,0,1,2,4,5,0,0,1352,12,1037
4100,경기도,4145,부천시,,소사본동제2투,1755,982,465,461,19,1,12,0,1,0,6,3,0,1,969,13,773
4100,경기도,4145,부천시,,소사본동제3투,2343,1408,748,573,45,2,14,1,1,1,0,1,1,2,1389,19,935
4100,경기도,4145,부천시,,소사본동제4투,2927,1739,916,751,39,1,15,0,0,1,2,2,1,1,1729,10,1188
4100,경기도,4145,부천시,,소사본동제5투,2146,1268,604,612,28,0,12,0,0,0,5,0,0,0,1261,7,878
4100,경기도,4145,부천시,,소사본동제6투,3251,2061,1011,958,50,2,6,0,1,0,5,4,0,1,2038,23,1190
4100,경기도,4145,부천시,,소사본동제7투,1863,1112,528,522,32,1,15,0,0,0,5,0,0,0,1103,9,751
4100,경기도,4145,부천시,,소사본동제8투,2125,1313,638,601,39,2,16,0,1,0,2,0,1,0,1300,13,812
4100,경기도,4145,부천시,,소사본동제9투,3003,1945,904,932,72,1,13,0,0,1,0,0,0,0,1923,22,1058
4100,경기도,4145,부천시,,소사본동제10투,1892,1087,549,488,24,0,11,1,0,0,1,0,0,0,1074,13,805
4100,경기도,4145,부천시,,소사본동제11투,2248,1678,801,790,55,3,13,0,0,0,2,1,1,2,1668,10,570
4100,경기도,4145,부천시,,소사본동제12투,2243,1679,706,920,35,1,8,0,0,0,1,0,0,0,1671,8,564
4100,경기도,4145,부천시,,소사본동제13투,3202,2369,1270,973,77,2,15,0,0,0,1,2,0,2,2342,27,833
4100,경기도,4145,부천시,범안동,소계,70059,53963,29679,22048,1386,30,317,10,3,12,27,49,14,16,53591,372,16096
4100,경기도,4145,부천시,,관내사전투표,18431,18429,10987,6896,369,8,69,3,0,1,3,13,2,3,18354,75,2
4100,경기도,4145,부천시,,범안동제1투,2566,1285,622,588,44,2,15,0,0,0,1,0,1,1,1274,11,1281
4100,경기도,4145,부천시,,범안동제2투,2187,1280,642,573,30,2,14,0,0,0,0,1,0,1,1263,17,907
4100,경기도,4145,부천시,,범안동제3투,1997,1236,629,536,39,1,10,0,0,0,2,0,1,0,1218,18,761
4100,경기도,4145,부천시,,범안동제4투,1998,1219,655,501,27,0,16,0,0,1,1,4,2,1,1208,11,779
4100,경기도,4145,부천시,,범안동제5투,2510,1815,933,798,57,0,10,0,0,0,0,2,0,1,1801,14,695
4100,경기도,4145,부천시,,범안동제6투,1638,1219,617,550,35,1,5,0,0,0,1,0,0,0,1209,10,419
4100,경기도,4145,부천시,,범안동제7투,2163,1531,725,732,40,0,14,0,0,1,5,1,0,1,1519,12,632
4100,경기도,4145,부천시,,범안동제8투,2298,1754,865,818,44,1,11,0,0,0,1,2,0,1,1743,11,544
4100,경기도,4145,부천시,,범안동제9투,2522,1941,925,931,62,1,3,1,0,1,0,0,0,1,1925,16,581
4100,경기도,4145,부천시,,범안동제10투,2651,1831,932,800,62,1,12,0,0,0,1,1,0,1,1810,21,820
4100,경기도,4145,부천시,,범안동제11투,3288,2188,1091,993,59,3,13,0,0,1,0,2,1,3,2166,22,1100
4100,경기도,4145,부천시,,범안동제12투,2179,1622,823,738,46,1,3,0,0,0,0,0,1,0,1612,10,557
4100,경기도,4145,부천시,,범안동제13투,2001,1546,927,560,42,0,5,0,0,0,1,3,1,0,1539,7,455
4100,경기도,4145,부천시,,범안동제14투,2660,2102,1241,763,66,2,11,0,0,0,0,1,0,1,2085,17,558
4100,경기도,4145,부천시,,범안동제15투,2975,2344,1485,748,86,1,7,0,0,0,0,4,0,0,2331,13,631
4100,경기도,4145,부천시,,범안동제16투,2041,1608,879,679,33,1,7,0,0,1,0,1,1,0,1602,6,433
4100,경기도,4145,부천시,,범안동제17투,2127,1291,661,564,39,2,14,0,1,2,0,2,0,0,1285,6,836
4100,경기도,4145,부천시,,범안동제18투,2412,1550,842,617,45,2,20,0,0,1,3,2,1,0,1533,17,862
4100,경기도,4145,부천시,,범안동제19투,2301,1491,794,629,34,1,10,3,1,2,1,0,2,0,1477,14,810
4100,경기도,4145,부천시,,범안동제20투,2418,1444,746,608,46,0,21,1,0,0,2,5,1,0,1430,14,974
4100,경기도,4145,부천시,,범안동제21투,2114,1559,763,718,50,0,6,0,0,1,2,2,0,1,1543,16,555
4100,경기도,4145,부천시,,범안동제22투,2582,1678,895,708,31,0,21,2,1,0,3,3,0,0,1664,14,904
4100,경기도,4145,부천시,성곡동,소계,67534,48086,27158,18895,1057,38,419,11,5,9,25,47,13,30,47707,379,19448
4100,경기도,4145,부천시,,관내사전투표,18619,18617,11439,6622,328,10,92,6,1,2,4,18,1,12,18535,82,2
4100,경기도,4145,부천시,,성곡동제1투,2751,1272,736,472,35,0,15,0,0,0,1,2,0,1,1262,10,1479
4100,경기도,4145,부천시,,성곡동제2투,2792,1705,952,666,51,0,10,0,1,0,0,1,1,1,1683,22,1087
4100,경기도,4145,부천시,,성곡동제3투,2602,1553,884,596,34,0,12,0,0,2,0,2,2,1,1533,20,1049
4100,경기도,4145,부천시,,성곡동제4투,2316,1407,726,597,43,1,17,0,0,1,0,2,1,2,1390,17,909
4100,경기도,4145,부천시,,성곡동제5투,2035,1249,670,501,33,1,24,0,1,0,1,0,1,0,1232,17,786
4100,경기도,4145,부천시,,성곡동제6투,2620,1683,818,802,28,3,18,0,0,0,1,2,0,0,1672,11,937
4100,경기도,4145,부천시,,성곡동제7투,1698,1144,514,584,32,0,6,0,0,0,0,1,1,1,1139,5,554
4100,경기도,4145,부천시,,성곡동제8투,2156,1296,682,527,42,2,22,1,0,0,0,2,0,2,1280,16,860
4100,경기도,4145,부천시,,성곡동제9투,1880,1302,649,595,28,0,13,0,1,1,4,0,0,0,1291,11,578
4100,경기도,4145,부천시,,성곡동제10투,2887,2047,1040,899,52,3,24,1,0,0,1,2,0,1,2023,24,840
4100,경기도,4145,부천시,,성곡동제11투,2908,1693,931,679,46,2,16,1,0,1,0,2,0,0,1678,15,1215
4100,경기도,4145,부천시,,성곡동제12투,2774,1531,829,624,30,3,20,0,0,0,2,6,1,4,1519,12,1243
4100,경기도,4145,부천시,,성곡동제13투,2716,1498,824,605,36,0,15,0,0,0,3,0,1,0,1484,14,1218
4100,경기도,4145,부천시,,성곡동제14투,3251,1973,1074,803,49,2,20,0,0,0,1,2,2,1,1954,19,1278
4100,경기도,4145,부천시,,성곡동제15투,3185,1875,1093,694,41,2,22,0,1,0,0,0,1,0,1854,21,1310
4100,경기도,4145,부천시,,성곡동제16투,1811,1147,582,497,34,2,15,0,0,2,1,1,0,2,1136,11,664
4100,경기도,4145,부천시,,성곡동제17투,1769,1023,534,442,23,3,6,1,0,0,0,1,0,0,1010,13,746
4100,경기도,4145,부천시,,성곡동제18투,2316,1309,691,556,34,1,13,0,0,0,2,0,1,0,1298,11,1007
4100,경기도,4145,부천시,,성곡동제19투,2041,1340,735,548,24,3,17,0,0,0,1,1,0,0,1329,11,701
4100,경기도,4145,부천시,,성곡동제20투,2407,1422,755,586,34,0,22,1,0,0,3,2,0,2,1405,17,985
4100,경기도,4145,부천시,오정동,소계,67068,47076,26030,18924,1125,32,399,8,8,12,38,56,14,29,46675,401,19992
4100,경기도,4145,부천시,,관내사전투표,16656,16655,9984,6092,350,10,99,2,2,1,5,17,3,6,16571,84,1
4100,경기도,4145,부천시,,오정동제1투,3614,1902,1020,808,38,2,9,0,0,0,1,4,0,0,1882,20,1712
4100,경기도,4145,부천시,,오정동제2투,4053,2825,1377,1303,88,3,18,0,0,1,6,3,1,0,2800,25,1228
4100,경기도,4145,부천시,,오정동제3투,2755,1733,901,737,36,0,21,0,0,1,5,4,1,1,1707,26,1022
4100,경기도,4145,부천시,,오정동제4투,2704,1598,876,632,42,0,19,0,1,2,0,2,0,3,1577,21,1106
4100,경기도,4145,부천시,,오정동제5투,259,179,55,117,4,0,1,0,0,0,0,0,0,0,177,2,80
4100,경기도,4145,부천시,,오정동제6투,2752,1594,855,646,45,2,24,0,0,1,2,1,1,1,1578,16,1158
4100,경기도,4145,부천시,,오정동제7투,2791,1848,891,874,46,0,13,1,0,1,0,3,0,0,1829,19,943
4100,경기도,4145,부천시,,오정동제8투,2313,1350,717,570,26,1,18,0,0,1,0,2,2,0,1337,13,963
4100,경기도,4145,부천시,,오정동제9투,2429,1380,747,569,34,1,8,0,0,0,2,3,0,5,1369,11,1049
4100,경기도,4145,부천시,,오정동제10투,2833,1544,799,655,48,0,18,0,0,1,1,3,0,1,1526,18,1289
4100,경기도,4145,부천시,,오정동제11투,2648,1531,866,576,37,2,27,0,0,0,2,1,2,1,1514,17,1117
4100,경기도,4145,부천시,,오정동제12투,2865,1809,1025,704,48,0,14,0,1,2,1,1,0,0,1796,13,1056
4100,경기도,4145,부천시,,오정동제13투,1846,1179,599,524,29,0,8,0,1,0,1,1,0,0,1163,16,667
4100,경기도,4145,부천시,,오정동제14투,2373,1353,677,600,40,2,10,0,0,0,1,4,0,2,1336,17,1020
4100,경기도,4145,부천시,,오정동제15투,2858,1778,978,718,39,2,15,1,0,0,1,1,3,4,1762,16,1080
4100,경기도,4145,부천시,,오정동제16투,2064,1207,658,482,31,1,20,1,0,0,2,2,0,0,1197,10,857
4100,경기도,4145,부천시,,오정동제17투,3895,2504,1443,919,74,2,28,2,1,0,3,2,0,2,2476,28,1391
4100,경기도,4145,부천시,,오정동제18투,2193,1254,657,523,33,3,13,1,1,1,3,0,1,1,1237,17,939
4100,경기도,4145,부천시,,오정동제19투,1644,947,438,472,21,0,7,0,1,0,0,0,0,2,941,6,697
4100,경기도,4145,부천시,,오정동제20투,1523,906,467,403,16,1,9,0,0,0,2,2,0,0,900,6,617
4100,경기도,4145,부천시,잘못 투입·구분된 투표지,,0,12,4,7,0,0,0,0,0,0,0,0,0,0,11,1,-12
4100,경기도,4114,광명시,합계,,247357,198669,103470,87112,4746,98,1118,46,24,30,151,138,50,75,197058,1611,48688
4100,경기도,4114,광명시,거소·선상투표,,431,415,179,150,10,3,12,0,0,0,0,0,1,0,355,60,16
4100,경기도,4114,광명시,관외사전투표,,19319,19313,10156,8296,462,14,154,3,6,1,8,24,4,15,19143,170,6
4100,경기도,4114,광명시,재외투표,,1321,953,561,282,29,0,1,0,1,0,0,0,0,0,874,79,368
4100,경기도,4114,광명시,광명2동,소계,3507,2531,1312,1125,48,1,20,2,1,1,1,1,1,0,2513,18,976
4100,경기도,4114,광명시,,관내사전투표,1538,1537,864,629,24,1,12,1,1,0,0,0,0,0,1532,5,1
4100,경기도,4114,광명시,,광명2동·광명1동투표소,1969,994,448,496,24,0,8,1,0,1,1,1,1,0,981,13,975
4100,경기도,4114,광명시,광명3동,소계,8339,6000,3096,2689,113,4,47,1,1,1,8,3,1,5,5969,31,2339
4100,경기도,4114,광명시,,관내사전투표,2412,2412,1329,1015,45,3,9,0,0,0,0,2,1,3,2407,5,0
4100,경기도,4114,광명시,,광명3동제1투,2153,1319,666,597,18,0,17,0,1,1,4,0,0,0,1304,15,834
4100,경기도,4114,광명시,,광명3동제2투,1811,1068,531,502,22,0,9,0,0,0,2,0,0,1,1067,1,743
4100,경기도,4114,광명시,,광명3동제3투,1963,1201,570,575,28,1,12,1,0,0,2,1,0,1,1191,10,762
4100,경기도,4114,광명시,광명4동,소계,11222,8509,4280,3875,193,6,67,1,2,2,11,4,1,3,8445,64,2713
4100,경기도,4114,광명시,,관내사전투표,3601,3601,2070,1402,96,0,13,0,0,0,1,1,0,1,3584,17,0
4100,경기도,4114,광명시,,광명4동제1투,2066,1138,522,542,32,1,22,1,0,0,6,3,1,1,1131,7,928
4100,경기도,4114,광명시,,광명4동제2투,2025,1261,644,557,23,3,12,0,1,0,0,0,0,0,1240,21,764
4100,경기도,4114,광명시,,광명4동제3투,3530,2509,1044,1374,42,2,20,0,1,2,4,0,0,1,2490,19,1021
4100,경기도,4114,광명시,광명5동,소계,10163,7562,3884,3396,153,3,45,1,0,0,10,6,1,5,7504,58,2601
4100,경기도,4114,광명시,,관내사전투표,3392,3392,1920,1375,57,2,12,1,0,0,1,3,0,4,3375,17,0
4100,경기도,4114,광명시,,광명5동제1투,2451,1417,650,698,29,1,18,0,0,0,5,0,0,0,1401,16,1034
4100,경기도,4114,광명시,,광명5동제2투,2236,1533,737,737,35,0,8,0,0,0,1,0,1,1,1520,13,703
4100,경기도,4114,광명시,,광명5동제3투,2084,1220,577,586,32,0,7,0,0,0,3,3,0,0,1208,12,864
4100,경기도,4114,광명시,광명6동,소계,8422,6645,3358,3049,136,3,39,2,2,2,10,4,1,1,6607,38,1777
4100,경기도,4114,광명시,,관내사전투표,3016,3016,1697,1233,57,0,16,1,0,0,3,2,0,1,3010,6,0
4100,경기도,4114,광명시,,광명6동제1투,1915,1335,605,679,33,1,5,0,1,1,1,1,0,0,1327,8,580
4100,경기도,4114,광명시,,광명6동제2투,1424,990,467,486,23,1,7,0,0,1,0,0,0,0,985,5,434
4100,경기도,4114,광명시,,광명6동제3투,1687,1040,507,477,20,1,11,1,1,0,4,1,0,0,1023,17,647
4100,경기도,4114,광명시,,광명6동제4투,380,264,82,174,3,0,0,0,0,0,2,0,1,0,262,2,116
4100,경기도,4114,광명시,광명7동,소계,16160,12236,6338,5426,264,7,76,4,1,0,10,10,3,1,12140,96,3924
4100,경기도,4114,광명시,,관내사전투표,4556,4556,2556,1893,69,3,15,1,0,0,0,4,0,0,4541,15,0
4100,경기도,4114,광명시,,광명7동제1투,2461,1601,745,761,43,3,16,1,0,0,3,2,1,0,1575,26,860
4100,경기도,4114,광명시,,광명7동제2투,1898,1173,546,572,30,0,14,0,1,0,1,0,0,0,1164,9,725
4100,경기도,4114,광명시,,광명7동제3투,2624,1736,874,797,37,0,9,0,0,0,1,1,1,1,1721,15,888
4100,경기도,4114,광명시,,광명7동제4투,2032,1429,718,637,41,0,10,0,0,0,2,2,1,0,1411,18,603
4100,경기도,4114,광명시,,광명7동제5투,2589,1741,899,766,44,1,12,2,0,0,3,1,0,0,1728,13,848
4100,경기도,4114,광명시,철산1동,소계,8239,6773,3659,2840,166,11,31,2,1,1,4,5,2,0,6722,51,1466
4100,경기도,4114,광명시,,관내사전투표,3574,3574,2106,1346,83,5,9,1,1,0,1,2,1,0,3555,19,0
4100,경기도,4114,광명시,,철산1동제1투,2218,1491,752,670,37,5,9,0,0,1,2,1,1,0,1478,13,727
4100,경기도,4114,광명시,,철산1동제2투,2447,1708,801,824,46,1,13,1,0,0,1,2,0,0,1689,19,739
4100,경기도,4114,광명시,철산2동,소계,4852,3442,1775,1520,78,4,31,1,0,1,3,3,1,2,3419,23,1410
4100,경기도,4114,광명시,,관내사전투표,1660,1660,907,705,33,2,6,1,0,0,0,1,0,0,1655,5,0
4100,경기도,4114,광명시,,철산2동제1투,633,332,157,161,7,0,4,0,0,0,1,0,0,1,331,1,301
4100,경기도,4114,광명시,,철산2동제2투,433,221,115,90,7,0,6,0,0,0,0,1,0,1,220,1,212
4100,경기도,4114,광명시,,철산2동제3투,2126,1229,596,564,31,2,15,0,0,1,2,1,1,0,1213,16,897
4100,경기도,4114,광명시,철산3동,소계,25082,20782,10002,9944,533,11,89,7,0,4,20,5,3,7,20625,157,4300
4100,경기도,4114,광명시,,관내사전투표,7233,7232,3953,3086,139,1,21,1,0,2,2,0,1,1,7207,25,1
4100,경기도,4114,광명시,,철산3동제1투,1895,1438,580,790,45,3,8,1,0,0,1,1,0,1,1430,8,457
4100,경기도,4114,광명시,,철산3동제2투,1941,1491,608,816,40,0,6,0,0,0,4,1,0,1,1476,15,450
4100,경기도,4114,광명시,,철산3동제3투,1920,1351,664,622,34,1,14,1,0,0,1,1,0,0,1338,13,569
4100,경기도,4114,광명시,,철산3동제4투,2474,1664,720,853,50,2,9,2,0,0,5,0,2,0,1643,21,810
4100,경기도,4114,광명시,,철산3동제5투,881,626,295,298,17,0,4,0,0,0,1,0,0,0,615,11,255
4100,경기도,4114,광명시,,철산3동제6투,2834,2225,1048,1076,67,2,5,0,0,1,5,0,0,1,2205,20,609
4100,경기도,4114,광명시,,철산3동제7투,1591,1280,622,585,43,1,7,2,0,1,0,0,0,0,1261,19,311
4100,경기도,4114,광명시,,철산3동제8투,2109,1739,778,899,42,0,7,0,0,0,0,2,0,1,1729,10,370
4100,경기도,4114,광명시,,철산3동제9투,2204,1736,734,919,56,1,8,0,0,0,1,0,0,2,1721,15,468
4100,경기도,4114,광명시,철산4동,소계,11043,8899,4965,3540,238,4,51,2,0,1,10,6,2,6,8825,74,2144
4100,경기도,4114,광명시,,관내사전투표,4300,4300,2657,1510,95,1,13,0,0,1,1,2,0,1,4281,19,0
4100,경기도,4114,광명시,,철산4동제1투,1641,867,418,391,25,2,9,0,0,0,4,1,1,4,855,12,774
4100,경기도,4114,광명시,,철산4동제2투,1392,1007,500,439,42,0,11,2,0,0,2,0,1,0,997,10,385
4100,경기도,4114,광명시,,철산4동제3투,1814,1399,710,624,38,1,9,0,0,0,3,0,0,1,1386,13,415
4100,경기도,4114,광명시,,철산4동제4투,1896,1326,680,576,38,0,9,0,0,0,0,3,0,0,1306,20,570
4100,경기도,4114,광명시,하안1동,소계,18878,15150,7765,6827,361,1,70,3,1,2,8,7,2,2,15049,101,3728
4100,경기도,4114,광명시,,관내사전투표,5410,5410,3115,2146,112,0,13,0,0,0,1,3,0,1,5391,19,0
4100,경기도,4114,광명시,,하안1동제1투,1715,1123,511,549,37,0,8,0,0,0,3,1,0,0,1109,14,592
4100,경기도,4114,광명시,,하안1동제2투,2229,1648,781,797,43,0,9,1,0,0,0,0,0,0,1631,17,581
4100,경기도,4114,광명시,,하안1동제3투,2980,1789,863,851,36,0,19,0,0,2,4,0,0,0,1775,14,1191
4100,경기도,4114,광명시,,하안1동제4투,2144,1672,776,825,51,1,5,0,0,0,0,1,0,0,1659,13,472
4100,경기도,4114,광명시,,하안1동제5투,2078,1592,785,751,33,0,12,1,0,0,0,1,0,0,1583,9,486
4100,경기도,4114,광명시,,하안1동제6투,2322,1916,934,908,49,0,4,1,1,0,0,1,2,1,1901,15,406
4100,경기도,4114,광명시,하안2동,소계,11211,8765,4669,3728,235,2,40,3,3,1,5,5,3,2,8696,69,2446
4100,경기도,4114,광명시,,관내사전투표,4180,4180,2419,1623,94,0,10,3,1,1,1,2,1,1,4156,24,0
4100,경기도,4114,광명시,,하안2동제1투,1457,883,418,411,30,0,8,0,0,0,1,0,0,0,868,15,574
4100,경기도,4114,광명시,,하안2동제2투,1696,1161,582,526,39,1,6,0,0,0,1,1,2,0,1158,3,535
4100,경기도,4114,광명시,,하안2동제3투,1869,1180,589,552,16,0,8,0,0,0,1,0,0,0,1166,14,689
4100,경기도,4114,광명시,,하안2동제4투,2009,1361,661,616,56,1,8,0,2,0,1,2,0,1,1348,13,648
4100,경기도,4114,광명시,하안3동,소계,16124,12684,6738,5472,267,4,58,4,1,3,10,9,4,4,12574,110,3440
4100,경기도,4114,광명시,,관내사전투표,4949,4947,2909,1916,76,0,15,1,1,0,1,3,0,0,4922,25,2
4100,경기도,4114,광명시,,하안3동제1투,2324,1624,769,787,44,0,10,0,0,0,2,0,1,0,1613,11,700
4100,경기도,4114,광명시,,하안3동제2투,1302,829,428,360,20,1,6,1,0,0,0,1,1,1,819,10,473
4100,경기도,4114,광명시,,하안3동제3투,1850,1317,644,613,32,1,8,0,0,0,3,1,0,0,1302,15,533
4100,경기도,4114,광명시,,하안3동제4투,1992,1547,748,728,46,0,6,0,0,1,1,0,0,1,1531,16,445
4100,경기도,4114,광명시,,하안3동제5투,1626,1220,637,528,32,1,6,1,0,1,1,2,0,0,1209,11,406
4100,경기도,4114,광명시,,하안3동제6투,1079,607,299,277,13,1,2,0,0,0,1,1,1,1,596,11,472
4100,경기도,4114,광명시,,하안3동제7투,1002,593,304,263,4,0,5,1,0,1,1,1,1,1,582,11,409
4100,경기도,4114,광명시,하안4동,소계,10414,8584,4695,3509,248,3,44,1,1,3,5,4,2,2,8517,67,1830
4100,경기도,4114,광명시,,관내사전투표,4470,4470,2668,1645,110,0,19,0,0,0,1,2,1,1,4447,23,0
4100,경기도,4114,광명시,,하안4동제1투,2007,1369,664,625,47,1,10,1,0,1,3,0,0,0,1352,17,638
4100,경기도,4114,광명시,,하안4동제2투,1979,1401,687,643,46,1,10,0,0,0,1,2,0,0,1390,11,578
4100,경기도,4114,광명시,,하안4동제3투,1958,1344,676,596,45,1,5,0,1,2,0,0,1,1,1328,16,614
4100,경기도,4114,광명시,소하1동,소계,23130,18485,10237,7541,432,7,82,6,0,6,7,14,8,7,18347,138,4645
4100,경기도,4114,광명시,,관내사전투표,6573,6573,4010,2425,101,0,11,0,0,0,0,1,1,2,6551,22,0
4100,경기도,4114,광명시,,소하1동제1투,2159,1500,798,621,48,1,14,0,0,0,1,0,2,1,1486,14,659
4100,경기도,4114,광명시,,소하1동제2투,2019,1508,802,638,41,3,4,0,0,0,0,3,1,0,1492,16,511
4100,경기도,4114,광명시,,소하1동제3투,2098,1511,755,688,42,0,13,2,0,1,1,2,0,0,1504,7,587
4100,경기도,4114,광명시,,소하1동제4투,3396,2190,1175,897,61,2,17,1,0,5,2,3,1,0,2164,26,1206
4100,경기도,4114,광명시,,소하1동제5투,2275,1648,786,794,44,0,2,0,0,0,1,1,1,0,1629,19,627
4100,경기도,4114,광명시,,소하1동제6투,1844,1481,792,615,41,1,7,1,0,0,2,0,2,1,1462,19,363
4100,경기도,4114,광명시,,소하1동제7투,2766,2074,1119,863,54,0,14,2,0,0,0,4,0,3,2059,15,692
4100,경기도,4114,광명시,소하2동,소계,22370,17222,9353,7136,429,4,112,1,2,1,13,21,6,10,17088,134,5148
4100,경기도,4114,광명시,,관내사전투표,5810,5810,3479,2156,110,1,24,1,0,1,2,8,4,2,5788,22,0
4100,경기도,4114,광명시,,소하2동제1투,2029,1278,606,613,26,0,14,0,0,0,2,2,0,0,1263,15,751
4100,경기도,4114,광명시,,소하2동제2투,2440,1518,803,630,48,1,16,0,0,0,3,2,0,1,1504,14,922
4100,경기도,4114,광명시,,소하2동제3투,2600,1717,928,708,51,0,14,0,1,0,3,1,0,1,1707,10,883
4100,경기도,4114,광명시,,소하2동제4투,2828,2049,1034,913,51,2,16,0,1,0,1,3,1,3,2025,24,779
4100,경기도,4114,광명시,,소하2동제5투,2272,1698,879,749,48,0,5,0,0,0,2,1,1,1,1686,12,574
4100,경기도,4114,광명시,,소하2동제6투,2243,1637,888,674,38,0,15,0,0,0,0,4,0,1,1620,17,606
4100,경기도,4114,광명시,,소하2동제7투,2148,1515,736,693,57,0,8,0,0,0,0,0,0,1,1495,20,633
4100,경기도,4114,광명시,학온동,소계,2109,1702,663,990,25,1,11,1,0,0,3,0,2,2,1698,4,407
4100,경기도,4114,광명시,,관내사전투표,954,954,434,496,14,0,5,1,0,0,0,0,1,1,952,2,0
4100,경기도,4114,광명시,,학온동제1투,530,332,97,225,6,0,2,0,0,0,2,0,0,0,332,0,198
4100,경기도,4114,광명시,,학온동제2투,625,416,132,269,5,1,4,0,0,0,1,0,1,1,414,2,209
4100,경기도,4114,광명시,일직동,소계,15021,12012,5784,5775,324,5,38,1,1,0,5,7,2,1,11943,69,3009
4100,경기도,4114,광명시,,관내사전투표,3933,3933,2074,1750,82,2,6,0,0,0,2,2,0,1,3919,14,0
4100,경기도,4114,광명시,,일직동제1투,1522,925,469,404,32,0,7,1,0,0,0,0,0,0,913,12,597
4100,경기도,4114,광명시,,일직동제2투,2641,2067,913,1084,46,0,6,0,0,0,1,0,1,0,2051,16,574
4100,경기도,4114,광명시,,일직동제3투,2553,1987,892,1004,70,1,6,0,0,0,2,3,0,0,1978,9,566
4100,경기도,4114,광명시,,일직동제4투,1422,1046,523,479,33,1,3,0,1,0,0,0,0,0,1040,6,376
4100,경기도,4114,광명시,,일직동제5투,2950,2054,913,1054,61,1,10,0,0,0,0,2,1,0,2042,12,896
4100,경기도,4114,광명시,잘못 투입·구분된 투표지,,0,5,1,2,2,0,0,0,0,0,0,0,0,0,5,0,-5
4100,경기도,4115,평택시,합계,,472732,338768,166032,156630,7988,166,3791,108,47,71,220,525,87,140,335805,2963,133964
4100,경기도,4115,평택시,거소·선상투표,,1437,1391,490,630,27,2,69,2,1,3,1,1,2,1,1229,162,46
4100,경기도,4115,평택시,관외사전투표,,33194,33193,15725,15706,831,26,443,18,10,7,8,39,9,14,32836,357,1
4100,경기도,4115,평택시,재외투표,,1589,1119,614,331,43,0,6,0,0,1,0,0,1,0,996,123,470
4100,경기도,4115,평택시,팽성읍,소계,23756,15437,6656,8150,253,9,195,4,0,4,12,18,5,8,15314,123,8319
4100,경기도,4115,평택시,,관내사전투표,5710,5709,2846,2702,71,3,58,1,0,1,2,4,2,0,5690,19,1
4100,경기도,4115,평택시,,팽성읍제1투,2596,1483,559,837,48,2,22,0,0,0,1,0,1,0,1470,13,1113
4100,경기도,4115,평택시,,팽성읍제2투,2621,1547,660,806,36,0,17,0,0,1,3,1,1,4,1529,18,1074
4100,경기도,4115,평택시,,팽성읍제3투,3366,1438,644,706,25,2,34,0,0,0,4,4,0,1,1420,18,1928
4100,경기도,4115,평택시,,팽성읍제4투,1712,869,294,542,8,0,13,1,0,0,0,1,0,0,859,10,843
4100,경기도,4115,평택시,,팽성읍제5투,1563,1000,319,650,12,0,4,1,0,1,0,2,1,0,990,10,563
4100,경기도,4115,평택시,,팽성읍제6투,1497,795,294,464,16,0,11,0,0,0,0,1,0,0,786,9,702
4100,경기도,4115,평택시,,팽성읍제7투,2158,1206,472,669,17,0,21,1,0,1,2,2,0,2,1187,19,952
4100,경기도,4115,평택시,,팽성읍제8투,2533,1390,568,774,20,2,15,0,0,0,0,3,0,1,1383,7,1143
4100,경기도,4115,평택시,안중읍,소계,31733,21949,11791,9095,571,10,252,5,1,5,22,49,5,6,21812,137,9784
4100,경기도,4115,평택시,,관내사전투표,7422,7420,4266,2860,177,3,57,1,0,1,3,25,0,1,7394,26,2
4100,경기도,4115,평택시,,안중읍제1투,3362,1832,827,892,50,1,33,0,1,1,5,3,3,1,1817,15,1530
4100,경기도,4115,평택시,,안중읍제2투,2764,1562,631,876,24,0,16,0,0,2,6,1,0,0,1556,6,1202
4100,경기도,4115,평택시,,안중읍제3투,1600,1015,480,473,26,0,23,0,0,0,3,2,0,1,1008,7,585
4100,경기도,4115,평택시,,안중읍제4투,1793,1036,601,393,17,0,10,0,0,0,1,1,1,2,1026,10,757
4100,경기도,4115,평택시,,안중읍제5투,2786,1712,948,674,59,0,11,0,0,0,0,3,0,0,1695,17,1074
4100,경기도,4115,평택시,,안중읍제6투,3438,1646,757,782,41,1,38,2,0,0,0,4,1,0,1626,20,1792
4100,경기도,4115,평택시,,안중읍제7투,3553,2369,1366,888,68,1,20,1,0,1,4,4,0,1,2354,15,1184
4100,경기도,4115,평택시,,안중읍제8투,2322,1582,900,588,55,2,24,0,0,0,0,4,0,0,1573,9,740
4100,경기도,4115,평택시,,안중읍제9투,2693,1775,1015,669,54,2,20,1,0,0,0,2,0,0,1763,12,918
4100,경기도,4115,평택시,포승읍,소계,19057,12413,6391,5441,251,3,178,6,3,1,7,29,3,11,12324,89,6644
4100,경기도,4115,평택시,,관내사전투표,5276,5274,2968,2108,97,2,47,5,1,1,1,18,1,4,5253,21,2
4100,경기도,4115,평택시,,포승읍제1투,1839,902,402,461,14,0,15,0,0,0,3,1,0,0,896,6,937
4100,경기도,4115,평택시,,포승읍제2투,986,626,233,357,17,1,11,0,0,0,0,1,0,2,622,4,360
4100,경기도,4115,평택시,,포승읍제3투,1506,782,355,392,8,0,19,0,1,0,1,2,0,0,778,4,724
4100,경기도,4115,평택시,,포승읍제4투,1940,962,466,446,23,0,14,0,1,0,2,0,0,1,953,9,978
4100,경기도,4115,평택시,,포승읍제5투,3721,1933,1086,744,41,0,32,1,0,0,0,2,1,1,1908,25,1788
4100,경기도,4115,평택시,,포승읍제6투,1421,794,336,410,20,0,16,0,0,0,0,3,1,1,787,7,627
4100,경기도,4115,평택시,,포승읍제7투,2368,1140,545,523,31,0,24,0,0,0,0,2,0,2,1127,13,1228
4100,경기도,4115,평택시,진위면,소계,9426,6369,2984,3081,151,5,79,2,2,1,4,13,3,6,6331,38,3057
4100,경기도,4115,평택시,,관내사전투표,2524,2524,1279,1144,54,1,19,1,1,0,0,5,2,4,2510,14,0
4100,경기도,4115,평택시,,진위면제1투,1741,946,330,565,28,0,14,0,0,1,0,1,0,0,939,7,795
4100,경기도,4115,평택시,,진위면제2투,1023,620,248,352,6,0,9,0,0,0,0,2,0,0,617,3,403
4100,경기도,4115,평택시,,진위면제3투,2538,1407,699,635,39,3,18,0,0,0,2,2,0,1,1399,8,1131
4100,경기도,4115,평택시,,진위면제4투,1600,872,428,385,24,1,19,1,1,0,2,3,1,1,866,6,728
4100,경기도,4115,평택시,서탄면,소계,3151,2297,909,1282,45,0,36,1,2,0,2,3,1,2,2283,14,854
4100,경기도,4115,평택시,,관내사전투표,1036,1036,446,548,20,0,13,0,0,0,1,2,0,1,1031,5,0
4100,경기도,4115,평택시,,서탄면제1투,851,519,195,296,11,0,9,0,2,0,1,0,1,0,515,4,332
4100,경기도,4115,평택시,,서탄면제2투,794,473,160,287,11,0,8,1,0,0,0,0,0,1,468,5,321
4100,경기도,4115,평택시,,서탄면제3투,470,269,108,151,3,0,6,0,0,0,0,1,0,0,269,0,201
4100,경기도,4115,평택시,고덕면,소계,10523,7195,3280,3574,169,1,85,1,2,1,8,26,1,1,7149,46,3328
4100,경기도,4115,평택시,,관내사전투표,2390,2389,1168,1119,47,1,19,0,0,0,2,20,0,0,2376,13,1
4100,경기도,4115,평택시,,고덕면제1투,2986,1910,982,822,58,0,29,0,1,1,3,4,1,0,1901,9,1076
4100,경기도,4115,평택시,,고덕면제2투,1753,948,292,627,14,0,10,0,0,0,0,0,0,1,944,4,805
4100,경기도,4115,평택시,,고덕면제3투,2281,1316,615,624,38,0,22,0,1,0,2,2,0,0,1304,12,965
4100,경기도,4115,평택시,,고덕면제4투,1113,632,223,382,12,0,5,1,0,0,1,0,0,0,624,8,481
4100,경기도,4115,평택시,오성면,소계,6132,4461,1892,2362,105,1,51,2,0,1,8,6,3,1,4432,29,1671
4100,경기도,4115,평택시,,관내사전투표,2211,2210,1060,1077,47,1,9,1,0,1,1,2,0,0,2199,11,1
4100,경기도,4115,평택시,,오성면제1투,2264,1204,502,617,39,0,27,0,0,0,5,2,2,0,1194,10,1060
4100,경기도,4115,평택시,,오성면제2투,1210,757,244,479,14,0,10,0,0,0,1,1,0,1,750,7,453
4100,경기도,4115,평택시,,오성면제3투,447,290,86,189,5,0,5,1,0,0,1,1,1,0,289,1,157
4100,경기도,4115,평택시,현덕면,소계,5580,4365,1928,2276,75,3,38,1,0,1,4,7,4,3,4340,25,1215
4100,경기도,4115,평택시,,관내사전투표,2642,2642,1342,1216,48,3,13,0,0,1,0,4,3,1,2631,11,0
4100,경기도,4115,평택시,,현덕면제1투,1314,712,295,379,11,0,16,1,0,0,1,0,0,0,703,9,602
4100,경기도,4115,평택시,,현덕면제2투,723,458,124,318,8,0,3,0,0,0,0,1,1,1,456,2,265
4100,경기도,4115,평택시,,현덕면제3투,901,553,167,363,8,0,6,0,0,0,3,2,0,1,550,3,348
4100,경기도,4115,평택시,중앙동,소계,34708,24041,11607,11209,597,15,274,9,2,8,13,47,6,11,23798,243,10667
4100,경기도,4115,평택시,,관내사전투표,7037,7026,3679,3064,138,10,60,3,0,0,3,18,0,4,6979,47,11
4100,경기도,4115,평택시,,중앙동제1투,2523,1109,471,568,21,0,21,1,1,0,0,4,0,0,1087,22,1414
4100,경기도,4115,평택시,,중앙동제2투,2899,1312,534,686,27,1,29,0,0,1,2,2,2,1,1285,27,1587
4100,경기도,4115,평택시,,중앙동제3투,3189,2062,974,985,53,1,29,0,0,2,0,2,2,0,2048,14,1127
4100,경기도,4115,평택시,,중앙동제4투,2349,1573,571,921,38,0,20,1,0,3,3,1,0,1,1559,14,776
4100,경기도,4115,평택시,,중앙동제5투,2861,1852,970,796,54,0,7,1,0,1,0,3,1,2,1835,17,1009
4100,경기도,4115,평택시,,중앙동제6투,3038,1916,982,834,52,0,31,0,0,0,0,3,0,2,1904,12,1122
4100,경기도,4115,평택시,,중앙동제7투,2634,1941,926,882,76,0,12,0,0,0,1,5,0,1,1903,38,693
4100,경기도,4115,평택시,,중앙동제8투,2659,1743,865,787,49,0,20,1,0,0,2,1,0,0,1725,18,916
4100,경기도,4115,평택시,,중앙동제9투,2717,1805,909,814,47,2,15,1,0,0,1,2,1,0,1792,13,912
4100,경기도,4115,평택시,,중앙동제10투,2802,1702,726,872,42,1,30,1,1,1,1,6,0,0,1681,21,1100
4100,경기도,4115,평택시,서정동,소계,21144,13368,6503,6205,260,6,187,4,1,3,17,16,3,10,13215,153,7776
4100,경기도,4115,평택시,,관내사전투표,4905,4905,2596,2125,90,4,35,2,1,1,3,6,0,2,4865,40,0
4100,경기도,4115,평택시,,서정동제1투,3035,1338,624,639,30,1,24,0,0,0,2,2,0,2,1324,14,1697
4100,경기도,4115,평택시,,서정동제2투,2701,1539,735,730,28,0,20,1,0,0,0,1,0,1,1516,23,1162
4100,경기도,4115,평택시,,서정동제3투,1821,967,439,462,18,0,23,1,0,1,3,2,0,2,951,16,854
4100,경기도,4115,평택시,,서정동제4투,1490,769,304,426,12,0,15,0,0,0,1,1,0,0,759,10,721
4100,경기도,4115,평택시,,서정동제5투,2642,1364,614,674,28,1,26,0,0,1,3,1,0,0,1348,16,1278
4100,경기도,4115,평택시,,서정동제6투,2185,1131,554,505,23,0,27,0,0,0,5,1,1,2,1118,13,1054
4100,경기도,4115,평택시,,서정동제7투,2365,1355,637,644,31,0,17,0,0,0,0,2,2,1,1334,21,1010
4100,경기도,4115,평택시,송탄동,소계,16434,11661,6051,5083,287,3,125,1,2,1,6,11,5,7,11582,79,4773
4100,경기도,4115,평택시,,관내사전투표,4056,4056,2236,1687,73,3,28,1,0,0,2,5,3,2,4040,16,0
4100,경기도,4115,평택시,,송탄동제1투,2121,1119,462,599,23,0,17,0,0,0,0,1,1,2,1105,14,1002
4100,경기도,4115,평택시,,송탄동제2투,2297,1342,633,644,33,0,17,0,1,0,0,0,0,2,1330,12,955
4100,경기도,4115,평택시,,송탄동제3투,3244,2331,1220,992,75,0,23,0,1,1,0,2,0,0,2314,17,913
4100,경기도,4115,평택시,,송탄동제4투,4716,2813,1500,1161,83,0,40,0,0,0,4,3,1,1,2793,20,1903
4100,경기도,4115,평택시,지산동,소계,11490,7211,3568,3271,151,3,114,4,1,2,2,9,1,2,7128,83,4279
4100,경기도,4115,평택시,,관내사전투표,3487,3487,1803,1557,65,3,28,2,1,0,0,5,1,0,3465,22,0
4100,경기도,4115,평택시,,지산동제1투,4596,1740,792,807,35,0,60,1,0,1,1,2,0,0,1699,41,2856
4100,경기도,4115,평택시,,지산동제2투,3407,1984,973,907,51,0,26,1,0,1,1,2,0,2,1964,20,1423
4100,경기도,4115,평택시,송북동,소계,17922,12368,5813,5977,309,7,139,2,0,2,6,12,1,7,12275,93,5554
4100,경기도,4115,평택시,,관내사전투표,5288,5286,2627,2464,129,3,37,1,0,1,0,6,0,1,5269,17,2
4100,경기도,4115,평택시,,송북동제1투,1675,797,353,409,14,0,12,0,0,0,2,0,0,0,790,7,878
4100,경기도,4115,평택시,,송북동제2투,2688,1311,523,719,26,1,25,1,0,0,2,1,0,2,1300,11,1377
4100,경기도,4115,평택시,,송북동제3투,3286,2067,888,1078,50,2,27,0,0,1,0,1,0,0,2047,20,1219
4100,경기도,4115,평택시,,송북동제4투,2302,1371,624,653,41,0,18,0,0,0,2,3,1,2,1344,27,931
4100,경기도,4115,평택시,,송북동제5투,2683,1536,798,654,49,1,20,0,0,0,0,1,0,2,1525,11,1147
4100,경기도,4115,평택시,신장1동,소계,5858,3716,1723,1777,95,5,58,3,0,2,3,3,0,1,3670,46,2142
4100,경기도,4115,평택시,,관내사전투표,1919,1918,943,890,49,4,16,1,0,2,1,3,0,0,1909,9,1
4100,경기도,4115,평택시,,신장1동제1투,1921,892,375,456,20,1,22,2,0,0,1,0,0,0,877,15,1029
4100,경기도,4115,평택시,,신장1동제2투,2018,906,405,431,26,0,20,0,0,0,1,0,0,1,884,22,1112
4100,경기도,4115,평택시,신장2동,소계,5430,3235,1395,1684,64,1,50,0,0,1,3,10,2,0,3210,25,2195
4100,경기도,4115,평택시,,관내사전투표,1741,1741,813,858,33,1,13,0,0,0,2,8,1,0,1729,12,0
4100,경기도,4115,평택시,,신장2동제1투,2238,785,283,448,21,0,22,0,0,1,0,1,1,0,777,8,1453
4100,경기도,4115,평택시,,신장2동제2투,1451,709,299,378,10,0,15,0,0,0,1,1,0,0,704,5,742
4100,경기도,4115,평택시,신평동,소계,18456,11849,5187,6123,259,2,131,10,2,5,8,19,6,6,11758,91,6607
4100,경기도,4115,평택시,,관내사전투표,3632,3630,1773,1731,70,0,20,2,0,2,2,5,1,2,3608,22,2
4100,경기도,4115,평택시,,신평동제1투,1747,999,391,551,22,0,19,0,0,2,0,0,0,1,986,13,748
4100,경기도,4115,평택시,,신평동제2투,2520,1066,429,570,34,0,16,3,0,0,3,1,0,0,1056,10,1454
4100,경기도,4115,평택시,,신평동제3투,2944,1653,605,984,27,0,15,3,0,1,0,3,1,1,1640,13,1291
4100,경기도,4115,평택시,,신평동제4투,3816,1982,903,981,47,0,27,1,1,0,2,3,3,0,1968,14,1834
4100,경기도,4115,평택시,,신평동제5투,1153,567,232,299,10,1,14,0,1,0,0,2,0,0,559,8,586
4100,경기도,4115,평택시,,신평동제6투,499,364,123,217,9,1,10,0,0,0,0,1,0,1,362,2,135
4100,경기도,4115,평택시,,신평동제7투,2145,1588,731,790,40,0,10,1,0,0,1,4,1,1,1579,9,557
4100,경기도,4115,평택시,원평동,소계,11659,8294,3827,4040,222,8,96,1,3,2,5,10,2,4,8220,74,3365
4100,경기도,4115,평택시,,관내사전투표,3882,3881,1940,1775,104,2,26,1,1,0,2,6,0,4,3861,20,1
4100,경기도,4115,평택시,,원평동제1투,2503,1212,492,653,20,3,25,0,2,0,2,2,1,0,1200,12,1291
4100,경기도,4115,평택시,,원평동제2투,2176,1376,651,638,47,0,22,0,0,2,0,1,0,0,1361,15,800
4100,경기도,4115,평택시,,원평동제3투,2427,1470,626,755,41,3,19,0,0,0,1,1,0,0,1446,24,957
4100,경기도,4115,평택시,,원평동제4투,671,355,118,219,10,0,4,0,0,0,0,0,1,0,352,3,316
4100,경기도,4115,평택시,통복동,소계,5211,4022,1803,2029,89,2,41,1,1,3,1,6,1,1,3978,44,1189
4100,경기도,4115,평택시,,관내사전투표,2589,2589,1241,1240,52,2,21,1,1,3,1,4,1,0,2567,22,0
4100,경기도,4115,평택시,,통복동제1투,1313,727,305,373,24,0,9,0,0,0,0,1,0,1,713,14,586
4100,경기도,4115,평택시,,통복동제2투,1309,706,257,416,13,0,11,0,0,0,0,1,0,0,698,8,603
4100,경기도,4115,평택시,비전1동,소계,36548,26469,13770,11525,672,12,234,6,3,2,13,46,2,4,26289,180,10079
4100,경기도,4115,평택시,,관내사전투표,7902,7902,4574,3049,165,3,44,4,1,2,1,19,1,1,7864,38,0
4100,경기도,4115,평택시,,비전1동제1투,2643,1685,724,874,43,2,25,0,0,0,1,2,0,0,1671,14,958
4100,경기도,4115,평택시,,비전1동제2투,1497,877,334,508,13,2,9,0,0,0,3,0,0,0,869,8,620
4100,경기도,4115,평택시,,비전1동제3투,2325,1692,808,805,49,2,10,0,0,0,0,1,0,0,1675,17,633
4100,경기도,4115,평택시,,비전1동제4투,1308,956,399,512,30,0,8,1,0,0,0,0,0,0,950,6,352
4100,경기도,4115,평택시,,비전1동제5투,1175,803,264,510,17,0,7,0,0,0,0,0,0,1,799,4,372
4100,경기도,4115,평택시,,비전1동제6투,2976,1691,844,743,45,0,40,1,0,0,1,5,0,0,1679,12,1285
4100,경기도,4115,평택시,,비전1동제7투,3815,2352,1273,965,57,0,30,0,0,0,1,7,0,0,2333,19,1463
4100,경기도,4115,평택시,,비전1동제8투,2933,1784,949,751,50,2,13,0,1,0,3,0,1,1,1771,13,1149
4100,경기도,4115,평택시,,비전1동제9투,2572,1709,880,746,54,0,10,0,0,0,1,8,0,1,1700,9,863
4100,경기도,4115,평택시,,비전1동제10투,2578,1641,853,710,45,0,13,0,1,0,0,2,0,0,1624,17,937
4100,경기도,4115,평택시,,비전1동제11투,1848,1300,739,481,54,0,15,0,0,0,1,0,0,0,1290,10,548
4100,경기도,4115,평택시,,비전1동제12투,2976,2077,1129,871,50,1,10,0,0,0,1,2,0,0,2064,13,899
4100,경기도,4115,평택시,비전2동,소계,40673,29554,14212,14040,747,15,215,6,4,2,26,47,6,12,29332,222,11119
4100,경기도,4115,평택시,,관내사전투표,8516,8516,4297,3919,185,7,38,0,0,0,4,16,2,3,8471,45,0
4100,경기도,4115,평택시,,비전2동제1투,2052,1276,577,651,24,0,8,0,1,0,2,4,0,0,1267,9,776
4100,경기도,4115,평택시,,비전2동제2투,1793,1066,444,566,27,0,14,2,0,0,1,2,0,0,1056,10,727
4100,경기도,4115,평택시,,비전2동제3투,2157,1209,458,687,37,0,15,0,0,0,2,0,1,0,1200,9,948
4100,경기도,4115,평택시,,비전2동제4투,2581,1421,626,726,36,0,14,1,0,0,1,6,0,1,1411,10,1160
4100,경기도,4115,평택시,,비전2동제5투,1947,1367,651,644,30,1,17,0,0,0,2,4,0,0,1349,18,580
4100,경기도,4115,평택시,,비전2동제6투,1775,1251,579,620,32,0,7,1,0,0,0,0,0,2,1241,10,524
4100,경기도,4115,평택시,,비전2동제7투,2540,1669,688,901,39,0,16,0,0,1,2,1,0,2,1650,19,871
4100,경기도,4115,평택시,,비전2동제8투,2519,1623,742,792,44,1,14,0,0,1,5,2,0,1,1602,21,896
4100,경기도,4115,평택시,,비전2동제9투,3897,2630,1213,1271,88,2,21,1,1,0,4,4,1,2,2608,22,1267
4100,경기도,4115,평택시,,비전2동제10투,2763,2010,996,934,55,1,8,0,0,0,2,1,1,0,1998,12,753
4100,경기도,4115,평택시,,비전2동제11투,4437,3070,1619,1331,76,2,17,1,1,0,0,6,0,0,3053,17,1367
4100,경기도,4115,평택시,,비전2동제12투,3696,2446,1322,998,74,1,26,0,1,0,1,1,1,1,2426,20,1250
4100,경기도,4115,평택시,세교동,소계,22197,15678,7680,7318,346,3,144,5,2,4,7,34,6,4,15553,125,6519
4100,경기도,4115,평택시,,관내사전투표,5484,5484,3006,2283,121,3,29,0,0,1,0,8,2,2,5455,29,0
4100,경기도,4115,평택시,,세교동제1투,2746,1707,750,872,36,0,23,0,0,2,2,6,0,0,1691,16,1039
4100,경기도,4115,평택시,,세교동제2투,2801,1546,685,802,20,0,18,0,0,0,4,0,1,1,1531,15,1255
4100,경기도,4115,평택시,,세교동제3투,622,388,134,248,1,0,4,0,0,0,0,0,0,0,387,1,234
4100,경기도,4115,평택시,,세교동제4투,1043,563,223,313,8,0,12,0,0,0,0,2,2,0,560,3,480
4100,경기도,4115,평택시,,세교동제5투,2431,1500,752,656,47,0,14,1,1,0,0,8,0,0,1479,21,931
4100,경기도,4115,평택시,,세교동제6투,2807,1830,831,901,43,0,19,2,0,1,0,7,1,1,1806,24,977
4100,경기도,4115,평택시,,세교동제7투,4263,2660,1299,1243,70,0,25,2,1,0,1,3,0,0,2644,16,1603
4100,경기도,4115,평택시,청북읍,소계,18636,12947,7212,5212,274,5,140,4,1,1,10,19,4,6,12888,59,5689
4100,경기도,4115,평택시,,관내사전투표,4264,4264,2547,1578,78,1,35,1,0,0,0,8,1,1,4250,14,0
4100,경기도,4115,평택시,,청북읍제1투,1443,742,248,462,12,0,12,0,0,0,1,0,0,2,737,5,701
4100,경기도,4115,평택시,,청북읍제2투,1302,724,239,460,16,1,4,0,0,0,0,0,1,0,721,3,578
4100,경기도,4115,평택시,,청북읍제3투,753,483,128,333,7,0,7,0,0,0,2,2,1,1,481,2,270
4100,경기도,4115,평택시,,청북읍제4투,3555,2067,1261,698,55,2,27,2,0,0,3,7,1,1,2057,10,1488
4100,경기도,4115,평택시,,청북읍제5투,4393,2744,1595,1032,63,0,37,0,0,0,3,0,0,1,2731,13,1649
4100,경기도,4115,평택시,,청북읍제6투,2926,1923,1194,649,43,1,18,1,1,1,1,2,0,0,1911,12,1003
4100,경기도,4115,평택시,용이동,소계,19405,14473,7838,6054,336,6,128,3,1,2,8,16,0,3,14395,78,4932
4100,경기도,4115,평택시,,관내사전투표,4891,4891,2831,1894,98,2,38,0,0,0,0,9,0,1,4873,18,0
4100,경기도,4115,평택시,,용이동제1투,2879,1266,582,612,28,2,29,0,1,1,0,1,0,0,1256,10,1613
4100,경기도,4115,평택시,,용이동제2투,1868,1379,800,523,38,0,8,0,0,0,1,1,0,0,1371,8,489
4100,경기도,4115,평택시,,용이동제3투,2473,1872,1011,779,59,0,10,0,0,0,0,1,0,0,1860,12,601
4100,경기도,4115,평택시,,용이동제4투,2874,2203,1073,1053,44,0,14,1,0,1,2,2,0,0,2190,13,671
4100,경기도,4115,평택시,,용이동제5투,2121,1526,842,614,46,0,18,0,0,0,1,0,0,0,1521,5,595
4100,경기도,4115,평택시,,용이동제6투,2299,1336,699,579,23,2,11,2,0,0,4,2,0,2,1324,12,963
4100,경기도,4115,평택시,동삭동,소계,26057,18655,9774,8064,463,5,154,2,2,5,11,20,5,7,18512,143,7402
4100,경기도,4115,평택시,,관내사전투표,5484,5486,3107,2178,115,2,35,1,1,2,1,7,1,1,5451,35,-2
4100,경기도,4115,평택시,,동삭동제1투,3724,2371,1183,1096,51,1,19,0,0,0,2,3,1,1,2357,14,1353
4100,경기도,4115,평택시,,동삭동제2투,2918,2040,1014,945,53,0,14,1,0,1,0,0,0,0,2028,12,878
4100,경기도,4115,평택시,,동삭동제3투,2306,1462,707,656,57,0,14,0,0,1,2,1,0,2,1440,22,844
4100,경기도,4115,평택시,,동삭동제4투,2101,1489,764,666,38,1,10,0,0,1,1,3,0,0,1484,5,612
4100,경기도,4115,평택시,,동삭동제5투,3137,2219,1184,955,51,0,15,0,0,0,1,2,0,0,2208,11,918
4100,경기도,4115,평택시,,동삭동제6투,2327,1557,800,671,52,1,11,0,1,0,3,2,2,2,1545,12,770
4100,경기도,4115,평택시,,동삭동제7투,4060,2031,1015,897,46,0,36,0,0,0,1,2,1,1,1999,32,2029
4100,경기도,4115,평택시,고덕동,소계,15326,11036,5408,5090,296,8,129,5,1,1,5,9,0,2,10954,82,4290
4100,경기도,4115,평택시,,관내사전투표,3914,3914,2106,1635,99,5,45,1,0,0,2,5,0,0,3898,16,0
4100,경기도,4115,평택시,,고덕동제1투,3237,1966,993,882,44,1,24,0,1,1,0,0,0,1,1947,19,1271
4100,경기도,4115,평택시,,고덕동제2투,3031,2178,921,1155,65,0,17,2,0,0,1,2,0,0,2163,15,853
4100,경기도,4115,평택시,,고덕동제3투,2684,1583,739,740,49,1,25,2,0,0,2,2,0,1,1561,22,1101
4100,경기도,4115,평택시,,고덕동제4투,2460,1395,649,678,39,1,18,0,0,0,0,0,0,0,1385,10,1065
4100,경기도,4115,평택시,잘못 투입·구분된 투표지,,0,2,1,1,0,0,0,0,0,0,0,0,0,0,2,0,-2
4100,경기도,4116,양주시,합계,,197345,145562,75236,63800,3162,65,1475,36,20,31,111,287,41,70,144334,1228,51783
4100,경기도,4116,양주시,거소·선상투표,,708,597,234,228,16,4,15,2,2,0,1,1,2,1,506,91,111
4100,경기도,4116,양주시,관외사전투표,,16191,16189,8429,6940,392,10,210,7,2,3,7,44,4,8,16056,133,2
4100,경기도,4116,양주시,재외투표,,674,500,327,125,9,0,4,0,0,0,0,0,0,0,465,35,174
4100,경기도,4116,양주시,백석읍,소계,20638,14414,6963,6812,310,5,158,2,1,5,14,31,6,9,14316,98,6224
4100,경기도,4116,양주시,,관내사전투표,5459,5460,2837,2420,126,2,35,0,0,1,5,13,2,2,5443,17,-1
4100,경기도,4116,양주시,,백석읍제1투,2776,1341,585,698,19,1,22,1,0,0,0,2,0,2,1330,11,1435
4100,경기도,4116,양주시,,백석읍제2투,2217,1301,597,636,20,0,19,0,0,1,2,2,2,1,1280,21,916
4100,경기도,4116,양주시,,백석읍제3투,1597,911,334,534,14,0,15,0,0,0,3,1,0,0,901,10,686
4100,경기도,4116,양주시,,백석읍제4투,2862,1751,831,831,44,1,15,0,1,2,1,5,0,4,1735,16,1111
4100,경기도,4116,양주시,,백석읍제5투,1743,1033,455,525,25,0,17,0,0,0,1,3,1,0,1027,6,710
4100,경기도,4116,양주시,,백석읍제6투,1994,1259,628,569,35,0,14,0,0,1,0,3,1,0,1251,8,735
4100,경기도,4116,양주시,,백석읍제7투,1990,1358,696,599,27,1,21,1,0,0,2,2,0,0,1349,9,632
4100,경기도,4116,양주시,은현면,소계,5161,3742,1522,2047,52,0,62,1,0,1,2,9,4,4,3704,38,1419
4100,경기도,4116,양주시,,관내사전투표,1776,1776,815,881,24,0,29,0,0,0,0,4,1,1,1755,21,0
4100,경기도,4116,양주시,,은현면제1투,834,463,167,275,3,0,6,1,0,0,0,2,1,2,457,6,371
4100,경기도,4116,양주시,,은현면제2투,1340,753,271,450,7,0,13,0,0,0,1,3,2,0,747,6,587
4100,경기도,4116,양주시,,은현면제3투,606,360,135,206,12,0,3,0,0,1,0,0,0,0,357,3,246
4100,경기도,4116,양주시,,은현면제4투,605,390,134,235,6,0,11,0,0,0,1,0,0,1,388,2,215
4100,경기도,4116,양주시,남면,소계,5746,3957,1606,2188,72,0,38,0,3,2,4,4,2,9,3928,29,1789
4100,경기도,4116,양주시,,관내사전투표,1781,1781,756,941,35,0,21,0,3,2,2,2,2,5,1769,12,0
4100,경기도,4116,양주시,,남면제1투,1627,832,352,445,15,0,6,0,0,0,2,2,0,1,823,9,795
4100,경기도,4116,양주시,,남면제2투,598,366,118,236,6,0,5,0,0,0,0,0,0,0,365,1,232
4100,경기도,4116,양주시,,남면제3투,1207,643,257,370,6,0,4,0,0,0,0,0,0,2,639,4,564
4100,경기도,4116,양주시,,남면제4투,533,335,123,196,10,0,2,0,0,0,0,0,0,1,332,3,198
4100,경기도,4116,양주시,광적면,소계,10385,7441,3444,3717,119,6,81,1,0,3,5,7,5,4,7392,49,2944
4100,경기도,4116,양주시,,관내사전투표,4253,4253,2099,2005,70,2,38,1,0,1,1,6,1,2,4226,27,0
4100,경기도,4116,양주시,,광적면제1투,2994,1362,592,714,18,0,24,0,0,2,2,0,2,1,1355,7,1632
4100,경기도,4116,양주시,,광적면제2투,2064,1141,523,572,22,3,12,0,0,0,1,1,0,0,1134,7,923
4100,경기도,4116,양주시,,광적면제3투,245,172,45,120,2,0,2,0,0,0,0,0,0,0,169,3,73
4100,경기도,4116,양주시,,광적면제4투,829,513,185,306,7,1,5,0,0,0,1,0,2,1,508,5,316
4100,경기도,4116,양주시,장흥면,소계,8742,6052,2520,3223,119,3,114,1,0,1,8,8,2,0,5999,53,2690
4100,경기도,4116,양주시,,관내사전투표,2700,2700,1258,1351,44,0,24,0,0,1,1,1,2,0,2682,18,0
4100,경기도,4116,양주시,,장흥면제1투,2696,1479,505,856,36,2,62,0,0,0,2,2,0,0,1465,14,1217
4100,경기도,4116,양주시,,장흥면제2투,969,564,216,321,13,0,8,0,0,0,2,0,0,0,560,4,405
4100,경기도,4116,양주시,,장흥면제3투,2377,1309,541,695,26,1,20,1,0,0,3,5,0,0,1292,17,1068
4100,경기도,4116,양주시,양주1동,소계,5222,3976,1834,1973,88,5,32,0,2,1,3,3,2,1,3944,32,1246
4100,경기도,4116,양주시,,관내사전투표,1844,1844,971,795,50,4,7,0,0,1,0,2,0,0,1830,14,0
4100,경기도,4116,양주시,,양주1동제1투,1098,654,232,396,9,0,9,0,1,0,2,0,1,0,650,4,444
4100,경기도,4116,양주시,,양주1동제2투,699,491,156,314,10,0,5,0,0,0,1,0,0,0,486,5,208
4100,경기도,4116,양주시,,양주1동제3투,1581,987,475,468,19,1,11,0,1,0,0,1,1,1,978,9,594
4100,경기도,4116,양주시,양주2동,소계,36330,26251,14495,10727,583,8,209,4,1,5,17,29,6,7,26091,160,10079
4100,경기도,4116,양주시,,관내사전투표,8097,8096,4850,3027,121,2,35,3,0,3,0,11,1,1,8054,42,1
4100,경기도,4116,양주시,,양주2동제1투,2787,1748,883,785,46,0,18,0,0,0,4,1,1,0,1738,10,1039
4100,경기도,4116,양주시,,양주2동제2투,3018,1984,1042,851,52,1,16,0,0,0,2,1,0,0,1965,19,1034
4100,경기도,4116,양주시,,양주2동제3투,3138,2102,1126,881,48,0,29,1,0,0,2,1,2,1,2091,11,1036
4100,경기도,4116,양주시,,양주2동제4투,2572,1725,915,746,40,1,12,0,0,0,1,0,0,1,1716,9,847
4100,경기도,4116,양주시,,양주2동제5투,3663,2480,1394,971,55,0,30,0,1,2,2,6,0,1,2462,18,1183
4100,경기도,4116,양주시,,양주2동제6투,2835,1917,1020,820,44,1,19,0,0,0,1,2,1,1,1909,8,918
4100,경기도,4116,양주시,,양주2동제7투,2475,1508,814,612,55,0,12,0,0,0,2,1,0,0,1496,12,967
4100,경기도,4116,양주시,,양주2동제8투,2494,1427,696,669,29,1,13,0,0,0,3,3,0,1,1415,12,1067
4100,경기도,4116,양주시,,양주2동제9투,3036,1814,972,767,47,0,15,0,0,0,0,2,1,1,1805,9,1222
4100,경기도,4116,양주시,,양주2동제10투,2215,1450,783,598,46,2,10,0,0,0,0,1,0,0,1440,10,765
4100,경기도,4116,양주시,회천1동,소계,8640,6387,3185,2926,118,2,68,2,1,1,4,13,2,2,6324,63,2253
4100,경기도,4116,양주시,,관내사전투표,3349,3349,1777,1447,57,1,26,0,0,1,0,9,1,2,3321,28,0
4100,경기도,4116,양주시,,회천1동제1투,2327,1297,632,608,31,1,12,0,1,0,1,0,1,0,1287,10,1030
4100,경기도,4116,양주시,,회천1동제2투,2150,1240,598,574,26,0,18,2,0,0,2,3,0,0,1223,17,910
4100,경기도,4116,양주시,,회천1동제3투,814,501,178,297,4,0,12,0,0,0,1,1,0,0,493,8,313
4100,경기도,4116,양주시,회천2동,소계,21485,14894,7999,6171,335,4,150,6,6,1,20,54,3,8,14757,137,6591
4100,경기도,4116,양주시,,관내사전투표,5792,5792,3391,2194,82,2,40,1,2,1,3,37,0,2,5755,37,0
4100,경기도,4116,양주시,,회천2동제1투,2811,1450,733,627,39,0,19,0,0,0,4,4,1,2,1429,21,1361
4100,경기도,4116,양주시,,회천2동제2투,3121,1678,856,724,43,0,24,1,1,0,4,3,0,0,1656,22,1443
4100,경기도,4116,양주시,,회천2동제3투,1729,1047,543,437,31,1,19,0,0,0,1,2,1,0,1035,12,682
4100,경기도,4116,양주시,,회천2동제4투,2248,1304,638,596,38,0,13,0,1,0,3,3,0,0,1292,12,944
4100,경기도,4116,양주시,,회천2동제5투,2600,1722,859,775,46,1,11,4,1,0,5,1,0,4,1707,15,878
4100,경기도,4116,양주시,,회천2동제6투,3184,1901,979,818,56,0,24,0,1,0,0,4,1,0,1883,18,1283
4100,경기도,4116,양주시,회천3동,소계,20748,15104,8002,6375,393,11,129,5,1,4,8,29,0,11,14968,136,5644
4100,경기도,4116,양주시,,관내사전투표,6310,6310,3582,2479,139,4,45,3,0,1,1,6,0,2,6262,48,0
4100,경기도,4116,양주시,,회천3동제1투,1835,1082,492,534,27,1,11,0,0,1,0,6,0,1,1073,9,753
4100,경기도,4116,양주시,,회천3동제2투,2764,1510,790,636,37,2,14,1,0,0,2,4,0,0,1486,24,1254
4100,경기도,4116,양주시,,회천3동제3투,2702,1583,848,638,53,0,23,0,0,0,3,4,0,1,1570,13,1119
4100,경기도,4116,양주시,,회천3동제4투,1890,1336,594,663,45,0,11,1,0,1,1,0,0,2,1318,18,554
4100,경기도,4116,양주시,,회천3동제5투,2300,1349,698,574,46,2,13,0,0,0,0,1,0,5,1339,10,951
4100,경기도,4116,양주시,,회천3동제6투,2947,1934,998,851,46,2,12,0,1,1,1,8,0,0,1920,14,1013
4100,경기도,4116,양주시,회천4동,소계,36675,26056,14674,10348,556,7,205,5,1,4,18,55,3,6,25882,174,10619
4100,경기도,4116,양주시,,관내사전투표,7021,7020,4243,2567,111,3,32,1,0,1,4,31,1,1,6995,25,1
4100,경기도,4116,양주시,,회천4동제1투,3270,1911,943,879,32,0,20,0,0,1,4,3,1,0,1883,28,1359
4100,경기도,4116,양주시,,회천4동제2투,1493,781,360,390,15,0,6,0,0,0,2,2,0,0,775,6,712
4100,경기도,4116,양주시,,회천4동제3투,2402,1306,677,555,43,0,19,0,0,0,3,1,0,2,1300,6,1096
4100,경기도,4116,양주시,,회천4동제4투,2438,1685,944,669,41,1,16,1,0,1,0,2,0,0,1675,10,753
4100,경기도,4116,양주시,,회천4동제5투,1911,1196,617,525,31,0,10,0,0,0,0,2,0,0,1185,11,715
4100,경기도,4116,양주시,,회천4동제6투,2529,1948,962,904,50,0,11,1,0,0,3,0,0,0,1931,17,581
4100,경기도,4116,양주시,,회천4동제7투,2909,2016,1215,724,42,1,16,0,0,0,0,6,0,0,2004,12,893
4100,경기도,4116,양주시,,회천4동제8투,2434,1622,1067,466,54,0,11,1,0,0,0,2,0,0,1601,21,812
4100,경기도,4116,양주시,,회천4동제9투,2227,1347,830,455,33,0,14,0,1,1,0,3,0,0,1337,10,880
4100,경기도,4116,양주시,,회천4동제10투,2906,1931,1019,836,46,2,12,0,0,0,0,1,1,2,1919,12,975
4100,경기도,4116,양주시,,회천4동제11투,2940,1927,1037,819,29,0,29,1,0,0,1,2,0,1,1919,8,1013
4100,경기도,4116,양주시,,회천4동제12투,2195,1366,760,559,29,0,9,0,0,0,1,0,0,0,1358,8,829
4100,경기도,4116,양주시,잘못 투입·구분된 투표지,,0,2,2,0,0,0,0,0,0,0,0,0,0,0,2,0,-2
4100,경기도,4117,동두천시,합계,,81075,57532,28495,26434,1125,26,647,14,11,22,61,141,24,32,57032,500,23543
4100,경기도,4117,동두천시,거소·선상투표,,245,234,106,83,3,2,6,0,1,0,0,3,0,0,204,30,11
4100,경기도,4117,동두천시,관외사전투표,,5367,5361,2707,2299,137,3,96,0,1,3,1,51,1,6,5305,56,6
4100,경기도,4117,동두천시,재외투표,,298,192,122,49,3,1,1,0,0,0,0,0,0,0,176,16,106
4100,경기도,4117,동두천시,생연1동,소계,5784,3830,1839,1842,57,1,55,1,0,0,1,7,4,2,3809,21,1954
4100,경기도,4117,동두천시,,관내사전투표,1831,1831,938,834,23,0,18,0,0,0,1,6,3,1,1824,7,0
4100,경기도,4117,동두천시,,생연1동제1투,1940,956,450,461,22,0,16,0,0,0,0,1,0,1,951,5,984
4100,경기도,4117,동두천시,,생연1동제2투,2013,1043,451,547,12,1,21,1,0,0,0,0,1,0,1034,9,970
4100,경기도,4117,동두천시,생연2동,소계,9425,6635,3312,3025,128,3,77,3,2,5,7,13,2,5,6582,53,2790
4100,경기도,4117,동두천시,,관내사전투표,2837,2837,1533,1213,42,2,16,3,1,2,2,7,0,3,2824,13,0
4100,경기도,4117,동두천시,,생연2동제1투,1356,749,319,383,27,0,10,0,0,1,0,1,0,0,741,8,607
4100,경기도,4117,동두천시,,생연2동제2투,2487,1490,715,697,34,1,18,0,0,0,3,4,1,2,1475,15,997
4100,경기도,4117,동두천시,,생연2동제3투,917,489,224,243,6,0,9,0,0,0,1,1,0,0,484,5,428
4100,경기도,4117,동두천시,,생연2동제4투,1828,1070,521,489,19,0,24,0,1,2,1,0,1,0,1058,12,758
4100,경기도,4117,동두천시,중앙동,소계,4793,3229,1452,1666,40,1,40,0,2,2,1,6,1,2,3213,16,1564
4100,경기도,4117,동두천시,,관내사전투표,1797,1797,833,919,22,0,10,0,0,1,1,5,0,1,1792,5,0
4100,경기도,4117,동두천시,,중앙동제1투,1857,866,376,446,14,0,19,0,0,1,0,0,1,1,858,8,991
4100,경기도,4117,동두천시,,중앙동제2투,1139,566,243,301,4,1,11,0,2,0,0,1,0,0,563,3,573
4100,경기도,4117,동두천시,보산동,소계,2683,1814,826,905,33,1,25,0,0,2,5,2,2,0,1801,13,869
4100,경기도,4117,동두천시,,관내사전투표,960,960,467,457,18,0,10,0,0,0,1,2,1,0,956,4,0
4100,경기도,4117,동두천시,,보산동투표소,1723,854,359,448,15,1,15,0,0,2,4,0,1,0,845,9,869
4100,경기도,4117,동두천시,불현동,소계,19837,13098,6505,6025,251,4,137,5,1,1,16,24,6,8,12983,115,6739
4100,경기도,4117,동두천시,,관내사전투표,4780,4780,2592,2045,73,2,28,2,0,0,0,12,1,2,4757,23,0
4100,경기도,4117,동두천시,,불현동제1투,3398,1729,812,814,43,0,32,0,1,1,6,1,1,1,1712,17,1669
4100,경기도,4117,동두천시,,불현동제2투,1525,814,385,378,14,1,12,0,0,0,3,2,1,1,797,17,711
4100,경기도,4117,동두천시,,불현동제3투,1675,906,392,458,23,0,14,1,0,0,3,2,1,0,894,12,769
4100,경기도,4117,동두천시,,불현동제4투,2896,1677,848,749,37,0,20,1,0,0,1,2,0,1,1659,18,1219
4100,경기도,4117,동두천시,,불현동제5투,3946,2246,1097,1053,43,0,22,0,0,0,3,5,0,1,2224,22,1700
4100,경기도,4117,동두천시,,불현동제6투,1617,946,379,528,18,1,9,1,0,0,0,0,2,2,940,6,671
4100,경기도,4117,동두천시,송내동,소계,20407,14618,7694,6353,300,6,115,2,1,6,11,20,3,6,14517,101,5789
4100,경기도,4117,동두천시,,관내사전투표,6602,6602,3705,2676,121,3,41,1,0,3,4,12,0,2,6568,34,0
4100,경기도,4117,동두천시,,송내동제1투,3892,2175,1079,1009,50,0,20,0,0,0,0,1,0,0,2159,16,1717
4100,경기도,4117,동두천시,,송내동제2투,2952,1916,979,840,52,0,15,0,1,0,2,4,2,1,1896,20,1036
4100,경기도,4117,동두천시,,송내동제3투,2859,1558,777,725,26,2,12,1,0,1,1,0,0,1,1546,12,1301
4100,경기도,4117,동두천시,,송내동제4투,3570,2027,1020,910,43,1,25,0,0,2,4,2,1,2,2010,17,1543
4100,경기도,4117,동두천시,,송내동제5투,532,340,134,193,8,0,2,0,0,0,0,1,0,0,338,2,192
4100,경기도,4117,동두천시,소요동,소계,7514,5174,2367,2576,101,3,44,3,1,3,11,12,3,2,5126,48,2340
4100,경기도,4117,동두천시,,관내사전투표,2020,2020,996,940,30,3,15,2,1,1,4,4,1,1,1998,22,0
4100,경기도,4117,동두천시,,소요동제1투,983,478,214,235,7,0,13,0,0,0,0,0,0,0,469,9,505
4100,경기도,4117,동두천시,,소요동제2투,1900,1108,555,504,27,0,7,0,0,0,5,3,0,0,1101,7,792
4100,경기도,4117,동두천시,,소요동제3투,419,283,111,159,8,0,2,0,0,0,1,0,1,0,282,1,136
4100,경기도,4117,동두천시,,소요동제4투,1418,871,349,486,20,0,3,0,0,1,1,5,0,0,865,6,547
4100,경기도,4117,동두천시,,소요동제5투,774,414,142,252,9,0,4,1,0,1,0,0,1,1,411,3,360
4100,경기도,4117,동두천시,상패동,소계,4722,3346,1564,1611,72,1,51,0,2,0,8,3,2,1,3315,31,1376
4100,경기도,4117,동두천시,,관내사전투표,1659,1659,827,761,31,1,18,0,1,0,2,1,2,0,1644,15,0
4100,경기도,4117,동두천시,,상패동제1투,1943,1022,419,538,26,0,18,0,1,0,4,2,0,1,1009,13,921
4100,경기도,4117,동두천시,,상패동제2투,1120,665,318,312,15,0,15,0,0,0,2,0,0,0,662,3,455
4100,경기도,4117,동두천시,잘못 투입·구분된 투표지,,0,1,1,0,0,0,0,0,0,0,0,0,0,0,1,0,-1
4100,경기도,4118,안산시상록구,합계,,303413,222254,121488,90654,5103,165,2092,60,32,48,152,237,58,106,220195,2059,81159
4100,경기도,4118,안산시상록구,거소·선상투표,,620,587,244,224,12,5,26,1,0,0,1,2,0,2,517,70,33
4100,경기도,4118,안산시상록구,관외사전투표,,23763,23760,12820,9701,596,17,307,7,1,9,6,29,8,12,23513,247,3
4100,경기도,4118,안산시상록구,재외투표,,1133,821,464,247,40,0,3,0,0,0,0,0,0,0,754,67,312
4100,경기도,4118,안산시상록구,일동,소계,20022,13515,8000,4933,269,16,124,7,1,5,5,25,3,7,13395,120,6507
4100,경기도,4118,안산시상록구,,관내사전투표,5489,5489,3534,1784,92,4,26,2,0,2,1,11,0,2,5458,31,0
4100,경기도,4118,안산시상록구,,일동제1투,3623,1793,1003,720,30,1,14,0,0,1,2,1,2,1,1775,18,1830
4100,경기도,4118,안산시상록구,,일동제2투,3241,1820,954,757,45,3,32,0,0,1,0,3,0,1,1796,24,1421
4100,경기도,4118,안산시상록구,,일동제3투,4444,2563,1460,975,50,5,26,4,1,1,2,7,1,1,2533,30,1881
4100,경기도,4118,안산시상록구,,일동제4투,3225,1850,1049,697,52,3,26,1,0,0,0,3,0,2,1833,17,1375
4100,경기도,4118,안산시상록구,이동,소계,19182,12350,6692,5072,277,12,144,3,3,3,11,13,6,4,12240,110,6832
4100,경기도,4118,안산시상록구,,관내사전투표,3744,3744,2266,1341,70,3,31,1,0,2,1,7,1,1,3724,20,0
4100,경기도,4118,안산시상록구,,이동제1투,2231,1273,696,507,31,1,22,0,1,0,2,1,0,1,1262,11,958
4100,경기도,4118,안산시상록구,,이동제2투,2541,1344,734,530,35,3,22,1,0,0,1,0,1,0,1327,17,1197
4100,경기도,4118,안산시상록구,,이동제3투,2760,1341,721,546,29,0,22,1,1,0,0,2,1,1,1324,17,1419
4100,경기도,4118,안산시상록구,,이동제4투,2174,1069,547,440,33,3,22,0,1,1,3,1,3,1,1055,14,1105
4100,경기도,4118,안산시상록구,,이동제5투,3818,2150,1060,1004,44,2,19,0,0,0,3,0,0,0,2132,18,1668
4100,경기도,4118,안산시상록구,,이동제6투,1914,1429,668,704,35,0,6,0,0,0,1,2,0,0,1416,13,485
4100,경기도,4118,안산시상록구,본오1동,소계,28883,18606,10931,6815,400,10,193,4,4,5,9,20,5,12,18408,198,10277
4100,경기도,4118,안산시상록구,,관내사전투표,6309,6309,4023,2079,116,2,37,2,0,1,2,8,3,4,6277,32,0
4100,경기도,4118,안산시상록구,,본오1동제1투,3202,1662,890,671,48,0,28,0,2,1,1,2,0,1,1644,18,1540
4100,경기도,4118,안산시상록구,,본오1동제2투,2995,1615,936,582,45,2,22,0,0,1,2,3,1,1,1595,20,1380
4100,경기도,4118,안산시상록구,,본오1동제3투,2774,1510,842,606,32,0,11,0,0,0,0,3,1,1,1496,14,1264
4100,경기도,4118,안산시상록구,,본오1동제4투,2873,1654,955,607,39,0,22,0,0,0,1,0,0,2,1626,28,1219
4100,경기도,4118,안산시상록구,,본오1동제5투,3375,1831,1052,694,25,3,26,0,1,1,0,2,0,2,1806,25,1544
4100,경기도,4118,안산시상록구,,본오1동제6투,2637,1377,793,520,26,1,16,1,1,0,0,0,0,0,1358,19,1260
4100,경기도,4118,안산시상록구,,본오1동제7투,2681,1386,787,510,36,1,16,1,0,0,0,0,0,1,1352,34,1295
4100,경기도,4118,안산시상록구,,본오1동제8투,2037,1262,653,546,33,1,15,0,0,1,3,2,0,0,1254,8,775
4100,경기도,4118,안산시상록구,본오2동,소계,21077,15047,8392,5967,353,10,141,0,3,4,13,18,5,10,14916,131,6030
4100,경기도,4118,안산시상록구,,관내사전투표,4804,4803,2957,1686,99,4,28,0,0,1,0,3,2,5,4785,18,1
4100,경기도,4118,안산시상록구,,본오2동제1투,2312,1201,669,455,30,2,18,0,1,1,2,1,0,2,1181,20,1111
4100,경기도,4118,안산시상록구,,본오2동제2투,2291,1257,699,474,39,1,21,0,0,1,2,3,0,1,1241,16,1034
4100,경기도,4118,안산시상록구,,본오2동제3투,3526,1968,1109,762,43,1,30,0,1,0,1,2,1,1,1951,17,1558
4100,경기도,4118,안산시상록구,,본오2동제4투,2094,1479,799,623,30,0,9,0,0,1,0,3,0,0,1465,14,615
4100,경기도,4118,안산시상록구,,본오2동제5투,3718,2578,1270,1173,65,2,26,0,1,0,7,5,1,1,2551,27,1140
4100,경기도,4118,안산시상록구,,본오2동제6투,2332,1761,889,794,47,0,9,0,0,0,1,1,1,0,1742,19,571
4100,경기도,4118,안산시상록구,본오3동,소계,17387,12874,6943,5370,288,13,113,4,1,1,15,13,5,7,12773,101,4513
4100,경기도,4118,안산시상록구,,관내사전투표,5432,5432,3209,2032,110,7,28,2,0,0,4,7,3,3,5405,27,0
4100,경기도,4118,안산시상록구,,본오3동제1투,2174,1161,590,528,21,2,7,1,1,0,1,0,0,1,1152,9,1013
4100,경기도,4118,안산시상록구,,본오3동제2투,1954,1469,718,680,45,0,10,0,0,0,2,3,0,1,1459,10,485
4100,경기도,4118,안산시상록구,,본오3동제3투,3469,2074,1049,909,52,2,31,1,0,1,3,0,1,1,2050,24,1395
4100,경기도,4118,안산시상록구,,본오3동제4투,2872,1597,835,669,38,2,29,0,0,0,2,1,0,1,1577,20,1275
4100,경기도,4118,안산시상록구,,본오3동제5투,1486,1141,542,552,22,0,8,0,0,0,3,2,1,0,1130,11,345
4100,경기도,4118,안산시상록구,부곡동,소계,17557,12038,6889,4621,265,8,117,4,4,1,12,12,0,8,11941,97,5519
4100,경기도,4118,안산시상록구,,관내사전투표,4749,4749,2929,1672,84,3,31,1,1,1,4,5,0,3,4734,15,0
4100,경기도,4118,안산시상록구,,부곡동제1투,3713,2092,1131,855,53,0,19,2,2,0,4,1,0,1,2068,24,1621
4100,경기도,4118,안산시상록구,,부곡동제2투,3095,1644,872,693,36,3,19,0,1,0,1,2,0,0,1627,17,1451
4100,경기도,4118,안산시상록구,,부곡동제3투,2728,1611,894,618,54,0,21,1,0,0,2,1,0,0,1591,20,1117
4100,경기도,4118,안산시상록구,,부곡동제4투,3272,1942,1063,783,38,2,27,0,0,0,1,3,0,4,1921,21,1330
4100,경기도,4118,안산시상록구,월피동,소계,29764,20209,11397,7894,450,20,210,6,0,7,16,22,9,11,20042,167,9555
4100,경기도,4118,안산시상록구,,관내사전투표,5025,5020,3105,1745,87,5,37,2,0,3,2,5,4,2,4997,23,5
4100,경기도,4118,안산시상록구,,월피동제1투,3382,1770,966,697,52,0,33,1,0,1,1,2,2,1,1756,14,1612
4100,경기도,4118,안산시상록구,,월피동제2투,3745,2112,1115,873,57,3,25,2,0,2,2,1,0,0,2080,32,1633
4100,경기도,4118,안산시상록구,,월피동제3투,3081,1999,1055,845,43,5,21,0,0,0,3,3,1,1,1977,22,1082
4100,경기도,4118,안산시상록구,,월피동제4투,2625,1662,937,657,31,2,16,1,0,0,3,2,1,1,1651,11,963
4100,경기도,4118,안산시상록구,,월피동제5투,2585,1859,1010,765,48,1,16,0,0,0,1,3,0,0,1844,15,726
4100,경기도,4118,안산시상록구,,월피동제6투,2553,1818,987,763,40,2,7,0,0,1,1,3,1,1,1806,12,735
4100,경기도,4118,안산시상록구,,월피동제7투,3290,1966,1108,754,47,1,35,0,0,0,1,0,0,2,1948,18,1324
4100,경기도,4118,안산시상록구,,월피동제8투,3478,2003,1114,795,45,1,20,0,0,0,2,3,0,3,1983,20,1475
4100,경기도,4118,안산시상록구,성포동,소계,21088,16644,8435,7534,408,6,71,2,5,4,15,18,2,9,16509,135,4444
4100,경기도,4118,안산시상록구,,관내사전투표,6371,6371,3576,2605,128,2,12,0,2,0,0,7,1,6,6339,32,0
4100,경기도,4118,안산시상록구,,성포동제1투,2901,2108,935,1068,58,1,12,0,0,1,2,3,0,0,2080,28,793
4100,경기도,4118,안산시상록구,,성포동제2투,2356,1596,751,754,58,0,10,0,1,1,2,1,1,0,1579,17,760
4100,경기도,4118,안산시상록구,,성포동제3투,2712,1899,861,965,37,0,10,0,0,1,2,2,0,2,1880,19,813
4100,경기도,4118,안산시상록구,,성포동제4투,3604,2559,1192,1266,62,1,11,1,0,0,4,1,0,0,2538,21,1045
4100,경기도,4118,안산시상록구,,성포동제5투,3144,2111,1120,876,65,2,16,1,2,1,5,4,0,1,2093,18,1033
4100,경기도,4118,안산시상록구,반월동,소계,14352,10980,5505,4998,259,8,96,6,4,2,12,7,2,3,10902,78,3372
4100,경기도,4118,안산시상록구,,관내사전투표,4612,4612,2593,1865,96,5,25,3,1,0,2,4,0,2,4596,16,0
4100,경기도,4118,안산시상록구,,반월동제1투,3287,2027,921,973,62,2,31,0,2,1,4,1,2,0,1999,28,1260
4100,경기도,4118,안산시상록구,,반월동제2투,2643,1868,883,898,54,0,8,2,0,1,5,1,0,1,1853,15,775
4100,경기도,4118,안산시상록구,,반월동제3투,1658,980,438,499,19,0,17,0,1,0,0,0,0,0,974,6,678
4100,경기도,4118,안산시상록구,,반월동제4투,1459,1034,475,523,15,0,8,0,0,0,0,1,0,0,1022,12,425
4100,경기도,4118,안산시상록구,,반월동제5투,693,459,195,240,13,1,7,1,0,0,1,0,0,0,458,1,234
4100,경기도,4118,안산시상록구,안산동,소계,7508,5361,2822,2340,94,2,55,2,1,2,6,0,1,5,5330,31,2147
4100,경기도,4118,안산시상록구,,관내사전투표,2400,2395,1353,986,30,0,12,2,1,0,1,0,1,1,2387,8,5
4100,경기도,4118,안산시상록구,,안산동제1투,2336,1322,614,657,23,1,15,0,0,0,2,0,0,3,1315,7,1014
4100,경기도,4118,안산시상록구,,안산동제2투,2772,1644,855,697,41,1,28,0,0,2,3,0,0,1,1628,16,1128
4100,경기도,4118,안산시상록구,사동,소계,28825,20172,11389,7832,475,11,205,8,1,1,10,29,3,8,19972,200,8653
4100,경기도,4118,안산시상록구,,관내사전투표,8078,8078,4892,2908,167,2,51,4,1,0,2,6,1,2,8036,42,0
4100,경기도,4118,안산시상록구,,사동제1투,3380,1665,935,629,50,2,24,0,0,0,0,1,0,2,1643,22,1715
4100,경기도,4118,안산시상록구,,사동제2투,3330,1782,967,715,40,1,33,1,0,0,2,5,0,0,1764,18,1548
4100,경기도,4118,안산시상록구,,사동제3투,2440,1181,575,526,36,1,21,1,0,0,2,3,0,2,1167,14,1259
4100,경기도,4118,안산시상록구,,사동제4투,2357,1618,867,666,34,1,17,0,0,0,2,3,1,0,1591,27,739
4100,경기도,4118,안산시상록구,,사동제5투,2174,1692,950,660,46,0,8,0,0,1,1,3,0,0,1669,23,482
4100,경기도,4118,안산시상록구,,사동제6투,3203,1797,986,729,37,0,17,1,0,0,1,6,1,0,1778,19,1406
4100,경기도,4118,안산시상록구,,사동제7투,2076,1217,636,503,32,2,21,1,0,0,0,0,0,2,1197,20,859
4100,경기도,4118,안산시상록구,,사동제8투,1787,1142,581,496,33,2,13,0,0,0,0,2,0,0,1127,15,645
4100,경기도,4118,안산시상록구,사이동,소계,24994,17803,9877,7128,379,14,194,4,3,2,12,20,9,6,17648,155,7191
4100,경기도,4118,안산시상록구,,관내사전투표,6260,6260,3760,2300,121,3,36,3,1,0,1,6,2,1,6234,26,0
4100,경기도,4118,안산시상록구,,사이동제1투,1746,1227,513,646,34,1,15,0,0,0,0,2,0,1,1212,15,519
4100,경기도,4118,안산시상록구,,사이동제2투,2446,1625,737,817,30,1,19,1,0,0,2,2,1,0,1610,15,821
4100,경기도,4118,안산시상록구,,사이동제3투,1852,1315,621,635,33,2,7,0,0,2,2,1,0,1,1304,11,537
4100,경기도,4118,안산시상록구,,사이동제4투,2830,1577,928,556,37,3,26,0,1,0,0,3,1,0,1555,22,1253
4100,경기도,4118,안산시상록구,,사이동제5투,2607,1504,887,545,30,0,23,0,0,0,2,1,0,0,1488,16,1103
4100,경기도,4118,안산시상록구,,사이동제6투,3424,2041,1157,768,41,1,34,0,1,0,3,2,4,1,2012,29,1383
4100,경기도,4118,안산시상록구,,사이동제7투,3829,2254,1274,861,53,3,34,0,0,0,2,3,1,2,2233,21,1575
4100,경기도,4118,안산시상록구,해양동,소계,27258,21482,10684,9977,538,13,93,2,1,2,9,9,0,2,21330,152,5776
4100,경기도,4118,안산시상록구,,관내사전투표,5743,5743,3177,2419,107,5,13,0,1,0,2,2,0,0,5726,17,0
4100,경기도,4118,안산시상록구,,해양동제1투,3659,2334,1020,1172,73,1,16,1,0,1,3,2,0,0,2289,45,1325
4100,경기도,4118,안산시상록구,,해양동제2투,2820,2010,990,937,59,0,9,1,0,0,0,2,0,0,1998,12,810
4100,경기도,4118,안산시상록구,,해양동제3투,3107,2160,1008,1070,52,4,8,0,0,0,0,2,0,0,2144,16,947
4100,경기도,4118,안산시상록구,,해양동제4투,2877,2151,1099,961,62,2,13,0,0,1,1,0,0,0,2139,12,726
4100,경기도,4118,안산시상록구,,해양동제5투,3788,2949,1417,1424,70,1,13,0,0,0,0,1,0,1,2927,22,839
4100,경기도,4118,안산시상록구,,해양동제6투,2659,2183,1029,1066,67,0,10,0,0,0,2,0,0,0,2174,9,476
4100,경기도,4118,안산시상록구,,해양동제7투,2605,1952,944,928,48,0,11,0,0,0,1,0,0,1,1933,19,653
4100,경기도,4118,안산시상록구,잘못 투입·구분된 투표지,,0,5,4,1,0,0,0,0,0,0,0,0,0,0,5,0,-5
4100,경기도,4119,안산시단원구,합계,,260659,192948,103595,80605,4563,134,1715,55,29,35,136,183,41,84,191175,1773,67711
4100,경기도,4119,안산시단원구,거소·선상투표,,551,524,205,244,5,3,13,1,0,0,2,0,1,1,475,49,27
4100,경기도,4119,안산시단원구,관외사전투표,,19903,19894,10557,8330,506,19,224,5,0,4,11,25,3,16,19700,194,9
4100,경기도,4119,안산시단원구,재외투표,,777,543,316,169,16,0,1,0,0,0,1,0,0,0,503,40,234
4100,경기도,4119,안산시단원구,와동,소계,30273,19042,11198,6875,420,20,277,7,1,4,18,28,4,14,18866,176,11231
4100,경기도,4119,안산시단원구,,관내사전투표,6386,6386,3995,2150,128,2,52,1,0,0,4,12,0,4,6348,38,0
4100,경기도,4119,안산시단원구,,와동제1투,2545,1285,726,476,31,1,27,0,0,0,1,1,1,1,1265,20,1260
4100,경기도,4119,안산시단원구,,와동제2투,3294,1913,1057,753,40,5,25,0,0,0,4,1,0,1,1886,27,1381
4100,경기도,4119,안산시단원구,,와동제3투,2984,1825,971,749,52,2,24,3,0,1,1,3,1,2,1809,16,1159
4100,경기도,4119,안산시단원구,,와동제4투,3201,1687,992,602,29,6,29,2,1,0,1,0,2,2,1666,21,1514
4100,경기도,4119,안산시단원구,,와동제5투,3153,1451,834,517,39,0,38,1,0,0,4,4,0,1,1438,13,1702
4100,경기도,4119,안산시단원구,,와동제6투,2330,1167,673,425,25,2,24,0,0,1,0,4,0,1,1155,12,1163
4100,경기도,4119,안산시단원구,,와동제7투,3438,1800,1015,688,42,1,28,0,0,1,2,2,0,1,1780,20,1638
4100,경기도,4119,안산시단원구,,와동제8투,2942,1528,935,515,34,1,30,0,0,1,1,1,0,1,1519,9,1414
4100,경기도,4119,안산시단원구,호수동,소계,33030,26218,13560,11596,641,13,131,5,7,1,10,19,3,9,25995,223,6812
4100,경기도,4119,안산시단원구,,관내사전투표,7574,7574,4410,2937,155,1,26,0,0,0,3,5,3,2,7542,32,0
4100,경기도,4119,안산시단원구,,호수동제1투,2188,1436,742,633,33,1,10,0,0,0,0,0,0,0,1419,17,752
4100,경기도,4119,안산시단원구,,호수동제2투,1828,1428,670,720,24,0,5,0,1,0,0,0,0,0,1420,8,400
4100,경기도,4119,안산시단원구,,호수동제3투,2439,1374,694,617,33,0,15,2,0,0,0,1,0,0,1362,12,1065
4100,경기도,4119,안산시단원구,,호수동제4투,2553,1813,791,948,42,1,14,0,1,0,0,0,0,2,1799,14,740
4100,경기도,4119,안산시단원구,,호수동제5투,3059,2341,1261,975,61,2,11,0,1,0,0,1,0,1,2313,28,718
4100,경기도,4119,안산시단원구,,호수동제6투,3124,2382,1197,1076,74,1,10,2,1,1,2,3,0,1,2368,14,742
4100,경기도,4119,안산시단원구,,호수동제7투,2622,1866,924,841,47,2,17,0,1,0,0,3,0,1,1836,30,756
4100,경기도,4119,안산시단원구,,호수동제8투,2822,2190,1093,985,70,2,6,0,1,0,3,3,0,0,2163,27,632
4100,경기도,4119,안산시단원구,,호수동제9투,1918,1419,616,736,41,0,6,1,0,0,0,2,0,0,1402,17,499
4100,경기도,4119,안산시단원구,,호수동제10투,2903,2395,1162,1128,61,3,11,0,1,0,2,1,0,2,2371,24,508
4100,경기도,4119,안산시단원구,초지동,소계,35301,26073,14133,10797,659,17,176,4,1,6,11,15,5,11,25835,238,9228
4100,경기도,4119,안산시단원구,,관내사전투표,7439,7439,4485,2740,148,2,27,1,0,1,1,5,2,2,7414,25,0
4100,경기도,4119,안산시단원구,,초지동제1투,2054,1521,731,716,44,1,7,0,0,0,1,0,0,0,1500,21,533
4100,경기도,4119,안산시단원구,,초지동제2투,2007,1571,778,729,37,0,8,1,0,0,1,0,0,1,1555,16,436
4100,경기도,4119,안산시단원구,,초지동제3투,2391,1784,838,870,40,3,7,0,0,0,1,1,0,0,1760,24,607
4100,경기도,4119,안산시단원구,,초지동제4투,1870,1434,727,637,44,1,10,0,0,0,0,4,0,0,1423,11,436
4100,경기도,4119,안산시단원구,,초지동제5투,2060,1369,758,551,34,1,13,1,0,0,0,0,0,0,1358,11,691
4100,경기도,4119,안산시단원구,,초지동제6투,2034,1499,759,659,38,1,11,0,1,0,3,0,0,0,1472,27,535
4100,경기도,4119,안산시단원구,,초지동제7투,3350,1678,890,701,56,0,8,0,0,0,1,1,0,0,1657,21,1672
4100,경기도,4119,안산시단원구,,초지동제8투,2210,1425,756,609,28,0,9,1,0,1,1,1,0,2,1408,17,785
4100,경기도,4119,안산시단원구,,초지동제9투,2561,1628,858,681,40,3,18,0,0,3,2,1,2,3,1611,17,933
4100,경기도,4119,안산시단원구,,초지동제10투,2816,1861,1005,749,59,2,27,0,0,1,0,2,0,1,1846,15,955
4100,경기도,4119,안산시단원구,,초지동제11투,2469,1718,968,657,59,1,12,0,0,0,0,0,1,2,1700,18,751
4100,경기도,4119,안산시단원구,,초지동제12투,2040,1146,580,498,32,2,19,0,0,0,0,0,0,0,1131,15,894
4100,경기도,4119,안산시단원구,선부1동,소계,15235,11549,6114,4931,262,11,100,3,2,3,7,14,1,4,11452,97,3686
4100,경기도,4119,안산시단원구,,관내사전투표,4613,4613,2624,1836,97,3,22,2,0,0,2,4,0,2,4592,21,0
4100,경기도,4119,안산시단원구,,선부1동제1투,949,521,274,219,11,2,3,0,1,1,0,1,1,0,513,8,428
4100,경기도,4119,안산시단원구,,선부1동제2투,1507,1009,498,448,33,2,10,0,0,0,0,2,0,0,993,16,498
4100,경기도,4119,안산시단원구,,선부1동제3투,1751,1090,595,434,26,1,16,0,0,0,1,3,0,2,1078,12,661
4100,경기도,4119,안산시단원구,,선부1동제4투,1973,1165,582,513,33,0,19,0,0,2,3,1,0,0,1153,12,808
4100,경기도,4119,안산시단원구,,선부1동제5투,1406,921,465,419,14,1,12,0,1,0,1,1,0,0,914,7,485
4100,경기도,4119,안산시단원구,,선부1동제6투,3036,2230,1076,1062,48,2,18,1,0,0,0,2,0,0,2209,21,806
4100,경기도,4119,안산시단원구,선부2동,소계,13337,8831,5012,3401,191,4,104,4,5,1,6,6,3,3,8740,91,4506
4100,경기도,4119,안산시단원구,,관내사전투표,3422,3422,2095,1215,72,1,19,0,2,0,2,1,0,0,3407,15,0
4100,경기도,4119,안산시단원구,,선부2동제1투,1730,901,459,385,26,0,17,1,0,0,1,3,0,0,892,9,829
4100,경기도,4119,안산시단원구,,선부2동제2투,1941,1145,604,470,25,1,20,2,1,1,1,0,0,3,1128,17,796
4100,경기도,4119,안산시단원구,,선부2동제3투,2512,1325,736,523,22,1,16,0,1,0,2,2,1,0,1304,21,1187
4100,경기도,4119,안산시단원구,,선부2동제4투,2729,1465,825,565,28,1,26,0,1,0,0,0,1,0,1447,18,1264
4100,경기도,4119,안산시단원구,,선부2동제5투,1003,573,293,243,18,0,6,1,0,0,0,0,1,0,562,11,430
4100,경기도,4119,안산시단원구,선부3동,소계,26613,18680,10423,7407,452,9,173,8,4,5,10,21,1,5,18518,162,7933
4100,경기도,4119,안산시단원구,,관내사전투표,5174,5173,3154,1853,96,2,30,2,0,2,3,7,0,1,5150,23,1
4100,경기도,4119,안산시단원구,,선부3동제1투,2353,1098,669,363,32,0,20,1,0,1,1,0,0,0,1087,11,1255
4100,경기도,4119,안산시단원구,,선부3동제2투,2414,1289,719,503,29,0,20,1,0,1,2,0,0,2,1277,12,1125
4100,경기도,4119,안산시단원구,,선부3동제3투,2460,1150,663,418,29,0,22,1,0,0,0,0,0,0,1133,17,1310
4100,경기도,4119,안산시단원구,,선부3동제4투,3440,2437,1211,1098,74,1,18,1,0,0,3,4,0,0,2410,27,1003
4100,경기도,4119,안산시단원구,,선부3동제5투,2605,1678,927,665,51,0,16,0,0,1,1,1,1,1,1664,14,927
4100,경기도,4119,안산시단원구,,선부3동제6투,3478,2479,1265,1100,59,4,19,1,2,0,0,8,0,0,2458,21,999
4100,경기도,4119,안산시단원구,,선부3동제7투,1821,1297,705,528,34,1,11,0,0,0,0,0,0,0,1279,18,524
4100,경기도,4119,안산시단원구,,선부3동제8투,2868,2079,1110,879,48,1,17,1,2,0,0,1,0,1,2060,19,789
4100,경기도,4119,안산시단원구,대부동,소계,7226,5240,1938,3140,62,2,48,4,2,2,5,0,2,2,5207,33,1986
4100,경기도,4119,안산시단원구,,관내사전투표,2479,2479,1019,1397,31,2,16,0,2,0,2,0,0,0,2469,10,0
4100,경기도,4119,안산시단원구,,대부동제1투,1658,922,302,580,11,0,11,1,0,2,3,0,0,0,910,12,736
4100,경기도,4119,안산시단원구,,대부동제2투,1646,988,324,632,11,0,9,3,0,0,0,0,1,2,982,6,658
4100,경기도,4119,안산시단원구,,대부동제3투,1443,851,293,531,9,0,12,0,0,0,0,0,1,0,846,5,592
4100,경기도,4119,안산시단원구,고잔동,소계,18316,13018,7055,5330,358,12,127,6,0,0,7,11,6,5,12917,101,5298
4100,경기도,4119,안산시단원구,,관내사전투표,5652,5652,3305,2141,122,7,35,6,0,0,3,4,1,2,5626,26,0
4100,경기도,4119,안산시단원구,,고잔동제1투,2205,1215,623,522,39,0,15,0,0,0,0,0,1,0,1200,15,990
4100,경기도,4119,안산시단원구,,고잔동제2투,1501,841,383,411,26,1,8,0,0,0,0,0,1,0,830,11,660
4100,경기도,4119,안산시단원구,,고잔동제3투,3697,2303,1142,1031,80,2,26,0,0,0,2,1,2,0,2286,17,1394
4100,경기도,4119,안산시단원구,,고잔동제4투,2489,1419,765,560,49,2,14,0,0,0,1,3,0,0,1394,25,1070
4100,경기도,4119,안산시단원구,,고잔동제5투,2772,1588,837,665,42,0,29,0,0,0,1,3,1,3,1581,7,1184
4100,경기도,4119,안산시단원구,중앙동,소계,19740,14351,7331,6375,354,10,107,2,3,3,13,8,6,5,14217,134,5389
4100,경기도,4119,안산시단원구,,관내사전투표,5753,5751,3187,2371,125,3,24,1,3,1,1,3,1,3,5723,28,2
4100,경기도,4119,안산시단원구,,중앙동제1투,2629,1649,784,777,46,2,19,1,0,0,1,0,0,1,1631,18,980
4100,경기도,4119,안산시단원구,,중앙동제2투,3589,2053,1002,948,56,1,13,0,0,0,3,1,3,0,2027,26,1536
4100,경기도,4119,안산시단원구,,중앙동제3투,3120,1963,881,991,44,2,6,0,0,0,6,1,1,0,1932,31,1157
4100,경기도,4119,안산시단원구,,중앙동제4투,2826,1821,930,787,45,2,30,0,0,2,1,2,0,1,1800,21,1005
4100,경기도,4119,안산시단원구,,중앙동제5투,1823,1114,547,501,38,0,15,0,0,0,1,1,1,0,1104,10,709
4100,경기도,4119,안산시단원구,원곡동,소계,5185,2970,1686,1190,36,0,28,1,0,1,6,3,0,0,2951,19,2215
4100,경기도,4119,안산시단원구,,관내사전투표,1320,1320,830,453,15,0,10,0,0,0,3,3,0,0,1314,6,0
4100,경기도,4119,안산시단원구,,원곡동제1투,1040,316,145,159,8,0,2,0,0,0,0,0,0,0,314,2,724
4100,경기도,4119,안산시단원구,,원곡동제2투,871,401,177,207,7,0,5,0,0,0,3,0,0,0,399,2,470
4100,경기도,4119,안산시단원구,,원곡동제3투,1954,933,534,371,6,0,11,1,0,1,0,0,0,0,924,9,1021
4100,경기도,4119,안산시단원구,백운동,소계,17764,13509,7086,5832,328,9,103,1,1,1,13,17,1,2,13394,115,4255
4100,경기도,4119,안산시단원구,,관내사전투표,5881,5881,3290,2387,123,5,29,0,0,1,3,7,1,0,5846,35,0
4100,경기도,4119,안산시단원구,,백운동제1투,2153,1488,783,621,35,0,17,0,0,0,6,4,0,0,1466,22,665
4100,경기도,4119,안산시단원구,,백운동제2투,2358,1663,827,756,47,2,12,0,1,0,1,1,0,1,1648,15,695
4100,경기도,4119,안산시단원구,,백운동제3투,2239,1395,680,640,35,1,16,1,0,0,2,1,0,1,1377,18,844
4100,경기도,4119,안산시단원구,,백운동제4투,1184,799,381,376,29,0,6,0,0,0,0,0,0,0,792,7,385
4100,경기도,4119,안산시단원구,,백운동제5투,2397,1335,655,618,33,0,17,0,0,0,0,3,0,0,1326,9,1062
4100,경기도,4119,안산시단원구,,백운동제6투,1552,948,470,434,26,1,6,0,0,0,1,1,0,0,939,9,604
4100,경기도,4119,안산시단원구,신길동,소계,17408,12504,6980,4987,273,5,103,4,3,4,16,16,5,7,12403,101,4904
4100,경기도,4119,안산시단원구,,관내사전투표,4236,4236,2588,1521,72,2,20,3,1,1,1,0,2,1,4212,24,0
4100,경기도,4119,안산시단원구,,신길동제1투,2248,1510,760,675,35,0,16,0,0,0,4,1,3,1,1495,15,738
4100,경기도,4119,안산시단원구,,신길동제2투,2195,1595,810,703,47,1,11,0,0,2,5,3,0,2,1584,11,600
4100,경기도,4119,안산시단원구,,신길동제3투,1972,968,517,402,20,0,9,0,0,1,5,1,0,1,956,12,1004
4100,경기도,4119,안산시단원구,,신길동제4투,2020,1243,688,495,29,1,11,0,0,0,0,8,0,2,1234,9,777
4100,경기도,4119,안산시단원구,,신길동제5투,2500,1419,738,611,28,0,20,1,1,0,0,1,0,0,1400,19,1081
4100,경기도,4119,안산시단원구,,신길동제6투,2237,1533,879,580,42,1,16,0,1,0,1,2,0,0,1522,11,704
4100,경기도,4119,안산시단원구,잘못 투입·구분된 투표지,,0,2,1,1,0,0,0,0,0,0,0,0,0,0,2,0,-2
4100,경기도,4120,고양시덕양구,합계,,414210,323033,167037,139914,10643,165,1932,89,46,86,208,340,48,81,320589,2444,91177
4100,경기도,4120,고양시덕양구,거소·선상투표,,747,697,264,291,27,5,11,2,0,0,5,3,1,3,612,85,50
4100,경기도,4120,고양시덕양구,관외사전투표,,38196,38188,20589,15657,1209,33,291,16,2,6,16,55,6,13,37893,295,8
4100,경기도,4120,고양시덕양구,재외투표,,2513,1864,1016,595,70,0,9,0,0,0,0,1,0,0,1691,173,649
4100,경기도,4120,고양시덕양구,주교동,소계,12141,8361,4368,3547,282,4,69,3,2,1,8,10,0,4,8298,63,3780
4100,경기도,4120,고양시덕양구,,관내사전투표,3925,3924,2229,1523,124,2,18,0,0,1,2,7,0,2,3908,16,1
4100,경기도,4120,고양시덕양구,,주교동제1투,1566,824,380,407,21,0,7,1,0,0,1,1,0,0,818,6,742
4100,경기도,4120,고양시덕양구,,주교동제2투,2570,1397,679,623,47,0,25,1,1,0,1,0,0,1,1378,19,1173
4100,경기도,4120,고양시덕양구,,주교동제3투,2124,1107,540,490,49,1,9,1,0,0,2,1,0,0,1093,14,1017
4100,경기도,4120,고양시덕양구,,주교동제4투,1956,1109,540,504,41,1,10,0,1,0,2,1,0,1,1101,8,847
4100,경기도,4120,고양시덕양구,원신동,소계,15963,12123,6316,5185,463,4,62,0,1,8,3,5,0,0,12047,76,3840
4100,경기도,4120,고양시덕양구,,관내사전투표,3305,3305,1883,1306,93,2,6,0,0,0,1,1,0,0,3292,13,0
4100,경기도,4120,고양시덕양구,,원신동제1투,2752,1999,1010,889,83,0,6,0,0,2,0,0,0,0,1990,9,753
4100,경기도,4120,고양시덕양구,,원신동제2투,703,415,147,244,14,0,5,0,0,0,0,1,0,0,411,4,288
4100,경기도,4120,고양시덕양구,,원신동제3투,3128,2175,1167,880,77,0,27,0,0,3,2,3,0,0,2159,16,953
4100,경기도,4120,고양시덕양구,,원신동제4투,3326,2318,1122,1043,112,2,12,0,1,2,0,0,0,0,2294,24,1008
4100,경기도,4120,고양시덕양구,,원신동제5투,2749,1911,987,823,84,0,6,0,0,1,0,0,0,0,1901,10,838
4100,경기도,4120,고양시덕양구,흥도동,소계,20025,15605,8357,6339,708,6,80,1,3,4,9,8,2,0,15517,88,4420
4100,경기도,4120,고양시덕양구,,관내사전투표,4164,4164,2406,1573,149,1,13,1,0,0,3,3,2,0,4151,13,0
4100,경기도,4120,고양시덕양구,,흥도동제1투,923,495,179,287,15,0,9,0,1,0,0,0,0,0,491,4,428
4100,경기도,4120,고양시덕양구,,흥도동제2투,2178,1504,780,639,53,0,20,0,0,0,4,1,0,0,1497,7,674
4100,경기도,4120,고양시덕양구,,흥도동제3투,2608,1919,944,872,86,0,7,0,0,0,0,0,0,0,1909,10,689
4100,경기도,4120,고양시덕양구,,흥도동제4투,2918,2153,1229,752,144,3,13,0,1,1,0,0,0,0,2143,10,765
4100,경기도,4120,고양시덕양구,,흥도동제5투,2535,1796,976,708,80,1,10,0,0,2,1,0,0,0,1778,18,739
4100,경기도,4120,고양시덕양구,,흥도동제6투,1730,1407,708,607,80,0,4,0,1,1,0,1,0,0,1402,5,323
4100,경기도,4120,고양시덕양구,,흥도동제7투,2969,2167,1135,901,101,1,4,0,0,0,1,3,0,0,2146,21,802
4100,경기도,4120,고양시덕양구,성사1동,소계,17973,13230,6742,5856,424,5,75,2,1,8,16,14,3,1,13147,83,4743
4100,경기도,4120,고양시덕양구,,관내사전투표,5625,5625,3103,2311,154,0,16,0,0,2,1,10,2,1,5600,25,0
4100,경기도,4120,고양시덕양구,,성사1동제1투,2047,1062,511,486,42,0,12,1,0,0,2,0,0,0,1054,8,985
4100,경기도,4120,고양시덕양구,,성사1동제2투,2481,1367,659,631,46,1,17,0,0,1,3,0,0,0,1358,9,1114
4100,경기도,4120,고양시덕양구,,성사1동제3투,2618,1254,628,546,47,1,15,0,0,0,3,1,0,0,1241,13,1364
4100,경기도,4120,고양시덕양구,,성사1동제4투,2748,2101,1000,1009,63,1,6,1,1,1,2,2,1,0,2087,14,647
4100,경기도,4120,고양시덕양구,,성사1동제5투,2454,1821,841,873,72,2,9,0,0,4,5,1,0,0,1807,14,633
4100,경기도,4120,고양시덕양구,성사2동,소계,9208,7152,3638,3172,240,3,49,1,0,1,5,6,0,1,7116,36,2056
4100,경기도,4120,고양시덕양구,,관내사전투표,3241,3241,1824,1315,78,0,11,0,0,0,1,3,0,1,3233,8,0
4100,경기도,4120,고양시덕양구,,성사2동제1투,1917,1189,591,522,52,0,11,1,0,0,0,1,0,0,1178,11,728
4100,경기도,4120,고양시덕양구,,성사2동제2투,1904,1235,495,666,52,1,12,0,0,0,2,0,0,0,1228,7,669
4100,경기도,4120,고양시덕양구,,성사2동제3투,2146,1487,728,669,58,2,15,0,0,1,2,2,0,0,1477,10,659
4100,경기도,4120,고양시덕양구,효자동,소계,10989,8808,4455,3877,329,5,42,2,2,5,6,14,0,1,8738,70,2181
4100,경기도,4120,고양시덕양구,,관내사전투표,3172,3172,1770,1261,101,1,12,1,0,0,1,9,0,0,3156,16,0
4100,경기도,4120,고양시덕양구,,효자동제1투,974,593,213,352,11,0,7,0,0,0,2,0,0,1,586,7,381
4100,경기도,4120,고양시덕양구,,효자동제2투,1633,1226,616,529,62,1,5,0,1,0,0,2,0,0,1216,10,407
4100,경기도,4120,고양시덕양구,,효자동제3투,2680,2030,993,918,86,0,6,1,1,2,0,1,0,0,2008,22,650
4100,경기도,4120,고양시덕양구,,효자동제4투,1375,986,505,426,39,2,5,0,0,0,1,1,0,0,979,7,389
4100,경기도,4120,고양시덕양구,,효자동제5투,1155,801,358,391,30,1,7,0,0,3,2,1,0,0,793,8,354
4100,경기도,4120,고양시덕양구,창릉동,소계,17660,13957,7117,6238,424,2,73,3,2,2,8,5,0,2,13876,81,3703
4100,경기도,4120,고양시덕양구,,관내사전투표,5526,5526,3197,2136,148,0,19,0,0,1,1,2,0,1,5505,21,0
4100,경기도,4120,고양시덕양구,,창릉동제1투,1582,828,388,390,32,0,8,1,0,0,0,2,0,0,821,7,754
4100,경기도,4120,고양시덕양구,,창릉동제2투,1590,970,351,577,25,0,6,1,0,0,6,1,0,0,967,3,620
4100,경기도,4120,고양시덕양구,,창릉동제3투,1616,1104,535,514,34,0,8,0,0,0,1,0,0,0,1092,12,512
4100,경기도,4120,고양시덕양구,,창릉동제4투,2150,1707,848,787,46,2,11,0,2,1,0,0,0,1,1698,9,443
4100,경기도,4120,고양시덕양구,,창릉동제5투,2037,1414,632,717,47,0,8,1,0,0,0,0,0,0,1405,9,623
4100,경기도,4120,고양시덕양구,,창릉동제6투,3159,2408,1166,1117,92,0,13,0,0,0,0,0,0,0,2388,20,751
4100,경기도,4120,고양시덕양구,고양동,소계,22873,16189,8391,6965,568,8,101,2,5,6,9,12,6,7,16080,109,6684
4100,경기도,4120,고양시덕양구,,관내사전투표,7387,7372,4152,2921,213,2,31,1,5,1,1,5,1,4,7337,35,15
4100,경기도,4120,고양시덕양구,,고양동제1투,1906,1046,468,512,41,0,11,1,0,2,0,1,0,1,1037,9,860
4100,경기도,4120,고양시덕양구,,고양동제2투,2239,1151,593,478,45,2,16,0,0,1,2,0,0,1,1138,13,1088
4100,경기도,4120,고양시덕양구,,고양동제3투,2233,1274,605,594,51,1,6,0,0,0,0,2,2,1,1262,12,959
4100,경기도,4120,고양시덕양구,,고양동제4투,2954,1538,738,707,59,2,11,0,0,0,4,1,3,0,1525,13,1416
4100,경기도,4120,고양시덕양구,,고양동제5투,1343,785,305,430,36,0,6,0,0,0,0,0,0,0,777,8,558
4100,경기도,4120,고양시덕양구,,고양동제6투,2623,1557,795,680,54,0,13,0,0,1,2,2,0,0,1547,10,1066
4100,경기도,4120,고양시덕양구,,고양동제7투,2188,1466,735,643,69,1,7,0,0,1,0,1,0,0,1457,9,722
4100,경기도,4120,고양시덕양구,관산동,소계,28856,19216,9910,8270,665,5,183,4,4,4,14,18,6,13,19096,120,9640
4100,경기도,4120,고양시덕양구,,관내사전투표,6218,6217,3456,2526,159,2,40,2,0,1,4,4,1,2,6197,20,1
4100,경기도,4120,고양시덕양구,,관산동제1투,1786,938,486,401,30,0,6,0,0,0,1,1,1,1,927,11,848
4100,경기도,4120,고양시덕양구,,관산동제2투,1953,1149,509,554,57,0,10,0,0,0,1,3,0,3,1137,12,804
4100,경기도,4120,고양시덕양구,,관산동제3투,3293,2023,984,927,79,0,13,1,1,1,1,0,2,3,2012,11,1270
4100,경기도,4120,고양시덕양구,,관산동제4투,2403,1496,651,758,45,0,18,0,2,0,4,3,1,2,1484,12,907
4100,경기도,4120,고양시덕양구,,관산동제5투,3814,2049,1060,856,76,1,28,1,0,1,2,1,0,1,2027,22,1765
4100,경기도,4120,고양시덕양구,,관산동제6투,4147,2236,1195,911,90,0,23,0,0,0,0,4,1,0,2224,12,1911
4100,경기도,4120,고양시덕양구,,관산동제7투,3297,1941,983,831,82,1,31,0,0,1,1,2,0,0,1932,9,1356
4100,경기도,4120,고양시덕양구,,관산동제8투,1945,1167,586,506,47,1,14,0,1,0,0,0,0,1,1156,11,778
4100,경기도,4120,고양시덕양구,능곡동,소계,12477,9438,4470,4564,262,4,58,4,2,1,7,11,1,1,9385,53,3039
4100,경기도,4120,고양시덕양구,,관내사전투표,4522,4522,2377,1974,118,2,24,2,0,0,0,10,0,1,4508,14,0
4100,경기도,4120,고양시덕양구,,능곡동제1투,1750,1035,455,537,26,0,8,1,0,0,0,0,1,0,1028,7,715
4100,경기도,4120,고양시덕양구,,능곡동제2투,1929,1138,504,580,35,0,8,0,0,1,2,0,0,0,1130,8,791
4100,경기도,4120,고양시덕양구,,능곡동제3투,1340,836,346,448,22,2,8,0,0,0,1,0,0,0,827,9,504
4100,경기도,4120,고양시덕양구,,능곡동제4투,1509,985,349,583,34,0,8,1,2,0,1,1,0,0,979,6,524
4100,경기도,4120,고양시덕양구,,능곡동제5투,1427,922,439,442,27,0,2,0,0,0,3,0,0,0,913,9,505
4100,경기도,4120,고양시덕양구,화정1동,소계,31877,24765,12010,11562,843,17,112,4,5,6,17,22,2,3,24603,162,7112
4100,경기도,4120,고양시덕양구,,관내사전투표,11343,11342,6158,4737,332,6,35,1,2,1,2,15,0,2,11291,51,1
4100,경기도,4120,고양시덕양구,,화정1동제1투,2382,1742,864,773,80,1,5,0,1,0,0,0,0,0,1724,18,640
4100,경기도,4120,고양시덕양구,,화정1동제2투,2450,1672,740,837,65,0,9,0,1,0,4,1,0,0,1657,15,778
4100,경기도,4120,고양시덕양구,,화정1동제3투,2546,1682,826,786,52,0,3,0,0,1,3,0,0,0,1671,11,864
4100,경기도,4120,고양시덕양구,,화정1동제4투,2025,1392,603,705,60,1,3,2,0,1,3,0,0,0,1378,14,633
4100,경기도,4120,고양시덕양구,,화정1동제5투,2613,1839,656,1087,62,1,16,0,0,1,0,2,1,0,1826,13,774
4100,경기도,4120,고양시덕양구,,화정1동제6투,2314,1305,593,630,57,2,7,1,0,1,1,0,0,1,1293,12,1009
4100,경기도,4120,고양시덕양구,,화정1동제7투,1942,994,454,471,32,3,21,0,0,0,1,2,1,0,985,9,948
4100,경기도,4120,고양시덕양구,,화정1동제8투,2126,1579,589,919,51,1,9,0,1,1,0,1,0,0,1572,7,547
4100,경기도,4120,고양시덕양구,,화정1동제9투,2136,1218,527,617,52,2,4,0,0,0,3,1,0,0,1206,12,918
4100,경기도,4120,고양시덕양구,화정2동,소계,24146,18899,9853,8171,633,7,67,4,1,1,6,14,3,5,18765,134,5247
4100,경기도,4120,고양시덕양구,,관내사전투표,6858,6856,4032,2570,195,3,17,3,1,1,0,5,2,2,6831,25,2
4100,경기도,4120,고양시덕양구,,화정2동제1투,2599,1546,704,745,59,1,14,0,0,0,2,3,1,2,1531,15,1053
4100,경기도,4120,고양시덕양구,,화정2동제2투,2606,1733,849,783,75,1,8,1,0,0,0,3,0,0,1720,13,873
4100,경기도,4120,고양시덕양구,,화정2동제3투,2851,1958,962,894,67,0,9,0,0,0,0,1,0,0,1933,25,893
4100,경기도,4120,고양시덕양구,,화정2동제4투,2423,1782,882,830,53,1,3,0,0,0,0,0,0,0,1769,13,641
4100,경기도,4120,고양시덕양구,,화정2동제5투,2521,1882,954,844,58,1,7,0,0,0,1,0,0,0,1865,17,639
4100,경기도,4120,고양시덕양구,,화정2동제6투,1867,1439,631,749,42,0,4,0,0,0,1,1,0,0,1428,11,428
4100,경기도,4120,고양시덕양구,,화정2동제7투,2421,1703,839,756,84,0,5,0,0,0,2,1,0,1,1688,15,718
4100,경기도,4120,고양시덕양구,행주동,소계,14694,10016,4989,4528,257,2,108,5,0,5,9,26,2,1,9932,84,4678
4100,경기도,4120,고양시덕양구,,관내사전투표,3845,3845,2178,1531,77,2,22,2,0,1,1,11,0,0,3825,20,0
4100,경기도,4120,고양시덕양구,,행주동제1투,1543,723,337,346,19,0,10,0,0,2,1,1,0,0,716,7,820
4100,경기도,4120,고양시덕양구,,행주동제2투,2069,1143,531,533,36,0,18,2,0,1,0,7,0,0,1128,15,926
4100,경기도,4120,고양시덕양구,,행주동제3투,2294,1292,631,574,37,0,22,1,0,0,3,5,1,1,1275,17,1002
4100,경기도,4120,고양시덕양구,,행주동제4투,2088,1169,537,563,37,0,21,0,0,0,2,1,0,0,1161,8,919
4100,경기도,4120,고양시덕양구,,행주동제5투,779,535,182,330,12,0,7,0,0,0,1,0,0,0,532,3,244
4100,경기도,4120,고양시덕양구,,행주동제6투,2076,1309,593,651,39,0,8,0,0,1,1,1,1,0,1295,14,767
4100,경기도,4120,고양시덕양구,행신1동,소계,16784,13111,6782,5724,401,11,62,4,3,3,5,16,5,2,13018,93,3673
4100,경기도,4120,고양시덕양구,,관내사전투표,5146,5146,2948,2002,143,4,18,1,0,1,0,9,2,1,5129,17,0
4100,경기도,4120,고양시덕양구,,행신1동제1투,2280,1368,640,659,42,2,6,1,0,0,3,2,1,0,1356,12,912
4100,경기도,4120,고양시덕양구,,행신1동제2투,2487,1775,889,808,55,1,12,0,0,0,0,0,0,0,1765,10,712
4100,경기도,4120,고양시덕양구,,행신1동제3투,2137,1442,717,640,42,2,16,1,0,2,1,0,1,0,1422,20,695
4100,경기도,4120,고양시덕양구,,행신1동제4투,2349,1669,846,731,62,1,5,0,3,0,0,2,0,1,1651,18,680
4100,경기도,4120,고양시덕양구,,행신1동제5투,2385,1711,742,884,57,1,5,1,0,0,1,3,1,0,1695,16,674
4100,경기도,4120,고양시덕양구,행신2동,소계,24985,19728,10155,8610,625,9,92,7,1,5,16,30,5,7,19562,166,5257
4100,경기도,4120,고양시덕양구,,관내사전투표,7729,7729,4391,3057,201,1,23,4,0,0,1,14,2,3,7697,32,0
4100,경기도,4120,고양시덕양구,,행신2동제1투,2778,1752,824,830,49,1,17,0,0,1,2,5,1,1,1731,21,1026
4100,경기도,4120,고양시덕양구,,행신2동제2투,1930,1390,619,702,50,1,3,0,0,2,0,0,1,0,1378,12,540
4100,경기도,4120,고양시덕양구,,행신2동제3투,2825,2013,891,1013,59,1,8,0,1,0,4,5,0,0,1982,31,812
4100,경기도,4120,고양시덕양구,,행신2동제4투,2496,1759,945,699,81,2,12,1,0,0,0,1,0,2,1743,16,737
4100,경기도,4120,고양시덕양구,,행신2동제5투,2493,1742,841,813,58,0,8,1,0,0,5,0,0,0,1726,16,751
4100,경기도,4120,고양시덕양구,,행신2동제6투,2187,1556,794,670,57,0,9,0,0,0,1,1,1,1,1534,22,631
4100,경기도,4120,고양시덕양구,,행신2동제7투,2211,1524,761,671,58,3,10,1,0,1,2,3,0,0,1510,14,687
4100,경기도,4120,고양시덕양구,,행신2동제8투,336,263,89,155,12,0,2,0,0,1,1,1,0,0,261,2,73
4100,경기도,4120,고양시덕양구,행신3동,소계,19240,15622,8360,6554,486,5,62,6,3,2,15,16,1,4,15514,108,3618
4100,경기도,4120,고양시덕양구,,관내사전투표,6976,6976,4148,2595,174,2,14,3,0,1,2,5,1,2,6947,29,0
4100,경기도,4120,고양시덕양구,,행신3동제1투,2813,1713,883,731,64,1,12,0,1,0,3,5,0,0,1700,13,1100
4100,경기도,4120,고양시덕양구,,행신3동제2투,2534,1800,913,794,59,1,8,1,0,0,2,2,0,0,1780,20,734
4100,경기도,4120,고양시덕양구,,행신3동제3투,2615,1917,887,916,79,1,12,2,2,0,3,1,0,0,1903,14,698
4100,경기도,4120,고양시덕양구,,행신3동제4투,2574,1886,984,788,77,0,13,0,0,0,3,3,0,2,1870,16,688
4100,경기도,4120,고양시덕양구,,행신3동제5투,1728,1330,545,730,33,0,3,0,0,1,2,0,0,0,1314,16,398
4100,경기도,4120,고양시덕양구,화전동,소계,18699,14536,7900,6005,402,11,90,5,4,8,11,18,2,1,14457,79,4163
4100,경기도,4120,고양시덕양구,,관내사전투표,3719,3719,2192,1393,81,3,22,0,1,1,1,9,1,0,3704,15,0
4100,경기도,4120,고양시덕양구,,화전동제1투,2123,1132,491,576,31,2,16,0,0,1,2,3,0,0,1122,10,991
4100,경기도,4120,고양시덕양구,,화전동제2투,786,544,286,235,14,0,5,0,0,2,0,0,0,0,542,2,242
4100,경기도,4120,고양시덕양구,,화전동제3투,2535,1914,879,951,53,1,12,1,2,2,2,0,0,0,1903,11,621
4100,경기도,4120,고양시덕양구,,화전동제4투,2684,2090,1065,961,43,0,7,0,1,0,2,1,0,0,2080,10,594
4100,경기도,4120,고양시덕양구,,화전동제5투,1923,1513,900,541,52,1,8,0,0,0,2,1,0,1,1506,7,410
4100,경기도,4120,고양시덕양구,,화전동제6투,2474,1818,1045,677,61,3,11,2,0,2,2,2,0,0,1805,13,656
4100,경기도,4120,고양시덕양구,,화전동제7투,2455,1806,1042,671,67,1,9,2,0,0,0,2,1,0,1795,11,649
4100,경기도,4120,고양시덕양구,대덕동,소계,1999,1495,707,738,30,1,10,0,0,0,3,1,0,0,1490,5,504
4100,경기도,4120,고양시덕양구,,관내사전투표,817,817,437,353,15,1,5,0,0,0,2,0,0,0,813,4,0
4100,경기도,4120,고양시덕양구,,대덕동투표소,1182,678,270,385,15,0,5,0,0,0,1,1,0,0,677,1,504
4100,경기도,4120,고양시덕양구,삼송1동,소계,16277,13239,6540,6086,448,4,56,6,4,3,4,8,1,3,13163,76,3038
4100,경기도,4120,고양시덕양구,,관내사전투표,6347,6347,3471,2631,184,0,23,4,1,1,1,5,0,1,6322,25,0
4100,경기도,4120,고양시덕양구,,삼송1동제1투,2035,1179,455,652,45,2,9,1,0,0,2,0,0,1,1167,12,856
4100,경기도,4120,고양시덕양구,,삼송1동제2투,1830,1362,686,613,51,0,3,0,0,0,1,2,0,0,1356,6,468
4100,경기도,4120,고양시덕양구,,삼송1동제3투,2102,1504,648,775,55,0,9,0,1,1,0,0,1,1,1491,13,598
4100,경기도,4120,고양시덕양구,,삼송1동제4투,1617,1328,624,640,49,1,4,0,1,1,0,0,0,0,1320,8,289
4100,경기도,4120,고양시덕양구,,삼송1동제5투,2346,1519,656,775,64,1,8,1,1,0,0,1,0,0,1507,12,827
4100,경기도,4120,고양시덕양구,삼송2동,소계,19716,14870,7533,6612,503,6,78,6,0,4,10,11,2,5,14770,100,4846
4100,경기도,4120,고양시덕양구,,관내사전투표,4834,4834,2754,1908,132,1,13,2,0,0,1,4,0,1,4816,18,0
4100,경기도,4120,고양시덕양구,,삼송2동제1투,3179,2173,1040,1015,85,3,12,0,0,1,3,1,0,1,2161,12,1006
4100,경기도,4120,고양시덕양구,,삼송2동제2투,3554,2295,1178,1000,72,1,20,2,0,1,3,3,1,1,2282,13,1259
4100,경기도,4120,고양시덕양구,,삼송2동제3투,3396,2264,994,1153,86,0,5,2,0,1,1,1,1,0,2244,20,1132
4100,경기도,4120,고양시덕양구,,삼송2동제4투,2822,1916,856,953,66,0,19,0,0,0,1,1,0,1,1897,19,906
4100,경기도,4120,고양시덕양구,,삼송2동제5투,1931,1388,711,583,62,1,9,0,0,1,1,1,0,1,1370,18,543
4100,경기도,4120,고양시덕양구,행신4동,소계,16172,11914,6571,4763,344,8,92,2,1,3,6,16,0,4,11810,104,4258
4100,경기도,4120,고양시덕양구,,관내사전투표,4859,4856,2916,1771,106,3,21,1,0,1,1,8,0,1,4829,27,3
4100,경기도,4120,고양시덕양구,,행신4동제1투,2611,1398,703,613,39,3,20,1,0,0,1,1,0,2,1383,15,1213
4100,경기도,4120,고양시덕양구,,행신4동제2투,2022,1001,502,435,32,1,10,0,0,0,1,2,0,0,983,18,1021
4100,경기도,4120,고양시덕양구,,행신4동제3투,2286,1438,737,619,45,1,20,0,1,0,0,1,0,0,1424,14,848
4100,경기도,4120,고양시덕양구,,행신4동제4투,1754,1277,669,539,51,0,11,0,0,0,0,1,0,0,1271,6,477
4100,경기도,4120,고양시덕양구,,행신4동제5투,2640,1944,1044,786,71,0,10,0,0,2,3,3,0,1,1920,24,696
4100,경기도,4120,고양시덕양구,잘못 투입·구분된 투표지,,0,10,4,5,0,0,0,0,0,0,0,0,0,0,9,1,-10
4100,경기도,4121,고양시일산동구,합계,,256654,197004,96990,91849,5032,90,1120,51,12,53,120,133,24,49,195523,1481,59650
4100,경기도,4121,고양시일산동구,거소·선상투표,,504,468,179,204,11,3,13,1,0,1,2,0,1,3,418,50,36
4100,경기도,4121,고양시일산동구,관외사전투표,,26045,26043,13352,11475,695,12,215,11,3,4,11,37,2,10,25827,216,2
4100,경기도,4121,고양시일산동구,재외투표,,2130,1575,877,514,63,0,8,2,0,0,0,0,0,0,1464,111,555
4100,경기도,4121,고양시일산동구,식사동,소계,26840,20703,9494,10503,473,3,90,1,1,4,9,6,1,3,20588,115,6137
4100,경기도,4121,고양시일산동구,,관내사전투표,6812,6812,3618,3013,129,1,21,1,0,1,0,2,1,3,6790,22,0
4100,경기도,4121,고양시일산동구,,식사동제1투,1662,1221,522,654,33,0,5,0,0,0,2,0,0,0,1216,5,441
4100,경기도,4121,고양시일산동구,,식사동제2투,2698,1970,855,1039,47,0,9,0,0,1,2,2,0,0,1955,15,728
4100,경기도,4121,고양시일산동구,,식사동제3투,2060,1498,574,880,31,0,4,0,0,0,0,0,0,0,1489,9,562
4100,경기도,4121,고양시일산동구,,식사동제4투,2564,1936,874,977,56,0,9,0,1,1,1,0,0,0,1919,17,628
4100,경기도,4121,고양시일산동구,,식사동제5투,2561,1725,658,1007,37,0,12,0,0,0,1,1,0,0,1716,9,836
4100,경기도,4121,고양시일산동구,,식사동제6투,3566,2591,1002,1516,53,1,6,0,0,0,2,0,0,0,2580,11,975
4100,경기도,4121,고양시일산동구,,식사동제7투,3352,1889,906,896,56,0,13,0,0,1,1,1,0,0,1874,15,1463
4100,경기도,4121,고양시일산동구,,식사동제8투,1565,1061,485,521,31,1,11,0,0,0,0,0,0,0,1049,12,504
4100,경기도,4121,고양시일산동구,정발산동,소계,18430,13662,6682,6389,366,8,76,8,1,6,8,8,1,5,13558,104,4768
4100,경기도,4121,고양시일산동구,,관내사전투표,5129,5129,2862,2102,122,3,15,1,0,0,2,4,0,3,5114,15,0
4100,경기도,4121,고양시일산동구,,정발산동제1투,2450,1463,670,700,50,2,16,2,1,1,0,1,0,1,1444,19,987
4100,경기도,4121,고양시일산동구,,정발산동제2투,2196,1404,628,696,48,0,14,1,0,1,1,0,0,0,1389,15,792
4100,경기도,4121,고양시일산동구,,정발산동제3투,2476,1576,781,724,40,1,7,2,0,0,0,1,0,0,1556,20,900
4100,경기도,4121,고양시일산동구,,정발산동제4투,1471,1037,451,535,27,0,6,0,0,3,1,0,0,1,1024,13,434
4100,경기도,4121,고양시일산동구,,정발산동제5투,2283,1395,599,737,36,1,11,1,0,0,4,0,0,0,1389,6,888
4100,경기도,4121,고양시일산동구,,정발산동제6투,2425,1658,691,895,43,1,7,1,0,1,0,2,1,0,1642,16,767
4100,경기도,4121,고양시일산동구,풍산동,소계,27656,20441,10780,8821,527,11,97,6,3,6,10,16,2,6,20285,156,7215
4100,경기도,4121,고양시일산동구,,관내사전투표,4887,4885,2859,1885,93,3,9,1,2,1,2,8,1,2,4866,19,2
4100,경기도,4121,고양시일산동구,,풍산동제1투,2748,1885,969,813,61,3,11,1,0,1,1,2,0,0,1862,23,863
4100,경기도,4121,고양시일산동구,,풍산동제2투,3222,1888,998,791,57,1,20,0,0,2,1,2,0,1,1873,15,1334
4100,경기도,4121,고양시일산동구,,풍산동제3투,2630,1962,1044,831,57,0,9,0,0,1,1,0,0,0,1943,19,668
4100,경기도,4121,고양시일산동구,,풍산동제4투,2516,1733,824,839,44,1,11,0,0,0,2,2,0,0,1723,10,783
4100,경기도,4121,고양시일산동구,,풍산동제5투,3451,2289,1213,961,78,1,11,1,1,1,0,1,0,0,2268,21,1162
4100,경기도,4121,고양시일산동구,,풍산동제6투,2583,1979,1018,897,42,1,3,0,0,0,1,1,0,0,1963,16,604
4100,경기도,4121,고양시일산동구,,풍산동제7투,2534,1723,859,787,43,1,11,1,0,0,1,0,0,3,1706,17,811
4100,경기도,4121,고양시일산동구,,풍산동제8투,3085,2097,996,1017,52,0,12,2,0,0,1,0,1,0,2081,16,988
4100,경기도,4121,고양시일산동구,백석1동,소계,23191,17935,8960,8243,490,9,79,1,1,5,8,9,3,4,17812,123,5256
4100,경기도,4121,고양시일산동구,,관내사전투표,5714,5714,3288,2257,117,0,19,0,1,1,1,3,0,1,5688,26,0
4100,경기도,4121,고양시일산동구,,백석1동제1투,1760,1041,481,501,34,1,11,1,0,1,0,1,0,1,1032,9,719
4100,경기도,4121,고양시일산동구,,백석1동제2투,2256,1534,759,694,49,5,6,0,0,1,1,1,2,0,1518,16,722
4100,경기도,4121,고양시일산동구,,백석1동제3투,2338,1768,875,809,61,0,7,0,0,0,2,2,0,0,1756,12,570
4100,경기도,4121,고양시일산동구,,백석1동제4투,2592,1836,883,873,57,0,8,0,0,1,1,0,0,1,1824,12,756
4100,경기도,4121,고양시일산동구,,백석1동제5투,2577,1597,806,698,60,3,10,0,0,1,0,1,1,0,1580,17,980
4100,경기도,4121,고양시일산동구,,백석1동제6투,1911,1350,644,636,45,0,13,0,0,0,1,0,0,1,1340,10,561
4100,경기도,4121,고양시일산동구,,백석1동제7투,4043,3095,1224,1775,67,0,5,0,0,0,2,1,0,0,3074,21,948
4100,경기도,4121,고양시일산동구,백석2동,소계,17520,12542,6530,5481,336,7,81,1,1,4,11,5,2,1,12460,82,4978
4100,경기도,4121,고양시일산동구,,관내사전투표,5192,5192,3016,1999,121,5,19,1,0,0,1,3,1,1,5167,25,0
4100,경기도,4121,고양시일산동구,,백석2동제1투,2389,1504,723,708,53,0,9,0,0,0,1,0,0,0,1494,10,885
4100,경기도,4121,고양시일산동구,,백석2동제2투,2527,1596,754,763,52,0,17,0,1,0,3,0,0,0,1590,6,931
4100,경기도,4121,고양시일산동구,,백석2동제3투,3451,1887,890,915,33,1,18,0,0,2,3,1,1,0,1864,23,1564
4100,경기도,4121,고양시일산동구,,백석2동제4투,3961,2363,1147,1096,77,1,18,0,0,2,3,1,0,0,2345,18,1598
4100,경기도,4121,고양시일산동구,마두1동,소계,18505,14793,6997,7160,437,7,68,1,0,2,10,3,3,3,14691,102,3712
4100,경기도,4121,고양시일산동구,,관내사전투표,5285,5285,2939,2138,153,4,20,0,0,0,4,2,1,1,5262,23,0
4100,경기도,4121,고양시일산동구,,마두1동제1투,3095,2216,999,1116,73,2,11,0,0,0,2,0,0,0,2203,13,879
4100,경기도,4121,고양시일산동구,,마두1동제2투,2724,2128,854,1194,61,0,5,0,0,1,1,0,0,0,2116,12,596
4100,경기도,4121,고양시일산동구,,마두1동제3투,2719,1819,812,904,61,1,16,1,0,0,1,1,1,1,1799,20,900
4100,경기도,4121,고양시일산동구,,마두1동제4투,2490,1859,819,971,42,0,3,0,0,1,0,0,0,1,1837,22,631
4100,경기도,4121,고양시일산동구,,마두1동제5투,2192,1486,574,837,47,0,13,0,0,0,2,0,1,0,1474,12,706
4100,경기도,4121,고양시일산동구,마두2동,소계,14198,11844,5530,5953,251,5,26,3,0,2,8,6,0,2,11786,58,2354
4100,경기도,4121,고양시일산동구,,관내사전투표,6063,6063,3304,2608,108,3,6,2,0,0,3,4,0,2,6040,23,0
4100,경기도,4121,고양시일산동구,,마두2동제1투,2164,1534,532,946,39,0,5,1,0,1,2,1,0,0,1527,7,630
4100,경기도,4121,고양시일산동구,,마두2동제2투,2146,1563,598,898,49,1,6,0,0,0,0,0,0,0,1552,11,583
4100,경기도,4121,고양시일산동구,,마두2동제3투,1466,856,396,431,17,1,4,0,0,0,0,0,0,0,849,7,610
4100,경기도,4121,고양시일산동구,,마두2동제4투,2359,1828,700,1070,38,0,5,0,0,1,3,1,0,0,1818,10,531
4100,경기도,4121,고양시일산동구,장항1동,소계,7896,6095,2529,3381,116,0,29,0,0,2,3,5,0,0,6065,30,1801
4100,경기도,4121,고양시일산동구,,관내사전투표,1656,1655,850,769,17,0,8,0,0,0,1,5,0,0,1650,5,1
4100,경기도,4121,고양시일산동구,,장항1동제1투,1093,599,196,381,13,0,6,0,0,0,0,0,0,0,596,3,494
4100,경기도,4121,고양시일산동구,,장항1동제2투,3652,2859,1074,1692,65,0,13,0,0,2,2,0,0,0,2848,11,793
4100,경기도,4121,고양시일산동구,,장항1동제3투,1495,982,409,539,21,0,2,0,0,0,0,0,0,0,971,11,513
4100,경기도,4121,고양시일산동구,장항2동,소계,21076,13771,6464,6790,307,3,82,4,1,5,12,8,3,6,13685,86,7305
4100,경기도,4121,고양시일산동구,,관내사전투표,5203,5203,2773,2300,92,2,11,2,1,0,2,4,1,0,5188,15,0
4100,경기도,4121,고양시일산동구,,장항2동제1투,2794,1676,680,921,48,1,5,0,0,0,8,0,0,1,1664,12,1118
4100,경기도,4121,고양시일산동구,,장항2동제2투,2184,1660,571,1033,34,0,4,2,0,1,0,2,1,2,1650,10,524
4100,경기도,4121,고양시일산동구,,장항2동제3투,3331,1554,697,783,35,0,16,0,0,1,0,1,1,1,1535,19,1777
4100,경기도,4121,고양시일산동구,,장항2동제4투,3654,1833,870,875,48,0,18,0,0,2,2,1,0,1,1817,16,1821
4100,경기도,4121,고양시일산동구,,장항2동제5투,3910,1845,873,878,50,0,28,0,0,1,0,0,0,1,1831,14,2065
4100,경기도,4121,고양시일산동구,고봉동,소계,17065,10762,5207,5074,266,6,108,5,1,4,10,8,2,0,10691,71,6303
4100,경기도,4121,고양시일산동구,,관내사전투표,3295,3294,1746,1447,69,4,18,0,0,1,1,2,1,0,3289,5,1
4100,경기도,4121,고양시일산동구,,고봉동제1투,3213,1715,898,729,46,0,22,1,1,1,3,2,1,0,1704,11,1498
4100,경기도,4121,고양시일산동구,,고봉동제2투,3605,1841,800,946,49,1,25,1,0,1,0,1,0,0,1824,17,1764
4100,경기도,4121,고양시일산동구,,고봉동제3투,2883,1333,538,714,27,0,23,1,0,1,3,2,0,0,1309,24,1550
4100,경기도,4121,고양시일산동구,,고봉동제4투,2046,1156,539,559,36,0,11,0,0,0,1,0,0,0,1146,10,890
4100,경기도,4121,고양시일산동구,,고봉동제5투,2023,1423,686,679,39,1,9,2,0,0,2,1,0,0,1419,4,600
4100,경기도,4121,고양시일산동구,중산1동,소계,17589,12964,6256,6129,365,8,77,6,0,4,12,11,1,2,12871,93,4625
4100,경기도,4121,고양시일산동구,,관내사전투표,5518,5517,2940,2384,124,3,24,3,0,0,3,4,1,0,5486,31,1
4100,경기도,4121,고양시일산동구,,중산1동제1투,2359,1219,585,555,46,1,17,0,0,0,0,4,0,0,1208,11,1140
4100,경기도,4121,고양시일산동구,,중산1동제2투,2372,1341,645,631,39,1,7,1,0,1,2,0,0,0,1327,14,1031
4100,경기도,4121,고양시일산동구,,중산1동제3투,2679,1948,849,1001,66,1,8,2,0,2,3,0,0,1,1933,15,731
4100,경기도,4121,고양시일산동구,,중산1동제4투,2395,1471,635,749,55,1,13,0,0,1,4,2,0,1,1461,10,924
4100,경기도,4121,고양시일산동구,,중산1동제5투,2266,1468,602,809,35,1,8,0,0,0,0,1,0,0,1456,12,798
4100,경기도,4121,고양시일산동구,중산2동,소계,18009,13405,7153,5731,329,8,71,1,0,4,6,11,3,4,13321,84,4604
4100,경기도,4121,고양시일산동구,,관내사전투표,4583,4583,2681,1772,91,0,13,0,0,0,1,4,0,3,4565,18,0
4100,경기도,4121,고양시일산동구,,중산2동제1투,3225,2062,1035,937,50,4,16,0,0,1,3,2,0,0,2048,14,1163
4100,경기도,4121,고양시일산동구,,중산2동제2투,3079,2115,1007,1019,64,0,8,0,0,0,1,1,1,0,2101,14,964
4100,경기도,4121,고양시일산동구,,중산2동제3투,3715,2493,1309,1073,67,3,16,0,0,0,0,3,1,1,2473,20,1222
4100,경기도,4121,고양시일산동구,,중산2동제4투,3407,2152,1121,930,57,1,18,1,0,3,1,1,1,0,2134,18,1255
4100,경기도,4121,고양시일산동구,잘못 투입·구분된 투표지,,0,1,0,1,0,0,0,0,0,0,0,0,0,0,1,0,-1
4100,경기도,4122,고양시일산서구,합계,,251203,197311,99597,89677,4975,108,1019,43,18,47,130,147,33,63,195857,1454,53892
4100,경기도,4122,고양시일산서구,거소·선상투표,,516,436,160,181,15,6,14,0,0,0,2,2,0,0,380,56,80
4100,경기도,4122,고양시일산서구,관외사전투표,,23586,23581,12383,10180,601,14,162,5,3,2,10,21,5,11,23397,184,5
4100,경기도,4122,고양시일산서구,재외투표,,2142,1610,889,536,45,1,2,2,0,0,0,0,0,0,1475,135,532
4100,경기도,4122,고양시일산서구,일산1동,소계,20786,15571,8056,6871,404,12,92,1,2,3,8,21,6,5,15481,90,5215
4100,경기도,4122,고양시일산서구,,관내사전투표,6011,6011,3401,2417,129,4,21,1,1,0,1,11,1,0,5987,24,0
4100,경기도,4122,고양시일산서구,,일산1동제1투,2391,1463,742,653,45,1,8,0,1,0,1,4,0,0,1455,8,928
4100,경기도,4122,고양시일산서구,,일산1동제2투,2725,1726,862,785,44,2,15,0,0,0,0,0,2,3,1713,13,999
4100,경기도,4122,고양시일산서구,,일산1동제3투,2059,1254,603,591,38,2,8,0,0,0,2,3,0,0,1247,7,805
4100,경기도,4122,고양시일산서구,,일산1동제4투,2673,1722,871,771,38,2,21,0,0,0,2,3,2,1,1711,11,951
4100,경기도,4122,고양시일산서구,,일산1동제5투,2590,1791,799,899,62,1,14,0,0,3,1,0,1,0,1780,11,799
4100,경기도,4122,고양시일산서구,,일산1동제6투,2337,1604,778,755,48,0,5,0,0,0,1,0,0,1,1588,16,733
4100,경기도,4122,고양시일산서구,일산2동,소계,14878,11070,5509,5149,246,5,66,0,1,6,11,15,1,4,11013,57,3808
4100,경기도,4122,고양시일산서구,,관내사전투표,4091,4090,2279,1689,83,3,13,0,0,2,0,5,1,2,4077,13,1
4100,경기도,4122,고양시일산서구,,일산2동제1투,1854,1060,499,513,23,1,13,0,0,2,0,2,0,0,1053,7,794
4100,경기도,4122,고양시일산서구,,일산2동제2투,2935,2280,1069,1119,63,1,10,0,0,1,1,4,0,0,2268,12,655
4100,경기도,4122,고양시일산서구,,일산2동제3투,1930,1326,581,702,25,0,3,0,0,1,3,0,0,1,1316,10,604
4100,경기도,4122,고양시일산서구,,일산2동제4투,1490,778,355,383,15,0,13,0,0,0,1,2,0,0,769,9,712
4100,경기도,4122,고양시일산서구,,일산2동제5투,2578,1536,726,743,37,0,14,0,1,0,6,2,0,1,1530,6,1042
4100,경기도,4122,고양시일산서구,일산3동,소계,24963,20077,10338,8973,530,11,64,2,2,5,10,9,2,5,19951,126,4886
4100,경기도,4122,고양시일산서구,,관내사전투표,6289,6289,3767,2378,104,3,11,0,0,0,1,1,0,2,6267,22,0
4100,경기도,4122,고양시일산서구,,일산3동제1투,2272,1526,685,769,44,0,11,0,2,0,3,1,0,0,1515,11,746
4100,경기도,4122,고양시일산서구,,일산3동제2투,2738,2057,900,1073,58,3,3,1,0,0,0,1,0,0,2039,18,681
4100,경기도,4122,고양시일산서구,,일산3동제3투,2756,2046,1000,955,59,0,10,0,0,3,3,1,0,1,2032,14,710
4100,경기도,4122,고양시일산서구,,일산3동제4투,2061,1553,784,706,45,1,3,0,0,1,1,1,0,2,1544,9,508
4100,경기도,4122,고양시일산서구,,일산3동제5투,2681,1993,1009,888,72,1,6,0,0,0,1,1,0,0,1978,15,688
4100,경기도,4122,고양시일산서구,,일산3동제6투,2143,1657,772,810,61,0,1,0,0,0,0,1,0,0,1645,12,486
4100,경기도,4122,고양시일산서구,,일산3동제7투,1816,1289,666,552,41,2,12,1,0,0,0,2,1,0,1277,12,527
4100,경기도,4122,고양시일산서구,,일산3동제8투,2207,1667,755,842,46,1,7,0,0,1,1,0,1,0,1654,13,540
4100,경기도,4122,고양시일산서구,주엽1동,소계,21604,17048,8147,8294,391,7,60,3,2,4,8,4,5,3,16928,120,4556
4100,경기도,4122,고양시일산서구,,관내사전투표,5151,5151,2843,2182,96,2,7,1,0,0,0,0,0,0,5131,20,0
4100,경기도,4122,고양시일산서구,,주엽1동제1투,2502,1608,687,857,42,0,8,0,1,0,1,1,0,0,1597,11,894
4100,경기도,4122,고양시일산서구,,주엽1동제2투,2080,1560,664,827,47,0,8,0,0,0,0,0,0,0,1546,14,520
4100,경기도,4122,고양시일산서구,,주엽1동제3투,2069,1596,739,790,39,0,9,0,0,0,1,0,1,1,1580,16,473
4100,경기도,4122,고양시일산서구,,주엽1동제4투,2376,1675,818,785,48,0,9,0,0,0,0,2,2,0,1664,11,701
4100,경기도,4122,고양시일산서구,,주엽1동제5투,1349,900,458,397,25,0,8,1,1,2,2,0,0,1,895,5,449
4100,경기도,4122,고양시일산서구,,주엽1동제6투,2022,1524,567,896,37,3,4,1,0,0,2,0,1,0,1511,13,498
4100,경기도,4122,고양시일산서구,,주엽1동제7투,2337,1732,720,953,29,1,4,0,0,1,2,1,0,1,1712,20,605
4100,경기도,4122,고양시일산서구,,주엽1동제8투,1718,1302,651,607,28,1,3,0,0,1,0,0,1,0,1292,10,416
4100,경기도,4122,고양시일산서구,주엽2동,소계,21885,17116,8110,8329,438,9,67,4,1,6,22,6,1,8,17001,115,4769
4100,경기도,4122,고양시일산서구,,관내사전투표,5743,5743,3189,2410,107,2,7,1,1,0,1,2,0,4,5724,19,0
4100,경기도,4122,고양시일산서구,,주엽2동제1투,1953,1311,452,797,40,1,7,0,0,0,0,0,0,0,1297,14,642
4100,경기도,4122,고양시일산서구,,주엽2동제2투,1970,1459,656,738,39,0,9,0,0,0,1,0,0,1,1444,15,511
4100,경기도,4122,고양시일산서구,,주엽2동제3투,1582,1139,531,555,36,2,5,0,0,0,1,0,0,0,1130,9,443
4100,경기도,4122,고양시일산서구,,주엽2동제4투,2286,1530,645,796,53,2,9,2,0,2,7,0,0,2,1518,12,756
4100,경기도,4122,고양시일산서구,,주엽2동제5투,1756,1259,526,678,34,1,4,0,0,1,0,1,0,1,1246,13,497
4100,경기도,4122,고양시일산서구,,주엽2동제6투,1592,1019,494,471,30,0,5,0,0,1,5,1,0,0,1007,12,573
4100,경기도,4122,고양시일산서구,,주엽2동제7투,2581,1927,860,992,51,0,9,0,0,2,3,0,1,0,1918,9,654
4100,경기도,4122,고양시일산서구,,주엽2동제8투,2422,1729,757,892,48,1,12,1,0,0,4,2,0,0,1717,12,693
4100,경기도,4122,고양시일산서구,대화동,소계,28571,21266,10441,9883,578,9,106,10,2,10,18,26,2,9,21094,172,7305
4100,경기도,4122,고양시일산서구,,관내사전투표,6829,6819,3842,2758,145,2,19,4,1,0,2,10,0,2,6785,34,10
4100,경기도,4122,고양시일산서구,,대화동제1투,2889,1782,895,802,52,0,10,0,0,1,4,1,0,0,1765,17,1107
4100,경기도,4122,고양시일산서구,,대화동제2투,2524,1835,922,817,52,2,12,1,0,5,0,2,0,2,1815,20,689
4100,경기도,4122,고양시일산서구,,대화동제3투,2958,2043,965,971,58,3,11,1,1,0,6,4,0,0,2020,23,915
4100,경기도,4122,고양시일산서구,,대화동제4투,1638,1006,461,508,21,0,7,0,0,1,0,1,0,0,999,7,632
4100,경기도,4122,고양시일산서구,,대화동제5투,2325,1468,672,719,45,1,14,0,0,0,1,0,0,0,1452,16,857
4100,경기도,4122,고양시일산서구,,대화동제6투,3168,2109,938,1070,63,0,14,1,0,1,1,1,1,1,2091,18,1059
4100,경기도,4122,고양시일산서구,,대화동제7투,2275,1273,579,605,42,1,14,1,0,2,3,2,0,4,1253,20,1002
4100,경기도,4122,고양시일산서구,,대화동제8투,3965,2931,1167,1633,100,0,5,2,0,0,1,5,1,0,2914,17,1034
4100,경기도,4122,고양시일산서구,송포동,소계,16103,12597,5959,6200,298,6,50,1,0,1,6,5,1,4,12531,66,3506
4100,경기도,4122,고양시일산서구,,관내사전투표,4864,4865,2643,2090,98,3,10,0,0,0,0,3,1,1,4849,16,-1
4100,경기도,4122,고양시일산서구,,송포동제1투,3091,2010,744,1183,49,3,16,0,0,0,2,1,0,1,1999,11,1081
4100,경기도,4122,고양시일산서구,,송포동제2투,2861,1982,915,990,56,0,6,0,0,1,1,0,0,0,1969,13,879
4100,경기도,4122,고양시일산서구,,송포동제3투,2556,1763,795,899,42,0,8,1,0,0,1,1,0,1,1748,15,793
4100,경기도,4122,고양시일산서구,,송포동제4투,2731,1977,862,1038,53,0,10,0,0,0,2,0,0,1,1966,11,754
4100,경기도,4122,고양시일산서구,탄현1동,소계,24641,18551,9811,7964,496,11,101,4,2,4,11,14,3,9,18430,121,6090
4100,경기도,4122,고양시일산서구,,관내사전투표,7523,7522,4375,2906,165,3,28,2,1,0,1,6,3,2,7492,30,1
4100,경기도,4122,고양시일산서구,,탄현1동제1투,2302,1222,593,572,27,0,14,0,1,1,1,2,0,0,1211,11,1080
4100,경기도,4122,고양시일산서구,,탄현1동제2투,1955,1198,627,502,45,1,9,0,0,0,2,3,0,1,1190,8,757
4100,경기도,4122,고양시일산서구,,탄현1동제3투,2351,1575,829,668,50,1,13,1,0,1,0,0,0,4,1567,8,776
4100,경기도,4122,고양시일산서구,,탄현1동제4투,2424,1455,737,650,35,1,16,0,0,0,0,2,0,0,1441,14,969
4100,경기도,4122,고양시일산서구,,탄현1동제5투,2673,1669,876,702,58,3,11,1,0,2,1,0,0,1,1655,14,1004
4100,경기도,4122,고양시일산서구,,탄현1동제6투,2224,1602,753,785,44,1,4,0,0,0,4,1,0,0,1592,10,622
4100,경기도,4122,고양시일산서구,,탄현1동제7투,1985,1471,661,752,41,0,2,0,0,0,2,0,0,0,1458,13,514
4100,경기도,4122,고양시일산서구,,탄현1동제8투,1204,837,360,427,31,1,4,0,0,0,0,0,0,1,824,13,367
4100,경기도,4122,고양시일산서구,탄현2동,소계,14287,10927,5977,4494,283,5,72,5,0,1,5,12,3,1,10858,69,3360
4100,경기도,4122,고양시일산서구,,관내사전투표,4588,4588,2753,1696,91,2,16,1,0,1,1,7,0,1,4569,19,0
4100,경기도,4122,고양시일산서구,,탄현2동제1투,1712,971,493,433,28,0,8,0,0,0,0,0,1,0,963,8,741
4100,경기도,4122,고양시일산서구,,탄현2동제2투,3132,1970,1004,865,57,0,22,1,0,0,3,1,1,0,1954,16,1162
4100,경기도,4122,고양시일산서구,,탄현2동제3투,2576,1736,818,833,52,1,13,2,0,0,1,3,1,0,1724,12,840
4100,경기도,4122,고양시일산서구,,탄현2동제4투,2279,1662,909,667,55,2,13,1,0,0,0,1,0,0,1648,14,617
4100,경기도,4122,고양시일산서구,덕이동,소계,22419,15988,8116,7296,338,6,111,2,0,4,14,9,2,4,15902,86,6431
4100,경기도,4122,고양시일산서구,,관내사전투표,4063,4063,2356,1606,67,0,18,1,0,1,0,3,1,0,4053,10,0
4100,경기도,4122,고양시일산서구,,덕이동제1투,2409,1457,697,696,35,1,16,0,0,0,1,0,0,1,1447,10,952
4100,경기도,4122,고양시일산서구,,덕이동제2투,3796,2167,1069,1007,49,0,23,1,0,0,1,0,0,1,2151,16,1629
4100,경기도,4122,고양시일산서구,,덕이동제3투,2262,1625,803,759,36,0,8,0,0,1,1,2,0,0,1610,15,637
4100,경기도,4122,고양시일산서구,,덕이동제4투,2284,1697,864,778,36,2,3,0,0,0,3,2,0,1,1689,8,587
4100,경기도,4122,고양시일산서구,,덕이동제5투,4462,3136,1434,1601,69,1,16,0,0,0,1,1,0,0,3123,13,1326
4100,경기도,4122,고양시일산서구,,덕이동제6투,3143,1843,893,849,46,2,27,0,0,2,7,1,1,1,1829,14,1300
4100,경기도,4122,고양시일산서구,가좌동,소계,14822,11471,5699,5327,312,6,52,4,3,1,5,3,2,0,11414,57,3351
4100,경기도,4122,고양시일산서구,,관내사전투표,5108,5107,2786,2161,123,2,17,2,2,0,1,0,2,0,5096,11,1
4100,경기도,4122,고양시일산서구,,가좌동제1투,1918,1272,550,664,43,2,6,0,0,0,3,1,0,0,1269,3,646
4100,경기도,4122,고양시일산서구,,가좌동제2투,2400,1370,492,813,38,0,11,0,0,0,1,1,0,0,1356,14,1030
4100,경기도,4122,고양시일산서구,,가좌동제3투,2519,1733,864,788,45,1,14,2,1,0,0,0,0,0,1715,18,786
4100,경기도,4122,고양시일산서구,,가좌동제4투,2877,1989,1007,901,63,1,4,0,0,1,0,1,0,0,1978,11,888
4100,경기도,4122,고양시일산서구,잘못 투입·구분된 투표지,,0,2,2,0,0,0,0,0,0,0,0,0,0,0,2,0,-2
4100,경기도,4123,과천시,합계,,63841,54194,21072,30934,1314,30,228,19,10,20,28,31,7,12,53705,489,9647
4100,경기도,4123,과천시,거소·선상투표,,116,109,42,45,3,0,2,0,0,0,0,0,0,0,92,17,7
4100,경기도,4123,과천시,관외사전투표,,6547,6547,2823,3431,174,5,40,2,0,1,1,6,0,4,6487,60,0
4100,경기도,4123,과천시,재외투표,,754,558,249,237,16,0,0,0,0,0,0,0,0,0,502,56,196
4100,경기도,4123,과천시,중앙동,소계,8449,7174,2422,4502,167,1,14,0,1,6,4,3,0,2,7122,52,1275
4100,경기도,4123,과천시,,관내사전투표,3359,3359,1360,1914,61,1,2,0,0,3,0,2,0,0,3343,16,0
4100,경기도,4123,과천시,,중앙동제1투,1449,999,307,630,33,0,5,0,0,1,1,1,0,1,979,20,450
4100,경기도,4123,과천시,,중앙동제2투,1742,1422,372,1003,38,0,1,0,1,1,1,0,0,0,1417,5,320
4100,경기도,4123,과천시,,중앙동제3투,1899,1394,383,955,35,0,6,0,0,1,2,0,0,1,1383,11,505
4100,경기도,4123,과천시,갈현동,소계,11905,10079,3819,5892,237,4,36,2,3,5,9,3,2,0,10012,67,1826
4100,경기도,4123,과천시,,관내사전투표,3649,3649,1633,1931,60,0,10,1,0,1,2,0,0,0,3638,11,0
4100,경기도,4123,과천시,,갈현동제1투,1230,846,332,465,29,0,3,0,1,2,0,1,1,0,834,12,384
4100,경기도,4123,과천시,,갈현동제2투,2330,1910,525,1314,41,1,6,0,0,1,2,1,0,0,1891,19,420
4100,경기도,4123,과천시,,갈현동제3투,1826,1381,473,844,43,1,7,1,1,1,1,0,1,0,1373,8,445
4100,경기도,4123,과천시,,갈현동제4투,2143,1675,567,1040,41,1,8,0,1,0,3,1,0,0,1662,13,468
4100,경기도,4123,과천시,,갈현동제5투,727,618,289,298,23,1,2,0,0,0,1,0,0,0,614,4,109
4100,경기도,4123,과천시,별양동,소계,12149,10240,3733,6114,244,6,45,4,1,2,2,6,3,0,10160,80,1909
4100,경기도,4123,과천시,,관내사전투표,4692,4691,1980,2581,87,3,10,3,0,0,0,2,1,0,4667,24,1
4100,경기도,4123,과천시,,별양동제1투,2278,1517,534,908,43,1,15,0,1,0,0,0,2,0,1504,13,761
4100,경기도,4123,과천시,,별양동제2투,1389,1010,332,620,35,0,3,1,0,0,1,2,0,0,994,16,379
4100,경기도,4123,과천시,,별양동제3투,1404,1071,309,717,23,0,6,0,0,1,1,2,0,0,1059,12,333
4100,경기도,4123,과천시,,별양동제4투,2386,1951,578,1288,56,2,11,0,0,1,0,0,0,0,1936,15,435
4100,경기도,4123,과천시,부림동,소계,11435,9637,3682,5573,245,3,34,5,1,3,4,8,0,2,9560,77,1798
4100,경기도,4123,과천시,,관내사전투표,4973,4973,2174,2643,109,1,12,0,1,0,1,5,0,1,4947,26,0
4100,경기도,4123,과천시,,부림동제1투,1823,1315,417,832,41,0,5,2,0,1,2,1,0,1,1302,13,508
4100,경기도,4123,과천시,,부림동제2투,1510,983,394,544,23,1,6,1,0,0,1,2,0,0,972,11,527
4100,경기도,4123,과천시,,부림동제3투,1678,1278,356,859,44,1,6,1,0,0,0,0,0,0,1267,11,400
4100,경기도,4123,과천시,,부림동제4투,1451,1088,341,695,28,0,5,1,0,2,0,0,0,0,1072,16,363
4100,경기도,4123,과천시,과천동,소계,6702,5099,2077,2828,104,6,31,5,1,0,4,3,1,1,5061,38,1603
4100,경기도,4123,과천시,,관내사전투표,1747,1747,847,841,34,3,8,1,0,0,1,2,1,0,1738,9,0
4100,경기도,4123,과천시,,과천동제1투,1224,778,256,478,24,1,8,3,0,0,1,1,0,0,772,6,446
4100,경기도,4123,과천시,,과천동제2투,1453,1001,315,644,24,1,6,1,1,0,2,0,0,0,994,7,452
4100,경기도,4123,과천시,,과천동제3투,768,502,193,293,9,0,3,0,0,0,0,0,0,0,498,4,266
4100,경기도,4123,과천시,,과천동제4투,1510,1071,466,572,13,1,6,0,0,0,0,0,0,1,1059,12,439
4100,경기도,4123,과천시,문원동,소계,5784,4751,2225,2312,124,5,26,1,3,3,4,2,1,3,4709,42,1033
4100,경기도,4123,과천시,,관내사전투표,2189,2190,1089,1013,57,3,6,0,0,2,3,2,1,0,2176,14,-1
4100,경기도,4123,과천시,,문원동제1투,1703,1183,517,600,35,0,10,0,2,0,1,0,0,2,1167,16,520
4100,경기도,4123,과천시,,문원동제2투,1892,1378,619,699,32,2,10,1,1,1,0,0,0,1,1366,12,514
4100,경기도,4123,과천시,잘못 투입·구분된 투표지,,0,0,0,0,0,0,0,0,0,0,0,0,0,0,0,0,0
4100,경기도,4124,의왕시,합계,,139712,113105,54997,53556,2717,52,636,30,22,15,77,84,17,35,112238,867,26607
4100,경기도,4124,의왕시,거소·선상투표,,221,207,88,94,4,0,3,1,0,0,0,0,0,0,190,17,14
4100,경기도,4124,의왕시,관외사전투표,,16060,16056,8290,7116,405,7,93,2,2,0,2,17,2,7,15943,113,4
4100,경기도,4124,의왕시,재외투표,,948,699,396,225,22,0,3,0,0,1,0,0,0,0,647,52,249
4100,경기도,4124,의왕시,고천동,소계,12052,9558,4529,4612,238,5,69,7,2,2,7,15,0,3,9489,69,2494
4100,경기도,4124,의왕시,,관내사전투표,4941,4941,2566,2205,115,3,22,3,1,1,0,8,0,1,4925,16,0
4100,경기도,4124,의왕시,,고천동제1투,2730,1641,741,783,56,1,28,1,1,0,1,4,0,0,1616,25,1089
4100,경기도,4124,의왕시,,고천동제2투,1887,1276,532,686,30,0,8,1,0,0,4,1,0,2,1264,12,611
4100,경기도,4124,의왕시,,고천동제3투,2494,1700,690,938,37,1,11,2,0,1,2,2,0,0,1684,16,794
4100,경기도,4124,의왕시,부곡동,소계,22988,17412,9023,7629,413,12,136,5,8,2,13,8,4,9,17262,150,5576
4100,경기도,4124,의왕시,,관내사전투표,6087,6079,3462,2430,117,4,24,1,1,0,1,4,1,1,6046,33,8
4100,경기도,4124,의왕시,,부곡동제1투,1723,1086,502,531,30,0,9,0,0,0,0,1,0,2,1075,11,637
4100,경기도,4124,의왕시,,부곡동제2투,1796,1151,545,546,26,2,12,0,1,0,5,0,1,1,1139,12,645
4100,경기도,4124,의왕시,,부곡동제3투,2209,1362,710,597,27,1,9,0,0,1,1,2,0,0,1348,14,847
4100,경기도,4124,의왕시,,부곡동제4투,2514,1852,902,859,57,2,16,1,0,0,2,0,0,1,1840,12,662
4100,경기도,4124,의왕시,,부곡동제5투,2750,1817,878,842,41,1,25,1,5,0,1,1,1,1,1797,20,933
4100,경기도,4124,의왕시,,부곡동제6투,3308,2037,952,979,53,0,21,2,1,1,3,0,1,2,2015,22,1271
4100,경기도,4124,의왕시,,부곡동제7투,2601,2028,1072,845,62,2,20,0,0,0,0,0,0,1,2002,26,573
4100,경기도,4124,의왕시,오전동,소계,28791,22384,11003,10542,491,9,118,4,4,2,27,17,4,7,22228,156,6407
4100,경기도,4124,의왕시,,관내사전투표,6931,6931,3771,2974,120,1,28,0,0,2,1,4,1,1,6903,28,0
4100,경기도,4124,의왕시,,오전동제1투,1590,904,414,447,15,0,7,1,0,0,4,1,1,1,891,13,686
4100,경기도,4124,의왕시,,오전동제2투,2831,1868,899,880,52,1,14,1,0,0,4,2,1,2,1856,12,963
4100,경기도,4124,의왕시,,오전동제3투,2152,1337,553,732,28,2,9,0,0,0,0,1,0,0,1325,12,815
4100,경기도,4124,의왕시,,오전동제4투,1898,1479,612,789,52,0,4,1,0,0,3,1,0,0,1462,17,419
4100,경기도,4124,의왕시,,오전동제5투,2303,1717,846,811,33,3,4,0,0,0,3,2,1,0,1703,14,586
4100,경기도,4124,의왕시,,오전동제6투,1714,1204,563,587,30,1,8,0,0,0,6,0,0,0,1195,9,510
4100,경기도,4124,의왕시,,오전동제7투,2930,2300,1097,1109,59,0,14,0,3,0,3,1,0,1,2287,13,630
4100,경기도,4124,의왕시,,오전동제8투,2823,2154,1136,930,44,1,14,1,0,0,2,4,0,2,2134,20,669
4100,경기도,4124,의왕시,,오전동제9투,2168,1547,682,812,35,0,7,0,1,0,1,1,0,0,1539,8,621
4100,경기도,4124,의왕시,,오전동제10투,1451,943,430,471,23,0,9,0,0,0,0,0,0,0,933,10,508
4100,경기도,4124,의왕시,내손1동,소계,15120,12073,5451,6138,309,4,61,3,4,2,8,9,1,2,11992,81,3047
4100,경기도,4124,의왕시,,관내사전투표,4512,4512,2291,2082,96,0,16,1,1,2,1,4,1,0,4495,17,0
4100,경기도,4124,의왕시,,내손1동제1투,2151,1310,602,619,48,3,20,1,1,0,0,3,0,0,1297,13,841
4100,경기도,4124,의왕시,,내손1동제2투,1806,1314,526,738,34,0,3,0,1,0,2,0,0,0,1304,10,492
4100,경기도,4124,의왕시,,내손1동제3투,1807,1169,493,607,39,1,11,0,1,0,4,0,0,1,1157,12,638
4100,경기도,4124,의왕시,,내손1동제4투,2574,1950,764,1105,60,0,7,0,0,0,1,0,0,1,1938,12,624
4100,경기도,4124,의왕시,,내손1동제5투,2270,1818,775,987,32,0,4,1,0,0,0,2,0,0,1801,17,452
4100,경기도,4124,의왕시,내손2동,소계,17007,13752,6561,6696,327,4,48,5,1,2,5,3,3,3,13658,94,3255
4100,경기도,4124,의왕시,,관내사전투표,5910,5909,3115,2628,116,2,18,3,0,0,0,1,1,1,5885,24,1
4100,경기도,4124,의왕시,,내손2동제1투,2391,1845,898,873,45,1,9,0,0,1,0,0,1,0,1828,17,546
4100,경기도,4124,의왕시,,내손2동제2투,2126,1432,680,693,38,0,6,0,0,1,1,0,0,0,1419,13,694
4100,경기도,4124,의왕시,,내손2동제3투,1380,821,350,425,23,1,6,1,1,0,2,1,1,0,811,10,559
4100,경기도,4124,의왕시,,내손2동제4투,1185,676,267,389,10,0,2,1,0,0,1,0,0,0,670,6,509
4100,경기도,4124,의왕시,,내손2동제5투,2329,1740,745,929,49,0,6,0,0,0,0,0,0,0,1729,11,589
4100,경기도,4124,의왕시,,내손2동제6투,1686,1329,506,759,46,0,1,0,0,0,1,1,0,2,1316,13,357
4100,경기도,4124,의왕시,청계동,소계,26525,20961,9654,10503,508,11,105,3,1,4,15,15,3,4,20826,135,5564
4100,경기도,4124,의왕시,,관내사전투표,6296,6292,3389,2738,115,3,20,1,0,1,1,2,1,0,6271,21,4
4100,경기도,4124,의왕시,,청계동제1투,2328,1470,625,790,32,0,12,1,0,0,0,0,0,0,1460,10,858
4100,경기도,4124,의왕시,,청계동제2투,2087,1519,725,718,43,1,15,0,0,0,2,2,0,1,1507,12,568
4100,경기도,4124,의왕시,,청계동제3투,1501,1046,504,494,24,2,10,0,0,0,0,2,0,1,1037,9,455
4100,경기도,4124,의왕시,,청계동제4투,2770,1793,772,944,46,0,10,1,0,0,2,3,0,1,1779,14,977
4100,경기도,4124,의왕시,,청계동제5투,3009,2262,1046,1100,66,3,15,0,1,0,1,2,1,1,2236,26,747
4100,경기도,4124,의왕시,,청계동제6투,3211,2483,990,1390,73,1,10,0,0,0,4,1,1,0,2470,13,728
4100,경기도,4124,의왕시,,청계동제7투,2326,1731,611,1053,42,0,8,0,0,2,0,1,0,0,1717,14,595
4100,경기도,4124,의왕시,,청계동제8투,2997,2365,992,1276,67,1,5,0,0,1,5,2,0,0,2349,16,632
4100,경기도,4124,의왕시,잘못 투입·구분된 투표지,,0,3,2,1,0,0,0,0,0,0,0,0,0,0,3,0,-3
4100,경기도,4125,구리시,합계,,164281,127688,63465,58865,3023,36,878,31,18,32,107,117,28,54,126654,1034,36593
4100,경기도,4125,구리시,거소·선상투표,,258,244,98,101,2,0,5,0,0,0,0,1,0,2,209,35,14
4100,경기도,4125,구리시,관외사전투표,,13460,13451,7001,5773,332,3,146,8,3,6,5,28,7,9,13321,130,9
4100,경기도,4125,구리시,재외투표,,872,651,366,199,26,0,2,1,0,0,0,0,0,0,594,57,221
4100,경기도,4125,구리시,갈매동,소계,21819,16821,9096,7139,356,5,79,3,0,1,13,13,3,5,16713,108,4998
4100,경기도,4125,구리시,,관내사전투표,6627,6626,4058,2390,118,2,16,2,0,0,0,7,1,2,6596,30,1
4100,경기도,4125,구리시,,갈매동제1투,2430,1414,693,658,38,0,11,0,0,0,1,0,1,1,1403,11,1016
4100,경기도,4125,구리시,,갈매동제2투,2481,1721,836,819,46,0,6,0,0,0,1,0,1,1,1710,11,760
4100,경기도,4125,구리시,,갈매동제3투,1785,1204,648,503,32,1,11,0,0,0,3,1,0,0,1199,5,581
4100,경기도,4125,구리시,,갈매동제4투,2585,1923,964,897,36,0,7,0,0,1,2,2,0,0,1909,14,662
4100,경기도,4125,구리시,,갈매동제5투,1615,1025,483,490,19,0,14,1,0,0,2,1,0,0,1010,15,590
4100,경기도,4125,구리시,,갈매동제6투,2240,1452,643,761,21,0,7,0,0,0,3,0,0,1,1436,16,788
4100,경기도,4125,구리시,,갈매동제7투,2056,1456,771,621,46,2,7,0,0,0,1,2,0,0,1450,6,600
4100,경기도,4125,구리시,동구동,소계,28669,22620,11221,10444,585,1,121,4,5,8,22,20,4,11,22446,174,6049
4100,경기도,4125,구리시,,관내사전투표,6192,6192,3493,2538,98,0,21,0,0,1,3,6,1,5,6166,26,0
4100,경기도,4125,구리시,,동구동제1투,1501,893,414,424,32,0,15,0,0,0,0,1,0,0,886,7,608
4100,경기도,4125,구리시,,동구동제2투,842,531,154,356,7,0,5,0,0,0,0,2,0,0,524,7,311
4100,경기도,4125,구리시,,동구동제3투,2601,1887,913,893,47,0,11,0,1,0,1,2,0,1,1869,18,714
4100,경기도,4125,구리시,,동구동제4투,2208,1663,859,716,44,0,12,1,0,1,4,2,0,0,1639,24,545
4100,경기도,4125,구리시,,동구동제5투,2202,1604,719,817,41,0,13,0,0,2,4,1,0,0,1597,7,598
4100,경기도,4125,구리시,,동구동제6투,2071,1422,703,638,55,1,5,1,0,2,4,0,0,2,1411,11,649
4100,경기도,4125,구리시,,동구동제7투,2053,1505,690,730,60,0,8,0,0,0,0,1,0,0,1489,16,548
4100,경기도,4125,구리시,,동구동제8투,1984,1629,740,820,49,0,7,0,0,0,2,1,0,2,1621,8,355
4100,경기도,4125,구리시,,동구동제9투,2164,1603,812,723,45,0,8,0,1,0,0,1,1,0,1591,12,561
4100,경기도,4125,구리시,,동구동제10투,2640,1989,917,975,63,0,7,0,2,1,3,1,1,0,1970,19,651
4100,경기도,4125,구리시,,동구동제11투,2211,1702,807,814,44,0,9,2,1,1,1,2,1,1,1683,19,509
4100,경기도,4125,구리시,인창동,소계,18101,13921,6932,6431,312,8,98,4,2,2,14,10,4,6,13823,98,4180
4100,경기도,4125,구리시,,관내사전투표,4907,4907,2796,1979,87,2,22,0,0,0,0,1,1,5,4893,14,0
4100,경기도,4125,구리시,,인창동제1투,2158,1383,612,710,27,0,19,0,0,0,1,1,1,0,1371,12,775
4100,경기도,4125,구리시,,인창동제2투,2369,1561,728,761,34,1,14,1,0,0,3,0,1,0,1543,18,808
4100,경기도,4125,구리시,,인창동제3투,2095,1308,572,676,35,1,8,0,1,0,0,0,1,0,1294,14,787
4100,경기도,4125,구리시,,인창동제4투,2425,1608,788,731,42,2,15,1,1,0,4,6,0,0,1590,18,817
4100,경기도,4125,구리시,,인창동제5투,1970,1486,728,701,38,0,7,1,0,2,1,1,0,1,1480,6,484
4100,경기도,4125,구리시,,인창동제6투,2177,1668,708,873,49,2,13,1,0,0,5,1,0,0,1652,16,509
4100,경기도,4125,구리시,교문1동,소계,13748,9403,4406,4629,198,4,74,1,1,3,9,8,1,5,9339,64,4345
4100,경기도,4125,구리시,,관내사전투표,3370,3369,1720,1538,77,0,15,1,0,0,1,4,1,2,3359,10,1
4100,경기도,4125,구리시,,교문1동제1투,2233,1149,552,547,22,0,13,0,0,0,2,1,0,2,1139,10,1084
4100,경기도,4125,구리시,,교문1동제2투,1949,1073,480,542,24,0,14,0,0,2,3,0,0,0,1065,8,876
4100,경기도,4125,구리시,,교문1동제3투,1862,1004,454,505,21,2,10,0,0,0,0,0,0,0,992,12,858
4100,경기도,4125,구리시,,교문1동제4투,1997,1219,564,610,15,2,10,0,0,1,3,2,0,1,1208,11,778
4100,경기도,4125,구리시,,교문1동제5투,1229,779,307,438,20,0,7,0,1,0,0,1,0,0,774,5,450
4100,경기도,4125,구리시,,교문1동제6투,1108,810,329,449,19,0,5,0,0,0,0,0,0,0,802,8,298
4100,경기도,4125,구리시,교문2동,소계,15535,12338,5692,6149,320,4,60,1,1,2,8,6,3,4,12250,88,3197
4100,경기도,4125,구리시,,관내사전투표,4121,4121,2122,1872,87,0,13,0,1,0,1,4,1,2,4103,18,0
4100,경기도,4125,구리시,,교문2동제1투,1925,1305,540,715,30,0,8,0,0,1,0,0,0,0,1294,11,620
4100,경기도,4125,구리시,,교문2동제2투,1676,990,440,502,25,0,11,1,0,1,0,1,0,0,981,9,686
4100,경기도,4125,구리시,,교문2동제3투,1777,1359,622,674,39,0,8,0,0,0,4,0,0,2,1349,10,418
4100,경기도,4125,구리시,,교문2동제4투,1865,1473,619,796,37,0,3,0,0,0,1,1,1,0,1458,15,392
4100,경기도,4125,구리시,,교문2동제5투,1980,1448,637,739,50,1,5,0,0,0,2,0,0,0,1434,14,532
4100,경기도,4125,구리시,,교문2동제6투,2191,1642,712,851,52,3,12,0,0,0,0,0,1,0,1631,11,549
4100,경기도,4125,구리시,수택1동,소계,13699,9764,4713,4649,200,4,82,3,2,0,11,9,0,1,9674,90,3935
4100,경기도,4125,구리시,,관내사전투표,4031,4031,2130,1776,72,1,24,2,1,0,2,4,0,0,4012,19,0
4100,경기도,4125,구리시,,수택1동제1투,1554,850,359,457,15,0,6,0,0,0,1,2,0,0,840,10,704
4100,경기도,4125,구리시,,수택1동제2투,1999,1077,479,534,21,1,23,0,0,0,2,0,0,0,1060,17,922
4100,경기도,4125,구리시,,수택1동제3투,2403,1273,558,649,33,0,11,0,1,0,5,1,0,0,1258,15,1130
4100,경기도,4125,구리시,,수택1동제4투,2368,1711,784,850,41,2,15,0,0,0,1,2,0,1,1696,15,657
4100,경기도,4125,구리시,,수택1동제5투,1344,822,403,383,18,0,3,1,0,0,0,0,0,0,808,14,522
4100,경기도,4125,구리시,수택2동,소계,19831,14031,6965,6464,312,4,142,2,2,4,14,18,5,7,13939,92,5800
4100,경기도,4125,구리시,,관내사전투표,4720,4720,2550,2038,72,2,31,0,1,1,2,5,2,2,4706,14,0
4100,경기도,4125,구리시,,수택2동제1투,2017,1142,497,589,33,0,16,0,0,1,1,1,0,1,1139,3,875
4100,경기도,4125,구리시,,수택2동제2투,3125,2087,974,1012,65,0,18,1,1,0,2,4,1,1,2079,8,1038
4100,경기도,4125,구리시,,수택2동제3투,2337,1411,656,678,37,0,19,0,0,0,3,2,0,2,1397,14,926
4100,경기도,4125,구리시,,수택2동제4투,1592,969,433,485,17,2,18,0,0,0,2,0,0,0,957,12,623
4100,경기도,4125,구리시,,수택2동제5투,2344,1416,726,626,32,0,13,0,0,0,0,4,1,0,1402,14,928
4100,경기도,4125,구리시,,수택2동제6투,1903,1149,552,533,32,0,11,1,0,2,1,2,1,1,1136,13,754
4100,경기도,4125,구리시,,수택2동제7투,1793,1137,577,503,24,0,16,0,0,0,3,0,0,0,1123,14,656
4100,경기도,4125,구리시,수택3동,소계,18289,14444,6975,6887,380,3,69,4,2,6,11,4,1,4,14346,98,3845
4100,경기도,4125,구리시,,관내사전투표,6419,6419,3399,2783,167,0,22,0,1,3,6,2,0,3,6386,33,0
4100,경기도,4125,구리시,,수택3동제1투,2252,1387,608,725,29,0,5,1,1,0,2,1,0,0,1372,15,865
4100,경기도,4125,구리시,,수택3동제2투,2699,1997,870,1041,55,2,10,3,0,1,1,0,0,0,1983,14,702
4100,경기도,4125,구리시,,수택3동제3투,2747,2013,871,1063,55,0,9,0,0,0,2,1,0,0,2001,12,734
4100,경기도,4125,구리시,,수택3동제4투,2221,1228,575,604,25,0,14,0,0,1,0,0,0,1,1220,8,993
4100,경기도,4125,구리시,,수택3동제5투,1951,1400,652,671,49,1,9,0,0,1,0,0,1,0,1384,16,551
4100,경기도,4125,구리시,잘못 투입·구분된 투표지,,0,0,0,0,0,0,0,0,0,0,0,0,0,0,0,0,0
4100,경기도,4126,남양주시,합계,,608146,460518,239179,203075,10089,186,3326,100,56,107,322,388,97,156,457081,3437,147628
4100,경기도,4126,남양주시,거소·선상투표,,1136,1050,447,411,25,4,30,1,0,1,1,1,2,3,926,124,86
4100,경기도,4126,남양주시,관외사전투표,,51309,51294,26985,22014,1161,39,486,12,7,12,18,76,7,31,50848,446,15
4100,경기도,4126,남양주시,재외투표,,2804,2081,1253,579,72,4,7,0,0,2,3,0,0,0,1920,161,723
4100,경기도,4126,남양주시,와부읍,소계,46311,36730,17621,17715,841,6,192,13,5,12,28,31,9,14,36487,243,9581
4100,경기도,4126,남양주시,,관내사전투표,11630,11630,6453,4866,204,1,43,2,1,2,2,20,4,3,11601,29,0
4100,경기도,4126,남양주시,,와부읍제1투,2717,1766,772,891,60,1,12,0,0,1,1,0,1,1,1740,26,951
4100,경기도,4126,남양주시,,와부읍제2투,2288,1154,487,629,18,0,2,1,0,1,4,0,0,1,1143,11,1134
4100,경기도,4126,남양주시,,와부읍제3투,2356,1719,780,849,51,0,17,1,0,0,1,0,0,1,1700,19,637
4100,경기도,4126,남양주시,,와부읍제4투,3144,2275,1073,1099,69,1,15,1,0,0,5,1,0,0,2264,11,869
4100,경기도,4126,남양주시,,와부읍제5투,748,519,151,345,11,0,3,2,1,1,1,0,0,1,516,3,229
4100,경기도,4126,남양주시,,와부읍제6투,609,443,142,289,8,0,1,0,0,0,0,1,0,0,441,2,166
4100,경기도,4126,남양주시,,와부읍제7투,2643,2011,883,1042,48,0,11,1,0,1,0,1,1,1,1989,22,632
4100,경기도,4126,남양주시,,와부읍제8투,2411,1797,765,956,40,1,12,0,2,0,1,1,0,0,1778,19,614
4100,경기도,4126,남양주시,,와부읍제9투,1013,667,237,397,16,0,7,0,0,1,4,0,0,0,662,5,346
4100,경기도,4126,남양주시,,와부읍제10투,2124,1582,816,708,36,0,7,1,0,0,1,0,0,0,1569,13,542
4100,경기도,4126,남양주시,,와부읍제11투,3073,2387,1149,1131,70,0,14,0,1,0,0,0,0,2,2367,20,686
4100,경기도,4126,남양주시,,와부읍제12투,509,357,121,217,9,0,5,0,0,1,2,0,0,0,355,2,152
4100,경기도,4126,남양주시,,와부읍제13투,2263,1829,689,1070,37,0,7,0,0,3,3,0,1,3,1813,16,434
4100,경기도,4126,남양주시,,와부읍제14투,2643,1954,906,954,53,0,16,0,0,1,0,3,0,0,1933,21,689
4100,경기도,4126,남양주시,,와부읍제15투,2027,1619,755,804,43,1,8,1,0,0,0,1,1,0,1614,5,408
4100,경기도,4126,남양주시,,와부읍제16투,2441,1760,835,869,36,0,3,1,0,0,1,1,0,1,1747,13,681
4100,경기도,4126,남양주시,,와부읍제17투,1672,1261,607,599,32,1,9,2,0,0,2,2,1,0,1255,6,411
4100,경기도,4126,남양주시,진접읍,소계,69463,48653,26248,20587,949,23,398,8,7,13,35,43,9,13,48333,320,20810
4100,경기도,4126,남양주시,,관내사전투표,14309,14309,8487,5438,240,4,53,4,1,0,5,12,2,3,14249,60,0
4100,경기도,4126,남양주시,,진접읍제1투,1422,645,307,301,16,0,11,0,0,0,1,0,0,0,636,9,777
4100,경기도,4126,남양주시,,진접읍제2투,4131,2370,1265,1006,43,0,31,0,0,1,2,1,2,0,2351,19,1761
4100,경기도,4126,남양주시,,진접읍제3투,4208,2676,1392,1183,54,4,14,0,0,2,2,1,0,1,2653,23,1532
4100,경기도,4126,남양주시,,진접읍제4투,3115,1783,834,878,24,0,27,0,1,1,1,0,0,1,1767,16,1332
4100,경기도,4126,남양주시,,진접읍제5투,2539,1548,754,735,35,0,17,0,0,0,0,0,0,1,1542,6,991
4100,경기도,4126,남양주시,,진접읍제6투,3769,2233,1056,1075,51,2,18,1,0,2,1,1,0,0,2207,26,1536
4100,경기도,4126,남양주시,,진접읍제7투,4129,2503,1189,1186,55,3,29,0,2,2,5,4,0,1,2476,27,1626
4100,경기도,4126,남양주시,,진접읍제8투,3405,2136,1032,1033,35,1,15,0,0,0,0,2,1,0,2119,17,1269
4100,경기도,4126,남양주시,,진접읍제9투,2479,1469,592,808,37,0,18,0,1,0,1,2,0,0,1459,10,1010
4100,경기도,4126,남양주시,,진접읍제10투,3279,2280,1229,966,53,2,19,0,1,1,0,1,0,0,2272,8,999
4100,경기도,4126,남양주시,,진접읍제11투,2777,1728,945,709,34,1,18,0,0,1,3,3,1,2,1717,11,1049
4100,경기도,4126,남양주시,,진접읍제12투,2739,1924,1103,769,18,0,16,0,0,0,3,2,0,1,1912,12,815
4100,경기도,4126,남양주시,,진접읍제13투,3593,2501,1457,949,63,1,13,1,0,0,0,0,0,1,2485,16,1092
4100,경기도,4126,남양주시,,진접읍제14투,3441,2268,1287,878,60,0,15,2,0,1,3,3,0,0,2249,19,1173
4100,경기도,4126,남양주시,,진접읍제15투,3844,2265,1275,897,36,1,27,0,0,1,2,4,2,1,2246,19,1579
4100,경기도,4126,남양주시,,진접읍제16투,2202,1335,686,587,32,1,16,0,0,1,3,1,0,0,1327,8,867
4100,경기도,4126,남양주시,,진접읍제17투,2615,1679,853,757,32,2,19,0,0,0,3,4,1,0,1671,8,936
4100,경기도,4126,남양주시,,진접읍제18투,1467,1001,505,432,31,1,22,0,1,0,0,2,0,1,995,6,466
4100,경기도,4126,남양주시,화도읍,소계,88430,59963,32482,25135,1243,17,549,11,6,10,36,50,12,22,59573,390,28467
4100,경기도,4126,남양주시,,관내사전투표,17111,17095,10448,6174,295,3,91,3,0,1,4,15,0,8,17042,53,16
4100,경기도,4126,남양주시,,화도읍제1투,3110,1839,911,846,48,1,11,1,0,0,0,1,0,1,1820,19,1271
4100,경기도,4126,남양주시,,화도읍제2투,3717,2096,1116,867,61,1,23,0,1,0,1,2,0,0,2072,24,1621
4100,경기도,4126,남양주시,,화도읍제3투,4215,2430,1154,1168,46,1,30,1,0,0,5,1,1,1,2408,22,1785
4100,경기도,4126,남양주시,,화도읍제4투,3157,1862,916,858,48,1,22,0,0,1,0,0,1,1,1848,14,1295
4100,경기도,4126,남양주시,,화도읍제5투,2660,1575,749,753,41,0,16,0,0,0,0,1,0,0,1560,15,1085
4100,경기도,4126,남양주시,,화도읍제6투,2823,1721,844,799,31,1,21,0,0,0,4,4,2,2,1708,13,1102
4100,경기도,4126,남양주시,,화도읍제7투,1888,1123,582,479,26,0,19,0,0,0,1,3,0,0,1110,13,765
4100,경기도,4126,남양주시,,화도읍제8투,2929,1934,1021,840,47,0,13,1,0,0,0,1,0,0,1923,11,995
4100,경기도,4126,남양주시,,화도읍제9투,2357,1484,735,677,30,0,20,0,1,0,1,0,0,2,1466,18,873
4100,경기도,4126,남양주시,,화도읍제10투,2822,1922,1051,791,43,0,15,0,1,0,2,3,1,2,1909,13,900
4100,경기도,4126,남양주시,,화도읍제11투,2372,1505,798,634,46,0,12,0,0,1,2,0,0,0,1493,12,867
4100,경기도,4126,남양주시,,화도읍제12투,2450,1437,566,818,25,0,20,0,0,0,0,0,1,0,1430,7,1013
4100,경기도,4126,남양주시,,화도읍제13투,871,540,189,327,9,0,7,0,0,0,1,0,0,0,533,7,331
4100,경기도,4126,남양주시,,화도읍제14투,2885,1858,984,787,37,1,17,0,1,0,3,5,0,2,1837,21,1027
4100,경기도,4126,남양주시,,화도읍제15투,2258,1362,703,602,32,1,9,1,0,0,0,0,1,0,1349,13,896
4100,경기도,4126,남양주시,,화도읍제16투,3501,1972,1007,883,31,0,26,0,1,2,1,4,0,1,1956,16,1529
4100,경기도,4126,남양주시,,화도읍제17투,2769,1680,835,784,28,0,16,1,0,0,0,2,0,0,1666,14,1089
4100,경기도,4126,남양주시,,화도읍제18투,3684,1898,967,857,41,1,13,0,0,0,2,0,2,0,1883,15,1786
4100,경기도,4126,남양주시,,화도읍제19투,2570,1693,944,669,43,0,24,0,1,1,0,1,1,0,1684,9,877
4100,경기도,4126,남양주시,,화도읍제20투,1985,1038,499,490,24,1,11,1,0,1,3,0,0,1,1031,7,947
4100,경기도,4126,남양주시,,화도읍제21투,3657,2075,1173,811,37,0,34,1,0,0,1,2,1,0,2060,15,1582
4100,경기도,4126,남양주시,,화도읍제22투,2513,1083,585,432,31,1,20,0,0,2,1,1,0,0,1073,10,1430
4100,경기도,4126,남양주시,,화도읍제23투,4345,2819,1501,1210,64,2,25,0,0,1,1,0,1,0,2805,14,1526
4100,경기도,4126,남양주시,,화도읍제24투,3233,2044,1180,803,32,0,17,0,0,0,3,3,0,0,2038,6,1189
4100,경기도,4126,남양주시,,화도읍제25투,2548,1878,1024,776,47,2,17,1,0,0,0,1,0,1,1869,9,670
4100,경기도,4126,남양주시,진건읍,소계,19561,14132,6684,6871,294,8,110,5,2,7,9,15,6,3,14014,118,5429
4100,경기도,4126,남양주시,,관내사전투표,5308,5308,2898,2271,82,3,25,1,0,2,0,2,1,0,5285,23,0
4100,경기도,4126,남양주시,,진건읍제1투,2391,1282,548,670,31,3,16,1,0,0,2,1,1,0,1273,9,1109
4100,경기도,4126,남양주시,,진건읍제2투,610,400,117,265,11,0,3,0,0,0,0,0,0,0,396,4,210
4100,경기도,4126,남양주시,,진건읍제3투,1206,755,236,501,11,0,2,1,0,0,0,0,0,0,751,4,451
4100,경기도,4126,남양주시,,진건읍제4투,2249,1371,663,631,31,1,18,1,0,0,1,2,1,1,1350,21,878
4100,경기도,4126,남양주시,,진건읍제5투,3013,1905,856,959,46,0,14,0,0,4,1,1,1,0,1882,23,1108
4100,경기도,4126,남양주시,,진건읍제6투,3124,2085,949,1014,60,0,25,1,1,1,3,6,1,2,2063,22,1039
4100,경기도,4126,남양주시,,진건읍제7투,1660,1026,417,560,22,1,7,0,1,0,2,3,1,0,1014,12,634
4100,경기도,4126,남양주시,오남읍,소계,41590,28769,16082,11582,632,11,235,7,3,2,24,22,4,9,28613,156,12821
4100,경기도,4126,남양주시,,관내사전투표,9841,9840,5915,3653,174,4,39,2,1,2,1,7,1,3,9802,38,1
4100,경기도,4126,남양주시,,오남읍제1투,3960,1892,958,839,58,0,21,0,0,0,4,1,0,0,1881,11,2068
4100,경기도,4126,남양주시,,오남읍제2투,2435,1482,796,607,40,2,22,0,0,0,2,0,1,1,1471,11,953
4100,경기도,4126,남양주시,,오남읍제3투,2237,1286,579,644,36,0,15,0,0,0,2,0,0,0,1276,10,951
4100,경기도,4126,남양주시,,오남읍제4투,2966,1793,889,823,29,2,23,1,1,0,2,2,1,2,1775,18,1173
4100,경기도,4126,남양주시,,오남읍제5투,4201,2558,1374,1072,60,0,33,0,0,0,4,2,0,0,2545,13,1643
4100,경기도,4126,남양주시,,오남읍제6투,3402,2023,1144,805,41,2,13,0,0,0,4,0,0,1,2010,13,1379
4100,경기도,4126,남양주시,,오남읍제7투,2521,1649,961,621,32,0,18,2,0,0,0,0,0,0,1634,15,872
4100,경기도,4126,남양주시,,오남읍제8투,3869,2472,1377,991,61,0,24,0,1,0,2,5,0,1,2462,10,1397
4100,경기도,4126,남양주시,,오남읍제9투,3602,2305,1325,891,56,1,14,2,0,0,3,4,1,0,2297,8,1297
4100,경기도,4126,남양주시,,오남읍제10투,2556,1469,764,636,45,0,13,0,0,0,0,1,0,1,1460,9,1087
4100,경기도,4126,남양주시,별내면,소계,16117,12205,6493,5255,251,7,70,2,2,4,13,9,2,2,12110,95,3912
4100,경기도,4126,남양주시,,관내사전투표,5268,5268,3064,2059,85,2,24,1,0,0,2,4,1,2,5244,24,0
4100,경기도,4126,남양주시,,별내면제1투,886,388,132,244,8,0,1,0,0,0,2,0,0,0,387,1,498
4100,경기도,4126,남양주시,,별내면제2투,2386,1608,840,697,34,3,8,0,0,1,3,2,0,0,1588,20,778
4100,경기도,4126,남양주시,,별내면제3투,2564,1557,740,737,42,2,13,1,2,2,3,1,0,0,1543,14,1007
4100,경기도,4126,남양주시,,별내면제4투,2426,1668,863,737,34,0,11,0,0,0,1,1,0,0,1647,21,758
4100,경기도,4126,남양주시,,별내면제5투,2587,1716,854,781,48,0,13,0,0,1,2,1,1,0,1701,15,871
4100,경기도,4126,남양주시,수동면,소계,8421,6299,2837,3192,117,4,48,4,5,2,6,4,3,9,6231,68,2122
4100,경기도,4126,남양주시,,관내사전투표,3715,3715,1824,1733,64,4,19,2,5,2,2,2,3,9,3669,46,0
4100,경기도,4126,남양주시,,수동면제1투,1824,885,370,479,13,0,8,1,0,0,2,1,0,0,874,11,939
4100,경기도,4126,남양주시,,수동면제2투,1894,1082,390,646,22,0,13,1,0,0,0,1,0,0,1073,9,812
4100,경기도,4126,남양주시,,수동면제3투,988,617,253,334,18,0,8,0,0,0,2,0,0,0,615,2,371
4100,경기도,4126,남양주시,조안면,소계,3271,2492,933,1462,50,0,20,1,0,0,7,4,2,0,2479,13,779
4100,경기도,4126,남양주시,,관내사전투표,1131,1131,482,608,20,0,9,0,0,0,3,2,0,0,1124,7,0
4100,경기도,4126,남양주시,,조안면제1투,1011,617,201,389,13,0,7,0,0,0,2,1,1,0,614,3,394
4100,경기도,4126,남양주시,,조안면제2투,1129,744,250,465,17,0,4,1,0,0,2,1,1,0,741,3,385
4100,경기도,4126,남양주시,호평동,소계,42438,32132,17359,13607,693,8,203,5,3,7,16,24,7,8,31940,192,10306
4100,경기도,4126,남양주시,,관내사전투표,12207,12205,7155,4698,226,6,47,1,1,2,2,11,4,3,12156,49,2
4100,경기도,4126,남양주시,,호평동제1투,3804,2120,975,1040,45,0,37,1,0,2,3,0,0,0,2103,17,1684
4100,경기도,4126,남양주시,,호평동제2투,3837,2498,1312,1094,40,0,21,2,1,0,2,2,0,2,2476,22,1339
4100,경기도,4126,남양주시,,호평동제3투,3970,2542,1274,1150,66,0,29,0,0,2,3,2,0,0,2526,16,1428
4100,경기도,4126,남양주시,,호평동제4투,2420,1634,838,732,36,0,9,0,0,0,1,2,1,0,1619,15,786
4100,경기도,4126,남양주시,,호평동제5투,2801,1937,922,949,37,0,7,0,0,0,0,0,0,1,1916,21,864
4100,경기도,4126,남양주시,,호평동제6투,2090,1440,796,591,36,0,9,0,0,0,0,0,0,0,1432,8,650
4100,경기도,4126,남양주시,,호평동제7투,3545,2382,1234,1048,63,1,15,0,0,0,0,4,0,1,2366,16,1163
4100,경기도,4126,남양주시,,호평동제8투,3599,2371,1350,917,64,1,18,1,1,1,0,0,1,1,2355,16,1228
4100,경기도,4126,남양주시,,호평동제9투,4165,3003,1503,1388,80,0,11,0,0,0,5,3,1,0,2991,12,1162
4100,경기도,4126,남양주시,평내동,소계,27175,20369,11318,8314,432,10,120,2,1,6,22,5,2,4,20236,133,6806
4100,경기도,4126,남양주시,,관내사전투표,7341,7341,4550,2609,127,2,23,1,0,1,0,2,1,1,7317,24,0
4100,경기도,4126,남양주시,,평내동제1투,2039,1413,660,695,36,0,9,0,0,0,1,0,0,0,1401,12,626
4100,경기도,4126,남양주시,,평내동제2투,3723,2092,1002,1010,45,1,9,0,0,1,6,1,1,0,2076,16,1631
4100,경기도,4126,남양주시,,평내동제3투,2003,1376,763,537,54,0,7,0,0,1,0,0,0,0,1362,14,627
4100,경기도,4126,남양주시,,평내동제4투,2769,1890,1033,776,35,3,22,0,0,0,5,1,0,1,1876,14,879
4100,경기도,4126,남양주시,,평내동제5투,3639,2241,1155,994,48,2,18,0,0,1,3,0,0,0,2221,20,1398
4100,경기도,4126,남양주시,,평내동제6투,3109,2140,1149,900,42,1,19,0,1,2,4,0,0,2,2120,20,969
4100,경기도,4126,남양주시,,평내동제7투,2552,1876,1006,793,45,1,13,1,0,0,3,1,0,0,1863,13,676
4100,경기도,4126,남양주시,금곡동,소계,16617,12062,5629,5929,262,2,106,1,3,2,13,13,4,8,11972,90,4555
4100,경기도,4126,남양주시,,관내사전투표,4693,4692,2482,2039,106,0,27,1,0,0,2,6,1,0,4664,28,1
4100,경기도,4126,남양주시,,금곡동제1투,1768,1022,393,579,18,0,14,0,0,1,1,0,0,3,1009,13,746
4100,경기도,4126,남양주시,,금곡동제2투,2203,1383,613,701,28,0,20,0,1,1,3,0,2,1,1370,13,820
4100,경기도,4126,남양주시,,금곡동제3투,2205,1344,597,686,28,0,13,0,1,0,3,2,1,1,1332,12,861
4100,경기도,4126,남양주시,,금곡동제4투,1822,1042,423,566,23,1,14,0,0,0,1,2,0,2,1032,10,780
4100,경기도,4126,남양주시,,금곡동제5투,3926,2579,1121,1358,59,1,18,0,1,0,3,3,0,1,2565,14,1347
4100,경기도,4126,남양주시,양정동,소계,4225,3348,1446,1795,51,0,29,0,0,1,1,1,1,0,3325,23,877
4100,경기도,4126,남양주시,,관내사전투표,1945,1945,969,921,33,0,12,0,0,1,1,1,1,0,1939,6,0
4100,경기도,4126,남양주시,,양정동제1투,1421,855,284,542,13,0,8,0,0,0,0,0,0,0,847,8,566
4100,경기도,4126,남양주시,,양정동제2투,859,548,193,332,5,0,9,0,0,0,0,0,0,0,539,9,311
4100,경기도,4126,남양주시,별내동,소계,56945,42552,21856,19078,966,20,244,8,6,10,26,25,13,11,42263,289,14393
4100,경기도,4126,남양주시,,관내사전투표,12519,12519,7006,5169,216,3,46,1,2,1,5,12,4,5,12470,49,0
4100,경기도,4126,남양주시,,별내동제1투,3109,2200,1298,778,74,2,18,0,1,0,2,1,1,2,2177,23,909
4100,경기도,4126,남양주시,,별내동제2투,2864,2004,856,1068,45,1,14,1,0,1,1,1,0,0,1988,16,860
4100,경기도,4126,남양주시,,별내동제3투,2261,1651,812,775,38,1,7,0,0,0,2,2,1,0,1638,13,610
4100,경기도,4126,남양주시,,별내동제4투,3822,2767,1385,1282,64,0,10,0,0,1,1,0,1,1,2745,22,1055
4100,경기도,4126,남양주시,,별내동제5투,3849,2691,1406,1200,61,1,8,0,0,3,1,2,0,0,2682,9,1158
4100,경기도,4126,남양주시,,별내동제6투,2375,1420,663,699,26,0,13,1,1,0,0,1,0,0,1404,16,955
4100,경기도,4126,남양주시,,별내동제7투,3690,2453,1201,1149,67,2,13,2,0,0,1,1,0,0,2436,17,1237
4100,경기도,4126,남양주시,,별내동제8투,3721,2449,1169,1157,72,0,30,1,0,0,3,0,1,0,2433,16,1272
4100,경기도,4126,남양주시,,별내동제9투,2812,1895,931,863,48,3,25,0,0,1,4,2,0,0,1877,18,917
4100,경기도,4126,남양주시,,별내동제10투,2750,1962,889,1005,40,1,12,0,0,0,1,0,0,0,1948,14,788
4100,경기도,4126,남양주시,,별내동제11투,2345,1686,761,855,49,0,8,0,0,1,0,1,0,1,1676,10,659
4100,경기도,4126,남양주시,,별내동제12투,2803,1973,1059,839,38,3,11,1,0,0,2,0,0,1,1954,19,830
4100,경기도,4126,남양주시,,별내동제13투,4088,2428,1107,1200,68,1,20,1,2,1,0,2,1,0,2403,25,1660
4100,경기도,4126,남양주시,,별내동제14투,3937,2454,1313,1039,60,2,9,0,0,1,3,0,4,1,2432,22,1483
4100,경기도,4126,남양주시,다산1동,소계,62579,47964,24224,21875,1199,12,257,9,4,9,35,29,8,10,47671,293,14615
4100,경기도,4126,남양주시,,관내사전투표,11649,11648,6728,4603,226,4,32,3,1,1,2,12,0,3,11615,33,1
4100,경기도,4126,남양주시,,다산1동제1투,3097,1850,868,895,44,1,16,0,1,0,2,2,0,0,1829,21,1247
4100,경기도,4126,남양주시,,다산1동제2투,3203,2221,1042,1068,75,0,13,0,1,1,0,1,2,0,2203,18,982
4100,경기도,4126,남양주시,,다산1동제3투,3087,2031,970,981,44,0,17,0,1,1,1,2,0,0,2017,14,1056
4100,경기도,4126,남양주시,,다산1동제4투,2285,1817,662,1091,38,0,10,0,0,2,3,1,0,1,1808,9,468
4100,경기도,4126,남양주시,,다산1동제5투,2767,2167,898,1170,53,2,11,1,0,0,8,1,1,0,2145,22,600
4100,경기도,4126,남양주시,,다산1동제6투,2327,1857,719,1057,47,0,8,2,0,0,2,0,0,0,1835,22,470
4100,경기도,4126,남양주시,,다산1동제7투,2843,2255,821,1363,40,0,15,0,0,0,1,0,0,1,2241,14,588
4100,경기도,4126,남양주시,,다산1동제8투,1983,1458,623,768,36,0,11,0,0,0,4,2,1,1,1446,12,525
4100,경기도,4126,남양주시,,다산1동제9투,3637,2592,1363,1124,85,0,10,0,0,0,1,0,0,0,2583,9,1045
4100,경기도,4126,남양주시,,다산1동제10투,1543,969,511,419,23,0,8,0,0,0,0,0,0,0,961,8,574
4100,경기도,4126,남양주시,,다산1동제11투,2926,2159,995,1093,52,0,6,1,0,0,0,1,1,0,2149,10,767
4100,경기도,4126,남양주시,,다산1동제12투,2997,2385,1348,919,89,1,6,0,0,1,0,0,1,1,2366,19,612
4100,경기도,4126,남양주시,,다산1동제13투,4537,3109,1674,1317,77,1,16,0,0,1,4,3,1,0,3094,15,1428
4100,경기도,4126,남양주시,,다산1동제14투,2079,1607,1008,530,42,1,14,1,0,0,2,1,0,0,1599,8,472
4100,경기도,4126,남양주시,,다산1동제15투,3071,1894,988,822,61,0,13,0,0,1,1,0,0,0,1886,8,1177
4100,경기도,4126,남양주시,,다산1동제16투,3773,2732,1329,1283,75,1,18,0,0,1,2,1,0,0,2710,22,1041
4100,경기도,4126,남양주시,,다산1동제17투,2834,1928,1062,767,60,1,17,1,0,0,0,2,0,2,1912,16,906
4100,경기도,4126,남양주시,,다산1동제18투,1941,1285,615,605,32,0,16,0,0,0,2,0,1,1,1272,13,656
4100,경기도,4126,남양주시,다산2동,소계,26335,20930,10529,9647,484,4,86,4,0,2,6,23,2,3,20790,140,5405
4100,경기도,4126,남양주시,,관내사전투표,8282,8281,4595,3453,154,0,21,2,0,0,0,17,0,1,8243,38,1
4100,경기도,4126,남양주시,,다산2동제1투,3019,2156,923,1143,52,1,16,0,0,0,1,0,0,0,2136,20,863
4100,경기도,4126,남양주시,,다산2동제2투,3125,2071,1005,972,46,1,19,0,0,0,3,3,0,0,2049,22,1054
4100,경기도,4126,남양주시,,다산2동제3투,2786,2102,1019,981,69,0,9,1,0,1,0,1,2,1,2084,18,684
4100,경기도,4126,남양주시,,다산2동제4투,2898,1991,897,1016,49,2,6,0,0,0,1,1,0,0,1972,19,907
4100,경기도,4126,남양주시,,다산2동제5투,3148,2137,1001,1070,47,0,8,1,0,1,1,0,0,0,2129,8,1011
4100,경기도,4126,남양주시,,다산2동제6투,3077,2192,1089,1012,67,0,7,0,0,0,0,1,0,1,2177,15,885
4100,경기도,4126,남양주시,퇴계원읍,소계,23419,17490,8751,8026,367,7,136,7,2,5,23,13,4,6,17347,143,5929
4100,경기도,4126,남양주시,,관내사전투표,6467,6467,3513,2753,114,3,36,1,0,2,3,5,2,3,6435,32,0
4100,경기도,4126,남양주시,,퇴계원읍제1투,2986,2021,1004,930,49,0,9,2,0,1,3,2,1,1,2002,19,965
4100,경기도,4126,남양주시,,퇴계원읍제2투,3586,2139,1056,992,46,0,23,0,0,1,1,2,0,0,2121,18,1447
4100,경기도,4126,남양주시,,퇴계원읍제3투,3540,2174,1013,1042,44,0,33,2,0,0,4,3,1,2,2144,30,1366
4100,경기도,4126,남양주시,,퇴계원읍제4투,1566,919,413,462,21,2,6,0,2,0,4,1,0,0,911,8,647
4100,경기도,4126,남양주시,,퇴계원읍제5투,2974,2129,1000,1042,48,1,20,0,0,1,1,0,0,0,2113,16,845
4100,경기도,4126,남양주시,,퇴계원읍제6투,2300,1641,752,805,45,1,9,2,0,0,7,0,0,0,1621,20,659
4100,경기도,4126,남양주시,잘못 투입·구분된 투표지,,0,3,2,1,0,0,0,0,0,0,0,0,0,0,3,0,-3
4100,경기도,4127,오산시,합계,,188297,135108,72877,55793,3352,65,1427,38,12,17,74,143,26,58,133882,1226,53189
4100,경기도,4127,오산시,거소·선상투표,,340,321,135,106,4,0,14,0,1,2,0,1,1,1,265,56,19
4100,경기도,4127,오산시,관외사전투표,,15197,15195,8214,6202,373,12,187,6,2,1,4,27,5,6,15039,156,2
4100,경기도,4127,오산시,재외투표,,577,415,258,111,14,0,0,0,0,0,0,0,0,0,383,32,162
4100,경기도,4127,오산시,중앙동,소계,27123,20145,10740,8524,503,6,162,3,1,2,12,12,7,7,19979,166,6978
4100,경기도,4127,오산시,,관내사전투표,6512,6512,3636,2671,127,2,36,1,0,1,0,3,2,2,6481,31,0
4100,경기도,4127,오산시,,중앙동제1투,1453,776,318,423,15,1,9,0,0,0,0,1,1,1,769,7,677
4100,경기도,4127,오산시,,중앙동제2투,2085,1105,463,574,21,0,22,0,0,0,3,1,1,1,1086,19,980
4100,경기도,4127,오산시,,중앙동제3투,3224,2071,1176,793,57,0,16,0,0,0,1,3,0,1,2047,24,1153
4100,경기도,4127,오산시,,중앙동제4투,3094,2121,1162,836,85,3,10,1,1,0,5,0,1,0,2104,17,973
4100,경기도,4127,오산시,,중앙동제5투,3027,2108,923,1106,45,0,17,0,0,0,0,3,0,0,2094,14,919
4100,경기도,4127,오산시,,중앙동제6투,2448,1625,857,685,55,0,13,0,0,0,1,0,0,0,1611,14,823
4100,경기도,4127,오산시,,중앙동제7투,3128,2301,1359,833,56,0,25,1,0,1,1,0,0,1,2277,24,827
4100,경기도,4127,오산시,,중앙동제8투,2152,1526,846,603,42,0,14,0,0,0,1,1,2,1,1510,16,626
4100,경기도,4127,오산시,대원동,소계,47868,32788,17579,13650,842,16,331,7,2,3,24,32,5,18,32509,279,15080
4100,경기도,4127,오산시,,관내사전투표,8811,8810,5081,3395,202,3,58,2,0,0,3,7,1,2,8754,56,1
4100,경기도,4127,오산시,,대원동제1투,3874,1673,689,886,37,2,29,0,0,0,0,2,0,2,1647,26,2201
4100,경기도,4127,오산시,,대원동제2투,1977,1396,724,601,44,2,11,0,0,0,0,2,0,0,1384,12,581
4100,경기도,4127,오산시,,대원동제3투,2417,1438,742,628,28,1,14,1,0,1,1,2,0,0,1418,20,979
4100,경기도,4127,오산시,,대원동제4투,3963,2002,1019,865,57,2,28,0,2,0,1,1,1,2,1978,24,1961
4100,경기도,4127,오산시,,대원동제5투,1615,1127,570,512,27,0,6,1,0,0,1,1,0,0,1118,9,488
4100,경기도,4127,오산시,,대원동제6투,2071,1459,727,655,48,0,16,0,0,0,2,1,0,0,1449,10,612
4100,경기도,4127,오산시,,대원동제7투,3535,2302,1218,966,62,1,24,0,0,1,1,1,0,5,2279,23,1233
4100,경기도,4127,오산시,,대원동제8투,2770,1780,945,748,58,0,22,0,0,0,1,0,1,0,1775,5,990
4100,경기도,4127,오산시,,대원동제9투,3959,2419,1287,1018,60,1,24,2,0,0,3,5,0,2,2402,17,1540
4100,경기도,4127,오산시,,대원동제10투,1673,1127,662,387,42,1,18,0,0,0,0,2,1,2,1115,12,546
4100,경기도,4127,오산시,,대원동제11투,4083,2715,1535,1061,61,2,25,0,0,1,2,1,0,1,2689,26,1368
4100,경기도,4127,오산시,,대원동제12투,2499,1497,797,620,39,0,21,0,0,0,4,0,1,2,1484,13,1002
4100,경기도,4127,오산시,,대원동제13투,2568,1726,899,746,42,0,17,0,0,0,1,5,0,0,1710,16,842
4100,경기도,4127,오산시,,대원동제14투,2053,1317,684,562,35,1,18,1,0,0,4,2,0,0,1307,10,736
4100,경기도,4127,오산시,남촌동,소계,18141,9648,5164,3946,205,5,188,2,1,1,5,11,1,6,9535,113,8493
4100,경기도,4127,오산시,,관내사전투표,3501,3500,2043,1307,73,1,41,1,0,0,0,3,0,1,3470,30,1
4100,경기도,4127,오산시,,남촌동제1투,2033,1179,526,594,18,0,18,0,0,0,1,1,0,0,1158,21,854
4100,경기도,4127,오산시,,남촌동제2투,1762,704,310,362,14,0,8,0,0,0,1,0,0,0,695,9,1058
4100,경기도,4127,오산시,,남촌동제3투,2988,991,525,388,21,2,36,0,0,0,2,1,0,2,977,14,1997
4100,경기도,4127,오산시,,남촌동제4투,2387,1629,883,656,46,0,24,0,1,0,0,2,1,0,1613,16,758
4100,경기도,4127,오산시,,남촌동제5투,2983,906,493,345,13,2,33,1,0,1,1,3,0,2,894,12,2077
4100,경기도,4127,오산시,,남촌동제6투,2487,739,384,294,20,0,28,0,0,0,0,1,0,1,728,11,1748
4100,경기도,4127,오산시,신장동,소계,42362,29348,16084,11973,705,13,280,11,2,6,14,31,3,11,29133,215,13014
4100,경기도,4127,오산시,,관내사전투표,6410,6410,3934,2299,120,1,26,2,0,3,0,5,0,2,6392,18,0
4100,경기도,4127,오산시,,신장동제1투,2264,1427,593,755,39,0,23,1,0,0,0,1,0,1,1413,14,837
4100,경기도,4127,오산시,,신장동제2투,3625,2457,1289,1032,71,2,32,1,0,0,1,6,1,0,2435,22,1168
4100,경기도,4127,오산시,,신장동제3투,3145,1923,964,846,44,4,37,0,0,0,4,2,0,2,1903,20,1222
4100,경기도,4127,오산시,,신장동제4투,3184,2052,911,1038,46,0,23,1,2,0,2,2,0,1,2026,26,1132
4100,경기도,4127,오산시,,신장동제5투,2675,1673,858,734,52,0,16,0,0,0,3,1,0,0,1664,9,1002
4100,경기도,4127,오산시,,신장동제6투,2580,1442,837,530,35,1,18,1,0,0,1,1,0,0,1424,18,1138
4100,경기도,4127,오산시,,신장동제7투,3096,1822,1007,717,45,0,25,0,0,0,1,7,1,2,1805,17,1274
4100,경기도,4127,오산시,,신장동제8투,3986,2726,1529,1108,53,3,16,3,0,0,0,1,0,1,2714,12,1260
4100,경기도,4127,오산시,,신장동제9투,3303,1931,1095,748,50,2,14,1,0,1,1,1,1,0,1914,17,1372
4100,경기도,4127,오산시,,신장동제10투,2855,2028,1120,825,47,0,17,0,0,1,0,0,0,1,2011,17,827
4100,경기도,4127,오산시,,신장동제11투,2250,1326,643,612,43,0,11,0,0,0,1,2,0,0,1312,14,924
4100,경기도,4127,오산시,,신장동제12투,2989,2131,1304,729,60,0,22,1,0,1,0,2,0,1,2120,11,858
4100,경기도,4127,오산시,세마동,소계,23856,18280,9739,7726,481,6,153,6,3,2,8,19,2,6,18151,129,5576
4100,경기도,4127,오산시,,관내사전투표,6211,6211,3521,2469,134,2,38,0,0,1,1,9,1,2,6178,33,0
4100,경기도,4127,오산시,,세마동제1투,2728,1448,599,770,42,0,16,1,0,0,0,2,0,1,1431,17,1280
4100,경기도,4127,오산시,,세마동제2투,2708,1721,832,796,48,1,23,1,1,0,2,0,1,0,1705,16,987
4100,경기도,4127,오산시,,세마동제3투,2841,2204,1176,940,50,1,19,1,0,0,0,3,0,1,2191,13,637
4100,경기도,4127,오산시,,세마동제4투,2607,1845,989,755,58,1,18,0,0,0,3,1,0,1,1826,19,762
4100,경기도,4127,오산시,,세마동제5투,3104,2143,1227,805,62,1,25,3,0,0,1,2,0,1,2127,16,961
4100,경기도,4127,오산시,,세마동제6투,3657,2708,1395,1191,87,0,14,0,2,1,1,2,0,0,2693,15,949
4100,경기도,4127,오산시,초평동,소계,12833,8966,4964,3553,225,7,112,3,0,0,7,10,2,3,8886,80,3867
4100,경기도,4127,오산시,,관내사전투표,3835,3835,2302,1394,72,4,28,0,0,0,1,7,2,1,3811,24,0
4100,경기도,4127,오산시,,초평동제1투,1728,879,357,476,28,1,6,0,0,0,4,0,0,0,872,7,849
4100,경기도,4127,오산시,,초평동제2투,1778,992,529,414,21,1,13,2,0,0,0,1,0,0,981,11,786
4100,경기도,4127,오산시,,초평동제3투,2301,1312,683,531,43,0,39,0,0,0,0,1,0,1,1298,14,989
4100,경기도,4127,오산시,,초평동제4투,1540,1047,596,398,34,0,7,0,0,0,1,0,0,0,1036,11,493
4100,경기도,4127,오산시,,초평동제5투,1651,901,497,340,27,1,19,1,0,0,1,1,0,1,888,13,750
4100,경기도,4127,오산시,잘못 투입·구분된 투표지,,0,2,0,2,0,0,0,0,0,0,0,0,0,0,2,0,-2
4100,경기도,4128,화성시,합계,,703896,542027,283324,236055,12955,194,4007,100,58,90,223,399,117,177,537699,4328,161869
4100,경기도,4128,화성시,거소·선상투표,,959,894,368,370,10,3,26,1,1,0,1,2,0,3,785,109,65
4100,경기도,4128,화성시,관외사전투표,,59884,59856,29746,27398,1389,31,562,13,11,15,24,47,15,39,59290,566,28
4100,경기도,4128,화성시,재외투표,,3117,2238,1313,656,61,0,6,0,0,1,1,0,0,0,2038,200,879
4100,경기도,4128,화성시,봉담읍,소계,60174,43807,24200,17640,1102,16,436,11,4,9,24,37,9,22,43510,297,16367
4100,경기도,4128,화성시,,관내사전투표,13949,13946,8367,5128,285,4,81,4,0,2,4,15,1,2,13893,53,3
4100,경기도,4128,화성시,,봉담읍제1투,2198,1390,546,788,32,0,15,0,1,0,0,0,1,1,1384,6,808
4100,경기도,4128,화성시,,봉담읍제2투,1579,852,352,464,16,1,8,0,0,0,0,2,1,0,844,8,727
4100,경기도,4128,화성시,,봉담읍제3투,2279,1382,701,611,39,0,23,1,1,0,0,2,0,0,1378,4,897
4100,경기도,4128,화성시,,봉담읍제4투,1906,1238,649,524,29,3,14,0,0,0,0,2,0,0,1221,17,668
4100,경기도,4128,화성시,,봉담읍제5투,2930,1698,787,821,47,0,27,1,1,2,3,0,0,3,1692,6,1232
4100,경기도,4128,화성시,,봉담읍제6투,3161,1858,974,792,43,0,33,0,0,0,1,3,0,0,1846,12,1303
4100,경기도,4128,화성시,,봉담읍제7투,2029,1327,673,590,31,1,17,1,0,0,0,0,0,0,1313,14,702
4100,경기도,4128,화성시,,봉담읍제8투,2748,1685,939,645,47,1,24,2,0,1,0,1,1,2,1663,22,1063
4100,경기도,4128,화성시,,봉담읍제9투,2528,1828,1022,702,75,0,12,0,0,0,0,1,0,1,1813,15,700
4100,경기도,4128,화성시,,봉담읍제10투,2230,1635,841,708,42,0,19,0,0,1,3,1,0,0,1615,20,595
4100,경기도,4128,화성시,,봉담읍제11투,2571,1653,836,734,36,0,23,0,0,0,5,3,0,1,1638,15,918
4100,경기도,4128,화성시,,봉담읍제12투,2680,1945,1118,745,47,2,19,0,0,0,1,1,0,2,1935,10,735
4100,경기도,4128,화성시,,봉담읍제13투,2601,1563,908,571,51,1,14,0,0,0,0,1,2,3,1551,12,1038
4100,경기도,4128,화성시,,봉담읍제14투,3543,2497,1475,901,71,0,30,0,0,1,1,0,1,1,2481,16,1046
4100,경기도,4128,화성시,,봉담읍제15투,3222,1743,898,745,53,0,18,1,0,2,3,0,1,0,1721,22,1479
4100,경기도,4128,화성시,,봉담읍제16투,2148,1622,795,752,45,0,12,0,0,0,0,0,0,2,1606,16,526
4100,경기도,4128,화성시,,봉담읍제17투,3703,2459,1480,839,76,2,33,0,0,0,3,4,1,3,2441,18,1244
4100,경기도,4128,화성시,,봉담읍제18투,2169,1486,839,580,37,1,14,1,1,0,0,1,0,1,1475,11,683
4100,경기도,4128,화성시,우정읍,소계,14523,10300,4975,4847,239,5,102,5,2,7,7,17,7,5,10218,82,4223
4100,경기도,4128,화성시,,관내사전투표,4967,4967,2561,2207,117,2,36,3,1,6,2,9,4,0,4948,19,0
4100,경기도,4128,화성시,,우정읍제1투,2675,1448,782,601,38,1,18,0,0,0,0,0,1,0,1441,7,1227
4100,경기도,4128,화성시,,우정읍제2투,1696,953,328,589,9,0,9,0,0,0,2,2,0,1,940,13,743
4100,경기도,4128,화성시,,우정읍제3투,2112,1089,492,548,25,1,7,0,1,0,0,1,0,3,1078,11,1023
4100,경기도,4128,화성시,,우정읍제4투,1117,657,347,260,20,0,16,0,0,0,0,3,1,0,647,10,460
4100,경기도,4128,화성시,,우정읍제5투,1005,598,245,318,13,0,7,1,0,0,1,1,0,0,586,12,407
4100,경기도,4128,화성시,,우정읍제6투,951,588,220,324,17,1,9,1,0,1,2,1,1,1,578,10,363
4100,경기도,4128,화성시,향남읍,소계,61719,41940,23936,16231,938,19,404,7,3,4,20,51,14,13,41640,300,19779
4100,경기도,4128,화성시,,관내사전투표,12146,12145,7585,4138,266,7,82,0,1,0,4,16,3,1,12103,42,1
4100,경기도,4128,화성시,,향남읍제1투,2455,1215,518,648,20,1,15,0,0,0,1,0,0,1,1204,11,1240
4100,경기도,4128,화성시,,향남읍제2투,4637,2351,1133,1098,58,0,30,0,0,0,2,1,1,1,2324,27,2286
4100,경기도,4128,화성시,,향남읍제3투,832,529,185,329,6,0,4,0,0,0,0,0,0,0,524,5,303
4100,경기도,4128,화성시,,향남읍제4투,1125,666,231,402,19,0,6,0,0,1,0,2,0,0,661,5,459
4100,경기도,4128,화성시,,향남읍제5투,2338,1428,699,649,36,0,20,0,1,0,1,4,0,0,1410,18,910
4100,경기도,4128,화성시,,향남읍제6투,2146,1280,645,565,34,0,17,1,0,0,2,2,0,0,1266,14,866
4100,경기도,4128,화성시,,향남읍제7투,1812,1282,670,538,45,2,9,2,0,0,0,1,2,3,1272,10,530
4100,경기도,4128,화성시,,향남읍제8투,2505,1709,853,803,31,1,12,0,0,0,0,0,0,2,1702,7,796
4100,경기도,4128,화성시,,향남읍제9투,2614,1785,1045,653,46,0,15,0,0,0,0,4,3,1,1767,18,829
4100,경기도,4128,화성시,,향남읍제10투,1946,1347,859,431,30,0,8,1,0,0,0,4,3,0,1336,11,599
4100,경기도,4128,화성시,,향남읍제11투,2206,1337,779,503,30,2,10,0,0,0,1,3,0,0,1328,9,869
4100,경기도,4128,화성시,,향남읍제12투,2267,1199,699,420,38,1,25,1,0,0,1,1,1,1,1188,11,1068
4100,경기도,4128,화성시,,향남읍제13투,1633,1201,705,447,32,1,5,1,0,0,0,5,0,0,1196,5,432
4100,경기도,4128,화성시,,향남읍제14투,2850,1908,1237,606,40,0,9,0,0,0,0,4,0,0,1896,12,942
4100,경기도,4128,화성시,,향남읍제15투,4191,2546,1478,958,49,2,38,0,1,0,1,0,0,1,2528,18,1645
4100,경기도,4128,화성시,,향남읍제16투,4021,2556,1576,866,54,0,31,1,0,0,4,2,0,0,2534,22,1465
4100,경기도,4128,화성시,,향남읍제17투,3841,2026,1144,806,33,1,20,0,0,2,0,0,0,0,2006,20,1815
4100,경기도,4128,화성시,,향남읍제18투,4105,2070,1125,835,44,1,41,0,0,1,0,1,1,2,2051,19,2035
4100,경기도,4128,화성시,,향남읍제19투,2049,1360,770,536,27,0,7,0,0,0,3,1,0,0,1344,16,689
4100,경기도,4128,화성시,매송면,소계,5976,4405,1873,2368,63,2,51,0,0,1,8,2,1,1,4370,35,1571
4100,경기도,4128,화성시,,관내사전투표,1896,1896,845,988,25,1,18,0,0,0,4,0,0,0,1881,15,0
4100,경기도,4128,화성시,,매송면제1투,1652,993,383,570,17,1,13,0,0,0,1,0,1,1,987,6,659
4100,경기도,4128,화성시,,매송면제2투,1179,773,333,399,13,0,13,0,0,1,2,2,0,0,763,10,406
4100,경기도,4128,화성시,,매송면제3투,1249,743,312,411,8,0,7,0,0,0,1,0,0,0,739,4,506
4100,경기도,4128,화성시,비봉면,소계,5803,4298,1785,2359,75,0,36,1,0,1,1,10,1,0,4269,29,1505
4100,경기도,4128,화성시,,관내사전투표,2094,2094,997,1035,37,0,11,0,0,0,0,3,0,0,2083,11,0
4100,경기도,4128,화성시,,비봉면제1투,2161,1237,472,716,18,0,17,1,0,1,0,4,0,0,1229,8,924
4100,경기도,4128,화성시,,비봉면제2투,1033,602,213,363,10,0,4,0,0,0,1,3,1,0,595,7,431
4100,경기도,4128,화성시,,비봉면제3투,515,365,103,245,10,0,4,0,0,0,0,0,0,0,362,3,150
4100,경기도,4128,화성시,마도면,소계,6466,4597,2047,2368,66,2,56,2,1,2,2,4,1,1,4552,45,1869
4100,경기도,4128,화성시,,관내사전투표,2543,2543,1225,1238,38,1,21,1,0,1,0,3,1,1,2530,13,0
4100,경기도,4128,화성시,,마도면제1투,2556,1256,537,658,18,1,15,1,1,0,2,1,0,0,1234,22,1300
4100,경기도,4128,화성시,,마도면제2투,1367,798,285,472,10,0,20,0,0,1,0,0,0,0,788,10,569
4100,경기도,4128,화성시,송산면,소계,9203,6539,2471,3803,125,1,56,0,0,0,10,9,4,2,6481,58,2664
4100,경기도,4128,화성시,,관내사전투표,3113,3113,1340,1663,62,1,15,0,0,0,4,5,3,1,3094,19,0
4100,경기도,4128,화성시,,송산면제1투,3608,1847,697,1059,40,0,25,0,0,0,2,3,0,0,1826,21,1761
4100,경기도,4128,화성시,,송산면제2투,994,635,152,455,8,0,10,0,0,0,2,1,0,0,628,7,359
4100,경기도,4128,화성시,,송산면제3투,1488,944,282,626,15,0,6,0,0,0,2,0,1,1,933,11,544
4100,경기도,4128,화성시,서신면,소계,6192,4350,1734,2463,62,1,43,2,1,1,10,6,2,0,4325,25,1842
4100,경기도,4128,화성시,,관내사전투표,2113,2113,973,1086,30,1,11,2,0,0,2,2,1,0,2108,5,0
4100,경기도,4128,화성시,,서신면제1투,1430,793,278,474,11,0,15,0,1,1,2,0,0,0,782,11,637
4100,경기도,4128,화성시,,서신면제2투,1526,839,291,526,10,0,6,0,0,0,1,0,0,0,834,5,687
4100,경기도,4128,화성시,,서신면제3투,1123,605,192,377,11,0,11,0,0,0,5,4,1,0,601,4,518
4100,경기도,4128,화성시,팔탄면,소계,10244,7603,3628,3717,130,0,68,2,1,1,2,7,1,6,7563,40,2641
4100,경기도,4128,화성시,,관내사전투표,4556,4556,2418,2000,75,0,38,1,1,1,1,3,0,4,4542,14,0
4100,경기도,4128,화성시,,팔탄면제1투,2937,1523,657,803,25,0,19,1,0,0,1,2,0,0,1508,15,1414
4100,경기도,4128,화성시,,팔탄면제2투,1350,804,301,465,21,0,7,0,0,0,0,0,1,1,796,8,546
4100,경기도,4128,화성시,,팔탄면제3투,1401,720,252,449,9,0,4,0,0,0,0,2,0,1,717,3,681
4100,경기도,4128,화성시,장안면,소계,8204,5357,2396,2728,106,4,67,2,1,0,2,6,3,3,5318,39,2847
4100,경기도,4128,화성시,,관내사전투표,2127,2127,1075,973,39,1,22,1,1,0,1,4,1,0,2118,9,0
4100,경기도,4128,화성시,,장안면제1투,1621,792,320,438,18,0,10,0,0,0,1,1,1,1,790,2,829
4100,경기도,4128,화성시,,장안면제2투,1479,725,271,416,14,2,9,0,0,0,0,0,1,2,715,10,754
4100,경기도,4128,화성시,,장안면제3투,983,546,206,310,11,0,10,0,0,0,0,1,0,0,538,8,437
4100,경기도,4128,화성시,,장안면제4투,661,435,161,252,8,0,8,0,0,0,0,0,0,0,429,6,226
4100,경기도,4128,화성시,,장안면제5투,1333,732,363,339,16,1,8,1,0,0,0,0,0,0,728,4,601
4100,경기도,4128,화성시,양감면,소계,4709,3702,1701,1874,61,3,34,1,1,2,2,2,2,0,3683,19,1007
4100,경기도,4128,화성시,,관내사전투표,2348,2348,1224,1045,41,1,20,1,1,0,1,1,2,0,2337,11,0
4100,경기도,4128,화성시,,양감면제1투,1163,634,250,357,10,2,7,0,0,1,0,1,0,0,628,6,529
4100,경기도,4128,화성시,,양감면제2투,1198,720,227,472,10,0,7,0,0,1,1,0,0,0,718,2,478
4100,경기도,4128,화성시,정남면,소계,9809,6993,3048,3644,131,4,92,4,1,1,4,7,4,6,6946,47,2816
4100,경기도,4128,화성시,,관내사전투표,3085,3085,1500,1475,52,2,29,3,1,1,0,1,1,1,3066,19,0
4100,경기도,4128,화성시,,정남면제1투,1919,1116,394,672,18,0,20,0,0,0,0,4,0,2,1110,6,803
4100,경기도,4128,화성시,,정남면제2투,1459,765,269,462,11,0,12,0,0,0,0,0,1,3,758,7,694
4100,경기도,4128,화성시,,정남면제3투,1883,1099,394,653,27,2,11,1,0,0,2,1,0,0,1091,8,784
4100,경기도,4128,화성시,,정남면제4투,1463,928,491,382,23,0,20,0,0,0,2,1,2,0,921,7,535
4100,경기도,4128,화성시,남양읍,소계,31571,21817,11079,9755,511,7,236,8,3,4,7,13,5,9,21637,180,9754
4100,경기도,4128,화성시,,관내사전투표,8155,8155,4389,3494,157,2,59,3,0,1,0,7,1,3,8116,39,0
4100,경기도,4128,화성시,,남양읍제1투,3993,2299,1178,1005,64,2,28,0,0,0,1,0,1,1,2280,19,1694
4100,경기도,4128,화성시,,남양읍제2투,3800,2126,975,1036,48,1,39,0,0,1,3,3,2,0,2108,18,1674
4100,경기도,4128,화성시,,남양읍제3투,3066,1711,733,899,38,0,24,1,1,0,0,0,0,1,1697,14,1355
4100,경기도,4128,화성시,,남양읍제4투,792,551,170,359,12,0,3,1,0,1,1,0,0,0,547,4,241
4100,경기도,4128,화성시,,남양읍제5투,4500,2473,1302,1014,66,2,38,3,0,1,1,1,1,3,2432,41,2027
4100,경기도,4128,화성시,,남양읍제6투,3777,2089,1093,897,50,0,22,0,1,0,1,1,0,0,2065,24,1688
4100,경기도,4128,화성시,,남양읍제7투,3488,2413,1239,1051,76,0,23,0,1,0,0,1,0,1,2392,21,1075
4100,경기도,4128,화성시,진안동,소계,30857,21163,11045,9199,463,7,188,5,2,3,11,22,6,11,20962,201,9694
4100,경기도,4128,화성시,,관내사전투표,5530,5530,3040,2321,85,1,36,1,1,0,2,5,2,1,5495,35,0
4100,경기도,4128,화성시,,진안동제1투,3151,1577,722,768,34,0,16,0,0,0,1,3,0,2,1546,31,1574
4100,경기도,4128,화성시,,진안동제2투,2525,1363,671,610,37,0,22,0,0,0,1,2,0,0,1343,20,1162
4100,경기도,4128,화성시,,진안동제3투,2125,1633,773,779,48,1,12,1,1,1,2,4,0,1,1623,10,492
4100,경기도,4128,화성시,,진안동제4투,3748,2273,1247,919,56,0,28,2,0,0,1,1,1,2,2257,16,1475
4100,경기도,4128,화성시,,진안동제5투,3000,2023,1067,877,42,0,17,1,0,0,0,2,1,3,2010,13,977
4100,경기도,4128,화성시,,진안동제6투,3930,2673,1452,1107,65,3,15,0,0,2,2,3,0,0,2649,24,1257
4100,경기도,4128,화성시,,진안동제7투,2895,1269,576,595,33,2,26,0,0,0,0,0,0,0,1232,37,1626
4100,경기도,4128,화성시,,진안동제8투,2345,1844,956,828,41,0,4,0,0,0,0,0,1,1,1831,13,501
4100,경기도,4128,화성시,,진안동제9투,1608,978,541,395,22,0,12,0,0,0,2,2,1,1,976,2,630
4100,경기도,4128,화성시,병점1동,소계,27125,20502,10839,8745,515,5,152,0,1,1,11,18,0,3,20290,212,6623
4100,경기도,4128,화성시,,관내사전투표,7869,7869,4455,3155,160,1,29,0,0,0,3,4,0,1,7808,61,0
4100,경기도,4128,화성시,,병점1동제1투,3100,2054,1117,820,60,1,25,0,0,1,2,3,0,0,2029,25,1046
4100,경기도,4128,화성시,,병점1동제2투,2399,1578,749,752,37,0,23,0,0,0,1,0,0,2,1564,14,821
4100,경기도,4128,화성시,,병점1동제3투,3645,2034,941,935,63,1,25,0,0,0,2,2,0,0,1969,65,1611
4100,경기도,4128,화성시,,병점1동제4투,3099,2114,1115,921,45,0,17,0,0,0,0,3,0,0,2101,13,985
4100,경기도,4128,화성시,,병점1동제5투,3024,1830,899,836,54,1,17,0,1,0,0,3,0,0,1811,19,1194
4100,경기도,4128,화성시,,병점1동제6투,3989,3023,1563,1326,96,1,16,0,0,0,3,3,0,0,3008,15,966
4100,경기도,4128,화성시,병점2동,소계,18222,13996,8054,5328,360,3,106,5,1,1,7,11,5,4,13885,111,4226
4100,경기도,4128,화성시,,관내사전투표,6262,6263,3888,2159,142,2,30,1,1,0,2,4,2,2,6233,30,-1
4100,경기도,4128,화성시,,병점2동제1투,3085,2001,1064,813,68,0,26,2,0,0,1,4,1,1,1980,21,1084
4100,경기도,4128,화성시,,병점2동제2투,3184,2278,1225,965,57,0,11,1,0,0,0,0,1,1,2261,17,906
4100,경기도,4128,화성시,,병점2동제3투,3010,1794,964,730,57,0,18,0,0,0,2,0,1,0,1772,22,1216
4100,경기도,4128,화성시,,병점2동제4투,2681,1660,913,661,36,1,21,1,0,1,2,3,0,0,1639,21,1021
4100,경기도,4128,화성시,반월동,소계,21646,16931,8898,7373,420,4,90,0,1,0,9,6,4,5,16810,121,4715
4100,경기도,4128,화성시,,관내사전투표,6027,6024,3396,2445,136,1,17,0,1,0,0,1,1,2,6000,24,3
4100,경기도,4128,화성시,,반월동제1투,2456,1583,742,766,43,2,9,0,0,0,0,1,0,0,1563,20,873
4100,경기도,4128,화성시,,반월동제2투,2823,1818,846,884,44,0,15,0,0,0,1,1,2,0,1793,25,1005
4100,경기도,4128,화성시,,반월동제3투,2465,1873,882,916,49,0,12,0,0,0,3,0,0,0,1862,11,592
4100,경기도,4128,화성시,,반월동제4투,3052,2268,1296,874,64,1,14,0,0,0,4,3,0,0,2256,12,784
4100,경기도,4128,화성시,,반월동제5투,3710,2616,1309,1193,70,0,17,0,0,0,1,0,1,2,2593,23,1094
4100,경기도,4128,화성시,,반월동제6투,1113,749,427,295,14,0,6,0,0,0,0,0,0,1,743,6,364
4100,경기도,4128,화성시,기배동,소계,12241,9790,5487,3878,272,7,75,0,2,1,5,6,1,6,9740,50,2451
4100,경기도,4128,화성시,,관내사전투표,5192,5192,3149,1873,115,2,27,0,1,0,0,5,1,2,5175,17,0
4100,경기도,4128,화성시,,기배동제1투,1648,1108,556,486,47,0,12,0,0,0,1,0,0,2,1104,4,540
4100,경기도,4128,화성시,,기배동제2투,3204,2083,1059,899,73,3,25,0,1,0,3,1,0,2,2066,17,1121
4100,경기도,4128,화성시,,기배동제3투,2197,1407,723,620,37,2,11,0,0,1,1,0,0,0,1395,12,790
4100,경기도,4128,화성시,화산동,소계,18277,13109,6894,5680,276,3,128,5,1,1,7,8,2,4,13009,100,5168
4100,경기도,4128,화성시,,관내사전투표,5693,5691,3227,2298,106,0,29,2,0,0,1,5,0,1,5669,22,2
4100,경기도,4128,화성시,,화산동제1투,2394,1336,629,633,37,0,18,0,0,0,2,1,0,1,1321,15,1058
4100,경기도,4128,화성시,,화산동제2투,2564,1491,745,667,32,2,25,3,1,0,0,0,1,0,1476,15,1073
4100,경기도,4128,화성시,,화산동제3투,2948,1761,901,774,31,0,29,0,0,0,2,0,1,2,1740,21,1187
4100,경기도,4128,화성시,,화산동제4투,2333,1193,518,607,35,0,17,0,0,1,2,0,0,0,1180,13,1140
4100,경기도,4128,화성시,,화산동제5투,2345,1637,874,701,35,1,10,0,0,0,0,2,0,0,1623,14,708
4100,경기도,4128,화성시,동탄1동,소계,34329,26864,13442,12390,658,6,117,4,1,5,0,11,4,6,26644,220,7465
4100,경기도,4128,화성시,,관내사전투표,8809,8811,4823,3705,198,2,28,0,0,0,0,2,0,1,8759,52,-2
4100,경기도,4128,화성시,,동탄1동제1투,1937,1397,675,666,38,1,7,0,0,0,0,2,1,0,1390,7,540
4100,경기도,4128,화성시,,동탄1동제2투,2895,1965,934,959,43,0,10,0,0,1,0,1,0,1,1949,16,930
4100,경기도,4128,화성시,,동탄1동제3투,2099,1457,739,665,28,1,9,0,0,0,0,1,0,0,1443,14,642
4100,경기도,4128,화성시,,동탄1동제4투,2810,2158,1124,934,65,0,9,0,1,1,0,0,1,0,2135,23,652
4100,경기도,4128,화성시,,동탄1동제5투,2058,1575,757,745,47,0,13,0,0,0,0,1,0,1,1564,11,483
4100,경기도,4128,화성시,,동탄1동제6투,3227,2041,1025,934,53,0,8,2,0,1,0,0,1,1,2025,16,1186
4100,경기도,4128,화성시,,동탄1동제7투,2240,1659,881,704,49,0,10,0,0,1,0,2,0,0,1647,12,581
4100,경기도,4128,화성시,,동탄1동제8투,2665,2043,846,1129,42,1,5,1,0,1,0,0,1,1,2027,16,622
4100,경기도,4128,화성시,,동탄1동제9투,1964,1489,731,700,38,0,7,1,0,0,0,1,0,0,1478,11,475
4100,경기도,4128,화성시,,동탄1동제10투,3625,2269,907,1249,57,1,11,0,0,0,0,1,0,1,2227,42,1356
4100,경기도,4128,화성시,동탄2동,소계,24438,19819,10993,8096,489,6,80,6,3,4,8,11,2,5,19703,116,4619
4100,경기도,4128,화성시,,관내사전투표,7381,7381,4522,2663,138,3,12,3,0,0,0,5,1,0,7347,34,0
4100,경기도,4128,화성시,,동탄2동제1투,2931,2243,1105,1041,74,0,6,0,0,1,0,0,0,0,2227,16,688
4100,경기도,4128,화성시,,동탄2동제2투,1956,1456,809,581,40,0,9,0,0,1,3,2,0,1,1446,10,500
4100,경기도,4128,화성시,,동탄2동제3투,2952,2216,1108,1008,65,1,14,0,0,0,0,0,1,0,2197,19,736
4100,경기도,4128,화성시,,동탄2동제4투,2663,2072,1018,966,61,1,9,2,1,0,0,1,0,2,2061,11,591
4100,경기도,4128,화성시,,동탄2동제5투,3083,1824,949,788,47,0,19,0,1,2,4,1,0,0,1811,13,1259
4100,경기도,4128,화성시,,동탄2동제6투,3472,2627,1482,1049,64,1,11,1,1,0,1,2,0,2,2614,13,845
4100,경기도,4128,화성시,동탄3동,소계,31190,24454,13792,9649,652,12,129,4,3,2,8,6,8,5,24270,184,6736
4100,경기도,4128,화성시,,관내사전투표,10901,10903,6499,4006,289,5,40,2,0,0,3,3,1,0,10848,55,-2
4100,경기도,4128,화성시,,동탄3동제1투,2783,1889,1102,700,55,1,12,0,0,0,2,0,1,1,1874,15,894
4100,경기도,4128,화성시,,동탄3동제2투,3155,2032,1097,831,61,0,17,0,1,1,1,1,4,1,2015,17,1123
4100,경기도,4128,화성시,,동탄3동제3투,4369,2469,1123,1208,60,2,29,2,0,0,0,0,1,2,2427,42,1900
4100,경기도,4128,화성시,,동탄3동제4투,3197,2235,1198,943,56,0,9,0,2,1,1,1,0,0,2211,24,962
4100,경기도,4128,화성시,,동탄3동제5투,3674,2638,1487,1056,59,3,14,0,0,0,0,1,0,0,2620,18,1036
4100,경기도,4128,화성시,,동탄3동제6투,3111,2288,1286,905,72,1,8,0,0,0,1,0,1,1,2275,13,823
4100,경기도,4128,화성시,동탄4동,소계,35181,29529,15454,13054,741,1,84,0,1,1,4,25,2,4,29371,158,5652
4100,경기도,4128,화성시,,관내사전투표,10795,10792,6213,4280,220,0,32,0,0,0,0,10,2,1,10758,34,3
4100,경기도,4128,화성시,,동탄4동제1투,3246,2466,1287,1068,76,1,9,0,0,0,0,1,0,0,2442,24,780
4100,경기도,4128,화성시,,동탄4동제2투,2481,1872,933,865,55,0,7,0,0,0,0,0,0,0,1860,12,609
4100,경기도,4128,화성시,,동탄4동제3투,3114,2481,1139,1247,69,0,6,0,0,0,0,3,0,0,2464,17,633
4100,경기도,4128,화성시,,동탄4동제4투,2109,1635,755,826,43,0,1,0,0,0,0,5,0,0,1630,5,474
4100,경기도,4128,화성시,,동탄4동제5투,2186,1784,808,905,48,0,5,0,0,0,1,3,0,0,1770,14,402
4100,경기도,4128,화성시,,동탄4동제6투,2387,1818,1010,729,62,0,4,0,0,0,0,1,0,0,1806,12,569
4100,경기도,4128,화성시,,동탄4동제7투,3441,2570,1322,1162,64,0,9,0,0,1,0,1,0,1,2560,10,871
4100,경기도,4128,화성시,,동탄4동제8투,3091,2248,1122,1040,55,0,5,0,1,0,3,1,0,0,2227,21,843
4100,경기도,4128,화성시,,동탄4동제9투,2331,1863,865,932,49,0,6,0,0,0,0,0,0,2,1854,9,468
4100,경기도,4128,화성시,새솔동,소계,16707,13049,7339,5242,316,5,72,2,4,0,1,5,1,2,12989,60,3658
4100,경기도,4128,화성시,,관내사전투표,5419,5419,3282,1982,120,0,16,0,1,0,0,3,0,0,5404,15,0
4100,경기도,4128,화성시,,새솔동제1투,2594,1784,964,751,47,1,11,0,1,0,0,0,0,0,1775,9,810
4100,경기도,4128,화성시,,새솔동제2투,3753,2445,1291,1064,53,3,15,0,0,0,0,0,1,2,2429,16,1308
4100,경기도,4128,화성시,,새솔동제3투,3240,2251,1217,933,61,1,23,1,1,0,0,1,0,0,2238,13,989
4100,경기도,4128,화성시,,새솔동제4투,1701,1150,585,512,35,0,7,1,1,0,1,1,0,0,1143,7,551
4100,경기도,4128,화성시,동탄5동,소계,32099,24928,12981,10909,672,14,138,4,1,4,5,8,6,5,24747,181,7171
4100,경기도,4128,화성시,,관내사전투표,8072,8071,4544,3268,175,7,33,1,0,0,1,2,1,1,8033,38,1
4100,경기도,4128,화성시,,동탄5동제1투,2434,1731,849,796,55,0,7,1,0,1,1,0,1,0,1711,20,703
4100,경기도,4128,화성시,,동탄5동제2투,2828,2133,1075,970,64,0,7,0,0,0,0,1,0,2,2119,14,695
4100,경기도,4128,화성시,,동탄5동제3투,2187,1562,720,770,40,1,10,0,0,0,0,1,2,0,1544,18,625
4100,경기도,4128,화성시,,동탄5동제4투,3034,2065,1035,946,58,1,6,2,0,0,0,0,0,1,2049,16,969
4100,경기도,4128,화성시,,동탄5동제5투,2934,2139,1145,899,69,0,9,0,0,1,1,0,0,0,2124,15,795
4100,경기도,4128,화성시,,동탄5동제6투,2525,1601,793,723,42,0,17,0,0,1,1,3,0,0,1580,21,924
4100,경기도,4128,화성시,,동탄5동제7투,2950,2188,1088,1020,57,1,12,0,0,1,0,0,1,0,2180,8,762
4100,경기도,4128,화성시,,동탄5동제8투,3435,2409,1233,1065,66,3,25,0,1,0,0,0,1,1,2395,14,1026
4100,경기도,4128,화성시,,동탄5동제9투,1700,1029,499,452,46,1,12,0,0,0,1,1,0,0,1012,17,671
4100,경기도,4128,화성시,동탄6동,소계,26072,19490,9650,9039,506,9,96,0,1,6,3,10,0,1,19321,169,6582
4100,경기도,4128,화성시,,관내사전투표,6926,6926,3907,2812,154,2,19,0,0,2,0,4,0,0,6900,26,0
4100,경기도,4128,화성시,,동탄6동제1투,3260,1852,782,967,48,0,12,0,0,0,1,0,0,0,1810,42,1408
4100,경기도,4128,화성시,,동탄6동제2투,2569,1487,686,705,45,0,16,0,1,1,0,2,0,1,1457,30,1082
4100,경기도,4128,화성시,,동탄6동제3투,2738,1953,966,902,53,4,11,0,0,1,0,2,0,0,1939,14,785
4100,경기도,4128,화성시,,동탄6동제4투,3295,2196,926,1175,68,1,11,0,0,1,1,0,0,0,2183,13,1099
4100,경기도,4128,화성시,,동탄6동제5투,3903,2735,1368,1247,77,1,18,0,0,0,1,0,0,0,2712,23,1168
4100,경기도,4128,화성시,,동탄6동제6투,3381,2341,1015,1231,61,1,9,0,0,1,0,2,0,0,2320,21,1040
4100,경기도,4128,화성시,동탄7동,소계,54776,42054,22408,18084,1048,11,192,5,4,8,13,18,5,4,41800,254,12722
4100,경기도,4128,화성시,,관내사전투표,11786,11783,6747,4708,244,4,28,3,1,1,0,4,1,0,11741,42,3
4100,경기도,4128,화성시,,동탄7동제1투,3260,2396,1316,983,72,0,3,1,0,0,1,5,0,1,2382,14,864
4100,경기도,4128,화성시,,동탄7동제2투,2506,1751,704,982,48,0,3,0,0,0,2,0,0,0,1739,12,755
4100,경기도,4128,화성시,,동탄7동제3투,2156,1608,793,760,31,0,8,0,2,0,0,0,0,0,1594,14,548
4100,경기도,4128,화성시,,동탄7동제4투,3453,2361,1052,1223,56,0,13,1,0,0,0,3,0,0,2348,13,1092
4100,경기도,4128,화성시,,동탄7동제5투,2489,1674,764,853,31,1,9,0,0,0,0,1,0,0,1659,15,815
4100,경기도,4128,화성시,,동탄7동제6투,4146,2972,1492,1340,87,0,21,0,0,2,1,3,2,0,2948,24,1174
4100,경기도,4128,화성시,,동탄7동제7투,3664,2386,1377,895,73,1,17,0,0,1,1,2,0,1,2368,18,1278
4100,경기도,4128,화성시,,동탄7동제8투,3894,2812,1449,1254,72,2,16,0,0,1,2,0,0,1,2797,15,1082
4100,경기도,4128,화성시,,동탄7동제9투,3848,2927,1498,1303,92,0,15,0,0,0,2,0,0,1,2911,16,921
4100,경기도,4128,화성시,,동탄7동제10투,3430,2394,1296,989,71,0,15,0,1,1,0,0,0,0,2373,21,1036
4100,경기도,4128,화성시,,동탄7동제11투,3133,2261,1339,844,54,0,11,0,0,0,1,0,1,0,2250,11,872
4100,경기도,4128,화성시,,동탄7동제12투,3489,2610,1409,1119,59,0,8,0,0,1,3,0,1,0,2600,10,879
4100,경기도,4128,화성시,,동탄7동제13투,3522,2119,1172,831,58,3,25,0,0,1,0,0,0,0,2090,29,1403
4100,경기도,4128,화성시,동탄8동,소계,22183,17650,9747,7166,498,3,85,1,2,4,6,14,2,2,17530,120,4533
4100,경기도,4128,화성시,,관내사전투표,6780,6778,3989,2564,159,0,34,0,0,1,1,4,1,1,6754,24,2
4100,경기도,4128,화성시,,동탄8동제1투,3485,2436,1438,883,80,0,11,0,0,0,1,2,1,0,2416,20,1049
4100,경기도,4128,화성시,,동탄8동제2투,2929,2042,1171,774,58,0,10,0,0,1,0,4,0,0,2018,24,887
4100,경기도,4128,화성시,,동탄8동제3투,2297,1634,783,789,35,2,7,0,1,0,2,0,0,1,1620,14,663
4100,경기도,4128,화성시,,동탄8동제4투,2190,1466,728,674,44,0,6,1,1,0,0,0,0,0,1454,12,724
4100,경기도,4128,화성시,,동탄8동제5투,1962,1380,698,609,51,1,5,0,0,1,1,2,0,0,1368,12,582
4100,경기도,4128,화성시,,동탄8동제6투,2540,1914,940,873,71,0,12,0,0,1,1,2,0,0,1900,14,626
4100,경기도,4128,화성시,잘못 투입·구분된 투표지,,0,3,1,2,0,0,0,0,0,0,0,0,0,0,3,0,-3
4100,경기도,4129,시흥시,합계,,424723,317197,178462,125544,7082,151,2682,47,51,50,218,285,57,136,314765,2432,107526
4100,경기도,4129,시흥시,거소·선상투표,,713,672,288,260,13,3,21,1,0,0,0,1,0,0,587,85,41
4100,경기도,4129,시흥시,관외사전투표,,31621,31616,16889,13160,768,16,393,11,6,7,16,40,6,16,31328,288,5
4100,경기도,4129,시흥시,재외투표,,1387,987,626,242,26,0,5,0,0,0,1,0,0,0,900,87,400
4100,경기도,4129,시흥시,대야동,소계,35084,26230,13820,11307,629,10,177,5,5,6,24,25,6,10,26024,206,8854
4100,경기도,4129,시흥시,,관내사전투표,7301,7301,4188,2894,141,2,29,0,0,2,2,6,1,1,7266,35,0
4100,경기도,4129,시흥시,,대야동제1투,3761,2084,1063,914,48,0,25,0,0,0,1,2,1,1,2055,29,1677
4100,경기도,4129,시흥시,,대야동제2투,2078,1315,610,646,25,0,15,0,0,0,3,4,0,1,1304,11,763
4100,경기도,4129,시흥시,,대야동제3투,2797,1734,915,729,36,0,20,1,1,0,5,3,2,2,1714,20,1063
4100,경기도,4129,시흥시,,대야동제4투,3640,2599,1370,1104,82,2,18,1,1,1,4,2,0,0,2585,14,1041
4100,경기도,4129,시흥시,,대야동제5투,342,259,52,200,1,0,2,0,0,0,1,0,0,0,256,3,83
4100,경기도,4129,시흥시,,대야동제6투,2563,1686,881,711,54,0,14,1,2,0,0,1,1,1,1666,20,877
4100,경기도,4129,시흥시,,대야동제7투,2948,2089,1077,914,55,1,10,2,0,1,2,4,1,0,2067,22,859
4100,경기도,4129,시흥시,,대야동제8투,3069,2146,1047,1007,61,0,13,0,1,0,0,1,0,2,2132,14,923
4100,경기도,4129,시흥시,,대야동제9투,2860,2161,1234,825,60,1,20,0,0,1,2,0,0,1,2144,17,699
4100,경기도,4129,시흥시,,대야동제10투,3725,2856,1383,1363,66,4,11,0,0,1,4,2,0,1,2835,21,869
4100,경기도,4129,시흥시,신천동,소계,29385,20119,10924,8309,442,7,195,4,1,2,19,19,9,12,19943,176,9266
4100,경기도,4129,시흥시,,관내사전투표,6571,6571,3857,2521,101,0,46,3,0,0,3,8,1,2,6542,29,0
4100,경기도,4129,시흥시,,신천동제1투,2028,990,492,448,22,0,16,0,0,1,0,1,1,0,981,9,1038
4100,경기도,4129,시흥시,,신천동제2투,4232,2440,1200,1098,68,2,40,0,0,0,3,1,2,2,2416,24,1792
4100,경기도,4129,시흥시,,신천동제3투,2002,1167,603,507,30,0,12,0,0,1,1,0,0,1,1155,12,835
4100,경기도,4129,시흥시,,신천동제4투,2899,1735,914,727,35,2,26,0,0,0,0,6,4,0,1714,21,1164
4100,경기도,4129,시흥시,,신천동제5투,2415,1387,782,542,36,0,4,0,0,0,2,1,0,3,1370,17,1028
4100,경기도,4129,시흥시,,신천동제6투,2322,1336,717,567,22,1,13,0,0,0,3,0,0,0,1323,13,986
4100,경기도,4129,시흥시,,신천동제7투,3500,2354,1240,1004,65,1,12,0,1,0,3,2,0,2,2330,24,1146
4100,경기도,4129,시흥시,,신천동제8투,3416,2139,1119,895,63,1,26,1,0,0,4,0,1,2,2112,27,1277
4100,경기도,4129,시흥시,신현동,소계,8825,6770,3377,3120,132,4,63,1,0,0,3,9,1,4,6714,56,2055
4100,경기도,4129,시흥시,,관내사전투표,3361,3361,1842,1423,56,3,13,1,0,0,0,6,1,0,3345,16,0
4100,경기도,4129,시흥시,,신현동제1투,1342,797,368,381,26,0,11,0,0,0,0,1,0,0,787,10,545
4100,경기도,4129,시흥시,,신현동제2투,1712,1042,476,513,23,0,13,0,0,0,1,0,0,2,1028,14,670
4100,경기도,4129,시흥시,,신현동제3투,2129,1361,639,651,26,1,24,0,0,0,2,2,0,0,1345,16,768
4100,경기도,4129,시흥시,,신현동제4투,281,209,52,152,1,0,2,0,0,0,0,0,0,2,209,0,72
4100,경기도,4129,시흥시,은행동,소계,40263,31078,17950,11836,780,11,233,3,3,3,15,25,2,9,30870,208,9185
4100,경기도,4129,시흥시,,관내사전투표,9052,9051,5634,3121,200,7,48,2,1,1,1,7,0,1,9023,28,1
4100,경기도,4129,시흥시,,은행동제1투,2616,1487,764,643,36,0,16,1,1,0,5,1,0,1,1468,19,1129
4100,경기도,4129,시흥시,,은행동제2투,3472,2134,1144,873,47,0,33,0,1,1,3,2,0,4,2108,26,1338
4100,경기도,4129,시흥시,,은행동제3투,2894,2073,1131,857,53,0,15,0,0,0,1,2,1,0,2060,13,821
4100,경기도,4129,시흥시,,은행동제4투,3710,2688,1505,1054,77,2,21,0,0,0,0,2,0,1,2662,26,1022
4100,경기도,4129,시흥시,,은행동제5투,2977,2137,1067,977,56,1,12,0,0,1,0,1,0,1,2116,21,840
4100,경기도,4129,시흥시,,은행동제6투,2401,1799,1029,682,54,1,12,0,0,0,2,7,1,0,1788,11,602
4100,경기도,4129,시흥시,,은행동제7투,3445,2624,1658,887,52,0,13,0,0,0,0,1,0,0,2611,13,821
4100,경기도,4129,시흥시,,은행동제8투,3340,2418,1325,990,71,0,15,0,0,0,2,0,0,0,2403,15,922
4100,경기도,4129,시흥시,,은행동제9투,2624,2036,1231,698,70,0,22,0,0,0,0,1,0,0,2022,14,588
4100,경기도,4129,시흥시,,은행동제10투,2244,1493,829,605,22,0,19,0,0,0,1,1,0,1,1478,15,751
4100,경기도,4129,시흥시,,은행동제11투,1488,1138,633,449,42,0,7,0,0,0,0,0,0,0,1131,7,350
4100,경기도,4129,시흥시,매화동,소계,10308,7579,4193,3117,111,6,64,3,2,0,12,8,1,5,7522,57,2729
4100,경기도,4129,시흥시,,관내사전투표,3608,3608,2130,1381,51,3,16,0,1,0,1,5,0,3,3591,17,0
4100,경기도,4129,시흥시,,매화동제1투,2842,1688,911,692,28,2,23,0,0,0,7,2,1,2,1668,20,1154
4100,경기도,4129,시흥시,,매화동제2투,1913,1131,538,559,16,1,6,0,1,0,2,1,0,0,1124,7,782
4100,경기도,4129,시흥시,,매화동제3투,1945,1152,614,485,16,0,19,3,0,0,2,0,0,0,1139,13,793
4100,경기도,4129,시흥시,목감동,소계,30260,23120,12955,9289,514,12,138,2,6,6,12,20,1,8,22963,157,7140
4100,경기도,4129,시흥시,,관내사전투표,7522,7521,4582,2769,109,3,22,0,0,0,2,3,0,3,7493,28,1
4100,경기도,4129,시흥시,,목감동제1투,2957,1811,851,861,48,2,11,1,4,1,3,5,0,0,1787,24,1146
4100,경기도,4129,시흥시,,목감동제2투,1116,774,365,379,11,0,5,0,0,0,0,0,0,0,760,14,342
4100,경기도,4129,시흥시,,목감동제3투,2923,1841,914,842,41,2,22,0,0,3,3,1,1,2,1831,10,1082
4100,경기도,4129,시흥시,,목감동제4투,2349,1597,882,622,53,2,18,0,0,1,0,2,0,1,1581,16,752
4100,경기도,4129,시흥시,,목감동제5투,2810,2063,1324,638,59,0,26,0,0,1,0,0,0,0,2048,15,747
4100,경기도,4129,시흥시,,목감동제6투,3713,2442,1267,1087,54,2,8,0,0,0,1,2,0,0,2421,21,1271
4100,경기도,4129,시흥시,,목감동제7투,3196,2354,1301,955,64,0,14,0,0,0,3,0,0,1,2338,16,842
4100,경기도,4129,시흥시,,목감동제8투,3674,2717,1469,1136,75,1,12,1,2,0,0,7,0,1,2704,13,957
4100,경기도,4129,시흥시,군자동,소계,17207,11620,6505,4579,243,10,132,2,3,5,15,14,6,9,11523,97,5587
4100,경기도,4129,시흥시,,관내사전투표,3852,3852,2279,1455,73,3,25,0,0,0,1,2,1,3,3842,10,0
4100,경기도,4129,시흥시,,군자동제1투,3194,1744,916,718,53,1,28,1,1,0,3,2,1,2,1726,18,1450
4100,경기도,4129,시흥시,,군자동제2투,2317,1334,749,520,32,1,13,0,0,2,3,2,1,2,1325,9,983
4100,경기도,4129,시흥시,,군자동제3투,2815,1650,882,667,21,2,34,0,1,1,3,2,2,0,1615,35,1165
4100,경기도,4129,시흥시,,군자동제4투,2904,1687,947,656,35,2,21,0,1,1,4,6,1,0,1674,13,1217
4100,경기도,4129,시흥시,,군자동제5투,2125,1353,732,563,29,1,11,1,0,1,1,0,0,2,1341,12,772
4100,경기도,4129,시흥시,정왕본동,소계,17355,9845,5689,3711,185,13,149,0,0,4,10,5,0,4,9770,75,7510
4100,경기도,4129,시흥시,,관내사전투표,3966,3966,2421,1384,73,5,46,0,0,2,4,4,0,2,3941,25,0
4100,경기도,4129,시흥시,,정왕본동제1투,2470,890,478,363,15,2,24,0,0,0,0,1,0,0,883,7,1580
4100,경기도,4129,시흥시,,정왕본동제2투,3642,1232,635,520,23,3,37,0,0,1,0,0,0,1,1220,12,2410
4100,경기도,4129,시흥시,,정왕본동제3투,1332,518,289,207,9,1,7,0,0,0,1,0,0,0,514,4,814
4100,경기도,4129,시흥시,,정왕본동제4투,1333,559,332,196,6,0,13,0,0,0,3,0,0,1,551,8,774
4100,경기도,4129,시흥시,,정왕본동제5투,1482,526,336,174,6,0,8,0,0,0,0,0,0,0,524,2,956
4100,경기도,4129,시흥시,,정왕본동제6투,3130,2154,1198,867,53,2,14,0,0,1,2,0,0,0,2137,17,976
4100,경기도,4129,시흥시,정왕1동,소계,18501,11426,6694,4242,225,5,132,2,3,0,12,12,3,6,11336,90,7075
4100,경기도,4129,시흥시,,관내사전투표,4580,4580,2858,1571,87,2,31,1,1,0,3,3,0,2,4559,21,0
4100,경기도,4129,시흥시,,정왕1동제1투,2311,1224,702,459,35,1,13,0,1,0,3,2,0,0,1216,8,1087
4100,경기도,4129,시흥시,,정왕1동제2투,2447,1184,617,497,27,2,24,0,1,0,2,5,1,0,1176,8,1263
4100,경기도,4129,시흥시,,정왕1동제3투,2048,841,467,330,16,0,14,0,0,0,0,0,1,2,830,11,1207
4100,경기도,4129,시흥시,,정왕1동제4투,1905,722,420,272,5,0,17,1,0,0,2,0,0,0,717,5,1183
4100,경기도,4129,시흥시,,정왕1동제5투,1787,1087,638,408,16,0,12,0,0,0,2,1,1,0,1078,9,700
4100,경기도,4129,시흥시,,정왕1동제6투,3423,1788,992,705,39,0,21,0,0,0,0,1,0,2,1760,28,1635
4100,경기도,4129,시흥시,정왕2동,소계,24577,16674,9858,6109,386,10,150,3,3,2,12,17,3,10,16563,111,7903
4100,경기도,4129,시흥시,,관내사전투표,5638,5638,3600,1868,109,3,28,0,0,0,4,2,0,1,5615,23,0
4100,경기도,4129,시흥시,,정왕2동제1투,2693,1683,1004,590,55,1,14,1,0,0,0,3,1,1,1670,13,1010
4100,경기도,4129,시흥시,,정왕2동제2투,3831,2493,1359,1007,69,0,24,0,1,0,3,2,0,2,2467,26,1338
4100,경기도,4129,시흥시,,정왕2동제3투,2810,1589,860,640,43,2,28,0,1,1,1,4,0,0,1580,9,1221
4100,경기도,4129,시흥시,,정왕2동제4투,2595,1735,1039,622,41,1,16,1,0,0,1,2,1,1,1725,10,860
4100,경기도,4129,시흥시,,정왕2동제5투,2887,1665,915,689,32,0,12,1,0,1,2,2,0,1,1655,10,1222
4100,경기도,4129,시흥시,,정왕2동제6투,4123,1871,1081,693,37,3,28,0,1,0,1,2,1,4,1851,20,2252
4100,경기도,4129,시흥시,정왕3동,소계,19660,13675,8113,5027,274,7,125,3,1,2,8,11,3,9,13583,92,5985
4100,경기도,4129,시흥시,,관내사전투표,5868,5866,3672,2022,103,0,35,2,0,1,2,4,0,4,5845,21,2
4100,경기도,4129,시흥시,,정왕3동제1투,2638,1594,892,634,34,1,10,0,0,0,1,4,1,0,1577,17,1044
4100,경기도,4129,시흥시,,정왕3동제2투,2685,1646,956,611,43,3,13,0,0,0,4,0,1,2,1633,13,1039
4100,경기도,4129,시흥시,,정왕3동제3투,3480,1935,1127,715,45,2,26,0,0,1,0,1,1,1,1919,16,1545
4100,경기도,4129,시흥시,,정왕3동제4투,2293,1203,695,467,18,0,15,0,0,0,0,1,0,2,1198,5,1090
4100,경기도,4129,시흥시,,정왕3동제5투,2696,1431,771,578,31,1,26,1,1,0,1,1,0,0,1411,20,1265
4100,경기도,4129,시흥시,정왕4동,소계,16116,12288,7223,4572,276,4,96,2,3,0,7,10,1,4,12198,90,3828
4100,경기도,4129,시흥시,,관내사전투표,4935,4935,3141,1643,80,1,35,0,0,0,0,4,0,1,4905,30,0
4100,경기도,4129,시흥시,,정왕4동제1투,2529,1658,887,697,44,0,12,1,0,0,1,0,0,1,1643,15,871
4100,경기도,4129,시흥시,,정왕4동제2투,1850,1243,597,602,22,0,9,0,1,0,2,2,1,0,1236,7,607
4100,경기도,4129,시흥시,,정왕4동제3투,2388,1563,897,587,47,1,14,1,1,0,2,2,0,1,1553,10,825
4100,경기도,4129,시흥시,,정왕4동제4투,2374,1518,875,569,42,1,15,0,0,0,0,2,0,1,1505,13,856
4100,경기도,4129,시흥시,,정왕4동제5투,2040,1371,826,474,41,1,11,0,1,0,2,0,0,0,1356,15,669
4100,경기도,4129,시흥시,과림동,소계,1973,1598,679,874,22,0,7,0,0,0,3,2,0,0,1587,11,375
4100,경기도,4129,시흥시,,관내사전투표,1031,1031,504,498,17,0,5,0,0,0,1,2,0,0,1027,4,0
4100,경기도,4129,시흥시,,과림동투표소,942,567,175,376,5,0,2,0,0,0,2,0,0,0,560,7,375
4100,경기도,4129,시흥시,연성동,소계,18361,13994,8075,5345,357,2,80,1,2,2,13,12,3,4,13896,98,4367
4100,경기도,4129,시흥시,,관내사전투표,4205,4207,2721,1354,99,0,12,0,1,0,0,3,1,2,4193,14,-2
4100,경기도,4129,시흥시,,연성동제1투,2385,1532,829,626,50,1,9,0,0,0,1,0,0,0,1516,16,853
4100,경기도,4129,시흥시,,연성동제2투,3193,2290,1164,1031,56,1,14,1,1,0,3,2,1,0,2274,16,903
4100,경기도,4129,시흥시,,연성동제3투,3335,2357,1387,867,58,0,16,0,0,0,5,3,0,2,2338,19,978
4100,경기도,4129,시흥시,,연성동제4투,2308,1602,889,639,43,0,9,0,0,2,3,4,0,0,1589,13,706
4100,경기도,4129,시흥시,,연성동제5투,1668,1217,615,544,31,0,15,0,0,0,1,0,0,0,1206,11,451
4100,경기도,4129,시흥시,,연성동제6투,1267,789,470,284,20,0,5,0,0,0,0,0,1,0,780,9,478
4100,경기도,4129,시흥시,능곡동,소계,18442,14134,7697,5911,312,4,84,2,1,4,7,15,4,1,14042,92,4308
4100,경기도,4129,시흥시,,관내사전투표,5548,5548,3343,2047,111,1,18,2,1,1,1,4,3,1,5533,15,0
4100,경기도,4129,시흥시,,능곡동제1투,2787,1807,829,908,39,0,16,0,0,1,2,2,1,0,1798,9,980
4100,경기도,4129,시흥시,,능곡동제2투,2963,1927,1030,805,44,2,17,0,0,1,1,2,0,0,1902,25,1036
4100,경기도,4129,시흥시,,능곡동제3투,2427,1564,871,636,27,1,15,0,0,0,0,2,0,0,1552,12,863
4100,경기도,4129,시흥시,,능곡동제4투,2375,1609,823,728,33,0,7,0,0,1,1,3,0,0,1596,13,766
4100,경기도,4129,시흥시,,능곡동제5투,2342,1679,801,787,58,0,11,0,0,0,2,2,0,0,1661,18,663
4100,경기도,4129,시흥시,월곶동,소계,13087,9318,5152,3825,166,6,89,1,4,2,9,11,1,1,9267,51,3769
4100,경기도,4129,시흥시,,관내사전투표,4017,4017,2407,1498,62,3,18,0,0,0,2,5,1,1,3997,20,0
4100,경기도,4129,시흥시,,월곶동제1투,229,152,46,100,4,0,1,0,0,0,1,0,0,0,152,0,77
4100,경기도,4129,시흥시,,월곶동제2투,3487,1990,985,915,37,0,33,0,1,2,2,2,0,0,1977,13,1497
4100,경기도,4129,시흥시,,월곶동제3투,2193,1391,789,543,27,1,23,1,0,0,3,0,0,0,1387,4,802
4100,경기도,4129,시흥시,,월곶동제4투,3161,1768,925,769,36,2,14,0,3,0,1,4,0,0,1754,14,1393
4100,경기도,4129,시흥시,장곡동,소계,23013,17320,9906,6763,420,9,95,1,4,2,5,13,5,8,17231,89,5693
4100,경기도,4129,시흥시,,관내사전투표,6092,6092,3828,2107,109,3,19,1,0,1,0,3,2,5,6078,14,0
4100,경기도,4129,시흥시,,장곡동제1투,2643,1806,956,780,48,2,10,0,0,0,0,1,0,0,1797,9,837
4100,경기도,4129,시흥시,,장곡동제2투,3089,2038,1153,776,68,1,16,0,0,0,1,1,1,1,2018,20,1051
4100,경기도,4129,시흥시,,장곡동제3투,3113,1857,1039,708,61,2,22,0,1,0,1,0,1,0,1835,22,1256
4100,경기도,4129,시흥시,,장곡동제4투,3227,2025,1161,765,59,1,16,0,1,0,3,4,1,0,2011,14,1202
4100,경기도,4129,시흥시,,장곡동제5투,2541,1884,925,894,47,0,5,0,2,1,0,2,0,0,1876,8,657
4100,경기도,4129,시흥시,,장곡동제6투,2308,1618,844,733,28,0,7,0,0,0,0,2,0,2,1616,2,690
4100,경기도,4129,시흥시,배곧1동,소계,24075,18851,11396,6789,423,4,117,0,2,2,10,8,2,11,18764,87,5224
4100,경기도,4129,시흥시,,관내사전투표,6451,6451,4160,2093,144,0,24,0,0,0,2,2,0,2,6427,24,0
4100,경기도,4129,시흥시,,배곧1동제1투,3906,2742,1596,1044,64,1,18,0,2,0,1,0,0,3,2729,13,1164
4100,경기도,4129,시흥시,,배곧1동제2투,2298,1763,994,716,25,0,9,0,0,0,1,1,0,2,1748,15,535
4100,경기도,4129,시흥시,,배곧1동제3투,2489,1728,1030,640,32,0,14,0,0,0,0,2,1,1,1720,8,761
4100,경기도,4129,시흥시,,배곧1동제4투,1692,1179,671,462,29,0,6,0,0,0,1,3,0,1,1173,6,513
4100,경기도,4129,시흥시,,배곧1동제5투,1895,1378,801,509,48,1,13,0,0,0,2,0,1,0,1375,3,517
4100,경기도,4129,시흥시,,배곧1동제6투,2225,1568,945,564,35,1,18,0,0,0,0,0,0,0,1563,5,657
4100,경기도,4129,시흥시,,배곧1동제7투,3119,2042,1199,761,46,1,15,0,0,2,3,0,0,2,2029,13,1077
4100,경기도,4129,시흥시,배곧2동,소계,24510,18279,10452,7156,378,8,137,0,2,1,5,8,0,5,18152,127,6231
4100,경기도,4129,시흥시,,관내사전투표,5429,5429,3354,1935,89,0,22,0,0,0,0,2,0,1,5403,26,0
4100,경기도,4129,시흥시,,배곧2동제1투,3381,2020,1088,852,39,2,20,0,0,0,1,1,0,1,2004,16,1361
4100,경기도,4129,시흥시,,배곧2동제2투,4033,2261,1134,1006,50,1,38,0,1,0,1,0,0,0,2231,30,1772
4100,경기도,4129,시흥시,,배곧2동제3투,2048,1511,885,569,42,0,9,0,0,0,0,0,0,0,1505,6,537
4100,경기도,4129,시흥시,,배곧2동제4투,2070,1574,817,698,39,1,4,0,0,0,0,2,0,0,1561,13,496
4100,경기도,4129,시흥시,,배곧2동제5투,1975,1398,799,545,30,1,10,0,1,0,1,1,0,1,1389,9,577
4100,경기도,4129,시흥시,,배곧2동제6투,1922,1394,778,567,28,0,7,0,0,1,2,0,0,0,1383,11,528
4100,경기도,4129,시흥시,,배곧2동제7투,2134,1540,909,573,39,1,12,0,0,0,0,2,0,0,1536,4,594
4100,경기도,4129,시흥시,,배곧2동제8투,1518,1152,688,411,22,2,15,0,0,0,0,0,0,2,1140,12,366
4100,경기도,4129,시흥시,잘못 투입·구분된 투표지,,0,4,1,1,0,0,0,0,0,0,0,0,0,0,2,2,-4
4100,경기도,4130,군포시,합계,,229884,183089,94891,80277,4593,79,1185,47,24,42,118,120,35,58,181469,1620,46795
4100,경기도,4130,군포시,거소·선상투표,,344,327,146,128,8,1,5,0,1,1,1,0,2,1,294,33,17
4100,경기도,4130,군포시,관외사전투표,,18292,18288,9731,7672,488,9,165,8,2,0,6,23,4,10,18118,170,4
4100,경기도,4130,군포시,재외투표,,1339,1022,587,316,38,0,3,0,0,0,0,0,0,0,944,78,317
4100,경기도,4130,군포시,군포1동,소계,25643,18383,9263,8306,429,16,169,2,4,5,11,12,0,8,18225,158,7260
4100,경기도,4130,군포시,,관내사전투표,5111,5111,2799,2153,86,3,38,1,0,1,0,4,0,2,5087,24,0
4100,경기도,4130,군포시,,군포1동제1투,2818,1634,795,764,33,1,22,0,0,1,3,2,0,1,1622,12,1184
4100,경기도,4130,군포시,,군포1동제2투,3512,1809,884,812,47,1,32,0,1,1,1,1,0,0,1780,29,1703
4100,경기도,4130,군포시,,군포1동제3투,2716,1722,795,835,44,5,21,0,1,0,2,2,0,1,1706,16,994
4100,경기도,4130,군포시,,군포1동제4투,2821,1716,898,706,52,3,26,0,0,1,3,1,0,1,1691,25,1105
4100,경기도,4130,군포시,,군포1동제5투,499,259,106,139,6,0,1,0,0,0,0,0,0,1,253,6,240
4100,경기도,4130,군포시,,군포1동제6투,149,110,50,56,0,0,1,0,0,0,0,0,0,0,107,3,39
4100,경기도,4130,군포시,,군포1동제7투,3549,2618,1269,1254,66,1,8,0,0,1,1,2,0,0,2602,16,931
4100,경기도,4130,군포시,,군포1동제8투,2454,1874,929,861,50,2,10,1,1,0,1,0,0,1,1856,18,580
4100,경기도,4130,군포시,,군포1동제9투,2014,1530,738,726,45,0,10,0,1,0,0,0,0,1,1521,9,484
4100,경기도,4130,군포시,군포2동,소계,34189,27138,14440,11559,691,4,147,11,1,5,18,13,5,7,26901,237,7051
4100,경기도,4130,군포시,,관내사전투표,9157,9157,5396,3486,198,0,24,5,0,1,2,3,2,2,9119,38,0
4100,경기도,4130,군포시,,군포2동제1투,2813,1958,900,972,49,1,7,0,1,1,5,1,0,0,1937,21,855
4100,경기도,4130,군포시,,군포2동제2투,2588,1669,862,721,48,1,18,1,0,0,0,1,0,0,1652,17,919
4100,경기도,4130,군포시,,군포2동제3투,2600,1809,875,839,48,0,16,2,0,0,5,1,1,1,1788,21,791
4100,경기도,4130,군포시,,군포2동제4투,3132,2284,1131,1048,63,0,9,1,0,2,4,0,0,0,2258,26,848
4100,경기도,4130,군포시,,군포2동제5투,2285,1785,955,751,54,1,7,0,0,0,0,0,0,2,1770,15,500
4100,경기도,4130,군포시,,군포2동제6투,2196,1483,773,632,36,0,10,0,0,0,1,1,2,0,1455,28,713
4100,경기도,4130,군포시,,군포2동제7투,3473,2520,1251,1133,90,1,15,0,0,1,1,2,0,1,2495,25,953
4100,경기도,4130,군포시,,군포2동제8투,3167,2332,1302,926,58,0,22,0,0,0,0,0,0,1,2309,23,835
4100,경기도,4130,군포시,,군포2동제9투,1613,1172,579,533,31,0,16,0,0,0,0,2,0,0,1161,11,441
4100,경기도,4130,군포시,,군포2동제10투,1165,969,416,518,16,0,3,2,0,0,0,2,0,0,957,12,196
4100,경기도,4130,군포시,산본1동,소계,13061,9499,4683,4391,227,8,69,2,3,5,9,6,3,4,9410,89,3562
4100,경기도,4130,군포시,,관내사전투표,3648,3647,1966,1547,87,2,21,0,0,0,1,3,1,1,3629,18,1
4100,경기도,4130,군포시,,산본1동제1투,2007,1167,538,566,37,0,10,0,0,1,1,1,0,0,1154,13,840
4100,경기도,4130,군포시,,산본1동제2투,1389,882,364,483,17,1,5,0,0,0,1,0,0,0,871,11,507
4100,경기도,4130,군포시,,산본1동제3투,1747,1058,504,497,20,3,13,0,1,1,1,1,0,1,1042,16,689
4100,경기도,4130,군포시,,산본1동제4투,1934,1263,577,625,28,0,9,0,1,2,4,1,2,0,1249,14,671
4100,경기도,4130,군포시,,산본1동제5투,2336,1482,734,673,38,2,11,2,1,1,1,0,0,2,1465,17,854
4100,경기도,4130,군포시,산본2동,소계,19871,16110,7675,7820,385,9,76,2,1,7,6,6,2,4,15993,117,3761
4100,경기도,4130,군포시,,관내사전투표,5327,5328,2931,2266,94,4,8,2,0,0,1,1,1,0,5308,20,-1
4100,경기도,4130,군포시,,산본2동제1투,2162,1450,611,773,42,1,7,0,0,4,0,0,0,0,1438,12,712
4100,경기도,4130,군포시,,산본2동제2투,1681,1156,571,534,28,1,11,0,0,0,2,1,0,0,1148,8,525
4100,경기도,4130,군포시,,산본2동제3투,2246,1693,829,790,42,0,12,0,0,1,1,2,0,2,1679,14,553
4100,경기도,4130,군포시,,산본2동제4투,1842,1385,583,734,44,1,6,0,0,2,1,0,0,0,1371,14,457
4100,경기도,4130,군포시,,산본2동제5투,1890,1388,668,656,37,0,10,0,0,0,0,0,0,0,1371,17,502
4100,경기도,4130,군포시,,산본2동제6투,2201,1688,718,899,46,0,10,0,1,0,0,1,0,1,1676,12,513
4100,경기도,4130,군포시,,산본2동제7투,2522,2022,764,1168,52,2,12,0,0,0,1,1,1,1,2002,20,500
4100,경기도,4130,군포시,금정동,소계,15067,10863,5696,4694,242,3,101,4,3,3,12,6,3,3,10770,93,4204
4100,경기도,4130,군포시,,관내사전투표,4346,4346,2496,1704,98,2,20,1,1,1,4,2,0,1,4330,16,0
4100,경기도,4130,군포시,,금정동제1투,2523,1525,729,708,53,0,15,2,1,0,1,0,0,0,1509,16,998
4100,경기도,4130,군포시,,금정동제2투,2908,1741,900,758,31,0,27,1,0,1,0,3,1,0,1722,19,1167
4100,경기도,4130,군포시,,금정동제3투,3128,1914,946,881,33,0,23,0,0,1,6,1,2,2,1895,19,1214
4100,경기도,4130,군포시,,금정동제4투,2162,1337,625,643,27,1,16,0,1,0,1,0,0,0,1314,23,825
4100,경기도,4130,군포시,재궁동,소계,16633,12987,6799,5603,334,6,86,1,0,3,11,11,3,3,12860,127,3646
4100,경기도,4130,군포시,,관내사전투표,5551,5550,3227,2117,133,3,25,0,0,0,0,7,0,1,5513,37,1
4100,경기도,4130,군포시,,재궁동제1투,2481,1763,822,853,37,2,19,0,0,0,1,1,1,0,1736,27,718
4100,경기도,4130,군포시,,재궁동제2투,2299,1504,796,632,40,0,11,0,0,1,5,1,2,1,1489,15,795
4100,경기도,4130,군포시,,재궁동제3투,2231,1475,684,711,40,1,13,0,0,0,3,1,0,0,1453,22,756
4100,경기도,4130,군포시,,재궁동제4투,2305,1579,709,782,59,0,11,1,0,2,0,1,0,0,1565,14,726
4100,경기도,4130,군포시,,재궁동제5투,1766,1116,561,508,25,0,7,0,0,0,2,0,0,1,1104,12,650
4100,경기도,4130,군포시,오금동,소계,16335,13121,6923,5654,337,6,62,3,2,3,7,7,3,3,13010,111,3214
4100,경기도,4130,군포시,,관내사전투표,4412,4412,2541,1749,79,1,8,2,0,0,2,1,1,1,4385,27,0
4100,경기도,4130,군포시,,오금동제1투,2622,1880,859,936,42,1,14,0,1,1,1,1,1,1,1858,22,742
4100,경기도,4130,군포시,,오금동제2투,2600,1869,926,857,54,1,11,1,0,0,1,1,1,0,1853,16,731
4100,경기도,4130,군포시,,오금동제3투,2069,1342,628,636,46,0,9,0,0,0,2,2,0,0,1323,19,727
4100,경기도,4130,군포시,,오금동제4투,1697,1297,657,579,37,0,12,0,0,2,0,1,0,0,1288,9,400
4100,경기도,4130,군포시,,오금동제5투,2935,2321,1312,897,79,3,8,0,1,0,1,1,0,1,2303,18,614
4100,경기도,4130,군포시,수리동,소계,12862,10216,5166,4624,270,1,53,7,0,2,7,7,3,3,10143,73,2646
4100,경기도,4130,군포시,,관내사전투표,3730,3730,2117,1513,70,0,10,4,0,0,2,1,0,1,3718,12,0
4100,경기도,4130,군포시,,수리동제1투,1750,1268,508,696,40,0,4,0,0,1,2,4,1,0,1256,12,482
4100,경기도,4130,군포시,,수리동제2투,1664,1222,536,625,41,1,4,0,0,0,0,0,0,0,1207,15,442
4100,경기도,4130,군포시,,수리동제3투,1780,1315,671,573,44,0,12,0,0,1,2,1,1,1,1306,9,465
4100,경기도,4130,군포시,,수리동제4투,2029,1490,732,678,48,0,11,2,0,0,1,0,1,0,1473,17,539
4100,경기도,4130,군포시,,수리동제5투,1909,1191,602,539,27,0,12,1,0,0,0,1,0,1,1183,8,718
4100,경기도,4130,군포시,궁내동,소계,14861,12230,6359,5389,332,2,47,0,2,2,7,8,2,3,12153,77,2631
4100,경기도,4130,군포시,,관내사전투표,5206,5204,3063,1993,109,2,11,0,0,2,1,3,1,2,5187,17,2
4100,경기도,4130,군포시,,궁내동제1투,1564,985,491,449,28,0,9,0,0,0,0,2,0,0,979,6,579
4100,경기도,4130,군포시,,궁내동제2투,1904,1422,608,743,48,0,10,0,0,0,0,1,0,1,1411,11,482
4100,경기도,4130,군포시,,궁내동제3투,2122,1590,711,806,46,0,4,0,1,0,2,1,1,0,1572,18,532
4100,경기도,4130,군포시,,궁내동제4투,2320,1753,826,838,69,0,3,0,1,0,2,1,0,0,1740,13,567
4100,경기도,4130,군포시,,궁내동제5투,1745,1276,660,560,32,0,10,0,0,0,2,0,0,0,1264,12,469
4100,경기도,4130,군포시,광정동,소계,18629,14607,7287,6721,356,8,76,3,5,4,7,5,2,5,14479,128,4022
4100,경기도,4130,군포시,,관내사전투표,5014,5014,2892,1977,106,1,20,0,0,0,2,2,0,1,5001,13,0
4100,경기도,4130,군포시,,광정동제1투,3169,1831,820,899,57,3,19,1,2,1,0,1,0,2,1805,26,1338
4100,경기도,4130,군포시,,광정동제2투,1868,1116,507,544,32,1,11,2,0,0,1,0,1,0,1099,17,752
4100,경기도,4130,군포시,,광정동제3투,2936,2198,975,1135,60,0,3,0,0,1,2,1,0,1,2178,20,738
4100,경기도,4130,군포시,,광정동제4투,1457,1151,508,584,26,1,10,0,2,2,2,1,1,0,1137,14,306
4100,경기도,4130,군포시,,광정동제5투,1488,1204,525,634,30,0,3,0,0,0,0,0,0,0,1192,12,284
4100,경기도,4130,군포시,,광정동제6투,2697,2093,1060,948,45,2,10,0,1,0,0,0,0,1,2067,26,604
4100,경기도,4130,군포시,대야동,소계,7943,6463,3544,2658,147,5,46,1,0,0,9,5,2,1,6418,45,1480
4100,경기도,4130,군포시,,관내사전투표,3466,3466,2100,1254,74,2,15,0,0,0,1,4,2,1,3453,13,0
4100,경기도,4130,군포시,,대야동제1투,2195,1475,737,650,39,0,20,1,0,0,3,0,0,0,1450,25,720
4100,경기도,4130,군포시,,대야동제2투,2282,1522,707,754,34,3,11,0,0,0,5,1,0,0,1515,7,760
4100,경기도,4130,군포시,송부동,소계,14815,11832,6591,4740,309,1,80,3,0,2,7,11,1,3,11748,84,2983
4100,경기도,4130,군포시,,관내사전투표,3954,3954,2423,1397,98,1,14,0,0,1,0,3,0,0,3937,17,0
4100,경기도,4130,군포시,,송부동제1투,3535,2446,1275,1069,55,0,22,0,0,1,4,3,1,0,2430,16,1089
4100,경기도,4130,군포시,,송부동제2투,1653,1329,723,553,31,0,2,3,0,0,0,2,0,1,1315,14,324
4100,경기도,4130,군포시,,송부동제3투,2469,1805,910,799,60,0,12,0,0,0,1,2,0,1,1785,20,664
4100,경기도,4130,군포시,,송부동제4투,1551,1114,580,481,37,0,9,0,0,0,0,0,0,0,1107,7,437
4100,경기도,4130,군포시,,송부동제5투,1653,1184,680,441,28,0,21,0,0,0,2,1,0,1,1174,10,469
4100,경기도,4130,군포시,잘못 투입·구분된 투표지,,0,3,1,2,0,0,0,0,0,0,0,0,0,0,3,0,-3
4100,경기도,4131,하남시,합계,,265087,208858,101106,100088,4624,81,1025,39,27,35,114,156,37,39,207371,1487,56229
4100,경기도,4131,하남시,거소·선상투표,,384,361,125,174,6,1,7,1,0,1,0,1,0,0,316,45,23
4100,경기도,4131,하남시,관외사전투표,,29968,29962,15096,13718,673,20,174,6,4,4,9,29,2,4,29739,223,6
4100,경기도,4131,하남시,재외투표,,1488,1092,622,353,24,2,2,0,0,0,1,0,0,0,1004,88,396
4100,경기도,4131,하남시,천현동,소계,6158,4366,1755,2493,56,2,26,0,0,1,4,3,0,0,4340,26,1792
4100,경기도,4131,하남시,,관내사전투표,2037,2037,908,1072,30,1,9,0,0,1,0,3,0,0,2024,13,0
4100,경기도,4131,하남시,,천현동제1투,1563,889,305,554,14,0,12,0,0,0,2,0,0,0,887,2,674
4100,경기도,4131,하남시,,천현동제2투,1604,876,365,491,9,0,4,0,0,0,1,0,0,0,870,6,728
4100,경기도,4131,하남시,,천현동제3투,954,564,177,376,3,1,1,0,0,0,1,0,0,0,559,5,390
4100,경기도,4131,하남시,신장1동,소계,7606,5842,2834,2792,100,2,52,1,4,3,6,9,5,1,5809,33,1764
4100,경기도,4131,하남시,,관내사전투표,3812,3810,1947,1746,60,2,24,1,2,0,0,8,3,1,3794,16,2
4100,경기도,4131,하남시,,신장1동제1투,1405,747,312,399,18,0,6,0,1,1,3,0,0,0,740,7,658
4100,경기도,4131,하남시,,신장1동제2투,2389,1285,575,647,22,0,22,0,1,2,3,1,2,0,1275,10,1104
4100,경기도,4131,하남시,신장2동,소계,34707,26393,11836,13681,520,11,124,3,3,5,14,16,2,9,26224,169,8314
4100,경기도,4131,하남시,,관내사전투표,8466,8465,4310,3951,135,2,20,2,0,1,1,4,0,3,8429,36,1
4100,경기도,4131,하남시,,신장2동제1투,2386,1335,570,723,21,2,6,0,0,0,1,1,0,0,1324,11,1051
4100,경기도,4131,하남시,,신장2동제2투,1822,1002,379,590,15,1,6,0,0,0,4,1,0,1,997,5,820
4100,경기도,4131,하남시,,신장2동제3투,1924,1148,520,574,29,1,13,0,0,0,0,1,0,0,1138,10,776
4100,경기도,4131,하남시,,신장2동제4투,1365,865,339,491,17,1,8,0,0,0,0,0,0,0,856,9,500
4100,경기도,4131,하남시,,신장2동제5투,2070,1595,593,944,39,0,10,0,0,0,2,2,0,0,1590,5,475
4100,경기도,4131,하남시,,신장2동제6투,2088,1604,690,853,37,0,8,0,0,0,1,0,0,1,1590,14,484
4100,경기도,4131,하남시,,신장2동제7투,2010,1491,623,817,29,0,9,0,0,1,1,1,0,1,1482,9,519
4100,경기도,4131,하남시,,신장2동제8투,2971,2072,911,1083,41,1,7,0,0,1,4,0,1,1,2050,22,899
4100,경기도,4131,하남시,,신장2동제9투,3197,2318,938,1300,46,1,14,1,0,1,0,5,1,1,2308,10,879
4100,경기도,4131,하남시,,신장2동제10투,2542,1820,734,1014,46,2,9,0,2,1,0,0,0,0,1808,12,722
4100,경기도,4131,하남시,,신장2동제11투,3866,2678,1229,1341,65,0,14,0,1,0,0,1,0,1,2652,26,1188
4100,경기도,4131,하남시,덕풍1동,소계,12444,9351,4510,4506,179,2,53,3,1,3,7,15,3,2,9284,67,3093
4100,경기도,4131,하남시,,관내사전투표,4348,4348,2309,1916,80,1,11,1,0,2,0,7,1,2,4330,18,0
4100,경기도,4131,하남시,,덕풍1동제1투,2446,1503,690,742,32,0,13,2,1,0,4,4,1,0,1489,14,943
4100,경기도,4131,하남시,,덕풍1동제2투,1594,1046,431,566,31,0,7,0,0,0,1,0,0,0,1036,10,548
4100,경기도,4131,하남시,,덕풍1동제3투,1840,981,445,494,13,0,11,0,0,1,1,3,1,0,969,12,859
4100,경기도,4131,하남시,,덕풍1동제4투,2216,1473,635,788,23,1,11,0,0,0,1,1,0,0,1460,13,743
4100,경기도,4131,하남시,덕풍2동,소계,15599,11340,5415,5512,224,7,79,3,0,0,10,12,3,3,11268,72,4259
4100,경기도,4131,하남시,,관내사전투표,5115,5115,2669,2327,65,2,25,1,0,0,2,6,0,1,5098,17,0
4100,경기도,4131,하남시,,덕풍2동제1투,1816,1115,451,611,32,0,11,2,0,0,1,0,0,0,1108,7,701
4100,경기도,4131,하남시,,덕풍2동제2투,1583,835,367,436,16,0,3,0,0,0,0,1,2,0,825,10,748
4100,경기도,4131,하남시,,덕풍2동제3투,1801,1031,490,485,30,3,11,0,0,0,0,3,0,2,1024,7,770
4100,경기도,4131,하남시,,덕풍2동제4투,1615,821,370,406,19,1,13,0,0,0,3,1,0,0,813,8,794
4100,경기도,4131,하남시,,덕풍2동제5투,2059,1274,591,625,34,0,9,0,0,0,3,1,0,0,1263,11,785
4100,경기도,4131,하남시,,덕풍2동제6투,1610,1149,477,622,28,1,7,0,0,0,1,0,1,0,1137,12,461
4100,경기도,4131,하남시,덕풍3동,소계,19525,14730,7021,7188,329,5,74,1,1,2,14,9,3,4,14651,79,4795
4100,경기도,4131,하남시,,관내사전투표,5730,5730,3077,2516,101,0,19,0,0,0,2,2,3,0,5720,10,0
4100,경기도,4131,하남시,,덕풍3동제1투,2187,1621,678,879,39,0,11,0,0,1,0,2,0,0,1610,11,566
4100,경기도,4131,하남시,,덕풍3동제2투,3146,2105,1022,990,56,3,14,0,0,0,0,1,0,1,2087,18,1041
4100,경기도,4131,하남시,,덕풍3동제3투,2479,1407,596,740,39,1,11,0,0,0,7,2,0,0,1396,11,1072
4100,경기도,4131,하남시,,덕풍3동제4투,3674,2370,1007,1279,51,0,9,0,0,0,1,2,0,2,2351,19,1304
4100,경기도,4131,하남시,,덕풍3동제5투,2309,1497,641,784,43,1,10,1,1,1,4,0,0,1,1487,10,812
4100,경기도,4131,하남시,풍산동,소계,18834,14587,7384,6705,326,3,53,2,3,2,2,7,3,3,14493,94,4247
4100,경기도,4131,하남시,,관내사전투표,4811,4811,2779,1912,85,1,14,2,0,1,0,0,0,0,4794,17,0
4100,경기도,4131,하남시,,풍산동제1투,3086,1817,807,934,49,1,12,0,0,1,0,0,0,1,1805,12,1269
4100,경기도,4131,하남시,,풍산동제2투,2889,2145,956,1112,51,0,6,0,0,0,1,0,1,1,2128,17,744
4100,경기도,4131,하남시,,풍산동제3투,2910,2170,903,1191,48,0,5,0,0,0,0,2,0,1,2150,20,740
4100,경기도,4131,하남시,,풍산동제4투,2489,1771,1059,641,44,1,10,0,2,0,0,1,2,0,1760,11,718
4100,경기도,4131,하남시,,풍산동제5투,2649,1873,880,915,49,0,6,0,1,0,1,4,0,0,1856,17,776
4100,경기도,4131,하남시,감북동,소계,2670,2117,897,1138,52,1,11,0,0,1,1,2,1,0,2104,13,553
4100,경기도,4131,하남시,,관내사전투표,1230,1230,612,573,32,1,4,0,0,0,1,1,1,0,1225,5,0
4100,경기도,4131,하남시,,감북동투표소,1440,887,285,565,20,0,7,0,0,1,0,1,0,0,879,8,553
4100,경기도,4131,하남시,춘궁동,소계,3574,2752,1020,1658,43,0,15,0,0,1,2,5,1,1,2746,6,822
4100,경기도,4131,하남시,,관내사전투표,1607,1607,701,874,22,0,4,0,0,0,0,3,0,1,1605,2,0
4100,경기도,4131,하남시,,춘궁동투표소,1967,1145,319,784,21,0,11,0,0,1,2,2,1,0,1141,4,822
4100,경기도,4131,하남시,초이동,소계,2931,2145,905,1171,36,0,15,0,0,0,2,0,0,0,2129,16,786
4100,경기도,4131,하남시,,관내사전투표,1133,1133,560,539,17,0,8,0,0,0,0,0,0,0,1124,9,0
4100,경기도,4131,하남시,,초이동투표소,1798,1012,345,632,19,0,7,0,0,0,2,0,0,0,1005,7,786
4100,경기도,4131,하남시,미사1동,소계,38018,27534,13975,12398,741,8,138,6,4,6,14,12,6,4,27312,222,10484
4100,경기도,4131,하남시,,관내사전투표,8986,8986,5080,3636,190,1,26,3,2,0,5,2,3,1,8949,37,0
4100,경기도,4131,하남시,,미사1동제1투,3593,1897,907,867,75,0,18,1,0,0,1,0,1,1,1871,26,1696
4100,경기도,4131,하남시,,미사1동제2투,2262,1421,700,648,34,3,12,0,0,0,2,3,1,0,1403,18,841
4100,경기도,4131,하남시,,미사1동제3투,2984,2187,1065,1033,57,1,10,0,1,2,2,2,0,1,2174,13,797
4100,경기도,4131,하남시,,미사1동제4투,2190,1687,884,731,57,1,3,1,0,1,0,1,0,0,1679,8,503
4100,경기도,4131,하남시,,미사1동제5투,3084,2222,1048,1089,57,0,10,0,0,1,2,2,0,0,2209,13,862
4100,경기도,4131,하남시,,미사1동제6투,3465,2419,1268,1040,77,1,14,1,0,1,1,1,1,0,2405,14,1046
4100,경기도,4131,하남시,,미사1동제7투,3891,1934,894,921,59,1,19,0,0,0,0,1,0,1,1896,38,1957
4100,경기도,4131,하남시,,미사1동제8투,4406,2899,1229,1561,74,0,9,0,1,1,1,0,0,0,2876,23,1507
4100,경기도,4131,하남시,,미사1동제9투,3157,1882,900,872,61,0,17,0,0,0,0,0,0,0,1850,32,1275
4100,경기도,4131,하남시,미사2동,소계,33056,25920,13427,11604,584,11,88,10,4,3,15,18,5,4,25773,147,7136
4100,경기도,4131,하남시,,관내사전투표,9070,9070,5201,3638,161,4,30,3,0,2,0,5,0,4,9048,22,0
4100,경기도,4131,하남시,,미사2동제1투,2429,1388,613,708,30,0,12,1,1,0,3,1,0,0,1369,19,1041
4100,경기도,4131,하남시,,미사2동제2투,2751,2015,1063,865,65,0,4,0,0,0,1,1,0,0,1999,16,736
4100,경기도,4131,하남시,,미사2동제3투,4569,3011,1468,1402,76,3,23,3,1,0,4,6,0,0,2986,25,1558
4100,경기도,4131,하남시,,미사2동제4투,2591,1989,969,962,42,1,2,0,0,0,0,2,0,0,1978,11,602
4100,경기도,4131,하남시,,미사2동제5투,3366,2563,1219,1251,65,1,5,1,1,1,1,1,1,0,2547,16,803
4100,경기도,4131,하남시,,미사2동제6투,4127,2972,1508,1372,60,1,10,0,1,0,2,1,3,0,2958,14,1155
4100,경기도,4131,하남시,,미사2동제7투,2341,1645,782,803,42,1,0,0,0,0,1,1,1,0,1631,14,696
4100,경기도,4131,하남시,,미사2동제8투,1812,1267,604,603,43,0,2,2,0,0,3,0,0,0,1257,10,545
4100,경기도,4131,하남시,위례동,소계,17810,14331,5899,7974,325,4,36,1,3,0,5,1,1,0,14249,82,3479
4100,경기도,4131,하남시,,관내사전투표,5255,5255,2402,2741,89,1,7,1,0,0,1,0,0,0,5242,13,0
4100,경기도,4131,하남시,,위례동제1투,1641,1203,617,534,37,0,3,0,1,0,1,0,0,0,1193,10,438
4100,경기도,4131,하남시,,위례동제2투,3357,2427,861,1481,55,0,10,0,1,0,2,0,0,0,2410,17,930
4100,경기도,4131,하남시,,위례동제3투,2338,1727,605,1053,53,0,6,0,0,0,0,0,0,0,1717,10,611
4100,경기도,4131,하남시,,위례동제4투,2444,1639,555,1021,41,2,6,0,0,0,1,0,0,0,1626,13,805
4100,경기도,4131,하남시,,위례동제5투,2775,2080,859,1144,50,1,4,0,1,0,0,1,1,0,2061,19,695
4100,경기도,4131,하남시,감일동,소계,20315,16033,8383,7023,406,2,78,2,0,3,8,17,2,4,15928,105,4282
4100,경기도,4131,하남시,,관내사전투표,6513,6513,3841,2496,126,2,15,0,0,0,1,5,1,1,6488,25,0
4100,경기도,4131,하남시,,감일동제1투,2083,1544,703,773,44,0,9,0,0,0,0,2,0,1,1532,12,539
4100,경기도,4131,하남시,,감일동제2투,3179,2063,1040,920,57,0,24,0,0,1,3,0,0,0,2045,18,1116
4100,경기도,4131,하남시,,감일동제3투,2900,2056,1002,926,76,0,13,2,0,2,2,3,0,0,2026,30,844
4100,경기도,4131,하남시,,감일동제4투,3214,2124,987,1032,67,0,15,0,0,0,1,7,1,0,2110,14,1090
4100,경기도,4131,하남시,,감일동제5투,2426,1733,810,876,36,0,2,0,0,0,1,0,0,2,1727,6,693
4100,경기도,4131,하남시,잘못 투입·구분된 투표지,,0,2,2,0,0,0,0,0,0,0,0,0,0,0,2,0,-2
4100,경기도,4132,파주시,합계,,401260,297278,157155,126763,7176,154,2566,98,45,88,211,342,84,119,294801,2477,103982
4100,경기도,4132,파주시,거소·선상투표,,1298,1200,447,509,33,1,50,2,2,0,2,6,2,1,1055,145,98
4100,경기도,4132,파주시,관외사전투표,,30562,30553,16217,12826,784,21,299,9,9,10,17,74,10,14,30290,263,9
4100,경기도,4132,파주시,재외투표,,1951,1376,822,393,41,0,4,0,0,2,5,0,0,0,1267,109,575
4100,경기도,4132,파주시,문산읍,소계,36465,24748,12566,11038,551,10,280,8,3,14,18,34,13,14,24549,199,11717
4100,경기도,4132,파주시,,관내사전투표,8448,8448,4746,3384,153,2,82,2,1,1,3,17,6,4,8401,47,0
4100,경기도,4132,파주시,,문산읍제1투,2407,1510,663,792,26,0,11,0,0,1,3,0,1,1,1498,12,897
4100,경기도,4132,파주시,,문산읍제2투,4102,2486,1271,1090,75,0,30,0,0,0,0,1,1,0,2468,18,1616
4100,경기도,4132,파주시,,문산읍제3투,3312,1782,827,863,43,1,19,0,1,2,3,4,0,2,1765,17,1530
4100,경기도,4132,파주시,,문산읍제4투,2803,1461,757,619,49,0,19,0,1,1,2,1,1,0,1450,11,1342
4100,경기도,4132,파주시,,문산읍제5투,3159,1707,868,752,35,2,28,1,0,1,2,3,1,1,1694,13,1452
4100,경기도,4132,파주시,,문산읍제6투,758,520,215,285,10,1,4,0,0,0,0,0,0,0,515,5,238
4100,경기도,4132,파주시,,문산읍제7투,866,586,199,366,10,1,4,0,0,0,0,0,1,0,581,5,280
4100,경기도,4132,파주시,,문산읍제8투,608,376,143,205,6,1,2,2,0,0,1,1,0,1,362,14,232
4100,경기도,4132,파주시,,문산읍제9투,2335,1320,618,626,40,0,19,0,0,2,1,0,2,0,1308,12,1015
4100,경기도,4132,파주시,,문산읍제10투,1471,887,380,474,17,0,9,0,0,0,0,1,0,2,883,4,584
4100,경기도,4132,파주시,,문산읍제11투,3055,1811,939,770,35,2,24,3,0,5,3,6,0,2,1789,22,1244
4100,경기도,4132,파주시,,문산읍제12투,3141,1854,940,812,52,0,29,0,0,1,0,0,0,1,1835,19,1287
4100,경기도,4132,파주시,조리읍,소계,23799,16927,8414,7838,352,4,146,5,3,5,11,18,4,3,16803,124,6872
4100,경기도,4132,파주시,,관내사전투표,5378,5378,2970,2243,96,0,24,1,0,0,2,9,0,1,5346,32,0
4100,경기도,4132,파주시,,조리읍제1투,3307,2324,1056,1164,51,0,19,0,1,1,4,1,0,0,2297,27,983
4100,경기도,4132,파주시,,조리읍제2투,2597,1536,777,703,29,0,14,0,1,0,0,2,1,0,1527,9,1061
4100,경기도,4132,파주시,,조리읍제3투,1732,1120,537,524,23,2,20,0,0,1,1,0,0,1,1109,11,612
4100,경기도,4132,파주시,,조리읍제4투,2732,1938,934,908,59,1,20,2,1,0,0,0,2,0,1927,11,794
4100,경기도,4132,파주시,,조리읍제5투,1411,662,286,354,11,0,5,0,0,0,0,0,0,0,656,6,749
4100,경기도,4132,파주시,,조리읍제6투,2706,1646,860,723,39,0,11,0,0,0,0,5,0,0,1638,8,1060
4100,경기도,4132,파주시,,조리읍제7투,1516,846,337,471,16,0,16,0,0,0,0,0,0,0,840,6,670
4100,경기도,4132,파주시,,조리읍제8투,1277,764,354,372,12,0,8,0,0,3,3,1,0,1,754,10,513
4100,경기도,4132,파주시,,조리읍제9투,1143,713,303,376,16,1,9,2,0,0,1,0,1,0,709,4,430
4100,경기도,4132,파주시,법원읍,소계,9134,6389,2715,3328,146,3,84,4,1,2,7,13,5,5,6313,76,2745
4100,경기도,4132,파주시,,관내사전투표,2651,2651,1251,1248,57,2,38,2,1,2,1,5,2,4,2613,38,0
4100,경기도,4132,파주시,,법원읍제1투,1410,766,313,393,23,0,13,0,0,0,4,6,1,0,753,13,644
4100,경기도,4132,파주시,,법원읍제2투,496,282,104,163,8,0,2,1,0,0,0,0,0,0,278,4,214
4100,경기도,4132,파주시,,법원읍제3투,582,391,135,238,13,0,2,0,0,0,0,0,1,0,389,2,191
4100,경기도,4132,파주시,,법원읍제4투,1446,854,352,458,14,0,17,1,0,0,1,0,0,0,843,11,592
4100,경기도,4132,파주시,,법원읍제5투,1126,580,209,348,12,0,5,0,0,0,0,0,1,0,575,5,546
4100,경기도,4132,파주시,,법원읍제6투,1423,865,351,480,19,1,7,0,0,0,1,2,0,1,862,3,558
4100,경기도,4132,파주시,파주읍,소계,11569,7807,3532,3899,159,10,108,2,1,1,5,5,4,7,7733,74,3762
4100,경기도,4132,파주시,,관내사전투표,3110,3110,1527,1455,53,4,37,0,0,0,2,2,1,3,3084,26,0
4100,경기도,4132,파주시,,파주읍제1투,2349,1200,480,665,21,2,15,1,0,1,1,1,0,1,1188,12,1149
4100,경기도,4132,파주시,,파주읍제2투,1960,1082,531,494,21,0,19,0,0,0,1,0,0,0,1066,16,878
4100,경기도,4132,파주시,,파주읍제3투,777,470,193,246,13,2,4,0,1,0,0,0,2,1,462,8,307
4100,경기도,4132,파주시,,파주읍제4투,910,554,227,293,18,0,9,1,0,0,0,0,0,1,549,5,356
4100,경기도,4132,파주시,,파주읍제5투,768,423,142,261,13,0,5,0,0,0,0,0,0,0,421,2,345
4100,경기도,4132,파주시,,파주읍제6투,1695,968,432,485,20,2,19,0,0,0,1,2,1,1,963,5,727
4100,경기도,4132,파주시,광탄면,소계,9892,6996,2943,3735,172,5,68,1,0,3,9,6,1,2,6945,51,2896
4100,경기도,4132,파주시,,관내사전투표,3294,3291,1573,1587,75,3,28,0,0,2,2,2,1,1,3274,17,3
4100,경기도,4132,파주시,,광탄면제1투,2116,1086,428,596,30,1,12,0,0,0,4,2,0,0,1073,13,1030
4100,경기도,4132,파주시,,광탄면제2투,1529,874,309,529,20,1,6,0,0,1,1,0,0,0,867,7,655
4100,경기도,4132,파주시,,광탄면제3투,814,548,178,345,17,0,5,0,0,0,0,1,0,0,546,2,266
4100,경기도,4132,파주시,,광탄면제4투,1006,522,197,295,11,0,8,1,0,0,2,1,0,1,516,6,484
4100,경기도,4132,파주시,,광탄면제5투,1133,675,258,383,19,0,9,0,0,0,0,0,0,0,669,6,458
4100,경기도,4132,파주시,탄현면,소계,11461,8250,4126,3777,181,9,69,2,2,2,5,8,2,6,8189,61,3211
4100,경기도,4132,파주시,,관내사전투표,3313,3313,1871,1340,59,3,19,1,1,0,1,2,0,2,3299,14,0
4100,경기도,4132,파주시,,탄현면제1투,1235,620,194,396,15,0,5,0,0,0,0,0,0,0,610,10,615
4100,경기도,4132,파주시,,탄현면제2투,1042,635,241,348,17,0,10,1,1,0,1,2,1,2,624,11,407
4100,경기도,4132,파주시,,탄현면제3투,974,578,207,345,9,0,10,0,0,0,0,0,1,0,572,6,396
4100,경기도,4132,파주시,,탄현면제4투,1962,1218,611,541,36,3,15,0,0,1,1,2,0,1,1211,7,744
4100,경기도,4132,파주시,,탄현면제5투,2935,1886,1002,807,45,3,10,0,0,1,2,2,0,1,1873,13,1049
4100,경기도,4132,파주시,월롱면,소계,8968,6135,2782,3043,132,3,83,1,2,1,4,5,2,6,6064,71,2833
4100,경기도,4132,파주시,,관내사전투표,2985,2985,1609,1258,64,1,38,0,0,0,1,2,0,1,2974,11,0
4100,경기도,4132,파주시,,월롱면제1투,914,495,152,325,7,0,5,0,1,0,0,0,1,2,493,2,419
4100,경기도,4132,파주시,,월롱면제2투,1414,644,256,346,12,1,12,0,0,0,1,1,0,2,631,13,770
4100,경기도,4132,파주시,,월롱면제3투,1352,785,337,404,16,0,13,0,1,0,1,2,1,1,776,9,567
4100,경기도,4132,파주시,,월롱면제4투,1060,489,177,281,9,0,8,0,0,1,1,0,0,0,477,12,571
4100,경기도,4132,파주시,,월롱면제5투,1243,737,251,429,24,1,7,1,0,0,0,0,0,0,713,24,506
4100,경기도,4132,파주시,적성면,소계,5950,4291,1590,2491,83,2,45,1,2,1,2,7,5,3,4232,59,1659
4100,경기도,4132,파주시,,관내사전투표,1835,1835,753,989,32,2,20,0,0,1,0,6,3,2,1808,27,0
4100,경기도,4132,파주시,,적성면제1투,1949,1056,413,578,30,0,10,1,1,0,2,1,0,1,1037,19,893
4100,경기도,4132,파주시,,적성면제2투,446,295,84,204,3,0,2,0,0,0,0,0,0,0,293,2,151
4100,경기도,4132,파주시,,적성면제3투,753,479,137,329,7,0,3,0,0,0,0,0,0,0,476,3,274
4100,경기도,4132,파주시,,적성면제4투,457,265,102,150,5,0,5,0,0,0,0,0,1,0,263,2,192
4100,경기도,4132,파주시,,적성면제5투,510,361,101,241,6,0,5,0,1,0,0,0,1,0,355,6,149
4100,경기도,4132,파주시,파평면,소계,3763,2829,1134,1547,83,1,29,1,1,1,2,3,4,4,2810,19,934
4100,경기도,4132,파주시,,관내사전투표,1237,1237,549,618,42,1,12,0,0,0,1,0,1,2,1226,11,0
4100,경기도,4132,파주시,,파평면제1투,307,167,55,98,8,0,2,0,0,0,0,0,0,1,164,3,140
4100,경기도,4132,파주시,,파평면제2투,339,216,83,124,4,0,1,0,0,0,0,2,0,0,214,2,123
4100,경기도,4132,파주시,,파평면제3투,341,199,62,129,3,0,2,0,0,1,0,0,1,0,198,1,142
4100,경기도,4132,파주시,,파평면제4투,662,445,187,233,14,0,7,0,0,0,0,1,2,0,444,1,217
4100,경기도,4132,파주시,,파평면제5투,444,274,93,171,5,0,2,0,1,0,0,0,0,1,273,1,170
4100,경기도,4132,파주시,,파평면제6투,433,291,105,174,7,0,3,1,0,0,1,0,0,0,291,0,142
4100,경기도,4132,파주시,교하동,소계,36293,26370,14544,10767,637,8,181,16,0,4,16,28,4,6,26211,159,9923
4100,경기도,4132,파주시,,관내사전투표,5654,5653,3432,2078,98,2,12,1,0,0,3,6,1,0,5633,20,1
4100,경기도,4132,파주시,,교하동제1투,2005,1161,480,624,31,0,12,1,0,0,0,1,0,2,1151,10,844
4100,경기도,4132,파주시,,교하동제2투,2952,2045,1050,922,39,0,13,1,0,1,1,1,0,1,2029,16,907
4100,경기도,4132,파주시,,교하동제3투,3004,1811,1001,735,38,1,13,0,0,0,4,5,1,1,1799,12,1193
4100,경기도,4132,파주시,,교하동제4투,1335,851,353,458,24,1,4,0,0,0,3,2,0,1,846,5,484
4100,경기도,4132,파주시,,교하동제5투,2468,1509,832,610,36,2,11,0,0,1,0,3,0,0,1495,14,959
4100,경기도,4132,파주시,,교하동제6투,2379,1665,850,745,48,0,8,0,0,0,1,1,0,0,1653,12,714
4100,경기도,4132,파주시,,교하동제7투,2254,1644,855,718,45,1,13,1,0,0,0,1,1,0,1635,9,610
4100,경기도,4132,파주시,,교하동제8투,2365,1678,918,685,43,0,9,4,0,0,1,3,0,0,1663,15,687
4100,경기도,4132,파주시,,교하동제9투,1876,1364,829,472,41,0,14,2,0,0,0,0,0,0,1358,6,512
4100,경기도,4132,파주시,,교하동제10투,2852,1939,1089,789,34,0,13,4,0,1,1,0,0,0,1931,8,913
4100,경기도,4132,파주시,,교하동제11투,2884,2002,1184,715,53,1,31,1,0,0,0,1,0,0,1986,16,882
4100,경기도,4132,파주시,,교하동제12투,3239,2359,1258,978,81,0,24,1,0,1,0,3,1,1,2348,11,880
4100,경기도,4132,파주시,,교하동제13투,1026,689,413,238,26,0,4,0,0,0,2,1,0,0,684,5,337
4100,경기도,4132,파주시,운정1동,소계,42425,32689,18600,12761,783,15,226,11,2,11,27,30,5,9,32480,209,9736
4100,경기도,4132,파주시,,관내사전투표,13606,13606,8296,4878,288,4,54,5,1,0,1,19,2,4,13552,54,0
4100,경기도,4132,파주시,,운정1동제1투,4048,2040,1032,890,51,1,41,0,1,0,4,2,1,0,2023,17,2008
4100,경기도,4132,파주시,,운정1동제2투,2058,1571,869,625,50,0,12,0,0,1,0,3,0,0,1560,11,487
4100,경기도,4132,파주시,,운정1동제3투,3300,1897,996,805,35,2,25,1,0,0,4,1,0,0,1869,28,1403
4100,경기도,4132,파주시,,운정1동제4투,3601,2259,1209,944,63,0,22,0,0,0,1,1,1,2,2243,16,1342
4100,경기도,4132,파주시,,운정1동제5투,2806,1936,1021,830,54,1,10,1,0,1,4,0,0,2,1924,12,870
4100,경기도,4132,파주시,,운정1동제6투,2367,1721,934,707,49,2,6,2,0,3,2,0,1,0,1706,15,646
4100,경기도,4132,파주시,,운정1동제7투,3136,2211,1288,824,45,2,24,0,0,3,2,0,0,1,2189,22,925
4100,경기도,4132,파주시,,운정1동제8투,2844,2076,1033,968,55,0,5,1,0,0,0,1,0,0,2063,13,768
4100,경기도,4132,파주시,,운정1동제9투,1658,1272,678,543,30,0,6,0,0,3,3,0,0,0,1263,9,386
4100,경기도,4132,파주시,,운정1동제10투,3001,2100,1244,747,63,3,21,1,0,0,6,3,0,0,2088,12,901
4100,경기도,4132,파주시,운정2동,소계,40922,30757,17748,11746,824,9,168,7,5,7,19,13,2,5,30553,204,10165
4100,경기도,4132,파주시,,관내사전투표,6693,6693,4290,2188,156,5,23,2,0,1,0,4,0,2,6671,22,0
4100,경기도,4132,파주시,,운정2동제1투,2720,1704,927,701,37,0,15,0,0,0,1,0,0,1,1682,22,1016
4100,경기도,4132,파주시,,운정2동제2투,1321,948,555,348,35,0,3,1,0,1,1,0,0,0,944,4,373
4100,경기도,4132,파주시,,운정2동제3투,1026,739,407,289,26,0,4,0,0,0,0,0,0,1,727,12,287
4100,경기도,4132,파주시,,운정2동제4투,2578,1881,1030,766,49,1,11,0,0,1,2,2,0,1,1863,18,697
4100,경기도,4132,파주시,,운정2동제5투,1772,1142,614,481,26,0,6,0,1,0,0,1,0,0,1129,13,630
4100,경기도,4132,파주시,,운정2동제6투,2355,1817,967,776,50,1,10,0,0,0,2,1,1,0,1808,9,538
4100,경기도,4132,파주시,,운정2동제7투,2717,1762,967,718,50,0,8,1,0,0,1,0,1,0,1746,16,955
4100,경기도,4132,파주시,,운정2동제8투,3592,2496,1382,1015,66,0,12,0,1,2,6,0,0,0,2484,12,1096
4100,경기도,4132,파주시,,운정2동제9투,1648,1288,738,492,46,0,3,0,0,0,0,0,0,0,1279,9,360
4100,경기도,4132,파주시,,운정2동제10투,1758,1169,667,445,34,0,10,0,0,0,2,2,0,0,1160,9,589
4100,경기도,4132,파주시,,운정2동제11투,2176,1713,1086,537,49,1,24,2,1,1,1,3,0,0,1705,8,463
4100,경기도,4132,파주시,,운정2동제12투,2783,1895,1037,747,72,1,20,0,0,0,1,0,0,0,1878,17,888
4100,경기도,4132,파주시,,운정2동제13투,4393,3031,1681,1245,65,0,15,1,1,0,2,0,0,0,3010,21,1362
4100,경기도,4132,파주시,,운정2동제14투,3390,2479,1400,998,63,0,4,0,1,1,0,0,0,0,2467,12,911
4100,경기도,4132,파주시,운정3동,소계,59473,42241,23701,16884,1005,14,256,9,3,13,27,41,6,12,41971,270,17232
4100,경기도,4132,파주시,,관내사전투표,10671,10671,6728,3664,183,3,36,2,1,0,2,13,0,3,10635,36,0
4100,경기도,4132,파주시,,운정3동제1투,3479,2577,1321,1148,70,0,9,0,0,0,5,3,0,0,2556,21,902
4100,경기도,4132,파주시,,운정3동제2투,3591,2605,1421,1076,75,0,8,0,0,3,1,2,0,0,2586,19,986
4100,경기도,4132,파주시,,운정3동제3투,5529,3247,1856,1236,77,3,35,2,0,1,3,1,0,2,3216,31,2282
4100,경기도,4132,파주시,,운정3동제4투,4110,2270,1226,956,51,0,24,0,0,1,0,0,0,0,2258,12,1840
4100,경기도,4132,파주시,,운정3동제5투,3197,2150,1068,973,63,3,22,1,0,0,0,3,1,1,2135,15,1047
4100,경기도,4132,파주시,,운정3동제6투,3563,2384,1308,952,71,1,16,1,0,1,2,5,0,0,2357,27,1179
4100,경기도,4132,파주시,,운정3동제7투,1911,1398,728,611,32,0,9,0,0,0,0,0,1,1,1382,16,513
4100,경기도,4132,파주시,,운정3동제8투,2049,1268,668,551,30,0,12,0,0,0,0,0,1,1,1263,5,781
4100,경기도,4132,파주시,,운정3동제9투,2434,1834,1027,721,46,2,13,1,1,1,3,2,0,3,1820,14,600
4100,경기도,4132,파주시,,운정3동제10투,1698,1278,728,496,34,0,4,1,0,0,5,1,1,0,1270,8,420
4100,경기도,4132,파주시,,운정3동제11투,2200,1102,618,429,26,1,13,1,0,0,2,3,1,0,1094,8,1098
4100,경기도,4132,파주시,,운정3동제12투,4598,2182,1171,901,64,1,20,0,0,2,2,4,0,0,2165,17,2416
4100,경기도,4132,파주시,,운정3동제13투,3439,2470,1288,1095,58,0,10,0,1,0,2,1,0,0,2455,15,969
4100,경기도,4132,파주시,,운정3동제14투,1975,1272,636,577,32,0,12,0,0,1,0,1,0,0,1259,13,703
4100,경기도,4132,파주시,,운정3동제15투,5029,3533,1909,1498,93,0,13,0,0,3,0,2,1,1,3520,13,1496
4100,경기도,4132,파주시,금촌1동,소계,18839,12084,5897,5602,284,8,140,7,2,2,7,15,3,4,11971,113,6755
4100,경기도,4132,파주시,,관내사전투표,4902,4902,2611,2111,99,5,30,3,0,0,4,7,0,1,4871,31,0
4100,경기도,4132,파주시,,금촌1동제1투,2744,1420,675,662,38,0,28,0,0,0,1,0,0,2,1406,14,1324
4100,경기도,4132,파주시,,금촌1동제2투,1808,967,437,469,33,0,10,1,0,0,1,1,1,1,954,13,841
4100,경기도,4132,파주시,,금촌1동제3투,1692,810,323,446,21,1,10,0,0,0,0,2,1,0,804,6,882
4100,경기도,4132,파주시,,금촌1동제4투,2495,1288,535,683,24,1,21,2,2,0,1,2,0,0,1271,17,1207
4100,경기도,4132,파주시,,금촌1동제5투,2928,1417,720,609,32,1,30,0,0,1,0,2,0,0,1395,22,1511
4100,경기도,4132,파주시,,금촌1동제6투,2270,1280,596,622,37,0,11,1,0,1,0,1,1,0,1270,10,990
4100,경기도,4132,파주시,금촌2동,소계,26231,19858,11052,7891,546,19,155,5,4,4,14,21,4,9,19724,134,6373
4100,경기도,4132,파주시,,관내사전투표,8110,8110,4812,2971,218,7,51,3,2,0,2,13,1,2,8082,28,0
4100,경기도,4132,파주시,,금촌2동제1투,1676,1094,551,492,32,0,6,1,0,0,1,2,1,0,1086,8,582
4100,경기도,4132,파주시,,금촌2동제2투,1918,1035,523,451,36,2,12,0,0,0,0,1,0,1,1026,9,883
4100,경기도,4132,파주시,,금촌2동제3투,2174,1356,693,592,38,0,14,0,0,1,1,1,0,0,1340,16,818
4100,경기도,4132,파주시,,금촌2동제4투,2800,1884,1046,759,44,3,11,0,1,1,1,0,0,0,1866,18,916
4100,경기도,4132,파주시,,금촌2동제5투,1666,1063,503,506,19,1,15,0,0,0,4,1,1,1,1051,12,603
4100,경기도,4132,파주시,,금촌2동제6투,2739,1962,1092,777,41,4,23,1,1,1,2,2,0,3,1947,15,777
4100,경기도,4132,파주시,,금촌2동제7투,2853,1960,1091,769,71,1,12,0,0,1,1,1,0,0,1947,13,893
4100,경기도,4132,파주시,,금촌2동제8투,2295,1394,741,574,47,1,11,0,0,0,2,0,1,2,1379,15,901
4100,경기도,4132,파주시,금촌3동,소계,21466,15065,8018,6322,365,12,163,6,3,5,13,14,8,8,14937,128,6401
4100,경기도,4132,파주시,,관내사전투표,6032,6032,3393,2416,143,5,29,3,0,1,5,4,2,4,6005,27,0
4100,경기도,4132,파주시,,금촌3동제1투,2288,1350,684,588,32,2,16,0,0,1,0,2,1,1,1327,23,938
4100,경기도,4132,파주시,,금촌3동제2투,2011,1007,485,467,25,0,16,1,1,0,0,2,1,0,998,9,1004
4100,경기도,4132,파주시,,금촌3동제3투,2691,1430,692,650,38,2,23,1,0,1,0,2,0,0,1409,21,1261
4100,경기도,4132,파주시,,금촌3동제4투,2840,1739,944,707,38,3,26,0,0,1,1,2,2,0,1724,15,1101
4100,경기도,4132,파주시,,금촌3동제5투,3202,2049,1096,830,55,0,33,1,2,1,3,2,1,2,2026,23,1153
4100,경기도,4132,파주시,,금촌3동제6투,2402,1458,724,664,34,0,20,0,0,0,4,0,1,1,1448,10,944
4100,경기도,4132,파주시,장단면,소계,799,707,303,364,15,0,12,1,0,0,1,1,0,1,698,9,92
4100,경기도,4132,파주시,,관내사전투표,397,397,189,182,7,0,11,1,0,0,1,0,0,0,391,6,0
4100,경기도,4132,파주시,,장단면제1투,311,231,91,130,7,0,1,0,0,0,0,0,0,1,230,1,80
4100,경기도,4132,파주시,,장단면제2투,91,79,23,52,1,0,0,0,0,0,0,1,0,0,77,2,12
4100,경기도,4132,파주시,잘못 투입·구분된 투표지,,0,6,4,2,0,0,0,0,0,0,0,0,0,0,6,0,-6
4100,경기도,4133,여주시,합계,,98077,72566,30695,38731,1458,39,731,19,12,17,74,86,39,49,71950,616,25511
4100,경기도,4133,여주시,거소·선상투표,,158,148,62,65,1,0,6,0,0,0,0,0,1,0,135,13,10
4100,경기도,4133,여주시,관외사전투표,,8054,8054,3546,4112,195,6,89,3,4,3,6,6,2,7,7979,75,0
4100,경기도,4133,여주시,재외투표,,378,287,167,90,5,0,1,0,1,0,0,1,0,0,265,22,91
4100,경기도,4133,여주시,점동면,소계,4528,3494,1309,2067,43,3,23,3,1,1,2,3,3,3,3461,33,1034
4100,경기도,4133,여주시,,관내사전투표,1842,1842,776,1008,22,2,9,2,0,1,1,1,2,2,1826,16,0
4100,경기도,4133,여주시,,점동면제1투,1768,1003,348,614,16,0,12,0,0,0,1,0,1,1,993,10,765
4100,경기도,4133,여주시,,점동면제2투,535,368,107,251,4,1,1,1,0,0,0,0,0,0,365,3,167
4100,경기도,4133,여주시,,점동면제3투,383,281,78,194,1,0,1,0,1,0,0,2,0,0,277,4,102
4100,경기도,4133,여주시,가남읍,소계,12068,8275,3714,4211,155,1,105,1,1,3,6,11,8,3,8219,56,3793
4100,경기도,4133,여주시,,관내사전투표,3045,3045,1476,1465,59,0,30,1,1,1,2,1,2,1,3039,6,0
4100,경기도,4133,여주시,,가남읍제1투,2059,1041,446,544,15,0,12,0,0,1,2,2,0,0,1022,19,1018
4100,경기도,4133,여주시,,가남읍제2투,1393,885,325,520,24,1,10,0,0,0,0,1,0,0,881,4,508
4100,경기도,4133,여주시,,가남읍제3투,803,518,162,333,12,0,2,0,0,0,1,1,2,0,513,5,285
4100,경기도,4133,여주시,,가남읍제4투,411,274,87,176,6,0,2,0,0,0,0,0,2,0,273,1,137
4100,경기도,4133,여주시,,가남읍제5투,2576,1571,771,714,26,0,37,0,0,1,1,4,2,2,1558,13,1005
4100,경기도,4133,여주시,,가남읍제6투,1781,941,447,459,13,0,12,0,0,0,0,2,0,0,933,8,840
4100,경기도,4133,여주시,흥천면,소계,3965,2890,1002,1773,42,1,34,0,0,0,6,3,2,1,2864,26,1075
4100,경기도,4133,여주시,,관내사전투표,1177,1177,456,671,26,0,10,0,0,0,2,1,2,0,1168,9,0
4100,경기도,4133,여주시,,흥천면제1투,1538,938,324,579,8,0,10,0,0,0,4,2,0,1,928,10,600
4100,경기도,4133,여주시,,흥천면제2투,1250,775,222,523,8,1,14,0,0,0,0,0,0,0,768,7,475
4100,경기도,4133,여주시,금사면,소계,2415,1865,541,1265,20,2,10,1,1,0,1,0,1,0,1842,23,550
4100,경기도,4133,여주시,,관내사전투표,972,972,308,638,9,1,5,0,1,0,0,0,0,0,962,10,0
4100,경기도,4133,여주시,,금사면제1투,869,522,135,368,6,1,1,0,0,0,1,0,0,0,512,10,347
4100,경기도,4133,여주시,,금사면제2투,574,371,98,259,5,0,4,1,0,0,0,0,1,0,368,3,203
4100,경기도,4133,여주시,산북면,소계,2091,1634,615,956,29,0,15,0,0,2,0,3,3,4,1627,7,457
4100,경기도,4133,여주시,,관내사전투표,932,932,387,517,14,0,6,0,0,0,0,2,0,2,928,4,0
4100,경기도,4133,여주시,,산북면투표소,1159,702,228,439,15,0,9,0,0,2,0,1,3,2,699,3,457
4100,경기도,4133,여주시,대신면,소계,5705,4243,1440,2633,65,2,48,0,0,0,9,3,6,6,4212,31,1462
4100,경기도,4133,여주시,,관내사전투표,1814,1814,711,1049,19,2,13,0,0,0,0,1,2,2,1799,15,0
4100,경기도,4133,여주시,,대신면제1투,1261,733,187,504,19,0,14,0,0,0,5,1,0,1,731,2,528
4100,경기도,4133,여주시,,대신면제2투,1190,740,258,460,11,0,4,0,0,0,1,1,1,0,736,4,450
4100,경기도,4133,여주시,,대신면제3투,817,539,157,362,5,0,7,0,0,0,1,0,2,1,535,4,278
4100,경기도,4133,여주시,,대신면제4투,623,417,127,258,11,0,10,0,0,0,2,0,1,2,411,6,206
4100,경기도,4133,여주시,북내면,소계,4055,2992,1104,1774,50,0,29,2,0,0,3,3,2,2,2969,23,1063
4100,경기도,4133,여주시,,관내사전투표,1409,1409,622,741,24,0,6,2,0,0,1,1,1,1,1399,10,0
4100,경기도,4133,여주시,,북내면제1투,1551,868,286,544,13,0,14,0,0,0,1,1,1,1,861,7,683
4100,경기도,4133,여주시,,북내면제2투,723,457,115,325,9,0,5,0,0,0,0,1,0,0,455,2,266
4100,경기도,4133,여주시,,북내면제3투,372,258,81,164,4,0,4,0,0,0,1,0,0,0,254,4,114
4100,경기도,4133,여주시,강천면,소계,3732,2772,1104,1549,63,3,25,2,0,0,1,3,0,1,2751,21,960
4100,경기도,4133,여주시,,관내사전투표,1312,1312,604,658,29,2,12,1,0,0,0,2,0,0,1308,4,0
4100,경기도,4133,여주시,,강천면제1투,657,370,119,236,8,0,5,0,0,0,1,0,0,0,369,1,287
4100,경기도,4133,여주시,,강천면제2투,671,414,152,242,8,0,4,1,0,0,0,1,0,0,408,6,257
4100,경기도,4133,여주시,,강천면제3투,529,303,108,179,7,1,3,0,0,0,0,0,0,0,298,5,226
4100,경기도,4133,여주시,,강천면제4투,563,373,121,234,11,0,1,0,0,0,0,0,0,1,368,5,190
4100,경기도,4133,여주시,여흥동,소계,17065,11834,5190,6132,242,10,118,2,1,3,10,18,4,8,11738,96,5231
4100,경기도,4133,여주시,,관내사전투표,4736,4736,2285,2273,88,8,35,1,0,1,3,10,2,3,4709,27,0
4100,경기도,4133,여주시,,여흥동제1투,1551,734,279,419,17,0,5,1,0,1,1,2,0,0,725,9,817
4100,경기도,4133,여주시,,여흥동제2투,1982,1272,564,658,22,0,16,0,0,0,0,0,0,0,1260,12,710
4100,경기도,4133,여주시,,여흥동제3투,1869,1009,339,607,29,0,18,0,0,0,3,0,0,1,997,12,860
4100,경기도,4133,여주시,,여흥동제4투,1511,995,380,581,18,0,7,0,0,0,1,2,0,0,989,6,516
4100,경기도,4133,여주시,,여흥동제5투,3827,2033,933,992,47,1,31,0,1,0,1,2,2,3,2013,20,1794
4100,경기도,4133,여주시,,여흥동제6투,1589,1055,410,602,21,1,6,0,0,1,1,2,0,1,1045,10,534
4100,경기도,4133,여주시,중앙동,소계,14535,10162,4551,5120,256,5,108,2,1,4,12,16,4,3,10082,80,4373
4100,경기도,4133,여주시,,관내사전투표,4396,4396,2023,2173,120,1,32,1,0,2,3,7,1,0,4363,33,0
4100,경기도,4133,여주시,,중앙동제1투,1802,942,354,542,18,1,12,0,1,0,1,1,2,2,934,8,860
4100,경기도,4133,여주시,,중앙동제2투,2825,1620,685,869,31,1,17,0,0,0,1,3,0,1,1608,12,1205
4100,경기도,4133,여주시,,중앙동제3투,3454,2148,1057,967,66,2,27,1,0,1,4,4,1,0,2130,18,1306
4100,경기도,4133,여주시,,중앙동제4투,2058,1056,432,569,21,0,20,0,0,1,3,1,0,0,1047,9,1002
4100,경기도,4133,여주시,오학동,소계,14203,10131,4977,4727,224,6,92,3,2,1,13,9,3,6,10063,68,4072
4100,경기도,4133,여주시,,관내사전투표,5365,5365,2811,2385,100,5,30,1,0,0,3,3,2,2,5342,23,0
4100,경기도,4133,여주시,,오학동제1투,2649,1500,662,751,40,0,21,0,0,0,5,2,0,2,1483,17,1149
4100,경기도,4133,여주시,,오학동제2투,3111,1634,754,790,47,1,16,2,2,0,3,1,1,0,1617,17,1477
4100,경기도,4133,여주시,,오학동제3투,3078,1632,750,801,37,0,25,0,0,1,2,3,0,2,1621,11,1446
4100,경기도,4133,여주시,세종대왕면,소계,5125,3785,1373,2257,68,0,28,0,0,0,5,7,0,5,3743,42,1340
4100,경기도,4133,여주시,,관내사전투표,1642,1642,672,922,24,0,7,0,0,0,0,2,0,3,1630,12,0
4100,경기도,4133,여주시,,세종대왕면제1투,1410,784,274,465,23,0,7,0,0,0,0,2,0,2,773,11,626
4100,경기도,4133,여주시,,세종대왕면제2투,1313,870,263,563,16,0,7,0,0,0,4,3,0,0,856,14,443
4100,경기도,4133,여주시,,세종대왕면제3투,760,489,164,307,5,0,7,0,0,0,1,0,0,0,484,5,271
4100,경기도,4133,여주시,잘못 투입·구분된 투표지,,0,0,0,0,0,0,0,0,0,0,0,0,0,0,0,0,0
4100,경기도,4134,이천시,합계,,187895,137512,63562,67726,2995,68,1354,34,21,36,77,154,47,64,136138,1374,50383
4100,경기도,4134,이천시,거소·선상투표,,535,504,184,175,12,1,14,4,3,3,0,1,1,5,403,101,31
4100,경기도,4134,이천시,관외사전투표,,14598,14594,6601,7199,377,10,180,3,5,4,7,19,4,13,14422,172,4
4100,경기도,4134,이천시,재외투표,,666,455,256,136,18,0,3,0,0,1,0,0,0,0,414,41,211
4100,경기도,4134,이천시,장호원읍,소계,11391,8154,3409,4419,160,7,61,0,0,5,2,4,7,2,8076,78,3237
4100,경기도,4134,이천시,,관내사전투표,3408,3408,1593,1681,75,2,19,0,0,4,1,3,3,2,3383,25,0
4100,경기도,4134,이천시,,장호원읍제1투,1735,926,376,506,19,0,15,0,0,0,0,0,0,0,916,10,809
4100,경기도,4134,이천시,,장호원읍제2투,1493,860,345,485,11,1,12,0,0,0,0,0,0,0,854,6,633
4100,경기도,4134,이천시,,장호원읍제3투,710,466,133,320,4,1,2,0,0,0,0,0,2,0,462,4,244
4100,경기도,4134,이천시,,장호원읍제4투,721,491,156,314,10,3,0,0,0,0,0,0,1,0,484,7,230
4100,경기도,4134,이천시,,장호원읍제5투,836,538,172,346,8,0,2,0,0,0,0,1,1,0,530,8,298
4100,경기도,4134,이천시,,장호원읍제6투,457,294,104,177,5,0,3,0,0,0,0,0,0,0,289,5,163
4100,경기도,4134,이천시,,장호원읍제7투,2031,1171,530,590,28,0,8,0,0,1,1,0,0,0,1158,13,860
4100,경기도,4134,이천시,부발읍,소계,26347,18347,9295,8281,387,8,166,1,2,2,9,20,6,13,18190,157,8000
4100,경기도,4134,이천시,,관내사전투표,6230,6230,3300,2728,120,2,38,0,0,0,3,8,2,3,6204,26,0
4100,경기도,4134,이천시,,부발읍제1투,3657,1864,863,916,34,2,27,0,0,1,0,1,1,3,1848,16,1793
4100,경기도,4134,이천시,,부발읍제2투,1753,935,377,505,27,1,12,0,0,0,0,4,1,1,928,7,818
4100,경기도,4134,이천시,,부발읍제3투,433,295,79,204,8,0,4,0,0,0,0,0,0,0,295,0,138
4100,경기도,4134,이천시,,부발읍제4투,2667,1668,829,752,33,1,20,0,1,0,2,3,0,1,1642,26,999
4100,경기도,4134,이천시,,부발읍제5투,3146,1824,893,841,38,1,22,0,0,1,2,2,1,2,1803,21,1322
4100,경기도,4134,이천시,,부발읍제6투,2833,1776,904,792,45,0,11,1,0,0,2,1,0,1,1757,19,1057
4100,경기도,4134,이천시,,부발읍제7투,975,664,358,264,14,0,12,0,1,0,0,0,0,2,651,13,311
4100,경기도,4134,이천시,,부발읍제8투,2362,1350,628,666,23,1,16,0,0,0,0,1,1,0,1336,14,1012
4100,경기도,4134,이천시,,부발읍제9투,2291,1741,1064,613,45,0,4,0,0,0,0,0,0,0,1726,15,550
4100,경기도,4134,이천시,신둔면,소계,11437,8360,3917,4110,178,1,65,1,2,3,13,8,1,1,8300,60,3077
4100,경기도,4134,이천시,,관내사전투표,3750,3750,2015,1619,77,0,17,0,0,0,4,2,1,0,3735,15,0
4100,경기도,4134,이천시,,신둔면제1투,2824,1607,672,854,43,1,17,1,1,0,1,3,0,0,1593,14,1217
4100,경기도,4134,이천시,,신둔면제2투,3161,1897,808,1005,43,0,17,0,1,2,3,1,0,1,1881,16,1264
4100,경기도,4134,이천시,,신둔면제3투,1702,1106,422,632,15,0,14,0,0,1,5,2,0,0,1091,15,596
4100,경기도,4134,이천시,백사면,소계,8872,6125,2748,3123,120,2,61,2,4,1,6,6,2,4,6079,46,2747
4100,경기도,4134,이천시,,관내사전투표,2655,2655,1299,1280,45,0,12,2,0,0,0,4,1,0,2643,12,0
4100,경기도,4134,이천시,,백사면제1투,2746,1486,579,839,27,1,19,0,2,0,2,0,1,2,1472,14,1260
4100,경기도,4134,이천시,,백사면제2투,3471,1984,870,1004,48,1,30,0,2,1,4,2,0,2,1964,20,1487
4100,경기도,4134,이천시,호법면,소계,4954,3598,1363,2088,70,1,33,1,0,0,1,6,5,1,3569,29,1356
4100,경기도,4134,이천시,,관내사전투표,1813,1813,757,996,34,0,12,0,0,0,0,4,3,0,1806,7,0
4100,경기도,4134,이천시,,호법면제1투,2345,1259,453,746,24,0,15,0,0,0,1,2,1,1,1243,16,1086
4100,경기도,4134,이천시,,호법면제2투,796,526,153,346,12,1,6,1,0,0,0,0,1,0,520,6,270
4100,경기도,4134,이천시,마장면,소계,11838,8456,3716,4295,201,7,118,2,0,1,4,5,5,0,8354,102,3382
4100,경기도,4134,이천시,,관내사전투표,4317,4317,2034,2055,106,3,55,0,0,1,0,2,4,0,4260,57,0
4100,경기도,4134,이천시,,마장면제1투,3239,1778,716,950,50,2,29,0,0,0,4,2,1,0,1754,24,1461
4100,경기도,4134,이천시,,마장면제2투,2988,1641,724,838,32,1,29,2,0,0,0,1,0,0,1627,14,1347
4100,경기도,4134,이천시,,마장면제3투,1294,720,242,452,13,1,5,0,0,0,0,0,0,0,713,7,574
4100,경기도,4134,이천시,대월면,소계,12334,8661,4322,3927,196,3,99,4,0,2,4,9,2,4,8572,89,3673
4100,경기도,4134,이천시,,관내사전투표,4586,4586,2490,1925,89,1,41,4,0,2,1,6,1,2,4562,24,0
4100,경기도,4134,이천시,,대월면제1투,2092,1110,417,620,23,0,28,0,0,0,2,0,0,1,1091,19,982
4100,경기도,4134,이천시,,대월면제2투,754,454,128,305,10,2,4,0,0,0,0,0,0,1,450,4,300
4100,경기도,4134,이천시,,대월면제3투,3047,1568,770,700,48,0,15,0,0,0,1,3,1,0,1538,30,1479
4100,경기도,4134,이천시,,대월면제4투,1855,943,517,377,26,0,11,0,0,0,0,0,0,0,931,12,912
4100,경기도,4134,이천시,모가면,소계,4162,3208,1123,1977,45,0,26,0,1,1,3,2,0,2,3180,28,954
4100,경기도,4134,이천시,,관내사전투표,1798,1798,704,1040,26,0,12,0,1,1,2,2,0,0,1788,10,0
4100,경기도,4134,이천시,,모가면제1투,1425,811,254,530,9,0,6,0,0,0,1,0,0,1,801,10,614
4100,경기도,4134,이천시,,모가면제2투,939,599,165,407,10,0,8,0,0,0,0,0,0,1,591,8,340
4100,경기도,4134,이천시,설성면,소계,3750,2733,936,1693,45,3,25,0,0,2,2,2,1,1,2710,23,1017
4100,경기도,4134,이천시,,관내사전투표,1231,1231,481,706,23,2,13,0,0,0,0,0,0,0,1225,6,0
4100,경기도,4134,이천시,,설성면제1투,905,517,151,342,7,1,4,0,0,0,0,1,1,1,508,9,388
4100,경기도,4134,이천시,,설성면제2투,676,425,108,305,6,0,2,0,0,1,0,1,0,0,423,2,251
4100,경기도,4134,이천시,,설성면제3투,938,560,196,340,9,0,6,0,0,1,2,0,0,0,554,6,378
4100,경기도,4134,이천시,율면,소계,2409,1810,719,1018,34,1,13,0,0,2,1,1,1,1,1791,19,599
4100,경기도,4134,이천시,,관내사전투표,1036,1036,437,561,20,0,5,0,0,1,1,1,0,1,1027,9,0
4100,경기도,4134,이천시,,율면투표소,1373,774,282,457,14,1,8,0,0,1,0,0,1,0,764,10,599
4100,경기도,4134,이천시,창전동,소계,15588,10796,4707,5593,236,8,106,6,2,2,8,19,3,4,10694,102,4792
4100,경기도,4134,이천시,,관내사전투표,5361,5361,2631,2515,121,4,39,3,1,0,1,9,1,2,5327,34,0
4100,경기도,4134,이천시,,창전동제1투,2800,1456,558,808,39,1,20,0,0,0,1,5,0,1,1433,23,1344
4100,경기도,4134,이천시,,창전동제2투,1948,1034,383,601,19,1,10,0,0,2,3,3,0,0,1022,12,914
4100,경기도,4134,이천시,,창전동제3투,1663,794,298,459,16,1,11,0,1,0,0,0,0,0,786,8,869
4100,경기도,4134,이천시,,창전동제4투,1918,1124,441,627,19,0,16,3,0,0,2,1,0,0,1109,15,794
4100,경기도,4134,이천시,,창전동제5투,1898,1027,396,583,22,1,10,0,0,0,1,1,2,1,1017,10,871
4100,경기도,4134,이천시,증포동,소계,37097,26200,13856,11263,599,13,222,8,1,1,10,29,5,6,26013,187,10897
4100,경기도,4134,이천시,,관내사전투표,9095,9094,5140,3647,190,7,53,5,0,0,1,13,1,1,9058,36,1
4100,경기도,4134,이천시,,증포동제1투,3011,1717,829,808,35,0,13,1,0,0,0,2,0,2,1690,27,1294
4100,경기도,4134,이천시,,증포동제2투,2431,1389,637,680,32,2,20,0,0,0,1,6,0,0,1378,11,1042
4100,경기도,4134,이천시,,증포동제3투,3080,1779,877,811,33,1,28,0,0,0,2,1,0,1,1754,25,1301
4100,경기도,4134,이천시,,증포동제4투,2034,1217,628,536,28,0,15,0,0,0,0,0,0,0,1207,10,817
4100,경기도,4134,이천시,,증포동제5투,3629,2189,1129,957,58,2,21,1,0,0,0,3,1,0,2172,17,1440
4100,경기도,4134,이천시,,증포동제6투,2376,1453,683,691,45,0,13,0,0,0,2,2,1,0,1437,16,923
4100,경기도,4134,이천시,,증포동제7투,4489,2782,1508,1158,68,1,24,0,0,1,3,1,0,2,2766,16,1707
4100,경기도,4134,이천시,,증포동제8투,2540,1551,824,662,42,0,11,0,0,0,0,0,1,0,1540,11,989
4100,경기도,4134,이천시,,증포동제9투,2843,1963,1085,810,42,0,15,0,1,0,0,1,0,0,1954,9,880
4100,경기도,4134,이천시,,증포동제10투,1569,1066,516,503,26,0,9,1,0,0,1,0,1,0,1057,9,503
4100,경기도,4134,이천시,중리동,소계,12243,8551,3339,4821,170,1,97,2,1,4,5,14,1,4,8459,92,3692
4100,경기도,4134,이천시,,관내사전투표,3693,3693,1634,1910,85,0,29,0,0,0,1,8,0,1,3668,25,0
4100,경기도,4134,이천시,,중리동제1투,1730,878,301,528,14,0,14,1,1,0,1,3,0,1,864,14,852
4100,경기도,4134,이천시,,중리동제2투,2506,1357,515,777,19,0,23,1,0,1,1,0,0,1,1338,19,1149
4100,경기도,4134,이천시,,중리동제3투,2057,1249,390,804,17,1,17,0,0,3,2,1,0,1,1236,13,808
4100,경기도,4134,이천시,,중리동제4투,2257,1374,499,802,35,0,14,0,0,0,0,2,1,0,1353,21,883
4100,경기도,4134,이천시,관고동,소계,9674,6956,3070,3606,147,2,65,0,0,2,2,9,3,3,6909,47,2718
4100,경기도,4134,이천시,,관내사전투표,3865,3865,1831,1895,82,2,28,0,0,0,0,4,1,3,3846,19,0
4100,경기도,4134,이천시,,관고동제1투,2127,1154,486,623,18,0,13,0,0,1,0,2,0,0,1143,11,973
4100,경기도,4134,이천시,,관고동제2투,1836,1016,378,588,28,0,12,0,0,1,1,1,1,0,1010,6,820
4100,경기도,4134,이천시,,관고동제3투,1846,921,375,500,19,0,12,0,0,0,1,2,1,0,910,11,925
4100,경기도,4134,이천시,잘못 투입·구분된 투표지,,0,4,1,2,0,0,0,0,0,0,0,0,0,0,3,1,-4
4100,경기도,4135,용인시처인구,합계,,220689,162420,80188,75105,3618,78,1532,33,27,44,105,162,46,69,161007,1413,58269
4100,경기도,4135,용인시처인구,거소·선상투표,,558,520,229,178,12,2,8,1,1,0,3,2,0,3,439,81,38
4100,경기도,4135,용인시처인구,관외사전투표,,19375,19373,9701,8789,438,14,206,4,2,4,5,21,1,6,19191,182,2
4100,경기도,4135,용인시처인구,재외투표,,929,672,399,192,23,0,10,0,0,0,0,0,0,0,624,48,257
4100,경기도,4135,용인시처인구,포곡읍,소계,26527,18716,9956,7873,429,5,206,8,2,3,17,23,2,10,18534,182,7811
4100,경기도,4135,용인시처인구,,관내사전투표,6422,6422,3752,2454,108,3,49,4,0,2,0,8,1,3,6384,38,0
4100,경기도,4135,용인시처인구,,포곡읍제1투,2847,1464,735,667,21,1,21,0,0,0,0,1,0,1,1447,17,1383
4100,경기도,4135,용인시처인구,,포곡읍제2투,1269,883,454,374,20,0,17,0,0,0,3,3,0,0,871,12,386
4100,경기도,4135,용인시처인구,,포곡읍제3투,1669,1108,497,558,31,0,10,0,0,0,3,2,0,0,1101,7,561
4100,경기도,4135,용인시처인구,,포곡읍제4투,3727,2204,1094,962,66,1,43,2,1,0,3,4,0,2,2178,26,1523
4100,경기도,4135,용인시처인구,,포곡읍제5투,639,412,98,298,7,0,2,0,0,0,0,1,0,0,406,6,227
4100,경기도,4135,용인시처인구,,포곡읍제6투,2969,1816,971,744,61,0,16,1,0,1,2,1,1,1,1799,17,1153
4100,경기도,4135,용인시처인구,,포곡읍제7투,3540,2056,1113,842,51,0,24,0,0,0,2,1,0,0,2033,23,1484
4100,경기도,4135,용인시처인구,,포곡읍제8투,3445,2351,1242,974,64,0,24,1,1,0,4,2,0,3,2315,36,1094
4100,경기도,4135,용인시처인구,원삼면,소계,6564,4915,1796,2926,97,4,37,3,3,1,2,1,1,2,4873,42,1649
4100,경기도,4135,용인시처인구,,관내사전투표,2202,2201,931,1208,39,2,7,0,0,0,1,1,1,1,2191,10,1
4100,경기도,4135,용인시처인구,,원삼면제1투,1127,638,176,427,11,0,8,3,1,1,0,0,0,0,627,11,489
4100,경기도,4135,용인시처인구,,원삼면제2투,1018,668,225,420,8,0,9,0,1,0,0,0,0,0,663,5,350
4100,경기도,4135,용인시처인구,,원삼면제3투,1551,998,344,599,29,1,10,0,1,0,0,0,0,1,985,13,553
4100,경기도,4135,용인시처인구,,원삼면제4투,666,410,120,272,10,1,3,0,0,0,1,0,0,0,407,3,256
4100,경기도,4135,용인시처인구,백암면,소계,7413,5135,1941,2959,106,5,44,1,3,4,4,1,8,5,5081,54,2278
4100,경기도,4135,용인시처인구,,관내사전투표,2312,2312,1019,1195,48,1,24,1,1,0,1,0,3,2,2295,17,0
4100,경기도,4135,용인시처인구,,백암면제1투,1272,686,210,443,13,1,7,0,0,0,0,0,2,0,676,10,586
4100,경기도,4135,용인시처인구,,백암면제2투,656,431,111,301,7,1,2,0,0,0,2,1,2,0,427,4,225
4100,경기도,4135,용인시처인구,,백암면제3투,952,554,177,354,12,0,4,0,0,1,0,0,0,1,549,5,398
4100,경기도,4135,용인시처인구,,백암면제4투,1133,573,175,358,18,1,3,0,2,2,1,0,1,2,563,10,560
4100,경기도,4135,용인시처인구,,백암면제5투,1088,579,249,308,8,1,4,0,0,1,0,0,0,0,571,8,509
4100,경기도,4135,용인시처인구,양지면,소계,15088,10294,4724,5173,193,4,109,0,0,1,5,9,4,3,10225,69,4794
4100,경기도,4135,용인시처인구,,관내사전투표,4451,4451,2236,2067,77,3,31,0,0,0,1,2,2,1,4420,31,0
4100,경기도,4135,용인시처인구,,양지면제1투,3137,1686,681,925,36,0,26,0,0,0,0,2,0,2,1672,14,1451
4100,경기도,4135,용인시처인구,,양지면제2투,2162,1239,488,718,17,0,5,0,0,0,2,0,0,0,1230,9,923
4100,경기도,4135,용인시처인구,,양지면제3투,1468,937,344,541,21,0,19,0,0,1,0,3,2,0,931,6,531
4100,경기도,4135,용인시처인구,,양지면제4투,3870,1981,975,922,42,1,28,0,0,0,2,2,0,0,1972,9,1889
4100,경기도,4135,용인시처인구,중앙동,소계,19697,13735,6423,6659,355,9,135,1,2,2,4,26,5,3,13624,111,5962
4100,경기도,4135,용인시처인구,,관내사전투표,5337,5337,2729,2407,124,3,26,0,0,1,1,12,4,0,5307,30,0
4100,경기도,4135,용인시처인구,,중앙동제1투,1664,833,357,411,28,2,22,0,0,0,1,2,0,1,824,9,831
4100,경기도,4135,용인시처인구,,중앙동제2투,1248,772,314,413,19,0,13,0,0,0,0,1,1,1,762,10,476
4100,경기도,4135,용인시처인구,,중앙동제3투,1240,838,359,439,15,0,15,0,0,0,2,0,0,0,830,8,402
4100,경기도,4135,용인시처인구,,중앙동제4투,1715,975,463,469,27,0,9,1,0,0,0,1,0,1,971,4,740
4100,경기도,4135,용인시처인구,,중앙동제5투,1937,1165,511,581,41,0,13,0,0,0,0,3,0,0,1149,16,772
4100,경기도,4135,용인시처인구,,중앙동제6투,4244,2307,998,1183,65,3,28,0,2,1,0,5,0,0,2285,22,1937
4100,경기도,4135,용인시처인구,,중앙동제7투,2312,1508,692,756,36,1,9,0,0,0,0,2,0,0,1496,12,804
4100,경기도,4135,용인시처인구,유림동,소계,26658,18393,9953,7618,426,6,186,5,1,3,10,21,7,14,18250,143,8265
4100,경기도,4135,용인시처인구,,관내사전투표,5262,5262,3114,1990,100,1,30,1,0,1,0,2,2,3,5244,18,0
4100,경기도,4135,용인시처인구,,유림동제1투,2175,1112,530,530,21,0,17,0,0,0,2,1,1,0,1102,10,1063
4100,경기도,4135,용인시처인구,,유림동제2투,3193,2067,1117,877,38,1,14,1,0,0,0,3,1,1,2053,14,1126
4100,경기도,4135,용인시처인구,,유림동제3투,3414,2033,943,975,49,0,35,0,0,1,2,6,1,2,2014,19,1381
4100,경기도,4135,용인시처인구,,유림동제4투,4004,2279,1182,958,53,3,42,2,0,0,4,3,0,4,2251,28,1725
4100,경기도,4135,용인시처인구,,유림동제5투,3610,2292,1224,945,65,0,26,1,1,0,1,1,1,2,2267,25,1318
4100,경기도,4135,용인시처인구,,유림동제6투,3322,2184,1182,900,61,1,15,0,0,1,1,3,1,1,2166,18,1138
4100,경기도,4135,용인시처인구,,유림동제7투,1678,1164,661,443,39,0,7,0,0,0,0,2,0,1,1153,11,514
4100,경기도,4135,용인시처인구,동부동,소계,11591,8521,4055,4093,199,7,86,0,1,2,8,11,2,3,8467,54,3070
4100,경기도,4135,용인시처인구,,관내사전투표,4046,4046,2097,1809,76,3,32,0,0,0,2,5,1,0,4025,21,0
4100,경기도,4135,용인시처인구,,동부동제1투,2745,1582,686,816,42,3,20,0,0,0,3,2,0,1,1573,9,1163
4100,경기도,4135,용인시처인구,,동부동제2투,3487,1997,944,943,62,1,26,0,0,1,1,3,0,0,1981,16,1490
4100,경기도,4135,용인시처인구,,동부동제3투,1313,896,328,525,19,0,8,0,1,1,2,1,1,2,888,8,417
4100,경기도,4135,용인시처인구,모현읍,소계,20126,14028,7077,6411,273,8,114,1,4,7,7,10,7,3,13922,106,6098
4100,경기도,4135,용인시처인구,,관내사전투표,4339,4339,2366,1869,62,2,14,0,0,1,1,2,2,1,4320,19,0
4100,경기도,4135,용인시처인구,,모현읍제1투,3031,1769,948,730,43,2,24,1,1,1,2,0,0,1,1753,16,1262
4100,경기도,4135,용인시처인구,,모현읍제2투,1770,1104,455,609,19,1,10,0,0,0,0,1,3,0,1098,6,666
4100,경기도,4135,용인시처인구,,모현읍제3투,3650,2409,1209,1110,47,2,18,0,1,2,0,4,0,0,2393,16,1241
4100,경기도,4135,용인시처인구,,모현읍제4투,2630,1542,682,781,41,1,12,0,0,0,1,2,2,0,1522,20,1088
4100,경기도,4135,용인시처인구,,모현읍제5투,2350,1405,693,646,29,0,14,0,0,1,1,1,0,1,1386,19,945
4100,경기도,4135,용인시처인구,,모현읍제6투,2356,1460,724,666,32,0,22,0,2,2,2,0,0,0,1450,10,896
4100,경기도,4135,용인시처인구,이동읍,소계,16403,11225,5575,5183,210,3,135,2,1,3,6,9,4,7,11138,87,5178
4100,경기도,4135,용인시처인구,,관내사전투표,4545,4545,2459,1946,77,2,37,2,1,0,2,3,0,2,4531,14,0
4100,경기도,4135,용인시처인구,,이동읍제1투,2609,1495,689,728,24,0,28,0,0,1,1,2,2,0,1475,20,1114
4100,경기도,4135,용인시처인구,,이동읍제2투,567,360,106,238,3,0,2,0,0,1,1,0,0,0,351,9,207
4100,경기도,4135,용인시처인구,,이동읍제3투,849,499,165,302,13,0,11,0,0,0,1,0,0,1,493,6,350
4100,경기도,4135,용인시처인구,,이동읍제4투,3925,2238,1070,1060,47,0,38,0,0,0,1,0,2,3,2221,17,1687
4100,경기도,4135,용인시처인구,,이동읍제5투,3908,2088,1086,909,46,1,19,0,0,1,0,4,0,1,2067,21,1820
4100,경기도,4135,용인시처인구,남사읍,소계,15875,11766,5784,5601,209,2,67,2,2,4,18,6,2,3,11700,66,4109
4100,경기도,4135,용인시처인구,,관내사전투표,3315,3315,1779,1465,41,2,17,1,0,0,0,2,0,0,3307,8,0
4100,경기도,4135,용인시처인구,,남사읍제1투,987,564,190,349,8,0,3,0,1,1,4,0,0,0,556,8,423
4100,경기도,4135,용인시처인구,,남사읍제2투,558,355,105,236,4,0,5,0,1,0,0,1,0,0,352,3,203
4100,경기도,4135,용인시처인구,,남사읍제3투,987,678,239,416,13,0,4,0,0,0,0,0,1,0,673,5,309
4100,경기도,4135,용인시처인구,,남사읍제4투,923,577,202,343,8,0,9,0,0,1,2,0,0,0,565,12,346
4100,경기도,4135,용인시처인구,,남사읍제5투,3623,2401,1267,1056,45,0,13,0,0,1,6,2,0,2,2392,9,1222
4100,경기도,4135,용인시처인구,,남사읍제6투,3036,2040,1054,920,39,0,6,0,0,1,4,0,1,0,2025,15,996
4100,경기도,4135,용인시처인구,,남사읍제7투,2446,1836,948,816,51,0,10,1,0,0,2,1,0,1,1830,6,610
4100,경기도,4135,용인시처인구,역북동,소계,24299,17799,8954,8004,489,9,149,4,3,8,12,13,2,5,17652,147,6500
4100,경기도,4135,용인시처인구,,관내사전투표,7369,7369,4027,3064,178,4,36,2,2,2,2,4,1,0,7322,47,0
4100,경기도,4135,용인시처인구,,역북동제1투,1839,1032,447,515,36,1,18,0,0,0,4,2,0,2,1025,7,807
4100,경기도,4135,용인시처인구,,역북동제2투,3568,2052,991,942,70,1,28,0,0,0,0,4,0,0,2036,16,1516
4100,경기도,4135,용인시처인구,,역북동제3투,3152,1901,873,930,46,1,25,0,0,1,2,1,1,3,1883,18,1251
4100,경기도,4135,용인시처인구,,역북동제4투,2833,1634,675,856,51,2,19,1,1,1,1,1,0,0,1608,26,1199
4100,경기도,4135,용인시처인구,,역북동제5투,2669,1854,948,814,50,0,14,0,0,2,3,0,0,0,1831,23,815
4100,경기도,4135,용인시처인구,,역북동제6투,2869,1957,993,883,58,0,9,1,0,2,0,1,0,0,1947,10,912
4100,경기도,4135,용인시처인구,삼가동,소계,9586,7325,3619,3445,159,0,40,1,2,2,4,9,1,2,7284,41,2261
4100,경기도,4135,용인시처인구,,관내사전투표,2760,2760,1490,1179,63,0,16,0,1,0,0,2,0,1,2752,8,0
4100,경기도,4135,용인시처인구,,삼가동제1투,2247,1434,643,751,26,0,5,0,0,0,0,2,0,0,1427,7,813
4100,경기도,4135,용인시처인구,,삼가동제2투,2409,1640,726,853,32,0,10,1,0,2,3,2,0,1,1630,10,769
4100,경기도,4135,용인시처인구,,삼가동제3투,2170,1491,760,662,38,0,9,0,1,0,1,3,1,0,1475,16,679
4100,경기도,4135,용인시처인구,잘못 투입·구분된 투표지,,0,3,2,1,0,0,0,0,0,0,0,0,0,0,3,0,-3
4100,경기도,4136,용인시수지구,합계,,304545,250764,113161,128995,5334,81,831,32,34,73,146,98,26,54,248865,1899,53781
4100,경기도,4136,용인시수지구,거소·선상투표,,424,408,142,215,4,1,5,0,0,0,0,1,0,0,368,40,16
4100,경기도,4136,용인시수지구,관외사전투표,,30086,30077,14597,14417,644,21,138,8,3,4,9,7,6,9,29863,214,9
4100,경기도,4136,용인시수지구,재외투표,,3469,2544,1310,900,89,0,6,0,0,0,1,1,0,0,2307,237,925
4100,경기도,4136,용인시수지구,풍덕천1동,소계,29379,23303,10876,11512,548,10,97,3,3,8,16,16,2,6,23097,206,6076
4100,경기도,4136,용인시수지구,,관내사전투표,10004,10003,5206,4481,203,4,27,2,1,1,2,10,2,2,9941,62,1
4100,경기도,4136,용인시수지구,,풍덕천1동제1투,3111,1663,701,868,41,0,18,0,0,0,4,3,0,0,1635,28,1448
4100,경기도,4136,용인시수지구,,풍덕천1동제2투,2437,1528,616,832,46,2,9,0,0,2,1,1,0,0,1509,19,909
4100,경기도,4136,용인시수지구,,풍덕천1동제3투,2197,1557,739,753,37,1,7,0,0,0,0,0,0,1,1538,19,640
4100,경기도,4136,용인시수지구,,풍덕천1동제4투,2654,1975,872,1016,58,1,10,0,1,0,1,0,0,2,1961,14,679
4100,경기도,4136,용인시수지구,,풍덕천1동제5투,2417,1654,769,803,48,1,6,0,1,1,1,0,0,0,1630,24,763
4100,경기도,4136,용인시수지구,,풍덕천1동제6투,2628,1962,690,1196,46,0,13,0,0,1,3,1,0,1,1951,11,666
4100,경기도,4136,용인시수지구,,풍덕천1동제7투,2351,1756,774,907,43,0,5,0,0,1,4,1,0,0,1735,21,595
4100,경기도,4136,용인시수지구,,풍덕천1동제8투,1580,1205,509,656,26,1,2,1,0,2,0,0,0,0,1197,8,375
4100,경기도,4136,용인시수지구,풍덕천2동,소계,27836,22446,10953,10657,576,7,59,1,2,4,11,5,3,5,22283,163,5390
4100,경기도,4136,용인시수지구,,관내사전투표,7982,7982,4469,3309,146,3,17,0,1,1,3,1,0,0,7950,32,0
4100,경기도,4136,용인시수지구,,풍덕천2동제1투,2010,1546,747,722,52,0,4,0,1,0,2,0,0,0,1528,18,464
4100,경기도,4136,용인시수지구,,풍덕천2동제2투,1606,979,409,515,35,0,9,0,0,0,1,1,0,0,970,9,627
4100,경기도,4136,용인시수지구,,풍덕천2동제3투,2443,1872,759,1032,55,1,6,0,0,0,0,0,0,1,1854,18,571
4100,경기도,4136,용인시수지구,,풍덕천2동제4투,2085,1304,584,649,43,0,7,0,0,1,3,1,0,1,1289,15,781
4100,경기도,4136,용인시수지구,,풍덕천2동제5투,2453,1797,802,901,68,0,5,0,0,0,2,1,3,1,1783,14,656
4100,경기도,4136,용인시수지구,,풍덕천2동제6투,2323,1838,881,897,45,0,2,0,0,0,0,1,0,0,1826,12,485
4100,경기도,4136,용인시수지구,,풍덕천2동제7투,1867,1366,654,664,34,2,2,0,0,0,0,0,0,0,1356,10,501
4100,경기도,4136,용인시수지구,,풍덕천2동제8투,2835,2061,843,1128,63,1,5,1,0,0,0,0,0,2,2043,18,774
4100,경기도,4136,용인시수지구,,풍덕천2동제9투,2232,1701,805,840,35,0,2,0,0,2,0,0,0,0,1684,17,531
4100,경기도,4136,용인시수지구,신봉동,소계,28003,22718,9925,12127,406,5,80,3,3,11,17,4,3,6,22590,128,5285
4100,경기도,4136,용인시수지구,,관내사전투표,8280,8279,4247,3853,116,2,22,1,0,2,3,1,0,2,8249,30,1
4100,경기도,4136,용인시수지구,,신봉동제1투,1503,1099,504,552,26,0,4,0,1,1,4,0,1,0,1093,6,404
4100,경기도,4136,용인시수지구,,신봉동제2투,2006,1477,665,764,34,0,4,0,0,0,0,0,0,0,1467,10,529
4100,경기도,4136,용인시수지구,,신봉동제3투,3282,2466,1012,1364,47,0,9,1,1,0,0,2,1,2,2439,27,816
4100,경기도,4136,용인시수지구,,신봉동제4투,2770,2046,718,1257,44,0,8,0,0,2,3,0,0,0,2032,14,724
4100,경기도,4136,용인시수지구,,신봉동제5투,3071,2148,740,1342,38,0,11,0,0,5,1,0,0,0,2137,11,923
4100,경기도,4136,용인시수지구,,신봉동제6투,3375,2496,1029,1383,47,2,14,0,1,0,2,1,0,2,2481,15,879
4100,경기도,4136,용인시수지구,,신봉동제7투,3716,2707,1010,1612,54,1,8,1,0,1,4,0,1,0,2692,15,1009
4100,경기도,4136,용인시수지구,죽전1동,소계,21814,17614,8205,8887,335,5,51,2,0,4,11,10,0,5,17515,99,4200
4100,경기도,4136,용인시수지구,,관내사전투표,6781,6781,3558,3076,107,1,8,1,0,2,1,2,0,1,6757,24,0
4100,경기도,4136,용인시수지구,,죽전1동제1투,3529,2457,977,1396,53,1,11,0,0,0,1,1,0,0,2440,17,1072
4100,경기도,4136,용인시수지구,,죽전1동제2투,2941,2156,962,1121,47,0,5,0,0,0,3,3,0,0,2141,15,785
4100,경기도,4136,용인시수지구,,죽전1동제3투,2968,2164,907,1197,37,0,7,1,0,0,1,2,0,1,2153,11,804
4100,경기도,4136,용인시수지구,,죽전1동제4투,2700,1969,783,1106,41,2,12,0,0,1,2,2,0,1,1950,19,731
4100,경기도,4136,용인시수지구,,죽전1동제5투,2895,2087,1018,991,50,1,8,0,0,1,3,0,0,2,2074,13,808
4100,경기도,4136,용인시수지구,죽전2동,소계,12983,10253,4661,5237,245,3,24,1,3,1,9,4,1,1,10190,63,2730
4100,경기도,4136,용인시수지구,,관내사전투표,3206,3206,1678,1436,63,2,10,1,0,0,2,0,0,0,3192,14,0
4100,경기도,4136,용인시수지구,,죽전2동제1투,2863,1993,860,1057,54,1,1,0,0,0,2,1,1,1,1978,15,870
4100,경기도,4136,용인시수지구,,죽전2동제2투,2294,1570,633,865,47,0,4,0,2,0,0,2,0,0,1553,17,724
4100,경기도,4136,용인시수지구,,죽전2동제3투,2322,1750,708,993,38,0,5,0,1,0,0,0,0,0,1745,5,572
4100,경기도,4136,용인시수지구,,죽전2동제4투,2298,1734,782,886,43,0,4,0,0,1,5,1,0,0,1722,12,564
4100,경기도,4136,용인시수지구,동천동,소계,35443,28864,13127,14792,633,5,78,6,3,9,16,15,1,6,28691,173,6579
4100,경기도,4136,용인시수지구,,관내사전투표,12052,12051,6271,5477,215,1,22,2,1,0,4,7,0,3,12003,48,1
4100,경기도,4136,용인시수지구,,동천동제1투,2395,1517,591,842,53,0,8,0,0,1,2,0,0,0,1497,20,878
4100,경기도,4136,용인시수지구,,동천동제2투,2048,1404,574,788,22,2,4,1,0,0,0,1,0,0,1392,12,644
4100,경기도,4136,용인시수지구,,동천동제3투,2524,1908,792,1043,39,0,9,3,0,2,5,1,0,1,1895,13,616
4100,경기도,4136,용인시수지구,,동천동제4투,2513,1784,825,864,65,1,6,0,0,0,0,3,0,0,1764,20,729
4100,경기도,4136,용인시수지구,,동천동제5투,2130,1560,665,839,37,0,4,0,0,3,1,2,0,1,1552,8,570
4100,경기도,4136,용인시수지구,,동천동제6투,2098,1505,615,836,35,0,5,0,1,0,0,1,1,0,1494,11,593
4100,경기도,4136,용인시수지구,,동천동제7투,3042,2163,863,1226,54,0,6,0,1,1,1,0,0,0,2152,11,879
4100,경기도,4136,용인시수지구,,동천동제8투,2970,2245,760,1417,44,1,6,0,0,2,2,0,0,0,2232,13,725
4100,경기도,4136,용인시수지구,,동천동제9투,1811,1311,523,741,35,0,4,0,0,0,1,0,0,1,1305,6,500
4100,경기도,4136,용인시수지구,,동천동제10투,1860,1416,648,719,34,0,4,0,0,0,0,0,0,0,1405,11,444
4100,경기도,4136,용인시수지구,상현1동,소계,15166,12484,5629,6451,261,6,38,1,5,2,5,6,1,2,12407,77,2682
4100,경기도,4136,용인시수지구,,관내사전투표,5001,5001,2517,2376,74,1,14,1,0,2,0,1,0,1,4987,14,0
4100,경기도,4136,용인시수지구,,상현1동제1투,2502,1833,670,1104,38,1,4,0,0,0,1,2,0,0,1820,13,669
4100,경기도,4136,용인시수지구,,상현1동제2투,2634,1987,890,1016,56,2,6,0,2,0,0,2,0,1,1975,12,647
4100,경기도,4136,용인시수지구,,상현1동제3투,2573,1997,915,1002,47,0,9,0,2,0,1,1,0,0,1977,20,576
4100,경기도,4136,용인시수지구,,상현1동제4투,2456,1666,637,953,46,2,5,0,1,0,3,0,1,0,1648,18,790
4100,경기도,4136,용인시수지구,상현2동,소계,24599,20236,9340,10288,381,4,81,3,2,2,11,5,1,4,20122,114,4363
4100,경기도,4136,용인시수지구,,관내사전투표,8786,8785,4529,4072,127,0,25,0,0,0,0,0,1,0,8754,31,1
4100,경기도,4136,용인시수지구,,상현2동제1투,2581,1788,719,1008,39,1,5,1,0,0,2,0,0,0,1775,13,793
4100,경기도,4136,용인시수지구,,상현2동제2투,2422,1762,669,1029,33,0,7,0,0,0,4,3,0,0,1745,17,660
4100,경기도,4136,용인시수지구,,상현2동제3투,2247,1461,597,805,38,1,5,2,1,0,0,0,0,0,1449,12,786
4100,경기도,4136,용인시수지구,,상현2동제4투,3001,2186,951,1163,47,1,12,0,1,0,1,1,0,0,2177,9,815
4100,경기도,4136,용인시수지구,,상현2동제5투,2572,1910,767,1070,41,0,15,0,0,0,1,0,0,3,1897,13,662
4100,경기도,4136,용인시수지구,,상현2동제6투,2990,2344,1108,1141,56,1,12,0,0,2,3,1,0,1,2325,19,646
4100,경기도,4136,용인시수지구,성복동,소계,38699,31215,11073,19320,523,5,72,1,4,17,25,8,3,5,31056,159,7484
4100,경기도,4136,용인시수지구,,관내사전투표,9964,9964,4088,5720,117,1,11,0,1,5,0,1,1,1,9946,18,0
4100,경기도,4136,용인시수지구,,성복동제1투,2609,2012,602,1357,29,1,5,0,1,1,2,0,0,0,1998,14,597
4100,경기도,4136,용인시수지구,,성복동제2투,2955,2300,542,1694,39,1,8,0,0,0,1,1,1,0,2287,13,655
4100,경기도,4136,용인시수지구,,성복동제3투,2068,1418,377,1015,11,1,3,0,0,1,4,1,0,0,1413,5,650
4100,경기도,4136,용인시수지구,,성복동제4투,1437,1044,372,626,23,0,1,0,0,2,5,1,0,1,1031,13,393
4100,경기도,4136,용인시수지구,,성복동제5투,2014,1398,398,954,28,0,4,0,1,0,5,0,0,0,1390,8,616
4100,경기도,4136,용인시수지구,,성복동제6투,3314,2391,759,1553,49,0,8,1,1,4,2,0,1,0,2378,13,923
4100,경기도,4136,용인시수지구,,성복동제7투,2690,2007,744,1191,45,0,5,0,0,0,0,2,0,1,1988,19,683
4100,경기도,4136,용인시수지구,,성복동제8투,2989,1901,654,1194,29,0,11,0,0,2,1,0,0,0,1891,10,1088
4100,경기도,4136,용인시수지구,,성복동제9투,4156,3335,1299,1918,77,1,8,0,0,1,4,2,0,1,3311,24,821
4100,경기도,4136,용인시수지구,,성복동제10투,1882,1321,407,864,31,0,6,0,0,1,0,0,0,1,1310,11,561
4100,경기도,4136,용인시수지구,,성복동제11투,2621,2124,831,1234,45,0,2,0,0,0,1,0,0,0,2113,11,497
4100,경기도,4136,용인시수지구,죽전3동,소계,17842,13663,6463,6660,337,5,51,1,2,6,9,14,2,2,13552,111,4179
4100,경기도,4136,용인시수지구,,관내사전투표,4149,4149,2217,1803,85,2,11,1,0,2,1,5,1,0,4128,21,0
4100,경기도,4136,용인시수지구,,죽전3동제1투,2552,1559,684,785,40,1,12,0,2,3,3,3,1,0,1534,25,993
4100,경기도,4136,용인시수지구,,죽전3동제2투,2446,1707,697,933,51,0,8,0,0,0,1,2,0,1,1693,14,739
4100,경기도,4136,용인시수지구,,죽전3동제3투,3098,2253,1057,1128,51,2,2,0,0,0,1,0,0,1,2242,11,845
4100,경기도,4136,용인시수지구,,죽전3동제4투,2818,2064,942,1046,44,0,12,0,0,1,0,1,0,0,2046,18,754
4100,경기도,4136,용인시수지구,,죽전3동제5투,2779,1931,866,965,66,0,6,0,0,0,3,3,0,0,1909,22,848
4100,경기도,4136,용인시수지구,상현3동,소계,18802,14936,6858,7531,352,4,51,2,4,5,6,2,3,3,14821,115,3866
4100,경기도,4136,용인시수지구,,관내사전투표,5059,5059,2731,2188,101,0,14,1,0,0,0,0,0,0,5035,24,0
4100,경기도,4136,용인시수지구,,상현3동제1투,1887,1332,541,741,34,1,3,0,0,1,1,1,0,0,1323,9,555
4100,경기도,4136,용인시수지구,,상현3동제2투,2925,2232,769,1403,34,0,4,0,3,1,0,1,0,3,2218,14,693
4100,경기도,4136,용인시수지구,,상현3동제3투,1939,1426,561,806,40,0,9,0,0,2,0,0,0,0,1418,8,513
4100,경기도,4136,용인시수지구,,상현3동제4투,2641,1755,765,894,51,2,7,0,0,0,2,0,1,0,1722,33,886
4100,경기도,4136,용인시수지구,,상현3동제5투,2138,1437,695,683,34,0,5,1,1,1,2,0,1,0,1423,14,701
4100,경기도,4136,용인시수지구,,상현3동제6투,2213,1695,796,816,58,1,9,0,0,0,1,0,1,0,1682,13,518
4100,경기도,4136,용인시수지구,잘못 투입·구분된 투표지,,0,3,2,1,0,0,0,0,0,0,0,0,0,0,3,0,-3
4100,경기도,4137,용인시기흥구,합계,,361753,289459,143279,135606,6267,93,1477,40,31,75,150,188,37,84,287327,2132,72294
4100,경기도,4137,용인시기흥구,거소·선상투표,,508,483,174,233,6,0,8,0,1,1,0,0,1,2,426,57,25
4100,경기도,4137,용인시기흥구,관외사전투표,,35718,35714,18025,16202,826,14,243,10,3,7,10,41,3,21,35405,309,4
4100,경기도,4137,용인시기흥구,재외투표,,2985,2220,1278,700,59,1,4,0,0,0,0,1,0,1,2044,176,765
4100,경기도,4137,용인시기흥구,신갈동,소계,31087,24338,12404,10898,621,10,155,3,0,6,12,20,4,7,24140,198,6749
4100,경기도,4137,용인시기흥구,,관내사전투표,8820,8819,4868,3605,224,4,46,2,0,1,1,7,2,3,8763,56,1
4100,경기도,4137,용인시기흥구,,신갈동제1투,2509,1266,592,597,37,0,20,0,0,0,2,0,0,0,1248,18,1243
4100,경기도,4137,용인시기흥구,,신갈동제2투,2186,1404,654,682,44,1,8,0,0,0,0,2,0,0,1391,13,782
4100,경기도,4137,용인시기흥구,,신갈동제3투,1975,1250,608,590,21,0,12,0,0,1,0,3,0,1,1236,14,725
4100,경기도,4137,용인시기흥구,,신갈동제4투,2592,1827,933,819,39,1,13,0,0,0,0,2,0,2,1809,18,765
4100,경기도,4137,용인시기흥구,,신갈동제5투,2505,1837,825,927,49,2,11,1,0,1,1,3,0,0,1820,17,668
4100,경기도,4137,용인시기흥구,,신갈동제6투,2202,1704,902,732,44,1,9,0,0,0,1,2,0,0,1691,13,498
4100,경기도,4137,용인시기흥구,,신갈동제7투,3449,2546,1219,1231,61,0,9,0,0,2,5,0,1,0,2528,18,903
4100,경기도,4137,용인시기흥구,,신갈동제8투,2233,1778,888,824,49,1,5,0,0,1,2,0,0,1,1771,7,455
4100,경기도,4137,용인시기흥구,,신갈동제9투,2616,1907,915,891,53,0,22,0,0,0,0,1,1,0,1883,24,709
4100,경기도,4137,용인시기흥구,구갈동,소계,29374,22230,10876,10445,560,7,126,2,1,6,7,12,3,6,22051,179,7144
4100,경기도,4137,용인시기흥구,,관내사전투표,6460,6460,3626,2676,112,3,16,0,0,0,0,2,1,1,6437,23,0
4100,경기도,4137,용인시기흥구,,구갈동제1투,2590,1401,661,652,44,1,23,0,0,0,1,0,0,0,1382,19,1189
4100,경기도,4137,용인시기흥구,,구갈동제2투,2291,1409,638,687,37,0,23,0,0,2,2,0,0,0,1389,20,882
4100,경기도,4137,용인시기흥구,,구갈동제3투,3775,2437,1106,1206,79,1,12,0,0,0,2,3,0,2,2411,26,1338
4100,경기도,4137,용인시기흥구,,구갈동제4투,2163,1635,767,793,41,1,14,0,0,1,0,2,1,2,1622,13,528
4100,경기도,4137,용인시기흥구,,구갈동제5투,2429,1680,739,857,48,1,10,1,0,1,0,0,1,0,1658,22,749
4100,경기도,4137,용인시기흥구,,구갈동제6투,1373,1037,540,460,22,0,4,0,1,0,0,1,0,1,1029,8,336
4100,경기도,4137,용인시기흥구,,구갈동제7투,1504,1066,523,497,31,0,4,0,0,0,0,1,0,0,1056,10,438
4100,경기도,4137,용인시기흥구,,구갈동제8투,3610,2730,1234,1379,85,0,10,0,0,1,1,2,0,0,2712,18,880
4100,경기도,4137,용인시기흥구,,구갈동제9투,3179,2375,1042,1238,61,0,10,1,0,1,1,1,0,0,2355,20,804
4100,경기도,4137,용인시기흥구,상갈동,소계,10886,8432,4471,3607,217,4,54,0,1,1,5,7,2,4,8373,59,2454
4100,경기도,4137,용인시기흥구,,관내사전투표,4160,4160,2441,1586,85,2,15,0,0,0,1,3,1,3,4137,23,0
4100,경기도,4137,용인시기흥구,,상갈동제1투,2308,1323,618,628,44,1,14,0,0,0,1,3,0,0,1309,14,985
4100,경기도,4137,용인시기흥구,,상갈동제2투,2408,1448,718,647,46,1,15,0,1,0,3,1,0,1,1433,15,960
4100,경기도,4137,용인시기흥구,,상갈동제3투,2010,1501,694,746,42,0,10,0,0,1,0,0,1,0,1494,7,509
4100,경기도,4137,용인시기흥구,기흥동,소계,15401,10952,5121,5457,212,4,70,2,4,4,14,4,1,5,10898,54,4449
4100,경기도,4137,용인시기흥구,,관내사전투표,3989,3989,2062,1819,70,1,19,0,2,0,4,2,1,1,3981,8,0
4100,경기도,4137,용인시기흥구,,기흥동제1투,2341,1414,626,728,31,1,13,0,0,2,0,2,0,1,1404,10,927
4100,경기도,4137,용인시기흥구,,기흥동제2투,2187,1367,734,582,34,0,5,0,0,0,3,0,0,2,1360,7,820
4100,경기도,4137,용인시기흥구,,기흥동제3투,736,414,143,256,7,0,3,0,0,0,2,0,0,0,411,3,322
4100,경기도,4137,용인시기흥구,,기흥동제4투,3189,1761,853,828,43,2,15,1,2,0,2,0,0,0,1746,15,1428
4100,경기도,4137,용인시기흥구,,기흥동제5투,2959,2007,703,1244,27,0,15,1,0,2,3,0,0,1,1996,11,952
4100,경기도,4137,용인시기흥구,서농동,소계,18396,14317,7132,6602,343,3,70,1,2,1,6,8,2,6,14176,141,4079
4100,경기도,4137,용인시기흥구,,관내사전투표,5225,5226,2962,2115,101,0,17,0,0,0,0,2,0,1,5198,28,-1
4100,경기도,4137,용인시기흥구,,서농동제1투,1384,717,232,441,14,1,6,0,0,0,0,0,0,0,694,23,667
4100,경기도,4137,용인시기흥구,,서농동제2투,2559,1928,822,1011,59,0,8,0,2,1,0,2,1,2,1908,20,631
4100,경기도,4137,용인시기흥구,,서농동제3투,2480,1676,718,872,48,2,8,0,0,0,1,0,0,2,1651,25,804
4100,경기도,4137,용인시기흥구,,서농동제4투,2281,1443,665,705,37,0,15,1,0,0,3,1,0,1,1428,15,838
4100,경기도,4137,용인시기흥구,,서농동제5투,2608,1955,1060,815,49,0,9,0,0,0,1,3,1,0,1938,17,653
4100,경기도,4137,용인시기흥구,,서농동제6투,1859,1372,673,643,35,0,7,0,0,0,1,0,0,0,1359,13,487
4100,경기도,4137,용인시기흥구,구성동,소계,30386,23800,10998,12100,421,7,106,3,2,6,11,17,3,3,23677,123,6586
4100,경기도,4137,용인시기흥구,,관내사전투표,8448,8448,4328,3936,130,2,20,1,0,1,0,5,1,2,8426,22,0
4100,경기도,4137,용인시기흥구,,구성동제1투,3522,2304,814,1426,35,2,5,0,1,2,2,2,0,1,2290,14,1218
4100,경기도,4137,용인시기흥구,,구성동제2투,2774,1990,712,1208,42,1,13,1,0,1,2,2,0,0,1982,8,784
4100,경기도,4137,용인시기흥구,,구성동제3투,2835,1916,831,1030,32,1,14,0,0,0,0,3,1,0,1912,4,919
4100,경기도,4137,용인시기흥구,,구성동제4투,2689,2117,878,1159,50,0,8,0,0,0,1,2,0,0,2098,19,572
4100,경기도,4137,용인시기흥구,,구성동제5투,1560,1244,605,599,28,0,2,0,1,0,0,0,0,0,1235,9,316
4100,경기도,4137,용인시기흥구,,구성동제6투,3166,2071,1050,954,35,1,14,1,0,1,1,1,0,0,2058,13,1095
4100,경기도,4137,용인시기흥구,,구성동제7투,2963,2041,964,1002,28,0,24,0,0,0,1,2,0,0,2021,20,922
4100,경기도,4137,용인시기흥구,,구성동제8투,2429,1669,816,786,41,0,6,0,0,1,4,0,1,0,1655,14,760
4100,경기도,4137,용인시기흥구,마북동,소계,24323,19389,8275,10538,341,7,88,1,0,3,10,9,3,2,19277,112,4934
4100,경기도,4137,용인시기흥구,,관내사전투표,7303,7303,3608,3556,103,0,16,1,0,0,2,0,0,0,7286,17,0
4100,경기도,4137,용인시기흥구,,마북동제1투,2512,1586,612,899,35,0,17,0,0,0,2,1,0,0,1566,20,926
4100,경기도,4137,용인시기흥구,,마북동제2투,2343,1631,570,1005,30,0,13,0,0,1,2,1,0,0,1622,9,712
4100,경기도,4137,용인시기흥구,,마북동제3투,2781,1916,851,989,38,1,17,0,0,2,0,1,0,0,1899,17,865
4100,경기도,4137,용인시기흥구,,마북동제4투,2436,1923,630,1244,31,0,6,0,0,0,0,0,0,0,1911,12,513
4100,경기도,4137,용인시기흥구,,마북동제5투,2350,1745,749,929,35,4,11,0,0,0,1,2,1,1,1733,12,605
4100,경기도,4137,용인시기흥구,,마북동제6투,1828,1337,452,837,29,0,6,0,0,0,2,2,1,0,1329,8,491
4100,경기도,4137,용인시기흥구,,마북동제7투,2770,1948,803,1079,40,2,2,0,0,0,1,2,1,1,1931,17,822
4100,경기도,4137,용인시기흥구,상하동,소계,18410,14158,7274,6372,302,3,78,4,0,11,11,9,3,5,14072,86,4252
4100,경기도,4137,용인시기흥구,,관내사전투표,5410,5410,3062,2200,100,0,19,3,0,2,1,4,0,1,5392,18,0
4100,경기도,4137,용인시기흥구,,상하동제1투,3139,1922,906,930,46,0,15,0,0,1,5,3,0,0,1906,16,1217
4100,경기도,4137,용인시기흥구,,상하동제2투,3055,2062,995,978,45,2,15,0,0,3,3,2,3,0,2046,16,993
4100,경기도,4137,용인시기흥구,,상하동제3투,2402,1726,832,822,44,0,15,0,0,1,1,0,0,1,1716,10,676
4100,경기도,4137,용인시기흥구,,상하동제4투,2544,1653,792,795,41,1,8,1,0,1,0,0,0,2,1641,12,891
4100,경기도,4137,용인시기흥구,,상하동제5투,1860,1385,687,647,26,0,6,0,0,3,1,0,0,1,1371,14,475
4100,경기도,4137,용인시기흥구,보정동,소계,24880,19625,8224,10788,387,4,74,2,3,4,13,3,6,7,19515,110,5255
4100,경기도,4137,용인시기흥구,,관내사전투표,6258,6258,3070,3036,100,2,22,1,1,1,4,2,1,0,6240,18,0
4100,경기도,4137,용인시기흥구,,보정동제1투,3670,2348,952,1302,48,0,19,1,0,1,1,0,1,1,2326,22,1322
4100,경기도,4137,용인시기흥구,,보정동제2투,2867,2140,604,1481,36,0,3,0,0,1,1,0,0,0,2126,14,727
4100,경기도,4137,용인시기흥구,,보정동제3투,3768,2803,1045,1652,68,0,10,0,1,0,1,0,0,2,2779,24,965
4100,경기도,4137,용인시기흥구,,보정동제4투,2537,1864,771,1018,46,0,8,0,1,0,2,1,2,1,1850,14,673
4100,경기도,4137,용인시기흥구,,보정동제5투,2354,1739,681,1015,26,1,5,0,0,1,3,0,1,1,1734,5,615
4100,경기도,4137,용인시기흥구,,보정동제6투,2332,1716,797,848,51,1,5,0,0,0,1,0,1,2,1706,10,616
4100,경기도,4137,용인시기흥구,,보정동제7투,1094,757,304,436,12,0,2,0,0,0,0,0,0,0,754,3,337
4100,경기도,4137,용인시기흥구,영덕1동,소계,21126,16450,8499,7394,374,3,61,0,1,6,8,3,2,3,16354,96,4676
4100,경기도,4137,용인시기흥구,,관내사전투표,6087,6087,3559,2390,106,0,8,0,0,1,2,0,0,1,6067,20,0
4100,경기도,4137,용인시기흥구,,영덕1동제1투,1907,1298,624,620,25,0,12,0,0,2,2,2,1,0,1288,10,609
4100,경기도,4137,용인시기흥구,,영덕1동제2투,2075,1597,713,820,42,0,9,0,0,0,1,1,1,0,1587,10,478
4100,경기도,4137,용인시기흥구,,영덕1동제3투,2913,2180,1025,1056,72,1,9,0,0,1,0,0,0,1,2165,15,733
4100,경기도,4137,용인시기흥구,,영덕1동제4투,2927,1793,901,830,35,2,10,0,0,1,2,0,0,1,1782,11,1134
4100,경기도,4137,용인시기흥구,,영덕1동제5투,2837,2005,1036,902,56,0,2,0,0,0,1,0,0,0,1997,8,832
4100,경기도,4137,용인시기흥구,,영덕1동제6투,2380,1490,641,776,38,0,11,0,1,1,0,0,0,0,1468,22,890
4100,경기도,4137,용인시기흥구,영덕2동,소계,12957,10129,5129,4619,232,3,64,2,0,5,2,6,1,4,10067,62,2828
4100,경기도,4137,용인시기흥구,,관내사전투표,4164,4164,2400,1624,98,1,13,1,0,1,0,3,0,3,4144,20,0
4100,경기도,4137,용인시기흥구,,영덕2동제1투,2983,2071,797,1199,37,2,18,0,0,3,2,1,0,0,2059,12,912
4100,경기도,4137,용인시기흥구,,영덕2동제2투,3323,2148,1051,996,60,0,23,0,0,1,0,1,0,1,2133,15,1175
4100,경기도,4137,용인시기흥구,,영덕2동제3투,2487,1746,881,800,37,0,10,1,0,0,0,1,1,0,1731,15,741
4100,경기도,4137,용인시기흥구,보라동,소계,24875,19275,10040,8626,350,9,94,5,3,6,7,7,1,4,19152,123,5600
4100,경기도,4137,용인시기흥구,,관내사전투표,6861,6861,4057,2651,101,2,22,0,1,1,0,3,0,1,6839,22,0
4100,경기도,4137,용인시기흥구,,보라동제1투,1682,1038,494,496,20,0,7,0,0,0,0,2,0,2,1021,17,644
4100,경기도,4137,용인시기흥구,,보라동제2투,1748,1247,580,618,23,2,6,0,0,0,4,0,0,0,1233,14,501
4100,경기도,4137,용인시기흥구,,보라동제3투,2768,2043,875,1097,47,1,7,1,0,0,1,0,0,0,2029,14,725
4100,경기도,4137,용인시기흥구,,보라동제4투,3140,2157,1089,1001,34,0,13,0,1,1,2,0,0,1,2142,15,983
4100,경기도,4137,용인시기흥구,,보라동제5투,3021,1866,900,899,29,1,15,1,1,2,0,1,0,0,1849,17,1155
4100,경기도,4137,용인시기흥구,,보라동제6투,3076,2166,1187,878,60,3,15,3,0,2,0,1,0,0,2149,17,910
4100,경기도,4137,용인시기흥구,,보라동제7투,2579,1897,858,986,36,0,9,0,0,0,0,0,1,0,1890,7,682
4100,경기도,4137,용인시기흥구,동백1동,소계,22888,18163,10431,7082,432,7,75,3,6,4,12,19,1,1,18073,90,4725
4100,경기도,4137,용인시기흥구,,관내사전투표,7253,7253,4609,2452,150,4,13,0,0,0,0,9,0,0,7237,16,0
4100,경기도,4137,용인시기흥구,,동백1동제1투,3009,2181,1221,875,50,2,6,0,2,2,6,4,0,0,2168,13,828
4100,경기도,4137,용인시기흥구,,동백1동제2투,2486,1688,827,789,41,0,15,1,1,2,3,1,0,0,1680,8,798
4100,경기도,4137,용인시기흥구,,동백1동제3투,2639,1869,1029,760,52,0,13,0,2,0,2,0,1,0,1859,10,770
4100,경기도,4137,용인시기흥구,,동백1동제4투,2614,1801,949,779,37,0,11,0,0,0,0,2,0,0,1778,23,813
4100,경기도,4137,용인시기흥구,,동백1동제5투,2977,2017,1083,863,45,0,11,1,1,0,1,1,0,0,2006,11,960
4100,경기도,4137,용인시기흥구,,동백1동제6투,1910,1354,713,564,57,1,6,1,0,0,0,2,0,1,1345,9,556
4100,경기도,4137,용인시기흥구,동백2동,소계,19816,15915,8339,7079,314,3,64,1,4,1,7,17,0,2,15831,84,3901
4100,경기도,4137,용인시기흥구,,관내사전투표,6650,6650,3876,2630,97,1,15,1,0,0,1,5,0,1,6627,23,0
4100,경기도,4137,용인시기흥구,,동백2동제1투,2459,1829,886,870,49,1,7,0,0,0,4,3,0,0,1820,9,630
4100,경기도,4137,용인시기흥구,,동백2동제2투,3892,2577,1147,1341,56,0,10,0,3,1,0,1,0,1,2560,17,1315
4100,경기도,4137,용인시기흥구,,동백2동제3투,1781,1327,656,609,38,1,9,0,0,0,1,0,0,0,1314,13,454
4100,경기도,4137,용인시기흥구,,동백2동제4투,1905,1355,692,621,22,0,11,0,0,0,0,1,0,0,1347,8,550
4100,경기도,4137,용인시기흥구,,동백2동제5투,3129,2177,1082,1008,52,0,12,0,1,0,1,7,0,0,2163,14,952
4100,경기도,4137,용인시기흥구,동백3동,소계,17737,13865,6589,6860,270,4,43,1,0,3,15,5,1,1,13792,73,3872
4100,경기도,4137,용인시기흥구,,관내사전투표,4408,4408,2478,1817,82,0,8,0,0,2,1,3,1,0,4392,16,0
4100,경기도,4137,용인시기흥구,,동백3동제1투,3419,2309,1148,1078,52,3,14,0,0,0,2,0,0,0,2297,12,1110
4100,경기도,4137,용인시기흥구,,동백3동제2투,2733,1955,954,935,40,0,4,1,0,0,7,1,0,0,1942,13,778
4100,경기도,4137,용인시기흥구,,동백3동제3투,3976,2698,1278,1317,65,1,12,0,0,1,3,0,0,0,2677,21,1278
4100,경기도,4137,용인시기흥구,,동백3동제4투,1781,1479,258,1198,10,0,4,0,0,0,2,0,0,0,1472,7,302
4100,경기도,4137,용인시기흥구,,동백3동제5투,1420,1016,473,515,21,0,1,0,0,0,0,1,0,1,1012,4,404
4100,경기도,4137,용인시기흥구,잘못 투입·구분된 투표지,,0,4,0,4,0,0,0,0,0,0,0,0,0,0,4,0,-4
4100,경기도,4138,안성시,합계,,162452,117380,56723,54799,2892,87,1238,24,20,30,75,156,25,54,116123,1257,45072
4100,경기도,4138,안성시,거소·선상투표,,279,244,95,108,5,1,10,0,1,0,0,1,0,0,221,23,35
4100,경기도,4138,안성시,관외사전투표,,11813,11804,5734,5451,301,6,162,4,2,4,5,18,3,4,11694,110,9
4100,경기도,4138,안성시,재외투표,,611,436,282,104,13,0,2,0,0,0,0,0,0,0,401,35,175
4100,경기도,4138,안성시,공도읍,소계,43183,28526,15602,11563,693,12,291,6,3,11,14,36,5,9,28245,281,14657
4100,경기도,4138,안성시,,관내사전투표,8931,8931,5237,3362,196,3,49,2,0,3,0,13,3,4,8872,59,0
4100,경기도,4138,안성시,,공도읍제1투,4146,2477,1275,1085,60,2,28,0,0,0,1,2,0,0,2453,24,1669
4100,경기도,4138,안성시,,공도읍제2투,1667,899,460,383,28,1,9,0,0,2,0,0,0,0,883,16,768
4100,경기도,4138,안성시,,공도읍제3투,3168,1708,872,752,40,1,21,0,1,2,0,3,0,1,1693,15,1460
4100,경기도,4138,안성시,,공도읍제4투,3445,1574,802,685,34,0,27,1,1,0,0,1,0,0,1551,23,1871
4100,경기도,4138,안성시,,공도읍제5투,3491,2178,1137,939,51,1,15,2,0,0,3,3,1,1,2153,25,1313
4100,경기도,4138,안성시,,공도읍제6투,2617,1493,776,639,31,1,25,0,0,0,2,1,0,1,1476,17,1124
4100,경기도,4138,안성시,,공도읍제7투,4343,2276,1100,1048,54,1,37,0,0,1,4,4,0,0,2249,27,2067
4100,경기도,4138,안성시,,공도읍제8투,3031,1697,975,631,43,0,24,0,0,1,2,0,0,0,1676,21,1334
4100,경기도,4138,안성시,,공도읍제9투,1638,1047,582,409,24,0,18,0,0,0,1,3,0,0,1037,10,591
4100,경기도,4138,안성시,,공도읍제10투,2964,1802,971,727,56,0,24,0,0,0,1,4,1,1,1785,17,1162
4100,경기도,4138,안성시,,공도읍제11투,3742,2444,1415,903,76,2,14,1,1,2,0,2,0,1,2417,27,1298
4100,경기도,4138,안성시,보개면,소계,5186,4054,1698,2164,88,2,32,0,3,1,2,7,0,5,4002,52,1132
4100,경기도,4138,안성시,,관내사전투표,2352,2352,1098,1150,60,0,15,0,1,0,0,4,0,3,2331,21,0
4100,경기도,4138,안성시,,보개면제1투,914,491,195,266,12,1,7,0,0,1,1,1,0,0,484,7,423
4100,경기도,4138,안성시,,보개면제2투,463,289,90,182,6,0,4,0,2,0,0,2,0,0,286,3,174
4100,경기도,4138,안성시,,보개면제3투,922,569,210,337,6,0,6,0,0,0,1,0,0,0,560,9,353
4100,경기도,4138,안성시,,보개면제4투,535,353,105,229,4,1,0,0,0,0,0,0,0,2,341,12,182
4100,경기도,4138,안성시,금광면,소계,6113,4565,2182,2152,105,5,45,1,0,1,6,10,1,5,4513,52,1548
4100,경기도,4138,안성시,,관내사전투표,1783,1783,901,811,41,1,12,1,0,0,1,5,0,3,1776,7,0
4100,경기도,4138,안성시,,금광면제1투,968,626,234,348,20,2,8,0,0,0,1,2,0,1,616,10,342
4100,경기도,4138,안성시,,금광면제2투,473,304,102,185,8,0,4,0,0,1,0,0,0,0,300,4,169
4100,경기도,4138,안성시,,금광면제3투,555,343,135,191,6,0,5,0,0,0,1,1,0,0,339,4,212
4100,경기도,4138,안성시,,금광면제4투,401,266,79,172,2,2,4,0,0,0,3,1,0,1,264,2,135
4100,경기도,4138,안성시,,금광면제5투,1933,1243,731,445,28,0,12,0,0,0,0,1,1,0,1218,25,690
4100,경기도,4138,안성시,서운면,소계,3190,2446,1018,1300,55,3,27,0,0,0,3,6,0,1,2413,33,744
4100,경기도,4138,안성시,,관내사전투표,1391,1391,660,670,26,3,14,0,0,0,0,5,0,0,1378,13,0
4100,경기도,4138,안성시,,서운면제1투,900,494,171,288,14,0,6,0,0,0,3,1,0,0,483,11,406
4100,경기도,4138,안성시,,서운면제2투,415,266,76,178,6,0,3,0,0,0,0,0,0,0,263,3,149
4100,경기도,4138,안성시,,서운면제3투,484,295,111,164,9,0,4,0,0,0,0,0,0,1,289,6,189
4100,경기도,4138,안성시,미양면,소계,5152,3617,1675,1765,80,5,34,2,1,1,9,5,1,2,3580,37,1535
4100,경기도,4138,안성시,,관내사전투표,1774,1774,911,783,39,3,15,2,1,0,3,4,0,0,1761,13,0
4100,경기도,4138,안성시,,미양면제1투,1051,576,246,289,14,0,11,0,0,1,4,0,1,1,567,9,475
4100,경기도,4138,안성시,,미양면제2투,1471,767,336,392,18,2,6,0,0,0,2,0,0,1,757,10,704
4100,경기도,4138,안성시,,미양면제3투,856,500,182,301,9,0,2,0,0,0,0,1,0,0,495,5,356
4100,경기도,4138,안성시,대덕면,소계,12480,8365,4231,3721,208,5,94,2,0,1,5,17,1,2,8287,78,4115
4100,경기도,4138,안성시,,관내사전투표,3597,3597,1951,1492,93,1,25,0,0,1,1,10,0,1,3575,22,0
4100,경기도,4138,안성시,,대덕면제1투,1191,678,268,378,11,1,9,0,0,0,0,2,0,0,669,9,513
4100,경기도,4138,안성시,,대덕면제2투,1166,695,319,348,11,0,7,0,0,0,2,1,1,0,689,6,471
4100,경기도,4138,안성시,,대덕면제3투,3261,1364,608,672,25,2,32,2,0,0,0,0,0,1,1342,22,1897
4100,경기도,4138,안성시,,대덕면제4투,3265,2031,1085,831,68,1,21,0,0,0,2,4,0,0,2012,19,1234
4100,경기도,4138,안성시,양성면,소계,4619,3370,1317,1903,68,2,30,1,0,0,6,3,1,0,3331,39,1249
4100,경기도,4138,안성시,,관내사전투표,1657,1657,744,836,41,1,17,0,0,0,1,0,0,0,1640,17,0
4100,경기도,4138,안성시,,양성면제1투,1061,598,208,367,10,0,3,0,0,0,4,1,0,0,593,5,463
4100,경기도,4138,안성시,,양성면제2투,833,539,171,349,7,0,2,1,0,0,0,1,0,0,531,8,294
4100,경기도,4138,안성시,,양성면제3투,1068,576,194,351,10,1,8,0,0,0,1,1,1,0,567,9,492
4100,경기도,4138,안성시,원곡면,소계,5253,3623,1610,1846,77,2,44,0,0,2,1,5,1,4,3592,31,1630
4100,경기도,4138,안성시,,관내사전투표,1528,1528,716,766,25,0,10,0,0,1,0,2,1,0,1521,7,0
4100,경기도,4138,안성시,,원곡면제1투,2395,1245,510,659,25,2,24,0,0,1,1,3,0,4,1229,16,1150
4100,경기도,4138,안성시,,원곡면제2투,894,576,291,251,21,0,7,0,0,0,0,0,0,0,570,6,318
4100,경기도,4138,안성시,,원곡면제3투,436,274,93,170,6,0,3,0,0,0,0,0,0,0,272,2,162
4100,경기도,4138,안성시,일죽면,소계,6198,4491,1693,2592,82,4,49,0,0,0,4,1,4,1,4430,61,1707
4100,경기도,4138,안성시,,관내사전투표,2180,2180,847,1259,33,3,17,0,0,0,1,1,2,0,2163,17,0
4100,경기도,4138,안성시,,일죽면제1투,1157,602,233,332,13,0,8,0,0,0,0,0,0,1,587,15,555
4100,경기도,4138,안성시,,일죽면제2투,1127,672,272,363,17,0,5,0,0,0,3,0,0,0,660,12,455
4100,경기도,4138,안성시,,일죽면제3투,1026,627,216,372,15,1,10,0,0,0,0,0,2,0,616,11,399
4100,경기도,4138,안성시,,일죽면제4투,708,410,125,266,4,0,9,0,0,0,0,0,0,0,404,6,298
4100,경기도,4138,안성시,죽산면,소계,6012,4313,1757,2354,63,9,62,1,2,2,2,2,3,2,4259,54,1699
4100,경기도,4138,안성시,,관내사전투표,2457,2457,1018,1367,28,6,21,1,1,0,2,0,2,0,2446,11,0
4100,경기도,4138,안성시,,죽산면제1투,1909,999,413,529,15,1,21,0,0,0,0,1,0,0,980,19,910
4100,경기도,4138,안성시,,죽산면제2투,1150,566,228,278,16,2,14,0,1,2,0,1,1,2,545,21,584
4100,경기도,4138,안성시,,죽산면제3투,496,291,98,180,4,0,6,0,0,0,0,0,0,0,288,3,205
4100,경기도,4138,안성시,삼죽면,소계,3093,2260,889,1257,52,2,22,0,2,2,1,5,0,1,2233,27,833
4100,경기도,4138,안성시,,관내사전투표,1193,1192,511,627,24,2,8,0,0,1,1,3,0,1,1178,14,1
4100,경기도,4138,안성시,,삼죽면제1투,1157,642,209,393,14,0,13,0,2,1,0,2,0,0,634,8,515
4100,경기도,4138,안성시,,삼죽면제2투,743,426,169,237,14,0,1,0,0,0,0,0,0,0,421,5,317
4100,경기도,4138,안성시,고삼면,소계,2276,1889,830,981,31,3,12,0,1,0,2,4,0,1,1865,24,387
4100,경기도,4138,안성시,,관내사전투표,1270,1270,629,601,21,1,6,0,0,0,1,1,0,1,1261,9,0
4100,경기도,4138,안성시,,고삼면제1투,654,379,134,216,7,2,4,0,1,0,1,2,0,0,367,12,275
4100,경기도,4138,안성시,,고삼면제2투,352,240,67,164,3,0,2,0,0,0,0,1,0,0,237,3,112
4100,경기도,4138,안성시,안성1동,소계,10856,8007,3510,4099,214,10,72,2,1,3,6,7,1,4,7929,78,2849
4100,경기도,4138,안성시,,관내사전투표,4122,4122,1885,2078,88,5,28,1,0,2,2,4,0,3,4096,26,0
4100,경기도,4138,안성시,,안성1동제1투,1172,662,237,378,25,0,7,0,0,0,1,0,1,0,649,13,510
4100,경기도,4138,안성시,,안성1동제2투,1657,1045,454,527,36,2,12,0,1,1,1,0,0,0,1034,11,612
4100,경기도,4138,안성시,,안성1동제3투,2660,1469,666,723,47,2,13,1,0,0,0,2,0,1,1455,14,1191
4100,경기도,4138,안성시,,안성1동제4투,1245,709,268,393,18,1,12,0,0,0,2,1,0,0,695,14,536
4100,경기도,4138,안성시,안성2동,소계,19449,13590,6915,5983,374,9,148,1,3,1,4,11,1,8,13458,132,5859
4100,경기도,4138,안성시,,관내사전투표,6009,6009,3176,2573,159,3,47,0,0,0,1,6,0,4,5969,40,0
4100,경기도,4138,안성시,,안성2동제1투,3794,2002,955,937,62,1,23,0,0,0,0,2,1,1,1982,20,1792
4100,경기도,4138,안성시,,안성2동제2투,2919,1572,813,655,49,1,27,0,3,1,1,0,0,0,1550,22,1347
4100,경기도,4138,안성시,,안성2동제3투,2415,1509,737,708,28,1,19,1,0,0,0,1,0,0,1495,14,906
4100,경기도,4138,안성시,,안성2동제4투,607,394,171,198,10,0,5,0,0,0,1,1,0,2,388,6,213
4100,경기도,4138,안성시,,안성2동제5투,3705,2104,1063,912,66,3,27,0,0,0,1,1,0,1,2074,30,1601
4100,경기도,4138,안성시,안성3동,소계,16689,11774,5685,5450,383,7,102,4,1,1,5,18,3,5,11664,110,4915
4100,경기도,4138,안성시,,관내사전투표,4289,4288,2159,1949,124,2,19,1,0,0,3,7,0,1,4265,23,1
4100,경기도,4138,안성시,,안성3동제1투,3450,1984,989,877,81,0,14,0,0,0,1,5,1,1,1969,15,1466
4100,경기도,4138,안성시,,안성3동제2투,1350,868,445,355,37,1,10,2,0,0,0,2,0,1,853,15,482
4100,경기도,4138,안성시,,안성3동제3투,1182,668,293,334,18,0,9,0,1,0,0,0,0,0,655,13,514
4100,경기도,4138,안성시,,안성3동제4투,1865,1149,493,599,26,2,12,0,0,0,0,2,0,0,1134,15,716
4100,경기도,4138,안성시,,안성3동제5투,2104,1260,596,575,48,1,18,1,0,0,0,0,1,1,1241,19,844
4100,경기도,4138,안성시,,안성3동제6투,1042,611,261,317,19,0,8,0,0,0,0,1,1,0,607,4,431
4100,경기도,4138,안성시,,안성3동제7투,1407,946,449,444,30,1,12,0,0,1,1,1,0,1,940,6,461
4100,경기도,4138,안성시,잘못 투입·구분된 투표지,,0,6,0,6,0,0,0,0,0,0,0,0,0,0,6,0,-6
4100,경기도,4139,김포시,합계,,391889,302170,153206,136814,6905,114,2175,54,31,73,197,227,79,78,299953,2217,89719
4100,경기도,4139,김포시,거소·선상투표,,565,527,218,216,9,2,14,0,0,0,0,1,1,1,462,65,38
4100,경기도,4139,김포시,관외사전투표,,30250,30247,15442,13479,715,7,273,8,7,3,13,39,8,16,30010,237,3
4100,경기도,4139,김포시,재외투표,,2023,1504,898,420,47,0,3,0,0,3,0,2,0,0,1373,131,519
4100,경기도,4139,김포시,통진읍,소계,23083,15514,7375,7419,303,9,231,5,3,2,10,18,5,7,15387,127,7569
4100,경기도,4139,김포시,,관내사전투표,5472,5472,2925,2342,91,3,65,2,0,0,2,3,1,4,5438,34,0
4100,경기도,4139,김포시,,통진읍제1투,1732,1185,534,596,27,0,17,1,1,0,0,2,0,0,1178,7,547
4100,경기도,4139,김포시,,통진읍제2투,2516,1306,594,641,29,0,23,1,0,0,3,2,1,0,1294,12,1210
4100,경기도,4139,김포시,,통진읍제3투,2807,1656,798,768,30,3,28,0,0,0,2,2,1,0,1632,24,1151
4100,경기도,4139,김포시,,통진읍제4투,1151,761,243,487,14,1,9,0,0,0,0,1,0,0,755,6,390
4100,경기도,4139,김포시,,통진읍제5투,2103,1176,495,612,26,1,29,1,0,0,0,1,0,1,1166,10,927
4100,경기도,4139,김포시,,통진읍제6투,2571,1420,545,809,29,0,19,0,0,1,1,2,1,1,1408,12,1151
4100,경기도,4139,김포시,,통진읍제7투,1569,807,375,385,20,0,14,0,1,0,1,1,1,0,798,9,762
4100,경기도,4139,김포시,,통진읍제8투,3162,1731,866,779,37,1,27,0,1,1,1,4,0,1,1718,13,1431
4100,경기도,4139,김포시,고촌읍,소계,34177,27375,13117,13258,650,6,134,2,6,7,22,14,3,5,27224,151,6802
4100,경기도,4139,김포시,,관내사전투표,8803,8803,4760,3810,158,2,25,1,1,2,2,4,2,2,8769,34,0
4100,경기도,4139,김포시,,고촌읍제1투,2047,1175,474,628,43,1,9,0,0,0,4,1,0,2,1162,13,872
4100,경기도,4139,김포시,,고촌읍제2투,1131,780,221,526,19,0,7,1,0,0,1,0,0,0,775,5,351
4100,경기도,4139,김포시,,고촌읍제3투,2478,1691,743,874,40,0,19,0,1,0,1,1,0,0,1679,12,787
4100,경기도,4139,김포시,,고촌읍제4투,2620,1620,637,914,44,0,11,0,1,0,4,1,0,0,1612,8,1000
4100,경기도,4139,김포시,,고촌읍제5투,2671,1930,902,948,50,1,11,0,2,1,1,0,0,0,1916,14,741
4100,경기도,4139,김포시,,고촌읍제6투,2282,1787,761,970,37,0,4,0,0,0,0,1,0,0,1773,14,495
4100,경기도,4139,김포시,,고촌읍제7투,2893,2301,1106,1086,70,0,16,0,0,0,4,2,1,1,2286,15,592
4100,경기도,4139,김포시,,고촌읍제8투,3512,2711,1348,1256,76,0,10,0,1,3,1,1,0,0,2696,15,801
4100,경기도,4139,김포시,,고촌읍제9투,2560,2058,940,1042,51,2,10,0,0,0,1,1,0,0,2047,11,502
4100,경기도,4139,김포시,,고촌읍제10투,3180,2519,1225,1204,62,0,12,0,0,1,3,2,0,0,2509,10,661
4100,경기도,4139,김포시,양촌읍,소계,22685,15739,7978,7131,303,4,172,3,3,9,10,13,9,6,15641,98,6946
4100,경기도,4139,김포시,,관내사전투표,6004,5989,3372,2440,106,2,36,1,0,1,2,4,3,2,5969,20,15
4100,경기도,4139,김포시,,양촌읍제1투,2466,1265,565,641,14,0,26,0,1,0,1,3,2,0,1253,12,1201
4100,경기도,4139,김포시,,양촌읍제2투,1680,1008,490,469,27,0,10,0,0,1,0,0,0,1,998,10,672
4100,경기도,4139,김포시,,양촌읍제3투,903,569,218,326,12,0,10,0,0,0,0,0,1,0,567,2,334
4100,경기도,4139,김포시,,양촌읍제4투,2912,1741,848,822,31,1,20,0,0,0,2,1,0,0,1725,16,1171
4100,경기도,4139,김포시,,양촌읍제5투,365,188,55,125,1,0,4,0,0,0,1,0,0,0,186,2,177
4100,경기도,4139,김포시,,양촌읍제6투,198,134,44,80,4,0,4,0,0,0,1,0,0,0,133,1,64
4100,경기도,4139,김포시,,양촌읍제7투,789,545,183,337,13,0,7,1,0,1,0,0,0,1,543,2,244
4100,경기도,4139,김포시,,양촌읍제8투,2332,1424,740,610,28,0,18,1,0,4,1,3,2,0,1407,17,908
4100,경기도,4139,김포시,,양촌읍제9투,2795,1789,931,786,39,1,19,0,0,0,1,0,1,2,1780,9,1006
4100,경기도,4139,김포시,,양촌읍제10투,2241,1087,532,495,28,0,18,0,2,2,1,2,0,0,1080,7,1154
4100,경기도,4139,김포시,대곶면,소계,8575,5996,2370,3418,95,3,51,0,0,1,5,8,2,2,5955,41,2579
4100,경기도,4139,김포시,,관내사전투표,2514,2514,1151,1304,27,1,16,0,0,0,2,2,1,0,2504,10,0
4100,경기도,4139,김포시,,대곶면제1투,2074,1034,384,590,25,0,20,0,0,0,2,1,1,1,1024,10,1040
4100,경기도,4139,김포시,,대곶면제2투,1523,960,343,584,15,1,7,0,0,0,0,2,0,0,952,8,563
4100,경기도,4139,김포시,,대곶면제3투,796,451,176,262,6,1,1,0,0,1,0,1,0,1,449,2,345
4100,경기도,4139,김포시,,대곶면제4투,709,448,116,306,14,0,3,0,0,0,1,2,0,0,442,6,261
4100,경기도,4139,김포시,,대곶면제5투,959,589,200,372,8,0,4,0,0,0,0,0,0,0,584,5,370
4100,경기도,4139,김포시,월곶면,소계,5246,3833,1507,2120,65,6,57,2,1,4,3,8,2,2,3777,56,1413
4100,경기도,4139,김포시,,관내사전투표,2124,2124,963,1059,39,4,37,1,1,0,0,6,0,1,2111,13,0
4100,경기도,4139,김포시,,월곶면제1투,943,512,175,303,2,1,6,1,0,0,1,2,1,0,492,20,431
4100,경기도,4139,김포시,,월곶면제2투,362,235,68,137,11,0,4,0,0,1,0,0,0,1,222,13,127
4100,경기도,4139,김포시,,월곶면제3투,384,247,72,170,3,0,1,0,0,0,0,0,0,0,246,1,137
4100,경기도,4139,김포시,,월곶면제4투,1433,715,229,451,10,1,9,0,0,3,2,0,1,0,706,9,718
4100,경기도,4139,김포시,하성면,소계,7481,5501,2270,3022,89,1,63,0,0,2,3,1,2,1,5454,47,1980
4100,경기도,4139,김포시,,관내사전투표,2691,2691,1274,1341,37,0,20,0,0,0,1,0,1,1,2675,16,0
4100,경기도,4139,김포시,,하성면제1투,1894,958,395,510,20,0,17,0,0,0,2,1,1,0,946,12,936
4100,경기도,4139,김포시,,하성면제2투,785,532,200,306,8,0,10,0,0,2,0,0,0,0,526,6,253
4100,경기도,4139,김포시,,하성면제3투,736,463,148,299,8,1,3,0,0,0,0,0,0,0,459,4,273
4100,경기도,4139,김포시,,하성면제4투,934,598,167,402,12,0,11,0,0,0,0,0,0,0,592,6,336
4100,경기도,4139,김포시,,하성면제5투,441,259,86,164,4,0,2,0,0,0,0,0,0,0,256,3,182
4100,경기도,4139,김포시,사우동,소계,21770,16920,8714,7526,419,8,99,3,0,1,12,16,4,2,16804,116,4850
4100,경기도,4139,김포시,,관내사전투표,8713,8711,4842,3573,201,3,35,1,0,0,3,7,2,1,8668,43,2
4100,경기도,4139,김포시,,사우동제1투,2591,1306,592,635,36,2,16,1,0,0,3,3,0,0,1288,18,1285
4100,경기도,4139,김포시,,사우동제2투,2341,1295,587,649,31,2,13,0,0,0,2,1,1,0,1286,9,1046
4100,경기도,4139,김포시,,사우동제3투,2697,1833,849,907,44,1,7,0,0,0,2,1,1,1,1813,20,864
4100,경기도,4139,김포시,,사우동제4투,528,299,142,146,6,0,2,1,0,0,0,0,0,0,297,2,229
4100,경기도,4139,김포시,,사우동제5투,2774,1782,849,840,58,0,16,0,0,1,2,2,0,0,1768,14,992
4100,경기도,4139,김포시,,사우동제6투,2126,1694,853,776,43,0,10,0,0,0,0,2,0,0,1684,10,432
4100,경기도,4139,김포시,풍무동,소계,43898,33644,17135,15282,728,12,191,7,3,16,27,24,4,7,33436,208,10254
4100,경기도,4139,김포시,,관내사전투표,7966,7966,4490,3265,136,5,33,1,1,1,3,6,0,2,7943,23,0
4100,경기도,4139,김포시,,풍무동제1투,3472,2050,1026,919,59,1,20,0,1,0,1,2,0,1,2030,20,1422
4100,경기도,4139,김포시,,풍무동제2투,2444,1499,722,703,42,0,8,1,0,1,0,2,1,0,1480,19,945
4100,경기도,4139,김포시,,풍무동제3투,2813,2026,905,1034,48,0,9,2,0,4,5,1,1,1,2010,16,787
4100,경기도,4139,김포시,,풍무동제4투,2218,1494,781,644,46,1,12,0,1,0,1,1,0,0,1487,7,724
4100,경기도,4139,김포시,,풍무동제5투,3353,2285,1170,1018,57,0,13,3,0,0,2,1,1,2,2267,18,1068
4100,경기도,4139,김포시,,풍무동제6투,2638,1915,946,897,40,1,15,0,0,2,3,1,0,0,1905,10,723
4100,경기도,4139,김포시,,풍무동제7투,3239,2326,1243,1000,48,2,12,0,0,2,2,2,0,0,2311,15,913
4100,경기도,4139,김포시,,풍무동제8투,2956,2152,980,1122,38,0,6,0,0,1,0,0,0,0,2147,5,804
4100,경기도,4139,김포시,,풍무동제9투,2769,2065,1100,881,48,1,19,0,0,3,2,1,0,0,2055,10,704
4100,경기도,4139,김포시,,풍무동제10투,1239,896,364,496,9,0,8,0,0,0,3,5,0,1,886,10,343
4100,경기도,4139,김포시,,풍무동제11투,2099,1662,787,816,36,0,10,0,0,1,1,0,1,0,1652,10,437
4100,경기도,4139,김포시,,풍무동제12투,2598,2112,1065,963,55,1,12,0,0,0,2,0,0,0,2098,14,486
4100,경기도,4139,김포시,,풍무동제13투,4094,3196,1556,1524,66,0,14,0,0,1,2,2,0,0,3165,31,898
4100,경기도,4139,김포시,장기동,소계,30548,23650,12698,10079,560,15,133,6,2,4,9,12,7,4,23529,121,6898
4100,경기도,4139,김포시,,관내사전투표,9304,9303,5570,3477,182,9,30,4,0,0,3,4,1,0,9280,23,1
4100,경기도,4139,김포시,,장기동제1투,2930,1999,1066,838,61,0,17,0,1,0,0,1,0,0,1984,15,931
4100,경기도,4139,김포시,,장기동제2투,2615,1851,836,941,44,0,10,1,0,0,3,1,0,0,1836,15,764
4100,경기도,4139,김포시,,장기동제3투,2560,1463,638,739,38,3,19,0,0,2,0,3,4,0,1446,17,1097
4100,경기도,4139,김포시,,장기동제4투,3475,2545,1290,1152,70,0,15,0,0,0,1,2,0,1,2531,14,930
4100,경기도,4139,김포시,,장기동제5투,3463,1932,933,883,63,1,27,1,1,1,2,0,1,2,1915,17,1531
4100,경기도,4139,김포시,,장기동제6투,3393,2415,1244,1099,51,1,9,0,0,1,0,0,0,0,2405,10,978
4100,경기도,4139,김포시,,장기동제7투,2808,2142,1121,950,51,1,6,0,0,0,0,1,1,1,2132,10,666
4100,경기도,4139,김포시,구래동,소계,32995,23774,13124,9663,572,13,188,3,1,4,16,16,4,8,23612,162,9221
4100,경기도,4139,김포시,,관내사전투표,8183,8183,4917,2999,174,5,43,0,0,1,1,6,1,1,8148,35,0
4100,경기도,4139,김포시,,구래동제1투,2870,1208,618,519,25,0,21,0,0,0,1,0,0,0,1184,24,1662
4100,경기도,4139,김포시,,구래동제2투,3156,1997,1027,873,42,0,25,1,0,1,3,0,1,2,1975,22,1159
4100,경기도,4139,김포시,,구래동제3투,2300,1639,889,681,47,1,6,0,0,1,1,1,0,1,1628,11,661
4100,경기도,4139,김포시,,구래동제4투,3004,1849,959,812,43,1,14,1,0,0,3,3,1,2,1839,10,1155
4100,경기도,4139,김포시,,구래동제5투,3265,2109,1052,968,54,0,16,0,1,0,4,2,1,1,2099,10,1156
4100,경기도,4139,김포시,,구래동제6투,2956,2101,1169,852,52,1,18,0,0,1,0,0,0,1,2094,7,855
4100,경기도,4139,김포시,,구래동제7투,2276,1214,637,485,46,2,19,1,0,0,2,2,0,0,1194,20,1062
4100,경기도,4139,김포시,,구래동제8투,2233,1437,695,692,29,1,9,0,0,0,1,0,0,0,1427,10,796
4100,경기도,4139,김포시,,구래동제9투,2752,2037,1161,782,60,2,17,0,0,0,0,2,0,0,2024,13,715
4100,경기도,4139,김포시,운양동,소계,33180,25409,13146,11338,613,3,119,2,1,3,18,14,4,6,25267,142,7771
4100,경기도,4139,김포시,,관내사전투표,6853,6852,3865,2824,112,1,20,0,0,0,2,8,1,2,6835,17,1
4100,경기도,4139,김포시,,운양동제1투,3318,2418,1250,1083,56,0,12,0,0,0,2,0,0,0,2403,15,900
4100,경기도,4139,김포시,,운양동제2투,2795,1751,881,785,55,1,10,0,0,0,2,1,1,0,1736,15,1044
4100,경기도,4139,김포시,,운양동제3투,2113,1562,776,728,42,0,12,0,0,2,0,0,0,0,1560,2,551
4100,경기도,4139,김포시,,운양동제4투,2004,1527,767,682,51,0,4,0,1,0,1,3,0,0,1509,18,477
4100,경기도,4139,김포시,,운양동제5투,3241,2293,1104,1109,55,0,9,0,0,0,2,1,0,0,2280,13,948
4100,경기도,4139,김포시,,운양동제6투,2965,2063,1031,934,70,0,11,0,0,0,0,0,1,0,2047,16,902
4100,경기도,4139,김포시,,운양동제7투,3122,2333,1050,1216,38,0,10,1,0,0,3,0,0,1,2319,14,789
4100,경기도,4139,김포시,,운양동제8투,3203,2248,1186,966,53,1,16,0,0,0,4,0,0,2,2228,20,955
4100,경기도,4139,김포시,,운양동제9투,3566,2362,1236,1011,81,0,15,1,0,1,2,1,1,1,2350,12,1204
4100,경기도,4139,김포시,김포본동,소계,43172,32903,16033,15493,824,12,210,7,1,9,25,17,10,5,32646,257,10269
4100,경기도,4139,김포시,,관내사전투표,7435,7435,3976,3240,136,1,36,2,1,3,2,3,2,3,7405,30,0
4100,경기도,4139,김포시,,김포본동제1투,1529,840,378,406,35,1,5,0,0,0,2,0,1,0,828,12,689
4100,경기도,4139,김포시,,김포본동제2투,1567,950,426,492,11,0,3,0,0,0,1,2,0,0,935,15,617
4100,경기도,4139,김포시,,김포본동제3투,2053,1570,703,809,36,1,5,0,0,3,2,2,0,0,1561,9,483
4100,경기도,4139,김포시,,김포본동제4투,1494,963,444,471,25,0,7,0,0,0,2,0,2,0,951,12,531
4100,경기도,4139,김포시,,김포본동제5투,2362,1613,737,797,38,0,15,2,0,0,0,4,1,1,1595,18,749
4100,경기도,4139,김포시,,김포본동제6투,2274,1618,755,785,49,3,12,0,0,0,0,0,0,0,1604,14,656
4100,경기도,4139,김포시,,김포본동제7투,2136,1467,689,698,37,1,22,0,0,0,5,0,2,0,1454,13,669
4100,경기도,4139,김포시,,김포본동제8투,2477,1642,893,672,47,0,13,1,0,0,0,0,0,0,1626,16,835
4100,경기도,4139,김포시,,김포본동제9투,2770,1957,1025,838,49,0,22,0,0,0,1,0,0,1,1936,21,813
4100,경기도,4139,김포시,,김포본동제10투,3161,2223,978,1139,63,1,19,0,0,0,2,1,1,0,2204,19,938
4100,경기도,4139,김포시,,김포본동제11투,2811,2078,982,1021,40,1,12,2,0,0,4,2,0,0,2064,14,733
4100,경기도,4139,김포시,,김포본동제12투,2264,1576,645,863,36,0,9,0,0,1,1,1,0,0,1556,20,688
4100,경기도,4139,김포시,,김포본동제13투,1983,1517,843,607,47,0,7,0,0,0,0,0,0,0,1504,13,466
4100,경기도,4139,김포시,,김포본동제14투,2773,2184,1029,1050,70,2,17,0,0,2,3,1,0,0,2174,10,589
4100,경기도,4139,김포시,,김포본동제15투,4083,3270,1530,1605,105,1,6,0,0,0,0,1,1,0,3249,21,813
4100,경기도,4139,김포시,장기본동,소계,26727,20378,10441,9211,448,8,109,2,1,3,14,13,6,2,20258,120,6349
4100,경기도,4139,김포시,,관내사전투표,6573,6573,3623,2777,116,2,23,0,1,0,1,4,2,1,6550,23,0
4100,경기도,4139,김포시,,장기본동제1투,2352,1710,668,990,25,1,9,1,0,1,1,1,0,0,1697,13,642
4100,경기도,4139,김포시,,장기본동제2투,2555,1602,674,867,34,1,6,0,0,0,3,2,0,0,1587,15,953
4100,경기도,4139,김포시,,장기본동제3투,3294,2175,1037,1053,46,1,13,1,0,0,2,0,1,0,2154,21,1119
4100,경기도,4139,김포시,,장기본동제4투,3149,2168,1152,928,54,2,15,0,0,0,2,0,0,1,2154,14,981
4100,경기도,4139,김포시,,장기본동제5투,2798,1863,1024,770,46,0,12,0,0,0,2,1,1,0,1856,7,935
4100,경기도,4139,김포시,,장기본동제6투,3197,2293,1261,937,62,0,18,0,0,0,1,3,0,0,2282,11,904
4100,경기도,4139,김포시,,장기본동제7투,2809,1994,1002,889,65,1,13,0,0,2,2,2,2,0,1978,16,815
4100,경기도,4139,김포시,마산동,소계,25514,19237,10726,7734,465,5,128,4,2,2,10,11,8,4,19099,138,6277
4100,경기도,4139,김포시,,관내사전투표,6292,6291,3803,2305,119,3,24,0,1,1,1,6,3,0,6266,25,1
4100,경기도,4139,김포시,,마산동제1투,3384,1919,998,796,69,0,20,0,0,0,2,0,2,1,1888,31,1465
4100,경기도,4139,김포시,,마산동제2투,2610,1681,904,717,34,1,13,0,0,0,2,1,0,0,1672,9,929
4100,경기도,4139,김포시,,마산동제3투,2750,1863,947,830,45,0,16,2,0,0,1,1,0,2,1844,19,887
4100,경기도,4139,김포시,,마산동제4투,2423,1623,881,671,30,1,14,1,1,1,1,1,3,0,1605,18,800
4100,경기도,4139,김포시,,마산동제5투,2731,2053,1243,715,62,0,19,1,0,0,0,1,0,0,2041,12,678
4100,경기도,4139,김포시,,마산동제6투,2795,1986,1009,878,62,0,17,0,0,0,2,1,0,0,1969,17,809
4100,경기도,4139,김포시,,마산동제7투,2529,1821,941,822,44,0,5,0,0,0,1,0,0,1,1814,7,708
4100,경기도,4139,김포시,잘못 투입·구분된 투표지,,0,19,14,5,0,0,0,0,0,0,0,0,0,0,19,0,-19
4100,경기도,4140,광주시,합계,,327252,244873,130220,105675,4596,99,1891,47,32,56,143,313,51,83,243206,1667,82379
4100,경기도,4140,광주시,거소·선상투표,,553,511,234,196,12,2,12,0,0,0,0,0,0,1,457,54,42
4100,경기도,4140,광주시,관외사전투표,,36603,36588,20197,14950,731,18,293,8,5,5,10,80,2,16,36315,273,15
4100,경기도,4140,광주시,재외투표,,1468,1114,693,323,22,0,2,0,0,0,0,2,0,0,1042,72,354
4100,경기도,4140,광주시,오포읍,소계,77415,52918,28362,22718,933,17,414,7,5,18,32,64,6,16,52592,326,24497
4100,경기도,4140,광주시,,관내사전투표,10541,10537,6189,4091,151,0,49,0,1,5,2,17,2,2,10509,28,4
4100,경기도,4140,광주시,,오포읍제1투,2304,1564,855,660,25,0,7,0,0,0,2,2,0,0,1551,13,740
4100,경기도,4140,광주시,,오포읍제2투,4591,2858,1629,1092,51,4,45,0,0,0,0,6,1,1,2829,29,1733
4100,경기도,4140,광주시,,오포읍제3투,4082,2556,1548,927,45,1,18,1,1,1,0,3,0,1,2546,10,1526
4100,경기도,4140,광주시,,오포읍제4투,2850,1785,891,827,32,1,18,0,0,1,0,2,0,1,1773,12,1065
4100,경기도,4140,광주시,,오포읍제5투,3581,2135,1183,857,51,1,22,2,0,0,0,3,0,2,2121,14,1446
4100,경기도,4140,광주시,,오포읍제6투,4290,2508,1269,1148,55,1,13,0,0,0,0,0,0,1,2487,21,1782
4100,경기도,4140,광주시,,오포읍제7투,4132,2882,1393,1399,57,1,14,0,0,1,1,0,0,0,2866,16,1250
4100,경기도,4140,광주시,,오포읍제8투,3847,2576,1389,1097,44,1,21,0,1,0,4,1,0,0,2558,18,1271
4100,경기도,4140,광주시,,오포읍제9투,4369,2812,1363,1344,48,1,29,1,0,3,2,2,1,0,2794,18,1557
4100,경기도,4140,광주시,,오포읍제10투,4214,2580,1279,1197,36,0,30,1,2,0,6,6,1,1,2559,21,1634
4100,경기도,4140,광주시,,오포읍제11투,6420,3817,2000,1679,66,3,32,0,0,2,2,4,0,0,3788,29,2603
4100,경기도,4140,광주시,,오포읍제12투,2054,1392,721,625,25,0,9,1,0,0,1,0,1,1,1384,8,662
4100,경기도,4140,광주시,,오포읍제13투,2213,1573,900,602,43,1,13,0,0,1,2,2,0,0,1564,9,640
4100,경기도,4140,광주시,,오포읍제14투,2762,1591,782,730,31,1,22,0,0,0,2,8,0,3,1579,12,1171
4100,경기도,4140,광주시,,오포읍제15투,3912,2510,1291,1132,40,0,23,1,0,1,3,3,0,0,2494,16,1402
4100,경기도,4140,광주시,,오포읍제16투,4399,2715,1425,1182,56,1,21,0,0,0,2,3,0,1,2691,24,1684
4100,경기도,4140,광주시,,오포읍제17투,2557,1718,880,778,35,0,9,0,0,1,1,1,0,2,1707,11,839
4100,경기도,4140,광주시,,오포읍제18투,1646,1139,568,533,19,0,12,0,0,1,0,0,0,0,1133,6,507
4100,경기도,4140,광주시,,오포읍제19투,2651,1670,807,818,23,0,7,0,0,1,2,1,0,0,1659,11,981
4100,경기도,4140,광주시,초월읍,소계,34754,24654,12964,10805,486,4,177,4,2,5,19,28,6,6,24506,148,10100
4100,경기도,4140,광주시,,관내사전투표,8367,8366,4994,3134,147,0,41,2,0,0,0,10,4,3,8335,31,1
4100,경기도,4140,광주시,,초월읍제1투,2556,1473,700,691,35,1,14,0,0,0,2,7,0,0,1450,23,1083
4100,경기도,4140,광주시,,초월읍제2투,3024,2061,1064,915,52,0,15,0,1,0,0,0,0,0,2047,14,963
4100,경기도,4140,광주시,,초월읍제3투,3448,2228,1051,1064,68,1,15,1,0,0,2,0,1,1,2204,24,1220
4100,경기도,4140,광주시,,초월읍제4투,4492,2772,1419,1268,49,0,14,1,1,2,3,4,0,0,2761,11,1720
4100,경기도,4140,광주시,,초월읍제5투,2320,1372,609,723,19,1,12,0,0,0,2,0,0,0,1366,6,948
4100,경기도,4140,광주시,,초월읍제6투,3988,2289,1109,1095,43,0,23,0,0,2,1,3,0,1,2277,12,1699
4100,경기도,4140,광주시,,초월읍제7투,1511,924,333,565,11,0,7,0,0,0,3,1,0,0,920,4,587
4100,경기도,4140,광주시,,초월읍제8투,3510,2317,1281,941,45,1,27,0,0,0,3,3,1,0,2302,15,1193
4100,경기도,4140,광주시,,초월읍제9투,1538,852,404,409,17,0,9,0,0,1,3,0,0,1,844,8,686
4100,경기도,4140,광주시,곤지암읍,소계,19181,13632,6587,6515,239,14,140,4,1,2,7,15,5,9,13538,94,5549
4100,경기도,4140,광주시,,관내사전투표,5762,5762,3053,2546,87,8,34,2,1,1,3,6,2,3,5746,16,0
4100,경기도,4140,광주시,,곤지암읍제1투,2814,1783,855,849,41,1,16,0,0,0,0,3,0,0,1765,18,1031
4100,경기도,4140,광주시,,곤지암읍제2투,2978,1511,622,833,24,2,15,0,0,0,2,1,2,0,1501,10,1467
4100,경기도,4140,광주시,,곤지암읍제3투,1738,952,375,546,7,0,17,1,0,0,0,1,0,3,950,2,786
4100,경기도,4140,광주시,,곤지암읍제4투,1869,1143,393,691,23,0,11,1,0,1,2,1,1,1,1125,18,726
4100,경기도,4140,광주시,,곤지암읍제5투,4020,2481,1289,1050,57,3,47,0,0,0,0,3,0,2,2451,30,1539
4100,경기도,4140,광주시,도척면,소계,7792,5576,2596,2789,96,3,50,3,0,1,2,5,3,1,5549,27,2216
4100,경기도,4140,광주시,,관내사전투표,2589,2589,1355,1175,39,1,10,1,0,0,0,2,1,0,2584,5,0
4100,경기도,4140,광주시,,도척면제1투,2343,1271,606,607,25,1,15,1,0,1,1,2,1,0,1260,11,1072
4100,경기도,4140,광주시,,도척면제2투,1899,1171,455,658,28,1,19,0,0,0,1,0,1,1,1164,7,728
4100,경기도,4140,광주시,,도척면제3투,961,545,180,349,4,0,6,1,0,0,0,1,0,0,541,4,416
4100,경기도,4140,광주시,퇴촌면,소계,12485,8993,4261,4463,121,3,65,1,2,4,4,8,1,2,8935,58,3492
4100,경기도,4140,광주시,,관내사전투표,4391,4391,2313,1964,62,2,24,1,1,1,1,3,0,0,4372,19,0
4100,경기도,4140,광주시,,퇴촌면제1투,2514,1376,540,800,17,0,8,0,0,0,1,2,0,0,1368,8,1138
4100,경기도,4140,광주시,,퇴촌면제2투,2468,1453,662,737,23,0,11,0,0,3,0,2,0,1,1439,14,1015
4100,경기도,4140,광주시,,퇴촌면제3투,3112,1773,746,962,19,1,22,0,1,0,2,1,1,1,1756,17,1339
4100,경기도,4140,광주시,남종면,소계,1407,1152,406,704,16,2,10,0,0,0,3,0,1,1,1143,9,255
4100,경기도,4140,광주시,,관내사전투표,552,552,241,292,8,1,4,0,0,0,0,0,0,0,546,6,0
4100,경기도,4140,광주시,,남종면제1투,404,266,79,180,2,0,3,0,0,0,1,0,1,0,266,0,138
4100,경기도,4140,광주시,,남종면제2투,273,194,52,137,2,1,0,0,0,0,1,0,0,0,193,1,79
4100,경기도,4140,광주시,,남종면제3투,178,140,34,95,4,0,3,0,0,0,1,0,0,1,138,2,38
4100,경기도,4140,광주시,남한산성면,소계,2273,1818,748,1019,27,0,10,0,0,0,2,3,0,0,1809,9,455
4100,경기도,4140,광주시,,관내사전투표,900,900,420,454,14,0,5,0,0,0,1,2,0,0,896,4,0
4100,경기도,4140,광주시,,남한산성면제1투,455,264,81,177,4,0,2,0,0,0,0,0,0,0,264,0,191
4100,경기도,4140,광주시,,남한산성면제2투,481,355,140,203,5,0,2,0,0,0,0,1,0,0,351,4,126
4100,경기도,4140,광주시,,남한산성면제3투,437,299,107,185,4,0,1,0,0,0,1,0,0,0,298,1,138
4100,경기도,4140,광주시,경안동,소계,24713,18368,9310,8289,385,10,167,5,3,6,15,26,8,5,18229,139,6345
4100,경기도,4140,광주시,,관내사전투표,7840,7840,4218,3388,124,4,44,3,2,1,3,11,2,3,7803,37,0
4100,경기도,4140,광주시,,경안동제1투,2067,1062,409,590,27,0,14,0,1,1,2,4,0,1,1049,13,1005
4100,경기도,4140,광주시,,경안동제2투,2312,1362,707,589,33,1,15,0,0,1,0,1,1,0,1348,14,950
4100,경기도,4140,광주시,,경안동제3투,3422,2008,982,906,56,2,22,2,0,1,4,6,4,1,1986,22,1414
4100,경기도,4140,광주시,,경안동제4투,3728,2397,1176,1097,66,2,30,0,0,1,2,0,1,0,2375,22,1331
4100,경기도,4140,광주시,,경안동제5투,2197,1304,673,566,20,1,24,0,0,1,0,2,0,0,1287,17,893
4100,경기도,4140,광주시,,경안동제6투,3147,2395,1145,1153,59,0,18,0,0,0,4,2,0,0,2381,14,752
4100,경기도,4140,광주시,송정동,소계,17039,12272,6228,5550,260,4,112,3,1,1,9,3,5,9,12185,87,4767
4100,경기도,4140,광주시,,관내사전투표,4179,4179,2364,1686,87,0,19,0,0,0,0,1,0,2,4159,20,0
4100,경기도,4140,광주시,,송정동제1투,2579,1620,739,796,40,0,23,0,0,0,6,0,1,3,1608,12,959
4100,경기도,4140,광주시,,송정동제2투,1260,794,400,353,20,1,11,0,0,0,0,1,0,0,786,8,466
4100,경기도,4140,광주시,,송정동제3투,1464,951,389,534,11,0,8,0,0,0,2,0,1,0,945,6,513
4100,경기도,4140,광주시,,송정동제4투,2037,1502,720,717,32,3,15,3,0,0,0,0,0,1,1491,11,535
4100,경기도,4140,광주시,,송정동제5투,2110,1283,641,586,26,0,7,0,0,1,1,0,2,3,1267,16,827
4100,경기도,4140,광주시,,송정동제6투,3410,1943,975,878,44,0,29,0,1,0,0,1,1,0,1929,14,1467
4100,경기도,4140,광주시,쌍령동,소계,14153,10783,6094,4295,246,3,61,2,0,2,7,12,3,2,10727,56,3370
4100,경기도,4140,광주시,,관내사전투표,5104,5103,3117,1838,100,0,18,1,0,1,0,8,0,1,5084,19,1
4100,경기도,4140,광주시,,쌍령동제1투,2150,1204,643,509,29,0,8,1,0,0,2,1,0,0,1193,11,946
4100,경기도,4140,광주시,,쌍령동제2투,2408,1427,749,602,43,3,16,0,0,0,0,2,2,1,1418,9,981
4100,경기도,4140,광주시,,쌍령동제3투,2849,1933,952,899,48,0,14,0,0,1,4,1,1,0,1920,13,916
4100,경기도,4140,광주시,,쌍령동제4투,1642,1116,633,447,26,0,5,0,0,0,1,0,0,0,1112,4,526
4100,경기도,4140,광주시,탄벌동,소계,29520,20758,11453,8588,367,6,153,6,3,3,18,25,8,12,20642,116,8762
4100,경기도,4140,광주시,,관내사전투표,7596,7595,4449,2987,100,4,24,3,3,0,1,6,3,2,7582,13,1
4100,경기도,4140,광주시,,탄벌동제1투,2344,1280,692,521,31,0,18,0,0,0,3,2,0,0,1267,13,1064
4100,경기도,4140,광주시,,탄벌동제2투,2646,1861,859,921,50,0,8,1,0,3,4,0,0,2,1848,13,785
4100,경기도,4140,광주시,,탄벌동제3투,1522,875,425,401,24,0,11,0,0,0,1,2,0,0,864,11,647
4100,경기도,4140,광주시,,탄벌동제4투,2449,1673,864,757,26,1,11,1,0,0,1,3,0,0,1664,9,776
4100,경기도,4140,광주시,,탄벌동제5투,5088,2928,1697,1107,52,0,37,0,0,0,4,4,0,4,2905,23,2160
4100,경기도,4140,광주시,,탄벌동제6투,4100,2302,1278,920,45,1,24,0,0,0,3,4,4,4,2283,19,1798
4100,경기도,4140,광주시,,탄벌동제7투,3775,2244,1189,974,39,0,20,1,0,0,1,4,1,0,2229,15,1531
4100,경기도,4140,광주시,광남1동,소계,24297,16960,9317,7063,283,5,133,3,4,4,13,22,1,0,16848,112,7337
4100,경기도,4140,광주시,,관내사전투표,5680,5676,3330,2221,68,0,22,0,0,1,2,7,1,0,5652,24,4
4100,경기도,4140,광주시,,광남1동제1투,1196,719,394,294,10,1,10,0,1,0,0,0,0,0,710,9,477
4100,경기도,4140,광주시,,광남1동제2투,4290,2552,1376,1080,45,0,22,0,0,0,2,4,0,0,2529,23,1738
4100,경기도,4140,광주시,,광남1동제3투,4056,2336,1241,987,56,1,22,1,1,1,3,4,0,0,2317,19,1720
4100,경기도,4140,광주시,,광남1동제4투,2404,1369,732,584,22,1,15,0,2,1,1,0,0,0,1358,11,1035
4100,경기도,4140,광주시,,광남1동제5투,1255,954,475,450,15,1,5,0,0,1,1,0,0,0,948,6,301
4100,경기도,4140,광주시,,광남1동제6투,2429,1490,778,646,33,0,18,1,0,0,3,2,0,0,1481,9,939
4100,경기도,4140,광주시,,광남1동제7투,2987,1864,991,801,34,1,19,1,0,0,1,5,0,0,1853,11,1123
4100,경기도,4140,광주시,광남2동,소계,23599,18761,10761,7403,371,8,92,1,6,5,2,20,2,3,18674,87,4838
4100,경기도,4140,광주시,,관내사전투표,7542,7542,4641,2721,123,3,22,0,2,1,0,13,1,1,7528,14,0
4100,경기도,4140,광주시,,광남2동제1투,3189,2083,1185,821,46,1,14,1,0,0,1,2,0,0,2071,12,1106
4100,경기도,4140,광주시,,광남2동제2투,3133,2217,1144,996,35,3,15,0,1,2,1,0,0,0,2197,20,916
4100,경기도,4140,광주시,,광남2동제3투,3071,2161,1189,888,49,1,10,0,0,0,0,1,0,2,2140,21,910
4100,경기도,4140,광주시,,광남2동제4투,2222,1657,898,698,39,0,10,0,1,1,0,1,1,0,1649,8,565
4100,경기도,4140,광주시,,광남2동제5투,2745,1950,1104,774,54,0,7,0,0,0,0,2,0,0,1941,9,795
4100,경기도,4140,광주시,,광남2동제6투,1697,1151,600,505,25,0,14,0,2,1,0,1,0,0,1148,3,546
4100,경기도,4140,광주시,잘못 투입·구분된 투표지,,0,15,9,5,1,0,0,0,0,0,0,0,0,0,15,0,-15
4100,경기도,4141,포천시,합계,,131901,95968,44320,47306,1903,49,1056,26,17,22,113,158,43,50,95063,905,35933
4100,경기도,4141,포천시,거소·선상투표,,387,352,119,150,11,1,13,3,0,0,1,0,1,0,299,53,35
4100,경기도,4141,포천시,관외사전투표,,9687,9686,4592,4562,224,4,125,5,3,3,10,34,4,7,9573,113,1
4100,경기도,4141,포천시,재외투표,,365,281,156,86,8,0,5,0,0,0,0,0,0,0,255,26,84
4100,경기도,4141,포천시,소흘읍,소계,35560,24879,12819,11058,507,4,251,2,6,6,23,32,2,8,24718,161,10681
4100,경기도,4141,포천시,,관내사전투표,9643,9641,5364,3964,169,1,78,2,2,1,1,15,1,2,9600,41,2
4100,경기도,4141,포천시,,소흘읍제1투,3172,1586,795,708,34,1,24,0,0,0,5,3,0,1,1571,15,1586
4100,경기도,4141,포천시,,소흘읍제2투,1276,780,285,462,14,1,12,0,0,0,0,0,0,0,774,6,496
4100,경기도,4141,포천시,,소흘읍제3투,1958,1366,535,778,21,0,18,0,0,1,3,1,0,0,1357,9,592
4100,경기도,4141,포천시,,소흘읍제4투,1670,954,406,508,18,1,12,0,0,0,2,0,0,0,947,7,716
4100,경기도,4141,포천시,,소흘읍제5투,2888,1918,963,862,58,0,22,0,1,0,1,2,0,1,1910,8,970
4100,경기도,4141,포천시,,소흘읍제6투,2612,1459,685,708,29,0,14,0,0,0,0,3,0,3,1442,17,1153
4100,경기도,4141,포천시,,소흘읍제7투,2097,1105,586,490,11,0,9,0,1,0,1,2,0,0,1100,5,992
4100,경기도,4141,포천시,,소흘읍제8투,2523,1336,667,614,27,0,12,0,0,0,3,2,0,0,1325,11,1187
4100,경기도,4141,포천시,,소흘읍제9투,2940,1839,1013,743,46,0,18,0,1,1,2,0,1,1,1826,13,1101
4100,경기도,4141,포천시,,소흘읍제10투,2267,1309,697,541,40,0,14,0,0,1,2,2,0,0,1297,12,958
4100,경기도,4141,포천시,,소흘읍제11투,916,530,269,232,12,0,8,0,0,1,0,0,0,0,522,8,386
4100,경기도,4141,포천시,,소흘읍제12투,1598,1056,554,448,28,0,10,0,1,1,3,2,0,0,1047,9,542
4100,경기도,4141,포천시,군내면,소계,6523,4612,1959,2437,89,3,57,2,3,3,5,8,5,2,4573,39,1911
4100,경기도,4141,포천시,,관내사전투표,2034,2033,888,1047,35,2,23,0,2,0,4,6,3,2,2012,21,1
4100,경기도,4141,포천시,,군내면제1투,2353,1310,589,669,25,0,12,2,0,2,0,2,1,0,1302,8,1043
4100,경기도,4141,포천시,,군내면제2투,887,516,215,277,13,0,5,0,0,0,0,0,1,0,511,5,371
4100,경기도,4141,포천시,,군내면제3투,1249,753,267,444,16,1,17,0,1,1,1,0,0,0,748,5,496
4100,경기도,4141,포천시,내촌면,소계,3982,2863,1162,1571,36,2,43,0,0,1,3,2,2,1,2823,40,1119
4100,경기도,4141,포천시,,관내사전투표,1357,1357,578,729,16,1,14,0,0,0,1,1,1,0,1341,16,0
4100,경기도,4141,포천시,,내촌면제1투,1478,819,346,439,9,0,15,0,0,1,1,0,0,0,811,8,659
4100,경기도,4141,포천시,,내촌면제2투,462,265,81,171,7,1,3,0,0,0,0,0,0,0,263,2,197
4100,경기도,4141,포천시,,내촌면제3투,685,422,157,232,4,0,11,0,0,0,1,1,1,1,408,14,263
4100,경기도,4141,포천시,가산면,소계,6772,4851,2096,2581,74,3,36,1,1,3,6,7,7,4,4819,32,1921
4100,경기도,4141,포천시,,관내사전투표,2383,2383,1118,1201,35,1,13,0,0,2,1,2,3,1,2377,6,0
4100,경기도,4141,포천시,,가산면제1투,1957,1047,442,548,21,2,11,0,1,1,4,1,2,1,1034,13,910
4100,경기도,4141,포천시,,가산면제2투,1361,776,313,435,10,0,7,1,0,0,1,3,0,1,771,5,585
4100,경기도,4141,포천시,,가산면제3투,1071,645,223,397,8,0,5,0,0,0,0,1,2,1,637,8,426
4100,경기도,4141,포천시,신북면,소계,9630,6454,2779,3410,113,4,69,2,0,0,8,13,5,2,6405,49,3176
4100,경기도,4141,포천시,,관내사전투표,2506,2505,1188,1221,42,2,27,0,0,0,0,4,4,0,2488,17,1
4100,경기도,4141,포천시,,신북면제1투,1675,944,438,465,22,0,8,1,0,0,1,2,0,0,937,7,731
4100,경기도,4141,포천시,,신북면제2투,2053,972,422,514,13,0,14,0,0,0,0,2,0,0,965,7,1081
4100,경기도,4141,포천시,,신북면제3투,1273,824,268,514,17,0,9,0,0,0,5,1,0,1,815,9,449
4100,경기도,4141,포천시,,신북면제4투,718,467,124,326,4,2,4,1,0,0,1,2,0,0,464,3,251
4100,경기도,4141,포천시,,신북면제5투,1405,742,339,370,15,0,7,0,0,0,1,2,1,1,736,6,663
4100,경기도,4141,포천시,창수면,소계,1914,1495,562,874,21,1,18,0,1,0,3,3,0,1,1484,11,419
4100,경기도,4141,포천시,,관내사전투표,801,801,352,429,8,0,6,0,1,0,1,1,0,0,798,3,0
4100,경기도,4141,포천시,,창수면제1투,578,351,88,240,7,0,8,0,0,0,2,2,0,1,348,3,227
4100,경기도,4141,포천시,,창수면제2투,535,343,122,205,6,1,4,0,0,0,0,0,0,0,338,5,192
4100,경기도,4141,포천시,영중면,소계,4221,3115,1330,1656,38,2,36,1,0,0,7,5,4,3,3082,33,1106
4100,경기도,4141,포천시,,관내사전투표,1365,1365,642,683,11,1,10,1,0,0,0,3,1,0,1352,13,0
4100,경기도,4141,포천시,,영중면제1투,687,431,158,248,10,0,9,0,0,0,1,0,0,0,426,5,256
4100,경기도,4141,포천시,,영중면제2투,1099,651,278,342,9,1,11,0,0,0,4,1,0,1,647,4,448
4100,경기도,4141,포천시,,영중면제3투,437,290,115,157,4,0,4,0,0,0,2,1,3,0,286,4,147
4100,경기도,4141,포천시,,영중면제4투,633,378,137,226,4,0,2,0,0,0,0,0,0,2,371,7,255
4100,경기도,4141,포천시,일동면,소계,7999,5705,2328,3140,108,0,54,2,0,1,9,3,2,5,5652,53,2294
4100,경기도,4141,포천시,,관내사전투표,2342,2342,1066,1186,37,0,27,1,0,1,1,1,0,3,2323,19,0
4100,경기도,4141,포천시,,일동면제1투,1624,878,375,477,12,0,6,0,0,0,0,1,1,1,873,5,746
4100,경기도,4141,포천시,,일동면제2투,344,236,68,157,5,0,0,0,0,0,0,0,0,0,230,6,108
4100,경기도,4141,포천시,,일동면제3투,948,641,215,394,17,0,4,1,0,0,3,0,0,1,635,6,307
4100,경기도,4141,포천시,,일동면제4투,1651,953,381,525,28,0,9,0,0,0,2,1,1,0,947,6,698
4100,경기도,4141,포천시,,일동면제5투,373,256,87,155,7,0,4,0,0,0,0,0,0,0,253,3,117
4100,경기도,4141,포천시,,일동면제6투,717,399,136,246,2,0,4,0,0,0,3,0,0,0,391,8,318
4100,경기도,4141,포천시,이동면,소계,4838,3500,1391,1958,64,2,36,0,0,0,7,3,1,2,3464,36,1338
4100,경기도,4141,포천시,,관내사전투표,1393,1393,586,752,24,1,13,0,0,0,1,1,0,2,1380,13,0
4100,경기도,4141,포천시,,이동면제1투,1171,703,287,386,13,0,7,0,0,0,1,0,0,0,694,9,468
4100,경기도,4141,포천시,,이동면제2투,533,333,93,226,9,0,3,0,0,0,0,0,0,0,331,2,200
4100,경기도,4141,포천시,,이동면제3투,615,400,144,229,10,1,5,0,0,0,5,2,1,0,397,3,215
4100,경기도,4141,포천시,,이동면제4투,1126,671,281,365,8,0,8,0,0,0,0,0,0,0,662,9,455
4100,경기도,4141,포천시,영북면,소계,6666,4670,1871,2554,100,5,71,3,0,1,6,4,3,6,4624,46,1996
4100,경기도,4141,포천시,,관내사전투표,1936,1936,773,1058,49,2,31,3,0,0,2,4,1,1,1924,12,0
4100,경기도,4141,포천시,,영북면제1투,1225,628,263,341,6,0,6,0,0,1,2,0,0,1,620,8,597
4100,경기도,4141,포천시,,영북면제2투,496,326,102,210,4,0,6,0,0,0,1,0,1,1,325,1,170
4100,경기도,4141,포천시,,영북면제3투,1244,723,313,364,19,1,11,0,0,0,0,0,0,3,711,12,521
4100,경기도,4141,포천시,,영북면제4투,189,128,54,68,2,0,2,0,0,0,1,0,0,0,127,1,61
4100,경기도,4141,포천시,,영북면제5투,884,498,186,277,15,2,10,0,0,0,0,0,0,0,490,8,386
4100,경기도,4141,포천시,,영북면제6투,329,202,89,105,3,0,1,0,0,0,0,0,1,0,199,3,127
4100,경기도,4141,포천시,,영북면제7투,363,229,91,131,2,0,4,0,0,0,0,0,0,0,228,1,134
4100,경기도,4141,포천시,관인면,소계,2348,1755,695,998,27,0,17,0,0,0,1,4,0,1,1743,12,593
4100,경기도,4141,포천시,,관내사전투표,778,778,320,435,7,0,8,0,0,0,1,3,0,0,774,4,0
4100,경기도,4141,포천시,,관인면제1투,927,556,227,305,11,0,9,0,0,0,0,0,0,0,552,4,371
4100,경기도,4141,포천시,,관인면제2투,344,219,82,129,7,0,0,0,0,0,0,0,0,0,218,1,125
4100,경기도,4141,포천시,,관인면제3투,299,202,66,129,2,0,0,0,0,0,0,1,0,1,199,3,97
4100,경기도,4141,포천시,화현면,소계,2216,1625,591,946,36,0,20,1,0,1,8,2,1,1,1607,18,591
4100,경기도,4141,포천시,,관내사전투표,768,768,305,428,15,0,9,1,0,1,0,0,0,1,760,8,0
4100,경기도,4141,포천시,,화현면제1투,1081,616,207,368,16,0,10,0,0,0,8,1,0,0,610,6,465
4100,경기도,4141,포천시,,화현면제2투,367,241,79,150,5,0,1,0,0,0,0,1,1,0,237,4,126
4100,경기도,4141,포천시,포천동,소계,16343,11862,5700,5619,261,10,122,3,0,1,11,27,4,3,11761,101,4481
4100,경기도,4141,포천시,,관내사전투표,5699,5698,2933,2566,107,7,37,0,0,0,4,14,2,2,5672,26,1
4100,경기도,4141,포천시,,포천동제1투,2505,1547,706,744,40,1,27,1,0,0,2,3,2,1,1527,20,958
4100,경기도,4141,포천시,,포천동제2투,1302,695,286,371,12,0,15,0,0,0,2,1,0,0,687,8,607
4100,경기도,4141,포천시,,포천동제3투,2554,1445,637,729,38,1,15,0,0,0,1,3,0,0,1424,21,1109
4100,경기도,4141,포천시,,포천동제4투,3103,1811,830,882,50,1,21,1,0,1,2,6,0,0,1794,17,1292
4100,경기도,4141,포천시,,포천동제5투,1180,666,308,327,14,0,7,1,0,0,0,0,0,0,657,9,514
4100,경기도,4141,포천시,선단동,소계,12450,8262,4170,3705,186,8,83,1,3,2,5,11,2,4,8180,82,4188
4100,경기도,4141,포천시,,관내사전투표,3671,3670,1961,1573,78,5,24,0,1,1,0,7,1,2,3653,17,1
4100,경기도,4141,포천시,,선단동제1투,3371,1797,915,773,48,1,29,1,1,1,1,1,1,2,1774,23,1574
4100,경기도,4141,포천시,,선단동제2투,893,533,221,287,10,0,2,0,1,0,1,1,0,0,523,10,360
4100,경기도,4141,포천시,,선단동제3투,938,474,174,280,8,0,5,0,0,0,2,1,0,0,470,4,464
4100,경기도,4141,포천시,,선단동제4투,3577,1788,899,792,42,2,23,0,0,0,1,1,0,0,1760,28,1789
4100,경기도,4141,포천시,잘못 투입·구분된 투표지,,0,1,0,1,0,0,0,0,0,0,0,0,0,0,1,0,-1
4100,경기도,4142,연천군,합계,,37817,28904,12013,15325,604,17,402,7,5,13,64,50,22,27,28549,355,8913
4100,경기도,4142,연천군,거소·선상투표,,371,360,104,160,5,0,15,0,0,0,0,0,0,1,285,75,11
4100,경기도,4142,연천군,관외사전투표,,3256,3255,1471,1603,95,2,42,0,2,1,1,7,1,2,3227,28,1
4100,경기도,4142,연천군,재외투표,,127,89,55,23,2,0,0,0,0,0,1,0,0,0,81,8,38
4100,경기도,4142,연천군,연천읍,소계,6046,4507,1884,2387,84,4,56,3,0,2,5,15,3,4,4447,60,1539
4100,경기도,4142,연천군,,관내사전투표,1997,1997,934,957,31,3,27,1,0,0,0,8,2,3,1966,31,0
4100,경기도,4142,연천군,,연천읍제1투,1019,562,218,319,10,0,6,0,0,0,1,1,1,0,556,6,457
4100,경기도,4142,연천군,,연천읍제2투,872,595,216,355,11,0,5,0,0,1,2,1,0,0,591,4,277
4100,경기도,4142,연천군,,연천읍제3투,1204,709,313,356,15,1,11,1,0,0,2,0,0,0,699,10,495
4100,경기도,4142,연천군,,연천읍제4투,176,127,40,79,2,0,3,0,0,0,0,2,0,0,126,1,49
4100,경기도,4142,연천군,,연천읍제5투,778,517,163,321,15,0,4,1,0,1,0,3,0,1,509,8,261
4100,경기도,4142,연천군,전곡읍,소계,14595,10415,4539,5362,229,5,148,1,0,4,9,13,10,5,10325,90,4180
4100,경기도,4142,연천군,,관내사전투표,4331,4331,2019,2144,81,2,35,1,0,1,5,3,6,3,4300,31,0
4100,경기도,4142,연천군,,전곡읍제1투,2086,1153,478,609,27,1,24,0,0,0,1,2,1,0,1143,10,933
4100,경기도,4142,연천군,,전곡읍제2투,646,379,134,226,9,0,5,0,0,0,1,0,1,0,376,3,267
4100,경기도,4142,연천군,,전곡읍제3투,2574,1512,637,799,34,1,26,0,0,0,0,4,0,1,1502,10,1062
4100,경기도,4142,연천군,,전곡읍제4투,929,544,231,275,16,1,10,0,0,0,0,1,0,1,535,9,385
4100,경기도,4142,연천군,,전곡읍제5투,1593,1027,422,545,30,0,16,0,0,2,0,1,2,0,1018,9,566
4100,경기도,4142,연천군,,전곡읍제6투,237,159,60,89,4,0,3,0,0,1,0,0,0,0,157,2,78
4100,경기도,4142,연천군,,전곡읍제7투,190,126,36,87,0,0,1,0,0,0,0,0,0,0,124,2,64
4100,경기도,4142,연천군,,전곡읍제8투,295,183,77,96,3,0,5,0,0,0,0,0,0,0,181,2,112
4100,경기도,4142,연천군,,전곡읍제9투,1714,1001,445,492,25,0,23,0,0,0,2,2,0,0,989,12,713
4100,경기도,4142,연천군,군남면,소계,2457,1816,717,1013,41,1,21,1,0,1,3,4,1,1,1804,12,641
4100,경기도,4142,연천군,,관내사전투표,573,573,242,304,11,0,10,0,0,0,0,0,1,0,568,5,0
4100,경기도,4142,연천군,,군남면제1투,426,279,105,161,5,0,1,0,0,1,2,2,0,0,277,2,147
4100,경기도,4142,연천군,,군남면제2투,332,239,85,140,7,0,5,0,0,0,0,1,0,0,238,1,93
4100,경기도,4142,연천군,,군남면제3투,312,214,81,128,2,0,1,0,0,0,0,0,0,1,213,1,98
4100,경기도,4142,연천군,,군남면제4투,663,422,184,215,12,1,4,1,0,0,1,1,0,0,419,3,241
4100,경기도,4142,연천군,,군남면제5투,151,89,20,65,4,0,0,0,0,0,0,0,0,0,89,0,62
4100,경기도,4142,연천군,청산면,소계,3357,2508,914,1432,40,3,34,1,1,1,42,5,2,6,2481,27,849
4100,경기도,4142,연천군,,관내사전투표,997,997,410,545,12,1,13,0,0,0,2,0,0,1,984,13,0
4100,경기도,4142,연천군,,청산면제1투,1219,794,246,474,14,1,14,0,1,0,38,2,0,1,791,3,425
4100,경기도,4142,연천군,,청산면제2투,650,410,145,238,7,1,5,1,0,1,2,1,1,3,405,5,240
4100,경기도,4142,연천군,,청산면제3투,491,307,113,175,7,0,2,0,0,0,0,2,1,1,301,6,184
4100,경기도,4142,연천군,백학면,소계,2154,1638,631,927,36,1,27,0,1,0,0,1,2,1,1627,11,516
4100,경기도,4142,연천군,,관내사전투표,709,709,305,377,19,0,2,0,1,0,0,1,0,0,705,4,0
4100,경기도,4142,연천군,,백학면제1투,856,543,204,311,6,1,13,0,0,0,0,0,1,1,537,6,313
4100,경기도,4142,연천군,,백학면제2투,589,386,122,239,11,0,12,0,0,0,0,0,1,0,385,1,203
4100,경기도,4142,연천군,미산면,소계,1333,1001,376,585,15,0,11,0,0,0,2,1,0,2,992,9,332
4100,경기도,4142,연천군,,관내사전투표,427,427,175,233,7,0,4,0,0,0,1,1,0,0,421,6,0
4100,경기도,4142,연천군,,미산면투표소,906,574,201,352,8,0,7,0,0,0,1,0,0,2,571,3,332
4100,경기도,4142,연천군,왕징면,소계,937,761,286,448,12,0,8,0,1,0,0,1,1,1,758,3,176
4100,경기도,4142,연천군,,관내사전투표,329,329,133,186,5,0,3,0,0,0,0,0,0,1,328,1,0
4100,경기도,4142,연천군,,왕징면제1투,260,179,63,104,4,0,4,0,1,0,0,0,1,0,177,2,81
4100,경기도,4142,연천군,,왕징면제2투,141,105,37,66,1,0,1,0,0,0,0,0,0,0,105,0,36
4100,경기도,4142,연천군,,왕징면제3투,207,148,53,92,2,0,0,0,0,0,0,1,0,0,148,0,59
4100,경기도,4142,연천군,신서면,소계,2353,1867,776,994,26,1,31,1,0,4,1,3,2,4,1843,24,486
4100,경기도,4142,연천군,,관내사전투표,847,847,374,425,13,1,21,0,0,0,0,0,0,0,834,13,0
4100,경기도,4142,연천군,,신서면제1투,846,556,227,299,7,0,7,1,0,3,0,3,1,1,549,7,290
4100,경기도,4142,연천군,,신서면제2투,120,87,30,54,1,0,0,0,0,0,0,0,0,0,85,2,33
4100,경기도,4142,연천군,,신서면제3투,177,139,59,72,2,0,2,0,0,0,1,0,1,0,137,2,38
4100,경기도,4142,연천군,,신서면제4투,363,238,86,144,3,0,1,0,0,1,0,0,0,3,238,0,125
4100,경기도,4142,연천군,중면,소계,190,156,67,80,4,0,3,0,0,0,0,0,0,0,154,2,34
4100,경기도,4142,연천군,,관내사전투표,96,96,43,48,2,0,3,0,0,0,0,0,0,0,96,0,0
4100,경기도,4142,연천군,,중면투표소,94,60,24,32,2,0,0,0,0,0,0,0,0,0,58,2,34
4100,경기도,4142,연천군,장남면,소계,641,530,193,310,15,0,6,0,0,0,0,0,0,0,524,6,111
4100,경기도,4142,연천군,,관내사전투표,214,214,85,117,7,0,4,0,0,0,0,0,0,0,213,1,0
4100,경기도,4142,연천군,,장남면투표소,427,316,108,193,8,0,2,0,0,0,0,0,0,0,311,5,111
4100,경기도,4142,연천군,잘못 투입·구분된 투표지,,0,1,0,1,0,0,0,0,0,0,0,0,0,0,1,0,-1
4100,경기도,4143,양평군,합계,,106406,83065,34324,45487,1662,40,633,21,12,26,80,57,34,48,82424,641,23341
4100,경기도,4143,양평군,거소·선상투표,,279,266,120,80,9,0,7,0,0,0,0,2,1,2,221,45,13
4100,경기도,4143,양평군,관외사전투표,,11795,11792,5036,6297,270,7,86,1,1,4,5,7,3,6,11723,69,3
4100,경기도,4143,양평군,재외투표,,713,546,317,172,9,0,5,0,0,0,0,0,0,0,503,43,167
4100,경기도,4143,양평군,양평읍,소계,22411,16105,6692,8744,382,7,143,3,2,2,13,9,7,5,16009,96,6306
4100,경기도,4143,양평군,,관내사전투표,6325,6326,2967,3148,135,3,38,0,0,1,2,2,2,2,6300,26,-1
4100,경기도,4143,양평군,,양평읍제1투,1883,1029,404,569,32,0,8,0,0,0,0,1,3,0,1017,12,854
4100,경기도,4143,양평군,,양평읍제2투,2185,1329,513,757,33,0,14,1,0,1,1,1,0,0,1321,8,856
4100,경기도,4143,양평군,,양평읍제3투,998,644,167,455,18,0,2,0,0,0,0,0,0,0,642,2,354
4100,경기도,4143,양평군,,양평읍제4투,1057,688,202,465,11,0,6,0,0,0,1,0,0,0,685,3,369
4100,경기도,4143,양평군,,양평읍제5투,2829,1712,649,982,36,0,24,1,0,0,1,4,2,1,1700,12,1117
4100,경기도,4143,양평군,,양평읍제6투,1461,913,345,533,17,0,9,0,0,0,1,0,0,0,905,8,548
4100,경기도,4143,양평군,,양평읍제7투,3010,1837,737,994,61,3,23,0,0,0,1,1,0,2,1822,15,1173
4100,경기도,4143,양평군,,양평읍제8투,2663,1627,708,841,39,1,19,1,2,0,6,0,0,0,1617,10,1036
4100,경기도,4143,양평군,강상면,소계,8590,6801,3008,3559,144,2,45,2,2,2,8,2,3,1,6778,23,1789
4100,경기도,4143,양평군,,관내사전투표,3771,3771,1878,1781,82,1,15,0,1,0,3,1,0,0,3762,9,0
4100,경기도,4143,양평군,,강상면제1투,2532,1570,613,894,35,0,17,0,1,2,0,0,1,0,1563,7,962
4100,경기도,4143,양평군,,강상면제2투,1427,875,333,504,15,1,12,2,0,0,1,1,2,1,872,3,552
4100,경기도,4143,양평군,,강상면제3투,860,585,184,380,12,0,1,0,0,0,4,0,0,0,581,4,275
4100,경기도,4143,양평군,강하면,소계,3872,2990,1081,1822,41,1,20,0,0,1,5,2,2,0,2975,15,882
4100,경기도,4143,양평군,,관내사전투표,1626,1626,671,920,21,1,7,0,0,0,1,0,2,0,1623,3,0
4100,경기도,4143,양평군,,강하면제1투,1203,702,214,458,11,0,9,0,0,0,3,1,0,0,696,6,501
4100,경기도,4143,양평군,,강하면제2투,1043,662,196,444,9,0,4,0,0,1,1,1,0,0,656,6,381
4100,경기도,4143,양평군,양서면,소계,10366,7692,3260,4126,165,5,43,0,1,5,12,7,0,6,7630,62,2674
4100,경기도,4143,양평군,,관내사전투표,3060,3060,1506,1467,61,2,9,0,0,1,0,2,0,2,3050,10,0
4100,경기도,4143,양평군,,양서면제1투,2736,1895,737,1078,39,1,12,0,1,1,8,3,0,1,1881,14,841
4100,경기도,4143,양평군,,양서면제2투,936,626,200,383,17,2,7,0,0,0,2,0,0,2,613,13,310
4100,경기도,4143,양평군,,양서면제3투,2688,1451,571,805,38,0,11,0,0,2,1,1,0,1,1430,21,1237
4100,경기도,4143,양평군,,양서면제4투,946,660,246,393,10,0,4,0,0,1,1,1,0,0,656,4,286
4100,경기도,4143,양평군,옥천면,소계,7243,5748,2471,3055,115,1,60,1,0,3,2,4,1,2,5715,33,1495
4100,경기도,4143,양평군,,관내사전투표,3445,3445,1608,1725,63,0,30,1,0,3,1,1,1,1,3434,11,0
4100,경기도,4143,양평군,,옥천면제1투,1270,763,306,417,20,1,9,0,0,0,0,0,0,1,754,9,507
4100,경기도,4143,양평군,,옥천면제2투,965,588,197,366,17,0,5,0,0,0,1,2,0,0,588,0,377
4100,경기도,4143,양평군,,옥천면제3투,802,501,183,291,11,0,9,0,0,0,0,0,0,0,494,7,301
4100,경기도,4143,양평군,,옥천면제4투,761,451,177,256,4,0,7,0,0,0,0,1,0,0,445,6,310
4100,경기도,4143,양평군,서종면,소계,6953,5286,2179,2932,90,0,26,4,0,1,9,3,3,2,5249,37,1667
4100,경기도,4143,양평군,,관내사전투표,2290,2290,1123,1106,33,0,7,4,0,0,2,0,0,0,2275,15,0
4100,경기도,4143,양평군,,서종면제1투,2037,1242,445,740,27,0,12,0,0,1,2,2,0,0,1229,13,795
4100,경기도,4143,양평군,,서종면제2투,580,401,168,221,7,0,0,0,0,0,1,0,1,0,398,3,179
4100,경기도,4143,양평군,,서종면제3투,676,455,146,294,8,0,1,0,0,0,0,0,2,2,453,2,221
4100,경기도,4143,양평군,,서종면제4투,394,259,78,174,4,0,1,0,0,0,1,0,0,0,258,1,135
4100,경기도,4143,양평군,,서종면제5투,976,639,219,397,11,0,5,0,0,0,3,1,0,0,636,3,337
4100,경기도,4143,양평군,단월면,소계,3311,2550,974,1484,35,3,19,0,1,2,1,0,0,4,2523,27,761
4100,경기도,4143,양평군,,관내사전투표,1351,1351,583,732,13,1,7,0,0,0,0,0,0,0,1336,15,0
4100,경기도,4143,양평군,,단월면제1투,724,426,142,261,10,0,7,0,1,0,1,0,0,4,426,0,298
4100,경기도,4143,양평군,,단월면제2투,747,439,149,271,7,1,2,0,0,2,0,0,0,0,432,7,308
4100,경기도,4143,양평군,,단월면제3투,337,245,72,162,4,1,2,0,0,0,0,0,0,0,241,4,92
4100,경기도,4143,양평군,,단월면제4투,152,89,28,58,1,0,1,0,0,0,0,0,0,0,88,1,63
4100,경기도,4143,양평군,청운면,소계,3184,2371,843,1432,40,1,13,2,1,3,4,4,3,2,2348,23,813
4100,경기도,4143,양평군,,관내사전투표,1235,1227,491,698,17,0,8,1,0,1,0,1,1,0,1218,9,8
4100,경기도,4143,양평군,,청운면제1투,711,426,136,268,6,1,2,0,0,2,2,0,1,0,418,8,285
4100,경기도,4143,양평군,,청운면제2투,380,242,80,152,5,0,2,0,0,0,0,2,0,0,241,1,138
4100,경기도,4143,양평군,,청운면제3투,432,247,69,165,7,0,0,0,1,0,0,1,0,1,244,3,185
4100,경기도,4143,양평군,,청운면제4투,426,229,67,149,5,0,1,1,0,0,2,0,1,1,227,2,197
4100,경기도,4143,양평군,양동면,소계,3752,2831,978,1744,47,4,20,1,1,1,2,5,2,4,2809,22,921
4100,경기도,4143,양평군,,관내사전투표,1550,1550,571,934,23,4,7,1,0,1,0,2,1,0,1544,6,0
4100,경기도,4143,양평군,,양동면제1투,927,467,154,293,6,0,4,0,0,0,1,2,0,3,463,4,460
4100,경기도,4143,양평군,,양동면제2투,419,251,82,159,4,0,1,0,1,0,0,1,0,0,248,3,168
4100,경기도,4143,양평군,,양동면제3투,547,361,104,231,10,0,7,0,0,0,0,0,0,1,353,8,186
4100,경기도,4143,양평군,,양동면제4투,309,202,67,127,4,0,1,0,0,0,1,0,1,0,201,1,107
4100,경기도,4143,양평군,지평면,소계,5853,4466,1773,2541,64,1,32,3,1,1,7,2,4,4,4433,33,1387
4100,경기도,4143,양평군,,관내사전투표,2210,2210,1021,1136,21,1,14,1,1,0,2,0,0,1,2198,12,0
4100,경기도,4143,양평군,,지평면제1투,661,388,142,229,3,0,3,0,0,0,1,0,1,0,379,9,273
4100,경기도,4143,양평군,,지평면제2투,565,341,97,221,15,0,3,1,0,0,1,0,0,1,339,2,224
4100,경기도,4143,양평군,,지평면제3투,554,353,125,214,5,0,3,0,0,0,1,0,2,0,350,3,201
4100,경기도,4143,양평군,,지평면제4투,598,364,112,235,9,0,4,1,0,1,0,0,0,0,362,2,234
4100,경기도,4143,양평군,,지평면제5투,666,421,146,260,8,0,2,0,0,0,1,0,0,1,418,3,245
4100,경기도,4143,양평군,,지평면제6투,599,389,130,246,3,0,3,0,0,0,1,2,1,1,387,2,210
4100,경기도,4143,양평군,용문면,소계,13726,10210,4246,5559,183,8,93,4,2,1,5,9,3,8,10121,89,3516
4100,경기도,4143,양평군,,관내사전투표,4122,4122,2009,1998,54,2,17,1,1,0,0,3,3,3,4091,31,0
4100,경기도,4143,양평군,,용문면제1투,2617,1625,602,944,41,0,13,0,0,0,0,1,0,1,1602,23,992
4100,경기도,4143,양평군,,용문면제2투,1523,877,309,529,14,1,11,0,0,1,1,1,0,1,868,9,646
4100,경기도,4143,양평군,,용문면제3투,1669,1000,415,527,23,2,23,0,1,0,1,0,0,0,992,8,669
4100,경기도,4143,양평군,,용문면제4투,1160,806,302,476,13,0,8,0,0,0,1,0,0,2,802,4,354
4100,경기도,4143,양평군,,용문면제5투,1489,984,376,570,18,2,9,1,0,0,0,1,0,0,977,7,505
4100,경기도,4143,양평군,,용문면제6투,554,386,107,262,6,1,2,0,0,0,2,1,0,1,382,4,168
4100,경기도,4143,양평군,,용문면제7투,592,410,126,253,14,0,10,2,0,0,0,2,0,0,407,3,182
4100,경기도,4143,양평군,개군면,소계,4358,3408,1344,1939,68,0,21,0,0,0,7,1,2,2,3384,24,950
4100,경기도,4143,양평군,,관내사전투표,1762,1762,804,895,40,0,6,0,0,0,2,1,1,0,1749,13,0
4100,경기도,4143,양평군,,개군면제1투,1006,611,189,407,7,0,4,0,0,0,2,0,0,0,609,2,395
4100,경기도,4143,양평군,,개군면제2투,963,638,252,355,14,0,10,0,0,0,2,0,0,1,634,4,325
4100,경기도,4143,양평군,,개군면제3투,627,397,99,282,7,0,1,0,0,0,1,0,1,1,392,5,230
4100,경기도,4143,양평군,잘못 투입·구분된 투표지,,0,3,2,1,0,0,0,0,0,0,0,0,0,0,3,0,-3
4100,경기도,4144,가평군,합계,,55618,42512,16684,23870,872,30,402,16,6,18,47,44,30,30,42049,463,13106
4100,경기도,4144,가평군,거소·선상투표,,403,354,162,94,18,5,10,1,1,2,5,9,1,2,310,44,49
4100,경기도,4144,가평군,관외사전투표,,5570,5569,2373,2954,112,2,63,0,0,1,2,6,4,3,5520,49,1
4100,경기도,4144,가평군,재외투표,,284,216,128,60,4,0,1,0,0,0,2,0,0,0,195,21,68
4100,경기도,4144,가평군,가평읍,소계,15629,11538,4706,6389,255,2,75,2,1,3,5,7,7,6,11458,80,4091
4100,경기도,4144,가평군,,관내사전투표,5074,5074,2271,2632,104,0,34,1,0,0,0,5,1,2,5050,24,0
4100,경기도,4144,가평군,,가평읍제1투,2100,1185,439,688,36,1,6,0,0,0,0,0,1,0,1171,14,915
4100,경기도,4144,가평군,,가평읍제2투,1649,1018,413,563,18,0,10,0,1,1,3,0,1,0,1010,8,631
4100,경기도,4144,가평군,,가평읍제3투,2755,1716,710,932,50,0,6,0,0,1,0,1,0,3,1703,13,1039
4100,경기도,4144,가평군,,가평읍제4투,1173,689,308,353,12,0,5,0,0,0,0,1,2,0,681,8,484
4100,경기도,4144,가평군,,가평읍제5투,835,546,184,344,7,1,6,0,0,0,0,0,2,0,544,2,289
4100,경기도,4144,가평군,,가평읍제6투,760,496,170,308,10,0,4,0,0,0,0,0,0,1,493,3,264
4100,경기도,4144,가평군,,가평읍제7투,757,463,127,320,11,0,1,1,0,0,0,0,0,0,460,3,294
4100,경기도,4144,가평군,,가평읍제8투,526,351,84,249,7,0,3,0,0,1,2,0,0,0,346,5,175
4100,경기도,4144,가평군,설악면,소계,7473,5558,1933,3429,92,1,38,1,1,1,9,3,2,5,5515,43,1915
4100,경기도,4144,가평군,,관내사전투표,2691,2686,1085,1535,40,0,10,1,0,0,2,1,1,2,2677,9,5
4100,경기도,4144,가평군,,설악면제1투,1503,828,254,534,15,1,8,0,0,1,2,1,0,1,817,11,675
4100,경기도,4144,가평군,,설악면제2투,680,422,137,271,6,0,0,0,0,0,1,0,0,1,416,6,258
4100,경기도,4144,가평군,,설악면제3투,840,533,173,336,9,0,4,0,0,0,2,1,0,1,526,7,307
4100,경기도,4144,가평군,,설악면제4투,409,282,72,192,7,0,5,0,1,0,1,0,1,0,279,3,127
4100,경기도,4144,가평군,,설악면제5투,1350,807,212,561,15,0,11,0,0,0,1,0,0,0,800,7,543
4100,경기도,4144,가평군,청평면,소계,11292,8330,3269,4731,165,5,76,1,0,2,12,5,3,4,8273,57,2962
4100,경기도,4144,가평군,,관내사전투표,3386,3386,1540,1731,60,2,25,0,0,0,4,3,2,3,3370,16,0
4100,경기도,4144,가평군,,청평면제1투,2354,1421,528,819,34,1,20,0,0,0,3,2,0,1,1408,13,933
4100,경기도,4144,가평군,,청평면제2투,1105,758,181,550,12,0,6,0,0,0,2,0,1,0,752,6,347
4100,경기도,4144,가평군,,청평면제3투,268,164,47,113,3,0,1,0,0,0,0,0,0,0,164,0,104
4100,경기도,4144,가평군,,청평면제4투,2847,1683,664,939,45,1,20,0,0,1,1,0,0,0,1671,12,1164
4100,경기도,4144,가평군,,청평면제5투,316,220,81,133,2,0,0,0,0,1,0,0,0,0,217,3,96
4100,경기도,4144,가평군,,청평면제6투,647,449,175,259,9,1,2,1,0,0,1,0,0,0,448,1,198
4100,경기도,4144,가평군,,청평면제7투,369,249,53,187,0,0,2,0,0,0,1,0,0,0,243,6,120
4100,경기도,4144,가평군,상면,소계,4593,3426,1249,2010,70,4,37,1,0,2,2,2,2,4,3383,43,1167
4100,경기도,4144,가평군,,관내사전투표,1496,1496,621,798,32,3,15,1,0,0,2,1,0,2,1475,21,0
4100,경기도,4144,가평군,,상면제1투,979,632,216,390,14,0,3,0,0,0,0,1,1,1,626,6,347
4100,경기도,4144,가평군,,상면제2투,764,475,154,298,10,0,8,0,0,1,0,0,0,0,471,4,289
4100,경기도,4144,가평군,,상면제3투,367,229,70,147,6,0,4,0,0,0,0,0,0,0,227,2,138
4100,경기도,4144,가평군,,상면제4투,612,360,102,245,4,0,3,0,0,1,0,0,1,0,356,4,252
4100,경기도,4144,가평군,,상면제5투,375,234,86,132,4,1,4,0,0,0,0,0,0,1,228,6,141
4100,경기도,4144,가평군,북면,소계,3086,2343,819,1433,37,1,25,0,0,0,4,5,1,2,2327,16,743
4100,경기도,4144,가평군,,관내사전투표,1035,1035,401,606,16,1,3,0,0,0,0,2,0,1,1030,5,0
4100,경기도,4144,가평군,,북면제1투,810,494,145,328,9,0,5,0,0,0,2,0,1,0,490,4,316
4100,경기도,4144,가평군,,북면제2투,482,329,100,216,4,0,5,0,0,0,0,0,0,0,325,4,153
4100,경기도,4144,가평군,,북면제3투,450,278,107,156,5,0,7,0,0,0,0,0,0,1,276,2,172
4100,경기도,4144,가평군,,북면제4투,309,207,66,127,3,0,5,0,0,0,2,3,0,0,206,1,102
4100,경기도,4144,가평군,조종면,소계,7288,5176,2045,2769,119,10,77,10,3,7,6,7,10,3,5066,110,2112
4100,경기도,4144,가평군,,관내사전투표,2164,2163,912,1151,43,1,27,0,0,2,1,1,0,0,2138,25,1
4100,경기도,4144,가평군,,조종면제1투,1342,747,286,421,15,0,15,0,0,1,0,1,0,0,739,8,595
4100,경기도,4144,가평군,,조종면제2투,841,491,176,293,7,0,6,0,0,1,1,0,2,0,486,5,350
4100,경기도,4144,가평군,,조종면제3투,944,567,246,285,16,2,8,0,0,0,1,0,0,0,558,9,377
4100,경기도,4144,가평군,,조종면제4투,1132,665,265,262,29,7,12,10,3,3,2,3,7,3,606,59,467
4100,경기도,4144,가평군,,조종면제5투,438,269,81,171,4,0,6,0,0,0,1,2,1,0,266,3,169
4100,경기도,4144,가평군,,조종면제6투,427,274,79,186,5,0,3,0,0,0,0,0,0,0,273,1,153
4100,경기도,4144,가평군,잘못 투입·구분된 투표지,,0,2,0,1,0,0,0,0,0,0,0,0,0,1,2,0,-24200,강원도,4201,춘천시,합계,,243403,186646,82376,94926,5294,116,1775,83,27,26,98,202,58,67,185048,1598,56757
4200,강원도,4201,춘천시,거소·선상투표,,786,728,293,321,18,2,9,4,1,1,1,3,1,3,657,71,58
4200,강원도,4201,춘천시,관외사전투표,,14939,14933,7033,6990,466,8,231,6,1,3,2,17,4,8,14769,164,6
4200,강원도,4201,춘천시,재외투표,,940,692,426,183,22,0,3,2,0,0,0,1,0,0,637,55,248
4200,강원도,4201,춘천시,신북읍,소계,7611,5948,2465,3182,148,4,70,3,0,1,2,12,5,3,5895,53,1663
4200,강원도,4201,춘천시,,관내사전투표,3102,3102,1452,1512,83,2,14,2,0,0,2,9,2,1,3079,23,0
4200,강원도,4201,춘천시,,신북읍제1투,1048,640,217,396,8,1,10,1,0,1,0,0,1,0,635,5,408
4200,강원도,4201,춘천시,,신북읍제2투,1713,1098,414,615,32,0,26,0,0,0,0,0,1,0,1088,10,615
4200,강원도,4201,춘천시,,신북읍제3투,1115,708,245,419,16,0,14,0,0,0,0,2,0,2,698,10,407
4200,강원도,4201,춘천시,,신북읍제4투,633,400,137,240,9,1,6,0,0,0,0,1,1,0,395,5,233
4200,강원도,4201,춘천시,동면,소계,12948,9575,4406,4705,262,5,109,3,0,2,6,12,2,2,9514,61,3373
4200,강원도,4201,춘천시,,관내사전투표,3210,3210,1619,1486,72,1,16,2,0,1,1,3,0,0,3201,9,0
4200,강원도,4201,춘천시,,동면제1투,2274,1578,726,763,63,1,13,0,0,1,1,1,0,0,1569,9,696
4200,강원도,4201,춘천시,,동면제2투,893,542,164,346,8,1,12,0,0,0,1,2,1,0,535,7,351
4200,강원도,4201,춘천시,,동면제3투,171,127,29,94,1,0,1,0,0,0,0,1,0,0,126,1,44
4200,강원도,4201,춘천시,,동면제4투,3242,2054,958,983,55,1,36,1,0,0,1,2,1,1,2039,15,1188
4200,강원도,4201,춘천시,,동면제5투,3158,2064,910,1033,63,1,31,0,0,0,2,3,0,1,2044,20,1094
4200,강원도,4201,춘천시,동산면,소계,1369,1035,363,633,13,0,10,1,0,1,1,0,2,0,1024,11,334
4200,강원도,4201,춘천시,,관내사전투표,531,531,221,291,7,0,1,1,0,1,0,0,2,0,524,7,0
4200,강원도,4201,춘천시,,동산면제1투,544,336,90,235,2,0,5,0,0,0,1,0,0,0,333,3,208
4200,강원도,4201,춘천시,,동산면제2투,294,168,52,107,4,0,4,0,0,0,0,0,0,0,167,1,126
4200,강원도,4201,춘천시,신동면,소계,3617,3081,1338,1607,82,2,19,2,0,0,2,3,0,1,3056,25,536
4200,강원도,4201,춘천시,,관내사전투표,2251,2251,1101,1065,54,1,9,2,0,0,1,2,0,0,2235,16,0
4200,강원도,4201,춘천시,,신동면투표소,1366,830,237,542,28,1,10,0,0,0,1,1,0,1,821,9,536
4200,강원도,4201,춘천시,동내면,소계,14557,11205,5203,5458,317,13,106,5,1,0,3,15,0,7,11128,77,3352
4200,강원도,4201,춘천시,,관내사전투표,5228,5228,2681,2336,128,7,41,2,1,0,1,8,0,2,5207,21,0
4200,강원도,4201,춘천시,,동내면제1투,2407,1408,593,745,39,1,18,0,0,0,0,1,0,1,1398,10,999
4200,강원도,4201,춘천시,,동내면제2투,2035,1273,449,752,33,2,20,1,0,0,0,1,0,0,1258,15,762
4200,강원도,4201,춘천시,,동내면제3투,2335,1605,706,812,60,1,9,2,0,0,0,1,0,1,1592,13,730
4200,강원도,4201,춘천시,,동내면제4투,2552,1691,774,813,57,2,18,0,0,0,2,4,0,3,1673,18,861
4200,강원도,4201,춘천시,남면,소계,902,692,225,445,12,0,4,2,0,0,0,1,0,0,689,3,210
4200,강원도,4201,춘천시,,관내사전투표,387,387,154,219,9,0,2,1,0,0,0,1,0,0,386,1,0
4200,강원도,4201,춘천시,,남면투표소,515,305,71,226,3,0,2,1,0,0,0,0,0,0,303,2,210
4200,강원도,4201,춘천시,남산면,소계,3107,2379,868,1424,37,0,29,0,0,0,2,2,1,0,2363,16,728
4200,강원도,4201,춘천시,,관내사전투표,1133,1133,489,616,17,0,7,0,0,0,0,1,0,0,1130,3,0
4200,강원도,4201,춘천시,,남산면제1투,950,542,156,353,10,0,16,0,0,0,0,1,1,0,537,5,408
4200,강원도,4201,춘천시,,남산면제2투,522,368,129,225,5,0,2,0,0,0,1,0,0,0,362,6,154
4200,강원도,4201,춘천시,,남산면제3투,502,336,94,230,5,0,4,0,0,0,1,0,0,0,334,2,166
4200,강원도,4201,춘천시,서면,소계,3335,2486,894,1486,60,1,20,1,1,0,0,3,3,1,2470,16,849
4200,강원도,4201,춘천시,,관내사전투표,1155,1155,500,612,26,1,6,0,1,0,0,1,2,0,1149,6,0
4200,강원도,4201,춘천시,,서면제1투,719,475,150,305,11,0,2,1,0,0,0,0,0,1,470,5,244
4200,강원도,4201,춘천시,,서면제2투,887,561,159,372,17,0,9,0,0,0,0,2,0,0,559,2,326
4200,강원도,4201,춘천시,,서면제3투,574,295,85,197,6,0,3,0,0,0,0,0,1,0,292,3,279
4200,강원도,4201,춘천시,사북면,소계,1994,1480,527,871,38,2,16,0,2,0,2,7,2,1,1468,12,514
4200,강원도,4201,춘천시,,관내사전투표,544,544,208,300,12,0,11,0,2,0,1,3,1,0,538,6,0
4200,강원도,4201,춘천시,,사북면제1투,585,421,142,262,12,0,2,0,0,0,0,1,0,0,419,2,164
4200,강원도,4201,춘천시,,사북면제2투,283,182,60,113,7,0,1,0,0,0,0,0,0,0,181,1,101
4200,강원도,4201,춘천시,,사북면제3투,582,333,117,196,7,2,2,0,0,0,1,3,1,1,330,3,249
4200,강원도,4201,춘천시,북산면,소계,756,591,173,394,11,0,4,0,1,0,0,0,1,2,586,5,165
4200,강원도,4201,춘천시,,관내사전투표,296,296,102,183,6,0,3,0,1,0,0,0,0,0,295,1,0
4200,강원도,4201,춘천시,,북산면제1투,323,196,53,133,5,0,1,0,0,0,0,0,0,2,194,2,127
4200,강원도,4201,춘천시,,북산면제2투,137,99,18,78,0,0,0,0,0,0,0,0,1,0,97,2,38
4200,강원도,4201,춘천시,소양동,소계,7687,5988,2762,2973,148,7,45,4,0,0,2,5,5,1,5952,36,1699
4200,강원도,4201,춘천시,,관내사전투표,3227,3227,1656,1460,75,4,15,0,0,0,0,2,4,0,3216,11,0
4200,강원도,4201,춘천시,,소양동제1투,930,575,225,317,9,2,11,1,0,0,1,2,0,0,568,7,355
4200,강원도,4201,춘천시,,소양동제2투,2969,1911,783,1038,56,1,11,3,0,0,1,1,0,1,1895,16,1058
4200,강원도,4201,춘천시,,소양동제3투,561,275,98,158,8,0,8,0,0,0,0,0,1,0,273,2,286
4200,강원도,4201,춘천시,교동,소계,3612,2784,1150,1475,74,2,38,1,0,1,0,4,1,1,2747,37,828
4200,강원도,4201,춘천시,,관내사전투표,1710,1710,792,831,46,2,18,1,0,0,0,2,0,0,1692,18,0
4200,강원도,4201,춘천시,,교동투표소,1902,1074,358,644,28,0,20,0,0,1,0,2,1,1,1055,19,828
4200,강원도,4201,춘천시,조운동,소계,3274,2540,1095,1306,79,1,20,0,2,1,5,0,2,2,2513,27,734
4200,강원도,4201,춘천시,,관내사전투표,1768,1768,834,836,65,0,10,0,2,1,2,0,1,1,1752,16,0
4200,강원도,4201,춘천시,,조운동투표소,1506,772,261,470,14,1,10,0,0,0,3,0,1,1,761,11,734
4200,강원도,4201,춘천시,약사명동,소계,3908,3218,1434,1639,94,1,21,4,0,0,0,2,0,2,3197,21,690
4200,강원도,4201,춘천시,,관내사전투표,2179,2179,1032,1053,60,1,11,3,0,0,0,2,0,1,2163,16,0
4200,강원도,4201,춘천시,,약사명동투표소,1729,1039,402,586,34,0,10,1,0,0,0,0,0,1,1034,5,690
4200,강원도,4201,춘천시,근화동,소계,6462,4573,2070,2284,120,2,47,5,0,1,5,2,0,2,4538,35,1889
4200,강원도,4201,춘천시,,관내사전투표,2271,2271,1118,1055,58,0,22,4,0,1,0,1,0,1,2260,11,0
4200,강원도,4201,춘천시,,근화동제1투,2774,1616,703,829,45,2,17,1,0,0,2,0,0,0,1599,17,1158
4200,강원도,4201,춘천시,,근화동제2투,1417,686,249,400,17,0,8,0,0,0,3,1,0,1,679,7,731
4200,강원도,4201,춘천시,후평1동,소계,10453,7491,3049,4054,202,9,86,0,2,1,5,7,4,2,7421,70,2962
4200,강원도,4201,춘천시,,관내사전투표,3774,3770,1695,1913,96,2,29,0,0,0,2,3,3,1,3744,26,4
4200,강원도,4201,춘천시,,후평1동제1투,2317,1284,448,750,42,1,21,0,1,0,1,2,0,0,1266,18,1033
4200,강원도,4201,춘천시,,후평1동제2투,2191,1165,437,653,31,3,26,0,0,0,1,1,0,1,1153,12,1026
4200,강원도,4201,춘천시,,후평1동제3투,2171,1272,469,738,33,3,10,0,1,1,1,1,1,0,1258,14,899
4200,강원도,4201,춘천시,후평2동,소계,11336,8370,3721,4241,254,8,69,6,1,0,5,3,2,2,8312,58,2966
4200,강원도,4201,춘천시,,관내사전투표,4203,4203,2030,1976,124,6,31,4,0,0,1,2,0,1,4175,28,0
4200,강원도,4201,춘천시,,후평2동제1투,2786,1642,659,911,49,0,10,2,0,0,2,0,0,1,1634,8,1144
4200,강원도,4201,춘천시,,후평2동제2투,1933,1024,402,555,40,1,12,0,0,0,2,1,2,0,1015,9,909
4200,강원도,4201,춘천시,,후평2동제3투,2414,1501,630,799,41,1,16,0,1,0,0,0,0,0,1488,13,913
4200,강원도,4201,춘천시,후평3동,소계,16559,12121,5328,6214,336,9,105,4,0,5,10,11,4,6,12032,89,4438
4200,강원도,4201,춘천시,,관내사전투표,5246,5245,2470,2584,120,4,26,1,0,1,5,3,3,1,5218,27,1
4200,강원도,4201,춘천시,,후평3동제1투,2771,1705,690,944,48,1,12,1,0,0,0,0,0,1,1697,8,1066
4200,강원도,4201,춘천시,,후평3동제2투,2507,1528,755,686,49,0,20,1,0,1,3,2,0,1,1518,10,979
4200,강원도,4201,춘천시,,후평3동제3투,1921,1054,433,553,32,1,17,0,0,1,0,1,1,1,1040,14,867
4200,강원도,4201,춘천시,,후평3동제4투,1262,840,323,461,34,0,10,1,0,1,1,2,0,0,833,7,422
4200,강원도,4201,춘천시,,후평3동제5투,2852,1749,657,986,53,3,20,0,0,1,1,3,0,2,1726,23,1103
4200,강원도,4201,춘천시,효자1동,소계,4338,3504,1470,1862,108,3,34,1,0,0,2,3,2,1,3486,18,834
4200,강원도,4201,춘천시,,관내사전투표,2214,2214,996,1127,57,1,19,0,0,0,2,1,0,1,2204,10,0
4200,강원도,4201,춘천시,,효자1동투표소,2124,1290,474,735,51,2,15,1,0,0,0,2,2,0,1282,8,834
4200,강원도,4201,춘천시,효자2동,소계,9650,6563,2624,3548,180,4,85,3,0,3,7,14,5,2,6475,88,3087
4200,강원도,4201,춘천시,,관내사전투표,2621,2620,1132,1355,67,2,29,0,0,3,1,4,1,2,2596,24,1
4200,강원도,4201,춘천시,,효자2동제1투,2137,1272,506,659,46,0,16,1,0,0,3,7,1,0,1239,33,865
4200,강원도,4201,춘천시,,효자2동제2투,2189,1307,467,779,26,1,16,2,0,0,1,1,2,0,1295,12,882
4200,강원도,4201,춘천시,,효자2동제3투,1437,730,278,406,23,1,9,0,0,0,1,0,0,0,718,12,707
4200,강원도,4201,춘천시,,효자2동제4투,1266,634,241,349,18,0,15,0,0,0,1,2,1,0,627,7,632
4200,강원도,4201,춘천시,효자3동,소계,4075,2987,1163,1617,108,2,29,2,0,1,1,8,1,3,2935,52,1088
4200,강원도,4201,춘천시,,관내사전투표,1684,1684,719,868,56,1,11,1,0,1,0,6,1,0,1664,20,0
4200,강원도,4201,춘천시,,효자3동투표소,2391,1303,444,749,52,1,18,1,0,0,1,2,0,3,1271,32,1088
4200,강원도,4201,춘천시,석사동,소계,25642,19046,8636,9466,597,6,155,6,7,0,10,17,2,5,18907,139,6596
4200,강원도,4201,춘천시,,관내사전투표,6288,6286,3075,2958,176,2,24,1,3,0,2,6,0,3,6250,36,2
4200,강원도,4201,춘천시,,석사동제1투,2187,1454,591,767,56,0,19,1,0,0,3,4,1,0,1442,12,733
4200,강원도,4201,춘천시,,석사동제2투,1570,807,325,441,20,0,9,0,0,0,1,0,0,0,796,11,763
4200,강원도,4201,춘천시,,석사동제3투,1551,965,380,531,34,0,7,0,0,0,0,0,0,1,953,12,586
4200,강원도,4201,춘천시,,석사동제4투,2674,1987,829,1044,75,1,12,1,3,0,1,3,0,1,1970,17,687
4200,강원도,4201,춘천시,,석사동제5투,1975,1297,623,615,41,0,10,0,0,0,1,1,0,0,1291,6,678
4200,강원도,4201,춘천시,,석사동제6투,3341,2311,997,1185,78,1,26,2,0,0,1,1,0,0,2291,20,1030
4200,강원도,4201,춘천시,,석사동제7투,1521,890,320,518,25,1,16,0,0,0,1,2,0,0,883,7,631
4200,강원도,4201,춘천시,,석사동제8투,1581,1115,589,471,36,0,13,0,0,0,0,0,0,0,1109,6,466
4200,강원도,4201,춘천시,,석사동제9투,2954,1934,907,936,56,1,19,1,1,0,0,0,1,0,1922,12,1020
4200,강원도,4201,춘천시,퇴계동,소계,33765,25316,11555,12571,742,9,199,9,2,1,14,24,4,7,25137,179,8449
4200,강원도,4201,춘천시,,관내사전투표,6420,6420,3214,3008,143,2,22,2,0,0,0,5,0,0,6396,24,0
4200,강원도,4201,춘천시,,퇴계동제1투,3017,1806,725,978,51,0,27,0,0,0,2,2,0,0,1785,21,1211
4200,강원도,4201,춘천시,,퇴계동제2투,1482,971,391,518,37,0,13,0,0,0,0,2,0,0,961,10,511
4200,강원도,4201,춘천시,,퇴계동제3투,1740,1192,503,617,40,1,17,0,0,0,3,0,0,1,1182,10,548
4200,강원도,4201,춘천시,,퇴계동제4투,2003,1462,628,776,38,1,11,0,0,0,1,0,0,1,1456,6,541
4200,강원도,4201,춘천시,,퇴계동제5투,1286,929,399,465,39,0,11,0,0,0,0,4,2,0,920,9,357
4200,강원도,4201,춘천시,,퇴계동제6투,2182,1598,676,845,37,0,12,3,0,0,4,3,0,0,1580,18,584
4200,강원도,4201,춘천시,,퇴계동제7투,2918,1873,823,968,53,2,17,2,0,1,0,0,0,1,1867,6,1045
4200,강원도,4201,춘천시,,퇴계동제8투,2462,1614,681,831,62,0,17,1,0,0,1,1,1,0,1595,19,848
4200,강원도,4201,춘천시,,퇴계동제9투,1721,1263,589,619,38,0,8,1,0,0,1,1,0,1,1258,5,458
4200,강원도,4201,춘천시,,퇴계동제10투,2536,1683,758,842,46,0,17,0,1,0,2,2,1,2,1671,12,853
4200,강원도,4201,춘천시,,퇴계동제11투,1986,1503,709,711,55,2,9,0,1,0,0,0,0,0,1487,16,483
4200,강원도,4201,춘천시,,퇴계동제12투,4012,3002,1459,1393,103,1,18,0,0,0,0,4,0,1,2979,23,1010
4200,강원도,4201,춘천시,강남동,소계,17690,13666,5990,7086,381,5,88,3,4,2,2,10,2,1,13574,92,4024
4200,강원도,4201,춘천시,,관내사전투표,5732,5731,2658,2863,143,2,27,1,1,1,1,4,1,0,5702,29,1
4200,강원도,4201,춘천시,,강남동제1투,1546,937,399,482,25,0,16,0,0,0,0,3,0,0,925,12,609
4200,강원도,4201,춘천시,,강남동제2투,2265,1365,497,805,39,1,9,0,2,1,1,1,0,0,1356,9,900
4200,강원도,4201,춘천시,,강남동제3투,1750,1224,460,702,44,0,9,1,0,0,0,1,0,0,1217,7,526
4200,강원도,4201,춘천시,,강남동제4투,3047,2000,873,1029,59,0,15,1,0,0,0,0,1,1,1979,21,1047
4200,강원도,4201,춘천시,,강남동제5투,3350,2409,1103,1205,71,2,12,0,1,0,0,1,0,0,2395,14,941
4200,강원도,4201,춘천시,신사우동,소계,18091,13650,6112,6891,385,11,124,6,2,2,9,15,3,2,13562,88,4441
4200,강원도,4201,춘천시,,관내사전투표,6117,6117,2999,2855,171,5,46,2,1,1,3,6,2,1,6092,25,0
4200,강원도,4201,춘천시,,신사우동제1투,2670,1582,714,798,42,2,11,1,1,1,2,0,0,0,1572,10,1088
4200,강원도,4201,춘천시,,신사우동제2투,1620,1136,420,656,34,0,8,3,0,0,0,1,0,1,1123,13,484
4200,강원도,4201,춘천시,,신사우동제3투,1890,1151,403,681,42,0,11,0,0,0,0,1,0,0,1138,13,739
4200,강원도,4201,춘천시,,신사우동제4투,1058,657,231,402,6,1,8,0,0,0,0,2,1,0,651,6,401
4200,강원도,4201,춘천시,,신사우동제5투,2031,1211,478,675,31,1,11,0,0,0,4,0,0,0,1200,11,820
4200,강원도,4201,춘천시,,신사우동제6투,2705,1796,867,824,59,2,29,0,0,0,0,5,0,0,1786,10,909
4200,강원도,4201,춘천시,잘못 투입·구분된 투표지,,0,4,3,0,0,0,0,0,0,0,0,1,0,0,4,0,-4
4200,강원도,4202,원주시,합계,,302881,226239,100954,113560,6105,143,2595,58,38,63,228,267,83,111,224205,2034,76642
4200,강원도,4202,원주시,거소·선상투표,,553,526,218,228,6,1,16,0,0,0,0,2,0,2,473,53,27
4200,강원도,4202,원주시,관외사전투표,,19820,19811,9308,9294,623,17,263,7,4,8,11,22,5,21,19583,228,9
4200,강원도,4202,원주시,재외투표,,986,722,440,175,25,0,5,0,0,0,1,0,0,0,646,76,264
4200,강원도,4202,원주시,문막읍,소계,14893,10394,4807,5061,253,6,139,6,1,1,13,5,9,5,10306,88,4499
4200,강원도,4202,원주시,,관내사전투표,4698,4698,2364,2159,98,4,40,1,0,0,3,5,3,2,4679,19,0
4200,강원도,4202,원주시,,문막읍제1투,3795,2079,948,989,69,1,36,3,1,0,5,0,1,0,2053,26,1716
4200,강원도,4202,원주시,,문막읍제2투,1477,788,261,494,14,1,9,0,0,0,1,0,0,0,780,8,689
4200,강원도,4202,원주시,,문막읍제3투,851,553,142,375,10,0,12,0,0,0,3,0,1,1,544,9,298
4200,강원도,4202,원주시,,문막읍제4투,1715,942,402,490,20,0,14,0,0,1,0,0,2,1,930,12,773
4200,강원도,4202,원주시,,문막읍제5투,2357,1334,690,554,42,0,28,2,0,0,1,0,2,1,1320,14,1023
4200,강원도,4202,원주시,소초면,소계,6818,4889,1691,2944,111,4,57,2,2,1,26,5,3,4,4850,39,1929
4200,강원도,4202,원주시,,관내사전투표,1909,1909,773,1065,38,1,12,1,0,0,2,3,1,1,1897,12,0
4200,강원도,4202,원주시,,소초면제1투,1347,778,242,494,17,0,13,0,0,0,2,0,2,1,771,7,569
4200,강원도,4202,원주시,,소초면제2투,1068,719,220,466,13,1,10,1,0,0,1,1,0,1,714,5,349
4200,강원도,4202,원주시,,소초면제3투,1753,1036,316,656,35,1,12,0,0,0,4,1,0,1,1026,10,717
4200,강원도,4202,원주시,,소초면제4투,741,447,140,263,8,1,10,0,2,1,17,0,0,0,442,5,294
4200,강원도,4202,원주시,호저면,소계,3446,2606,932,1540,51,2,35,0,3,0,3,3,4,2,2575,31,840
4200,강원도,4202,원주시,,관내사전투표,1281,1281,528,679,30,1,20,0,2,0,1,1,1,1,1264,17,0
4200,강원도,4202,원주시,,호저면제1투,1388,830,255,540,15,1,8,0,1,0,0,2,0,0,822,8,558
4200,강원도,4202,원주시,,호저면제2투,777,495,149,321,6,0,7,0,0,0,2,0,3,1,489,6,282
4200,강원도,4202,원주시,지정면,소계,18683,13552,6827,6057,371,6,156,3,3,5,7,9,1,5,13450,102,5131
4200,강원도,4202,원주시,,관내사전투표,4885,4885,2625,2066,117,1,44,2,0,0,1,0,0,2,4858,27,0
4200,강원도,4202,원주시,,지정면제1투,921,524,153,336,12,2,10,1,0,1,1,0,0,0,516,8,397
4200,강원도,4202,원주시,,지정면제2투,608,386,133,230,4,0,10,0,0,2,1,1,0,0,381,5,222
4200,강원도,4202,원주시,,지정면제3투,2623,1712,864,758,51,1,24,0,2,1,0,1,1,1,1704,8,911
4200,강원도,4202,원주시,,지정면제4투,3508,2183,1151,926,60,0,26,0,1,0,0,3,0,0,2167,16,1325
4200,강원도,4202,원주시,,지정면제5투,3312,2221,1136,961,71,2,26,0,0,0,2,2,0,0,2200,21,1091
4200,강원도,4202,원주시,,지정면제6투,2826,1641,765,780,56,0,16,0,0,1,2,2,0,2,1624,17,1185
4200,강원도,4202,원주시,부론면,소계,1917,1484,421,1011,29,0,9,0,0,0,2,0,0,1,1473,11,433
4200,강원도,4202,원주시,,관내사전투표,791,791,261,501,16,0,6,0,0,0,2,0,0,0,786,5,0
4200,강원도,4202,원주시,,부론면투표소,1126,693,160,510,13,0,3,0,0,0,0,0,0,1,687,6,433
4200,강원도,4202,원주시,귀래면,소계,2077,1623,546,996,44,2,16,0,0,0,1,1,2,2,1610,13,454
4200,강원도,4202,원주시,,관내사전투표,952,952,369,541,28,1,5,0,0,0,0,0,1,1,946,6,0
4200,강원도,4202,원주시,,귀래면투표소,1125,671,177,455,16,1,11,0,0,0,1,1,1,1,664,7,454
4200,강원도,4202,원주시,흥업면,소계,8581,6604,2928,3349,156,4,74,1,0,4,6,7,2,3,6534,70,1977
4200,강원도,4202,원주시,,관내사전투표,3866,3866,1879,1820,87,2,29,1,0,1,1,4,1,3,3828,38,0
4200,강원도,4202,원주시,,흥업면제1투,2808,1573,660,812,40,0,30,0,0,3,3,1,0,0,1549,24,1235
4200,강원도,4202,원주시,,흥업면제2투,778,512,169,323,10,0,5,0,0,0,2,1,0,0,510,2,266
4200,강원도,4202,원주시,,흥업면제3투,1129,653,220,394,19,2,10,0,0,0,0,1,1,0,647,6,476
4200,강원도,4202,원주시,판부면,소계,6209,4601,2114,2269,106,1,57,3,3,1,2,4,0,3,4563,38,1608
4200,강원도,4202,원주시,,관내사전투표,2241,2241,1246,898,56,1,19,3,0,0,0,2,0,1,2226,15,0
4200,강원도,4202,원주시,,판부면제1투,781,538,197,322,6,0,3,0,0,0,0,0,0,0,528,10,243
4200,강원도,4202,원주시,,판부면제2투,578,385,120,243,8,0,9,0,0,1,0,1,0,2,384,1,193
4200,강원도,4202,원주시,,판부면제3투,2609,1437,551,806,36,0,26,0,3,0,2,1,0,0,1425,12,1172
4200,강원도,4202,원주시,신림면,소계,3374,2664,968,1590,41,0,44,1,0,0,0,6,2,2,2654,10,710
4200,강원도,4202,원주시,,관내사전투표,1463,1463,598,804,29,0,18,1,0,0,0,4,1,1,1456,7,0
4200,강원도,4202,원주시,,신림면제1투,1316,773,242,496,7,0,23,0,0,0,0,1,0,1,770,3,543
4200,강원도,4202,원주시,,신림면제2투,595,428,128,290,5,0,3,0,0,0,0,1,1,0,428,0,167
4200,강원도,4202,원주시,중앙동,소계,3722,2935,1117,1702,55,2,25,2,1,1,4,4,1,3,2917,18,787
4200,강원도,4202,원주시,,관내사전투표,2195,2194,912,1198,44,2,12,2,1,1,1,4,1,3,2181,13,1
4200,강원도,4202,원주시,,중앙동투표소,1527,741,205,504,11,0,13,0,0,0,3,0,0,0,736,5,786
4200,강원도,4202,원주시,원인동,소계,3721,2565,1025,1403,60,3,36,0,0,0,3,6,3,1,2540,25,1156
4200,강원도,4202,원주시,,관내사전투표,1119,1119,510,570,20,1,9,0,0,0,0,1,0,0,1111,8,0
4200,강원도,4202,원주시,,원인동제1투,1853,1020,363,588,31,1,18,0,0,0,1,3,3,1,1009,11,833
4200,강원도,4202,원주시,,원인동제2투,749,426,152,245,9,1,9,0,0,0,2,2,0,0,420,6,323
4200,강원도,4202,원주시,개운동,소계,10724,7880,3229,4303,171,6,75,1,2,4,11,12,3,1,7818,62,2844
4200,강원도,4202,원주시,,관내사전투표,3842,3842,1741,1961,80,3,26,0,0,2,2,5,3,1,3824,18,0
4200,강원도,4202,원주시,,개운동제1투,2357,1278,419,793,30,0,14,1,1,2,4,3,0,0,1267,11,1079
4200,강원도,4202,원주시,,개운동제2투,2535,1557,573,898,36,2,18,0,1,0,5,4,0,0,1537,20,978
4200,강원도,4202,원주시,,개운동제3투,1990,1203,496,651,25,1,17,0,0,0,0,0,0,0,1190,13,787
4200,강원도,4202,원주시,명륜1동,소계,9105,7283,3145,3763,219,5,65,6,1,0,7,10,4,3,7228,55,1822
4200,강원도,4202,원주시,,관내사전투표,4278,4278,2062,2009,128,3,35,5,1,0,0,6,2,0,4251,27,0
4200,강원도,4202,원주시,,명륜1동제1투,1573,930,323,567,16,1,6,0,0,0,4,1,2,3,923,7,643
4200,강원도,4202,원주시,,명륜1동제2투,1321,788,304,438,25,1,9,1,0,0,2,0,0,0,780,8,533
4200,강원도,4202,원주시,,명륜1동제3투,1933,1287,456,749,50,0,15,0,0,0,1,3,0,0,1274,13,646
4200,강원도,4202,원주시,명륜2동,소계,13430,9935,4355,5082,234,8,121,2,2,5,11,15,4,3,9842,93,3495
4200,강원도,4202,원주시,,관내사전투표,4809,4809,2300,2309,125,2,35,0,0,0,2,6,2,2,4783,26,0
4200,강원도,4202,원주시,,명륜2동제1투,1844,923,345,512,12,3,23,1,1,3,2,2,1,1,906,17,921
4200,강원도,4202,원주시,,명륜2동제2투,2795,1891,819,995,39,1,16,0,0,0,3,3,0,0,1876,15,904
4200,강원도,4202,원주시,,명륜2동제3투,2192,1328,524,721,31,1,26,1,1,0,3,2,0,0,1310,18,864
4200,강원도,4202,원주시,,명륜2동제4투,1790,984,367,545,27,1,21,0,0,2,1,2,1,0,967,17,806
4200,강원도,4202,원주시,단구동,소계,33408,23382,10838,11353,643,19,277,2,4,4,14,31,4,12,23201,181,10026
4200,강원도,4202,원주시,,관내사전투표,9109,9109,4655,4100,218,5,59,1,2,0,1,19,1,2,9063,46,0
4200,강원도,4202,원주시,,단구동제1투,2492,1360,558,721,38,1,25,0,0,0,0,1,0,3,1347,13,1132
4200,강원도,4202,원주시,,단구동제2투,2143,1244,474,685,40,2,23,0,0,0,1,1,1,1,1228,16,899
4200,강원도,4202,원주시,,단구동제3투,2438,1456,667,703,46,2,17,0,0,1,3,2,0,2,1443,13,982
4200,강원도,4202,원주시,,단구동제4투,1523,903,303,541,27,0,19,0,1,0,1,2,0,0,894,9,620
4200,강원도,4202,원주시,,단구동제5투,2806,1655,664,902,42,3,22,0,0,0,3,1,0,1,1638,17,1151
4200,강원도,4202,원주시,,단구동제6투,2568,1609,716,810,50,2,13,0,0,1,3,0,0,0,1595,14,959
4200,강원도,4202,원주시,,단구동제7투,2740,1506,653,780,38,1,20,0,0,1,0,1,0,1,1495,11,1234
4200,강원도,4202,원주시,,단구동제8투,2473,1423,626,705,44,3,30,0,1,0,0,1,0,2,1412,11,1050
4200,강원도,4202,원주시,,단구동제9투,2776,1752,886,766,55,0,23,0,0,1,1,1,1,0,1734,18,1024
4200,강원도,4202,원주시,,단구동제10투,2340,1365,636,640,45,0,26,1,0,0,1,2,1,0,1352,13,975
4200,강원도,4202,원주시,일산동,소계,7551,5473,2179,2982,145,3,67,0,0,2,12,4,3,3,5400,73,2078
4200,강원도,4202,원주시,,관내사전투표,2786,2786,1211,1444,70,2,27,0,0,0,1,3,1,1,2760,26,0
4200,강원도,4202,원주시,,일산동제1투,2244,1249,459,715,24,0,24,0,0,0,6,0,1,1,1230,19,995
4200,강원도,4202,원주시,,일산동제2투,2521,1438,509,823,51,1,16,0,0,2,5,1,1,1,1410,28,1083
4200,강원도,4202,원주시,학성동,소계,5238,4005,1603,2205,100,3,44,2,0,0,1,8,4,5,3975,30,1233
4200,강원도,4202,원주시,,관내사전투표,2423,2421,1064,1262,57,0,18,0,0,0,0,5,1,1,2408,13,2
4200,강원도,4202,원주시,,학성동제1투,1972,1184,406,707,30,2,16,1,0,0,1,2,2,3,1170,14,788
4200,강원도,4202,원주시,,학성동제2투,843,400,133,236,13,1,10,1,0,0,0,1,1,1,397,3,443
4200,강원도,4202,원주시,단계동,소계,22823,16553,7025,8678,468,8,180,3,3,3,13,22,2,3,16408,145,6270
4200,강원도,4202,원주시,,관내사전투표,6992,6992,3244,3446,194,1,53,1,1,1,2,14,0,1,6958,34,0
4200,강원도,4202,원주시,,단계동제1투,2784,1545,602,859,30,4,15,1,0,0,2,1,0,0,1514,31,1239
4200,강원도,4202,원주시,,단계동제2투,3130,1939,720,1090,69,1,32,0,0,1,2,1,1,1,1918,21,1191
4200,강원도,4202,원주시,,단계동제3투,3352,1983,761,1111,58,0,23,1,1,0,4,1,0,0,1960,23,1369
4200,강원도,4202,원주시,,단계동제4투,1372,793,269,473,20,0,17,0,1,1,0,4,0,1,786,7,579
4200,강원도,4202,원주시,,단계동제5투,2794,1746,716,943,50,2,16,0,0,0,2,0,1,0,1730,16,1048
4200,강원도,4202,원주시,,단계동제6투,2399,1555,713,756,47,0,24,0,0,0,1,1,0,0,1542,13,844
4200,강원도,4202,원주시,우산동,소계,10943,7874,3206,4280,188,5,104,3,2,2,6,13,3,1,7813,61,3069
4200,강원도,4202,원주시,,관내사전투표,3595,3595,1648,1794,89,3,36,3,2,0,1,4,0,0,3580,15,0
4200,강원도,4202,원주시,,우산동제1투,2185,1233,380,790,31,2,16,0,0,1,0,4,0,0,1224,9,952
4200,강원도,4202,원주시,,우산동제2투,2806,1721,695,933,39,0,18,0,0,1,3,4,2,1,1696,25,1085
4200,강원도,4202,원주시,,우산동제3투,2357,1325,483,763,29,0,34,0,0,0,2,1,1,0,1313,12,1032
4200,강원도,4202,원주시,태장1동,소계,8766,6368,2899,3145,149,2,92,2,1,4,7,13,5,3,6322,46,2398
4200,강원도,4202,원주시,,관내사전투표,3449,3449,1695,1610,78,1,40,1,1,1,3,5,1,3,3439,10,0
4200,강원도,4202,원주시,,태장1동제1투,2207,1233,489,655,32,1,27,0,0,2,1,4,2,0,1213,20,974
4200,강원도,4202,원주시,,태장1동제2투,3110,1686,715,880,39,0,25,1,0,1,3,4,2,0,1670,16,1424
4200,강원도,4202,원주시,태장2동,소계,19299,13407,5851,6787,379,9,208,4,2,4,12,17,9,10,13292,115,5892
4200,강원도,4202,원주시,,관내사전투표,5491,5490,2588,2660,137,3,51,2,2,0,1,8,3,3,5458,32,1
4200,강원도,4202,원주시,,태장2동제1투,1891,954,362,518,31,1,22,0,0,1,2,2,3,2,944,10,937
4200,강원도,4202,원주시,,태장2동제2투,3349,2046,926,997,70,0,31,0,0,0,1,2,0,1,2028,18,1303
4200,강원도,4202,원주시,,태장2동제3투,2179,1236,505,658,37,0,16,1,0,0,1,1,2,1,1222,14,943
4200,강원도,4202,원주시,,태장2동제4투,1381,779,267,456,20,2,21,0,0,3,2,1,1,0,773,6,602
4200,강원도,4202,원주시,,태장2동제5투,2448,1373,588,681,38,3,38,1,0,0,5,0,0,1,1355,18,1075
4200,강원도,4202,원주시,,태장2동제6투,2560,1529,615,817,46,0,29,0,0,0,0,3,0,2,1512,17,1031
4200,강원도,4202,원주시,봉산동,소계,6621,4893,1884,2764,108,10,53,1,0,1,14,9,1,1,4846,47,1728
4200,강원도,4202,원주시,,관내사전투표,2073,2070,868,1112,41,6,16,1,0,0,2,2,1,0,2049,21,3
4200,강원도,4202,원주시,,봉산동제1투,1321,746,242,451,22,0,15,0,0,0,2,4,0,1,737,9,575
4200,강원도,4202,원주시,,봉산동제2투,1259,735,233,461,14,0,11,0,0,1,5,1,0,0,726,9,524
4200,강원도,4202,원주시,,봉산동제3투,1968,1342,541,740,31,4,11,0,0,0,5,2,0,0,1334,8,626
4200,강원도,4202,원주시,행구동,소계,6986,5584,2526,2817,147,4,46,0,0,4,7,4,0,1,5556,28,1402
4200,강원도,4202,원주시,,관내사전투표,3222,3222,1604,1503,77,4,18,0,0,1,2,2,0,1,3212,10,0
4200,강원도,4202,원주시,,행구동제1투,1542,917,304,564,26,0,9,0,0,2,4,1,0,0,910,7,625
4200,강원도,4202,원주시,,행구동제2투,2222,1445,618,750,44,0,19,0,0,1,1,1,0,0,1434,11,777
4200,강원도,4202,원주시,무실동,소계,25003,17963,8528,8573,517,8,145,1,2,4,13,15,5,8,17819,144,7040
4200,강원도,4202,원주시,,관내사전투표,7058,7051,3693,3088,193,3,31,0,1,0,2,5,1,1,7018,33,7
4200,강원도,4202,원주시,,무실동제1투,2897,1593,636,853,57,2,23,0,0,0,1,1,0,1,1574,19,1304
4200,강원도,4202,원주시,,무실동제2투,2614,1502,604,808,47,0,20,0,0,0,1,2,1,0,1483,19,1112
4200,강원도,4202,원주시,,무실동제3투,2291,1669,784,811,48,0,10,0,0,0,0,2,0,1,1656,13,622
4200,강원도,4202,원주시,,무실동제4투,2999,1562,590,882,42,0,22,0,0,0,1,3,1,1,1542,20,1437
4200,강원도,4202,원주시,,무실동제5투,3157,2025,971,949,47,1,22,1,1,1,6,1,2,4,2006,19,1132
4200,강원도,4202,원주시,,무실동제6투,3987,2561,1250,1182,83,2,17,0,0,3,2,1,0,0,2540,21,1426
4200,강원도,4202,원주시,반곡관설동,소계,28184,20645,10333,9203,705,5,186,6,2,5,21,20,4,3,20493,152,7539
4200,강원도,4202,원주시,,관내사전투표,7518,7517,4267,2935,226,3,42,4,0,1,6,6,0,0,7490,27,1
4200,강원도,4202,원주시,,반곡관설동제1투,1828,1227,476,675,38,0,20,0,0,0,4,1,0,0,1214,13,601
4200,강원도,4202,원주시,,반곡관설동제2투,2619,1812,830,867,82,0,15,0,0,0,1,2,1,1,1799,13,807
4200,강원도,4202,원주시,,반곡관설동제3투,3338,1786,815,863,63,0,19,1,1,0,1,3,2,0,1768,18,1552
4200,강원도,4202,원주시,,반곡관설동제4투,2188,1414,717,605,46,1,23,0,0,0,0,2,0,1,1395,19,774
4200,강원도,4202,원주시,,반곡관설동제5투,3350,2199,1023,1066,67,0,16,0,1,3,3,2,1,1,2183,16,1151
4200,강원도,4202,원주시,,반곡관설동제6투,2619,1649,754,788,69,1,18,0,0,0,0,1,0,0,1631,18,970
4200,강원도,4202,원주시,,반곡관설동제7투,1744,1076,502,504,43,0,9,0,0,1,1,2,0,0,1062,14,668
4200,강원도,4202,원주시,,반곡관설동제8투,2980,1965,949,900,71,0,24,1,0,0,5,1,0,0,1951,14,1015
4200,강원도,4202,원주시,잘못 투입·구분된 투표지,,0,18,11,6,1,0,0,0,0,0,0,0,0,0,18,0,-18
4200,강원도,4203,강릉시,합계,,185823,141724,54377,80482,3434,80,1511,41,31,41,121,173,55,74,140420,1304,44099
4200,강원도,4203,강릉시,거소·선상투표,,487,447,139,223,14,1,16,0,0,0,0,0,1,3,397,50,40
4200,강원도,4203,강릉시,관외사전투표,,10804,10801,4710,5408,308,14,154,7,4,4,5,20,2,10,10646,155,3
4200,강원도,4203,강릉시,재외투표,,593,439,268,111,16,1,1,0,0,2,0,0,0,0,399,40,154
4200,강원도,4203,강릉시,주문진읍,소계,14258,9921,3287,6248,163,7,86,0,1,4,13,6,2,6,9823,98,4337
4200,강원도,4203,강릉시,,관내사전투표,3698,3698,1345,2237,57,3,25,0,0,1,2,2,0,2,3674,24,0
4200,강원도,4203,강릉시,,주문진읍제1투,1938,1109,319,745,14,0,5,0,1,1,2,0,0,1,1088,21,829
4200,강원도,4203,강릉시,,주문진읍제2투,2317,1277,416,802,19,1,20,0,0,0,4,2,0,2,1266,11,1040
4200,강원도,4203,강릉시,,주문진읍제3투,1882,1169,319,799,27,1,10,0,0,1,2,1,0,0,1160,9,713
4200,강원도,4203,강릉시,,주문진읍제4투,784,520,135,366,10,0,2,0,0,0,0,1,0,0,514,6,264
4200,강원도,4203,강릉시,,주문진읍제5투,2053,1237,435,749,22,0,14,0,0,1,0,0,2,1,1224,13,816
4200,강원도,4203,강릉시,,주문진읍제6투,1586,911,318,550,14,2,10,0,0,0,3,0,0,0,897,14,675
4200,강원도,4203,강릉시,성산면,소계,3264,2601,895,1604,51,2,19,1,0,0,2,3,2,1,2580,21,663
4200,강원도,4203,강릉시,,관내사전투표,1471,1471,565,853,25,2,10,1,0,0,0,1,1,1,1459,12,0
4200,강원도,4203,강릉시,,성산면제1투,1267,749,208,503,18,0,7,0,0,0,2,2,1,0,741,8,518
4200,강원도,4203,강릉시,,성산면제2투,526,381,122,248,8,0,2,0,0,0,0,0,0,0,380,1,145
4200,강원도,4203,강릉시,왕산면,소계,1298,1044,280,713,25,0,8,2,0,0,1,1,0,2,1032,12,254
4200,강원도,4203,강릉시,,관내사전투표,423,423,129,277,12,0,2,1,0,0,1,1,0,0,423,0,0
4200,강원도,4203,강릉시,,왕산면제1투,417,282,65,199,8,0,3,1,0,0,0,0,0,1,277,5,135
4200,강원도,4203,강릉시,,왕산면제2투,250,186,47,127,3,0,2,0,0,0,0,0,0,1,180,6,64
4200,강원도,4203,강릉시,,왕산면제3투,208,153,39,110,2,0,1,0,0,0,0,0,0,0,152,1,55
4200,강원도,4203,강릉시,구정면,소계,4019,3166,1135,1916,66,1,25,2,0,2,2,3,1,2,3155,11,853
4200,강원도,4203,강릉시,,관내사전투표,1800,1800,741,1003,37,0,11,1,0,2,1,2,0,0,1798,2,0
4200,강원도,4203,강릉시,,구정면제1투,1501,942,287,613,20,1,8,1,0,0,1,1,0,1,933,9,559
4200,강원도,4203,강릉시,,구정면제2투,718,424,107,300,9,0,6,0,0,0,0,0,1,1,424,0,294
4200,강원도,4203,강릉시,강동면,소계,4036,3116,930,2052,50,1,28,2,2,0,2,6,2,1,3076,40,920
4200,강원도,4203,강릉시,,관내사전투표,1733,1733,586,1078,22,0,16,2,2,0,0,4,1,0,1711,22,0
4200,강원도,4203,강릉시,,강동면제1투,1431,850,206,602,17,1,8,0,0,0,2,1,1,0,838,12,581
4200,강원도,4203,강릉시,,강동면제2투,872,533,138,372,11,0,4,0,0,0,0,1,0,1,527,6,339
4200,강원도,4203,강릉시,옥계면,소계,3114,2401,680,1607,44,0,32,0,1,0,3,3,2,1,2373,28,713
4200,강원도,4203,강릉시,,관내사전투표,1290,1290,412,829,20,0,16,0,0,0,2,1,1,0,1281,9,0
4200,강원도,4203,강릉시,,옥계면제1투,1073,618,145,441,7,0,11,0,1,0,1,2,0,1,609,9,455
4200,강원도,4203,강릉시,,옥계면제2투,751,493,123,337,17,0,5,0,0,0,0,0,1,0,483,10,258
4200,강원도,4203,강릉시,사천면,소계,4467,3568,1296,2069,86,3,39,4,1,3,6,8,3,4,3522,46,899
4200,강원도,4203,강릉시,,관내사전투표,2040,2040,859,1075,48,3,11,3,1,2,3,6,1,3,2015,25,0
4200,강원도,4203,강릉시,,사천면제1투,1549,959,273,625,24,0,21,0,0,1,2,2,1,0,949,10,590
4200,강원도,4203,강릉시,,사천면제2투,878,569,164,369,14,0,7,1,0,0,1,0,1,1,558,11,309
4200,강원도,4203,강릉시,연곡면,소계,5823,4483,1667,2616,88,4,60,2,1,1,4,6,1,4,4454,29,1340
4200,강원도,4203,강릉시,,관내사전투표,2567,2567,1077,1395,51,3,21,1,1,0,0,4,0,4,2557,10,0
4200,강원도,4203,강릉시,,연곡면제1투,2179,1240,436,730,27,1,29,1,0,0,3,0,1,0,1228,12,939
4200,강원도,4203,강릉시,,연곡면제2투,1077,676,154,491,10,0,10,0,0,1,1,2,0,0,669,7,401
4200,강원도,4203,강릉시,홍제동,소계,11226,8402,3353,4674,215,3,79,2,0,0,6,14,1,1,8348,54,2824
4200,강원도,4203,강릉시,,관내사전투표,3487,3487,1421,1931,86,2,24,2,0,0,1,4,0,0,3471,16,0
4200,강원도,4203,강릉시,,홍제동제1투,2534,1511,580,880,23,0,14,0,0,0,2,3,0,1,1503,8,1023
4200,강원도,4203,강릉시,,홍제동제2투,1675,987,317,612,29,1,14,0,0,0,2,0,1,0,976,11,688
4200,강원도,4203,강릉시,,홍제동제3투,3530,2417,1035,1251,77,0,27,0,0,0,1,7,0,0,2398,19,1113
4200,강원도,4203,강릉시,중앙동,소계,5276,4114,1353,2599,80,1,42,1,2,4,3,4,0,2,4091,23,1162
4200,강원도,4203,강릉시,,관내사전투표,2538,2538,926,1510,55,1,20,0,1,2,1,4,0,2,2522,16,0
4200,강원도,4203,강릉시,,중앙동제1투,1067,622,175,419,11,0,11,0,0,2,0,0,0,0,618,4,445
4200,강원도,4203,강릉시,,중앙동제2투,1671,954,252,670,14,0,11,1,1,0,2,0,0,0,951,3,717
4200,강원도,4203,강릉시,옥천동,소계,3893,3022,991,1911,53,1,42,0,1,0,3,3,1,1,3007,15,871
4200,강원도,4203,강릉시,,관내사전투표,1952,1952,709,1167,33,1,28,0,0,0,1,2,1,0,1942,10,0
4200,강원도,4203,강릉시,,옥천동투표소,1941,1070,282,744,20,0,14,0,1,0,2,1,0,1,1065,5,871
4200,강원도,4203,강릉시,교1동,소계,20176,15263,6370,8193,395,4,146,2,2,2,7,13,7,6,15147,116,4913
4200,강원도,4203,강릉시,,관내사전투표,6599,6599,3058,3285,165,3,43,1,0,1,0,8,5,1,6570,29,0
4200,강원도,4203,강릉시,,교1동제1투,2144,1332,424,844,33,1,20,0,1,0,1,0,0,1,1325,7,812
4200,강원도,4203,강릉시,,교1동제2투,2478,1621,528,1014,34,0,21,0,0,1,2,1,0,1,1602,19,857
4200,강원도,4203,강릉시,,교1동제3투,1935,1349,584,688,41,0,15,0,0,0,1,3,1,1,1334,15,586
4200,강원도,4203,강릉시,,교1동제4투,2722,1647,682,867,48,0,22,1,1,0,3,1,0,0,1625,22,1075
4200,강원도,4203,강릉시,,교1동제5투,2128,1281,526,686,43,0,12,0,0,0,0,0,1,0,1268,13,847
4200,강원도,4203,강릉시,,교1동제6투,2170,1434,568,809,31,0,13,0,0,0,0,0,0,2,1423,11,736
4200,강원도,4203,강릉시,교2동,소계,7145,5439,2051,3158,130,3,47,1,2,3,4,7,1,3,5410,29,1706
4200,강원도,4203,강릉시,,관내사전투표,2954,2954,1225,1636,61,2,15,0,0,0,2,3,1,2,2947,7,0
4200,강원도,4203,강릉시,,교2동제1투,1388,725,231,454,16,0,11,0,0,2,2,0,0,1,717,8,663
4200,강원도,4203,강릉시,,교2동제2투,1182,679,224,414,20,0,10,0,2,0,0,0,0,0,670,9,503
4200,강원도,4203,강릉시,,교2동제3투,1621,1081,371,654,33,1,11,1,0,1,0,4,0,0,1076,5,540
4200,강원도,4203,강릉시,포남1동,소계,8759,6444,2150,4008,133,3,68,0,1,1,12,8,6,2,6392,52,2315
4200,강원도,4203,강릉시,,관내사전투표,2760,2760,1002,1670,49,0,23,0,1,0,2,2,1,0,2750,10,0
4200,강원도,4203,강릉시,,포남1동제1투,2108,1289,432,785,31,1,22,0,0,0,5,2,0,0,1278,11,819
4200,강원도,4203,강릉시,,포남1동제2투,1826,1159,292,813,18,1,14,0,0,0,4,2,2,0,1146,13,667
4200,강원도,4203,강릉시,,포남1동제3투,2065,1236,424,740,35,1,9,0,0,1,1,2,3,2,1218,18,829
4200,강원도,4203,강릉시,포남2동,소계,10859,8024,2903,4715,192,7,100,1,2,10,4,9,3,3,7949,75,2835
4200,강원도,4203,강릉시,,관내사전투표,3684,3684,1439,2117,73,2,25,1,1,1,2,3,1,1,3666,18,0
4200,강원도,4203,강릉시,,포남2동제1투,2079,1163,369,720,23,1,25,0,1,1,0,3,0,1,1144,19,916
4200,강원도,4203,강릉시,,포남2동제2투,1853,1128,384,666,29,3,22,0,0,8,1,0,1,0,1114,14,725
4200,강원도,4203,강릉시,,포남2동제3투,1681,1005,354,587,33,0,15,0,0,0,1,3,0,1,994,11,676
4200,강원도,4203,강릉시,,포남2동제4투,1562,1044,357,625,34,1,13,0,0,0,0,0,1,0,1031,13,518
4200,강원도,4203,강릉시,초당동,소계,4150,3291,1393,1739,92,1,35,1,1,0,2,5,1,1,3271,20,859
4200,강원도,4203,강릉시,,관내사전투표,1797,1797,828,896,47,0,12,1,0,0,1,1,1,1,1788,9,0
4200,강원도,4203,강릉시,,초당동제1투,959,594,191,370,13,0,14,0,0,0,1,2,0,0,591,3,365
4200,강원도,4203,강릉시,,초당동제2투,1394,900,374,473,32,1,9,0,1,0,0,2,0,0,892,8,494
4200,강원도,4203,강릉시,송정동,소계,7736,5996,2452,3271,150,0,57,0,2,0,6,3,2,0,5943,53,1740
4200,강원도,4203,강릉시,,관내사전투표,3121,3121,1347,1660,73,0,21,0,0,0,1,1,0,0,3103,18,0
4200,강원도,4203,강릉시,,송정동제1투,2433,1491,579,822,34,0,28,0,0,0,2,2,2,0,1469,22,942
4200,강원도,4203,강릉시,,송정동제2투,2182,1384,526,789,43,0,8,0,2,0,3,0,0,0,1371,13,798
4200,강원도,4203,강릉시,내곡동,소계,12218,9024,3803,4759,251,3,102,2,2,1,5,13,2,4,8947,77,3194
4200,강원도,4203,강릉시,,관내사전투표,4143,4142,1893,2073,97,2,37,2,1,0,1,6,1,1,4114,28,1
4200,강원도,4203,강릉시,,내곡동제1투,2227,1436,538,811,41,0,25,0,0,0,2,5,0,1,1423,13,791
4200,강원도,4203,강릉시,,내곡동제2투,3211,1993,847,1023,70,0,21,0,1,1,2,1,1,1,1968,25,1218
4200,강원도,4203,강릉시,,내곡동제3투,2637,1453,525,852,43,1,19,0,0,0,0,1,0,1,1442,11,1184
4200,강원도,4203,강릉시,강남동,소계,14575,10635,3798,6322,245,11,122,4,1,2,12,13,9,5,10544,91,3940
4200,강원도,4203,강릉시,,관내사전투표,4601,4600,1848,2576,93,3,35,2,1,1,4,7,5,2,4577,23,1
4200,강원도,4203,강릉시,,강남동제1투,2335,1465,488,903,35,3,18,1,0,0,1,1,2,0,1452,13,870
4200,강원도,4203,강릉시,,강남동제2투,1881,1090,344,681,33,2,18,0,0,0,1,0,0,0,1079,11,791
4200,강원도,4203,강릉시,,강남동제3투,2178,1245,381,776,34,3,22,1,0,1,4,2,1,1,1226,19,933
4200,강원도,4203,강릉시,,강남동제4투,2058,1254,437,752,34,0,12,0,0,0,2,2,1,1,1241,13,804
4200,강원도,4203,강릉시,,강남동제5투,897,578,170,387,4,0,10,0,0,0,0,0,0,1,572,6,319
4200,강원도,4203,강릉시,,강남동제6투,625,403,130,247,12,0,7,0,0,0,0,1,0,0,397,6,222
4200,강원도,4203,강릉시,성덕동,소계,20716,15041,6467,7779,438,8,164,6,5,2,15,14,6,10,14914,127,5675
4200,강원도,4203,강릉시,,관내사전투표,5978,5978,2822,2908,145,0,49,2,3,1,1,7,2,4,5944,34,0
4200,강원도,4203,강릉시,,성덕동제1투,2812,1666,657,907,61,0,15,0,0,0,5,0,0,0,1645,21,1146
4200,강원도,4203,강릉시,,성덕동제2투,2754,1684,639,932,56,1,28,0,1,0,1,4,2,2,1666,18,1070
4200,강원도,4203,강릉시,,성덕동제3투,2891,1636,572,966,45,2,18,1,0,0,6,1,0,1,1612,24,1255
4200,강원도,4203,강릉시,,성덕동제4투,2584,1684,666,923,48,2,28,0,1,1,0,1,0,1,1671,13,900
4200,강원도,4203,강릉시,,성덕동제5투,2652,1737,859,775,67,2,17,3,0,0,1,1,0,1,1726,11,915
4200,강원도,4203,강릉시,,성덕동제6투,1045,656,252,368,16,1,9,0,0,0,1,0,2,1,650,6,389
4200,강원도,4203,강릉시,경포동,소계,6931,5039,2004,2786,149,1,39,1,0,0,4,11,0,2,4997,42,1892
4200,강원도,4203,강릉시,,관내사전투표,1465,1465,622,801,28,0,8,0,0,0,1,2,0,0,1462,3,0
4200,강원도,4203,강릉시,,경포동제1투,1770,1047,341,631,33,1,12,0,0,0,1,5,0,2,1026,21,723
4200,강원도,4203,강릉시,,경포동제2투,1355,842,267,536,19,0,12,1,0,0,2,0,0,0,837,5,513
4200,강원도,4203,강릉시,,경포동제3투,2341,1685,774,818,69,0,7,0,0,0,0,4,0,0,1672,13,656
4200,강원도,4203,강릉시,잘못 투입·구분된 투표지,,0,3,2,1,0,0,0,0,0,0,0,0,0,0,3,0,-3
4200,강원도,4204,동해시,합계,,77147,57515,22896,31739,1359,24,757,14,8,14,57,55,23,21,56967,548,19632
4200,강원도,4204,동해시,거소·선상투표,,1062,1030,382,444,23,1,51,1,0,3,2,3,1,3,914,116,32
4200,강원도,4204,동해시,관외사전투표,,5179,5179,2275,2544,165,4,103,2,3,2,2,3,1,4,5108,71,0
4200,강원도,4204,동해시,재외투표,,167,119,74,26,6,0,1,0,0,0,0,0,0,0,107,12,48
4200,강원도,4204,동해시,천곡동,소계,22099,15891,6393,8832,390,5,146,3,1,2,15,12,1,5,15805,86,6208
4200,강원도,4204,동해시,,관내사전투표,6077,6077,2461,3439,122,1,38,3,0,1,0,2,0,0,6067,10,0
4200,강원도,4204,동해시,,천곡동제1투,1591,959,339,574,21,0,11,0,0,0,1,2,0,0,948,11,632
4200,강원도,4204,동해시,,천곡동제2투,1328,785,269,481,17,0,9,0,0,0,1,1,0,1,779,6,543
4200,강원도,4204,동해시,,천곡동제3투,1853,973,371,547,24,0,15,0,0,0,2,2,0,1,962,11,880
4200,강원도,4204,동해시,,천곡동제4투,1389,794,300,468,19,1,5,0,0,0,0,1,0,0,794,0,595
4200,강원도,4204,동해시,,천곡동제5투,1519,930,342,552,24,1,2,0,0,0,2,0,0,1,924,6,589
4200,강원도,4204,동해시,,천곡동제6투,1943,1292,501,728,39,0,11,0,0,0,1,0,1,0,1281,11,651
4200,강원도,4204,동해시,,천곡동제7투,1424,826,301,475,28,0,9,0,1,0,5,1,0,0,820,6,598
4200,강원도,4204,동해시,,천곡동제8투,2458,1607,787,734,50,1,23,0,0,1,1,1,0,1,1599,8,851
4200,강원도,4204,동해시,,천곡동제9투,2517,1648,722,834,46,1,23,0,0,0,2,2,0,1,1631,17,869
4200,강원도,4204,동해시,송정동,소계,3486,2587,893,1557,60,1,35,1,1,0,5,4,3,0,2560,27,899
4200,강원도,4204,동해시,,관내사전투표,1292,1292,500,731,33,0,19,0,0,0,2,0,0,0,1285,7,0
4200,강원도,4204,동해시,,송정동제1투,1414,861,245,563,22,1,10,0,1,0,1,3,3,0,849,12,553
4200,강원도,4204,동해시,,송정동제2투,780,434,148,263,5,0,6,1,0,0,2,1,0,0,426,8,346
4200,강원도,4204,동해시,북삼동,소계,15133,11010,4890,5597,272,3,146,0,1,6,6,12,4,2,10939,71,4123
4200,강원도,4204,동해시,,관내사전투표,5265,5265,2446,2635,114,2,44,0,0,3,1,4,0,0,5249,16,0
4200,강원도,4204,동해시,,북삼동제1투,1432,838,325,460,26,0,17,0,1,0,1,2,0,0,832,6,594
4200,강원도,4204,동해시,,북삼동제2투,835,514,175,311,11,0,9,0,0,0,0,0,0,0,506,8,321
4200,강원도,4204,동해시,,북삼동제3투,2139,1271,546,645,41,0,26,0,0,1,0,2,0,0,1261,10,868
4200,강원도,4204,동해시,,북삼동제4투,1865,1023,477,491,25,0,16,0,0,0,3,3,1,0,1016,7,842
4200,강원도,4204,동해시,,북삼동제5투,1804,1068,464,567,15,0,10,0,0,0,0,0,1,0,1057,11,736
4200,강원도,4204,동해시,,북삼동제6투,1793,1031,457,488,40,1,24,0,0,2,1,1,2,2,1018,13,762
4200,강원도,4204,동해시,부곡동,소계,4800,3563,1378,2026,67,0,55,1,0,0,7,6,0,0,3540,23,1237
4200,강원도,4204,동해시,,관내사전투표,1891,1890,758,1070,32,0,15,0,0,0,1,5,0,0,1881,9,1
4200,강원도,4204,동해시,,부곡동제1투,1204,693,256,396,12,0,21,0,0,0,2,0,0,0,687,6,511
4200,강원도,4204,동해시,,부곡동제2투,807,443,170,236,17,0,10,1,0,0,1,1,0,0,436,7,364
4200,강원도,4204,동해시,,부곡동제3투,898,537,194,324,6,0,9,0,0,0,3,0,0,0,536,1,361
4200,강원도,4204,동해시,동호동,소계,4132,3000,1072,1805,59,2,30,0,2,0,0,2,3,1,2976,24,1132
4200,강원도,4204,동해시,,관내사전투표,1343,1343,518,783,16,1,7,0,2,0,0,1,2,1,1331,12,0
4200,강원도,4204,동해시,,동호동제1투,1580,945,351,544,29,1,15,0,0,0,0,1,0,0,941,4,635
4200,강원도,4204,동해시,,동호동제2투,1209,712,203,478,14,0,8,0,0,0,0,0,1,0,704,8,497
4200,강원도,4204,동해시,발한동,소계,3259,2318,714,1516,37,1,31,1,0,0,3,2,1,0,2306,12,941
4200,강원도,4204,동해시,,관내사전투표,1099,1099,353,711,17,0,11,0,0,0,2,1,0,0,1095,4,0
4200,강원도,4204,동해시,,발한동제1투,953,527,146,359,11,0,8,0,0,0,0,1,0,0,525,2,426
4200,강원도,4204,동해시,,발한동제2투,1207,692,215,446,9,1,12,1,0,0,1,0,1,0,686,6,515
4200,강원도,4204,동해시,묵호동,소계,2628,1786,611,1111,20,0,23,1,0,1,2,0,0,1,1770,16,842
4200,강원도,4204,동해시,,관내사전투표,737,737,281,439,7,0,5,1,0,0,0,0,0,0,733,4,0
4200,강원도,4204,동해시,,묵호동제1투,1344,727,231,461,10,0,13,0,0,0,2,0,0,0,717,10,617
4200,강원도,4204,동해시,,묵호동제2투,547,322,99,211,3,0,5,0,0,1,0,0,0,1,320,2,225
4200,강원도,4204,동해시,북평동,소계,9664,7033,2896,3785,193,6,86,3,0,0,6,4,2,3,6984,49,2631
4200,강원도,4204,동해시,,관내사전투표,3340,3340,1365,1862,55,3,33,2,0,0,2,1,1,1,3325,15,0
4200,강원도,4204,동해시,,북평동제1투,2371,1414,584,745,46,1,23,0,0,0,1,2,0,1,1403,11,957
4200,강원도,4204,동해시,,북평동제2투,1171,630,209,383,16,1,7,1,0,0,1,1,0,1,620,10,541
4200,강원도,4204,동해시,,북평동제3투,2782,1649,738,795,76,1,23,0,0,0,2,0,1,0,1636,13,1133
4200,강원도,4204,동해시,망상동,소계,2926,2043,678,1276,27,0,27,0,0,0,8,2,3,0,2021,22,883
4200,강원도,4204,동해시,,관내사전투표,675,675,238,423,8,0,2,0,0,0,0,0,0,0,671,4,0
4200,강원도,4204,동해시,,망상동제1투,908,582,175,380,6,0,8,0,0,0,6,1,2,0,578,4,326
4200,강원도,4204,동해시,,망상동제2투,1343,786,265,473,13,0,17,0,0,0,2,1,1,0,772,14,557
4200,강원도,4204,동해시,삼화동,소계,2612,1955,639,1220,40,1,23,1,0,0,1,5,4,2,1936,19,657
4200,강원도,4204,동해시,,관내사전투표,1057,1057,364,654,20,0,13,1,0,0,0,1,0,0,1053,4,0
4200,강원도,4204,동해시,,삼화동제1투,861,475,146,295,13,1,5,0,0,0,0,2,2,1,465,10,386
4200,강원도,4204,동해시,,삼화동제2투,694,423,129,271,7,0,5,0,0,0,1,2,2,1,418,5,271
4200,강원도,4204,동해시,잘못 투입·구분된 투표지,,0,1,1,0,0,0,0,0,0,0,0,0,0,0,1,0,-1
4200,강원도,4205,삼척시,합계,,56233,43642,16297,25308,897,25,457,25,9,22,32,58,48,34,43212,430,12591
4200,강원도,4205,삼척시,거소·선상투표,,207,191,59,101,1,1,7,1,1,0,0,0,1,0,172,19,16
4200,강원도,4205,삼척시,관외사전투표,,4499,4499,1996,2242,123,3,73,0,0,1,3,8,0,4,4453,46,0
4200,강원도,4205,삼척시,재외투표,,128,89,60,18,4,0,0,0,0,0,1,0,0,0,83,6,39
4200,강원도,4205,삼척시,도계읍,소계,7742,5698,1774,3645,101,4,60,3,2,3,8,11,7,4,5622,76,2044
4200,강원도,4205,삼척시,,관내사전투표,2958,2958,961,1886,45,2,22,2,1,2,4,3,2,2,2932,26,0
4200,강원도,4205,삼척시,,도계읍제1투,216,133,27,100,3,0,1,0,0,0,0,0,0,0,131,2,83
4200,강원도,4205,삼척시,,도계읍제2투,365,191,52,120,8,1,2,0,0,0,0,1,1,0,185,6,174
4200,강원도,4205,삼척시,,도계읍제3투,826,459,140,281,14,0,1,0,0,1,0,2,2,0,441,18,367
4200,강원도,4205,삼척시,,도계읍제4투,1027,626,182,402,10,0,11,1,0,0,0,4,1,2,613,13,401
4200,강원도,4205,삼척시,,도계읍제5투,375,222,70,146,2,0,3,0,0,0,0,0,0,0,221,1,153
4200,강원도,4205,삼척시,,도계읍제6투,952,490,142,326,8,1,5,0,0,0,3,1,0,0,486,4,462
4200,강원도,4205,삼척시,,도계읍제7투,110,84,16,63,0,0,1,0,0,0,0,0,1,0,81,3,26
4200,강원도,4205,삼척시,,도계읍제8투,913,535,184,321,11,0,14,0,1,0,1,0,0,0,532,3,378
4200,강원도,4205,삼척시,원덕읍,소계,4296,3305,1088,2076,51,5,29,2,1,1,6,7,7,1,3274,31,991
4200,강원도,4205,삼척시,,관내사전투표,1498,1498,562,883,18,5,8,1,0,1,2,2,4,0,1486,12,0
4200,강원도,4205,삼척시,,원덕읍제1투,1113,741,233,477,11,0,4,0,0,0,0,1,1,0,727,14,372
4200,강원도,4205,삼척시,,원덕읍제2투,533,324,98,208,7,0,5,1,0,0,3,0,1,0,323,1,209
4200,강원도,4205,삼척시,,원덕읍제3투,825,509,131,355,9,0,7,0,1,0,1,3,0,0,507,2,316
4200,강원도,4205,삼척시,,원덕읍제4투,327,233,64,153,6,0,5,0,0,0,0,1,1,1,231,2,94
4200,강원도,4205,삼척시,근덕면,소계,4481,3422,1065,2221,55,1,24,3,0,4,2,4,9,3,3391,31,1059
4200,강원도,4205,삼척시,,관내사전투표,1558,1558,531,976,23,0,7,2,0,0,0,2,7,2,1550,8,0
4200,강원도,4205,삼척시,,근덕면제1투,412,274,100,160,8,0,2,0,0,2,0,0,0,0,272,2,138
4200,강원도,4205,삼척시,,근덕면제2투,945,512,143,338,15,0,7,0,0,0,0,1,0,0,504,8,433
4200,강원도,4205,삼척시,,근덕면제3투,605,431,107,314,2,0,1,0,0,0,2,1,0,1,428,3,174
4200,강원도,4205,삼척시,,근덕면제4투,481,305,83,210,2,0,3,1,0,0,0,0,2,0,301,4,176
4200,강원도,4205,삼척시,,근덕면제5투,480,342,101,223,5,1,4,0,0,2,0,0,0,0,336,6,138
4200,강원도,4205,삼척시,하장면,소계,1039,784,257,490,7,0,16,0,0,1,2,1,1,3,778,6,255
4200,강원도,4205,삼척시,,관내사전투표,257,257,95,153,4,0,3,0,0,0,0,0,1,1,257,0,0
4200,강원도,4205,삼척시,,하장면제1투,300,173,49,116,1,0,4,0,0,1,0,0,0,0,171,2,127
4200,강원도,4205,삼척시,,하장면제2투,207,143,35,102,1,0,3,0,0,0,2,0,0,0,143,0,64
4200,강원도,4205,삼척시,,하장면제3투,275,211,78,119,1,0,6,0,0,0,0,1,0,2,207,4,64
4200,강원도,4205,삼척시,노곡면,소계,606,490,148,322,9,0,5,0,0,0,1,0,1,0,486,4,116
4200,강원도,4205,삼척시,,관내사전투표,180,180,59,112,3,0,4,0,0,0,1,0,0,0,179,1,0
4200,강원도,4205,삼척시,,노곡면제1투,239,172,46,119,3,0,1,0,0,0,0,0,0,0,169,3,67
4200,강원도,4205,삼척시,,노곡면제2투,187,138,43,91,3,0,0,0,0,0,0,0,1,0,138,0,49
4200,강원도,4205,삼척시,미로면,소계,1620,1260,388,820,22,0,12,0,0,2,0,2,3,3,1252,8,360
4200,강원도,4205,삼척시,,관내사전투표,691,691,232,439,10,0,5,0,0,0,0,1,1,1,689,2,0
4200,강원도,4205,삼척시,,미로면제1투,503,316,88,210,7,0,4,0,0,2,0,1,0,1,313,3,187
4200,강원도,4205,삼척시,,미로면제2투,256,147,34,104,4,0,1,0,0,0,0,0,2,1,146,1,109
4200,강원도,4205,삼척시,,미로면제3투,170,106,34,67,1,0,2,0,0,0,0,0,0,0,104,2,64
4200,강원도,4205,삼척시,가곡면,소계,595,493,166,288,13,0,10,0,0,0,1,2,2,2,484,9,102
4200,강원도,4205,삼척시,,관내사전투표,228,228,86,127,6,0,3,0,0,0,0,0,2,1,225,3,0
4200,강원도,4205,삼척시,,가곡면제1투,170,106,31,66,4,0,1,0,0,0,1,1,0,0,104,2,64
4200,강원도,4205,삼척시,,가곡면제2투,197,159,49,95,3,0,6,0,0,0,0,1,0,1,155,4,38
4200,강원도,4205,삼척시,신기면,소계,606,475,166,276,6,1,6,0,2,0,0,3,4,2,466,9,131
4200,강원도,4205,삼척시,,관내사전투표,249,249,99,133,4,1,3,0,1,0,0,1,2,1,245,4,0
4200,강원도,4205,삼척시,,신기면투표소,357,226,67,143,2,0,3,0,1,0,0,2,2,1,221,5,131
4200,강원도,4205,삼척시,남양동,소계,6421,4879,1601,3086,79,2,52,3,0,5,3,4,2,1,4838,41,1542
4200,강원도,4205,삼척시,,관내사전투표,2241,2241,823,1340,40,0,20,0,0,2,2,1,0,0,2228,13,0
4200,강원도,4205,삼척시,,남양동제1투,681,379,105,263,4,1,1,0,0,0,0,0,0,0,374,5,302
4200,강원도,4205,삼척시,,남양동제2투,826,549,147,380,6,0,7,1,0,1,0,0,1,0,543,6,277
4200,강원도,4205,삼척시,,남양동제3투,1163,739,240,473,13,0,6,0,0,1,0,0,0,1,734,5,424
4200,강원도,4205,삼척시,,남양동제4투,1067,650,208,397,13,1,16,2,0,1,1,2,1,0,642,8,417
4200,강원도,4205,삼척시,,남양동제5투,443,321,78,233,3,0,2,0,0,0,0,1,0,0,317,4,122
4200,강원도,4205,삼척시,성내동,소계,7546,6064,2434,3370,133,6,53,4,1,3,2,5,7,4,6022,42,1482
4200,강원도,4205,삼척시,,관내사전투표,3623,3623,1573,1906,78,4,29,2,0,3,1,1,5,3,3605,18,0
4200,강원도,4205,삼척시,,성내동제1투,1111,695,230,440,14,0,2,0,1,0,1,0,1,1,690,5,416
4200,강원도,4205,삼척시,,성내동제2투,741,476,198,262,7,1,4,0,0,0,0,0,0,0,472,4,265
4200,강원도,4205,삼척시,,성내동제3투,1201,754,246,461,24,1,8,2,0,0,0,4,0,0,746,8,447
4200,강원도,4205,삼척시,,성내동제4투,870,516,187,301,10,0,10,0,0,0,0,0,1,0,509,7,354
4200,강원도,4205,삼척시,교동,소계,10809,8237,3704,4158,212,1,82,4,1,1,1,7,3,6,8180,57,2572
4200,강원도,4205,삼척시,,관내사전투표,4345,4345,2064,2124,96,0,33,1,0,1,0,4,1,2,4326,19,0
4200,강원도,4205,삼척시,,교동제1투,1716,1085,426,600,29,0,15,0,0,0,0,1,1,2,1074,11,631
4200,강원도,4205,삼척시,,교동제2투,1465,888,386,449,25,1,13,2,1,0,0,2,1,2,882,6,577
4200,강원도,4205,삼척시,,교동제3투,1978,1140,458,616,30,0,15,1,0,0,0,0,0,0,1120,20,838
4200,강원도,4205,삼척시,,교동제4투,1305,779,370,369,32,0,6,0,0,0,1,0,0,0,778,1,526
4200,강원도,4205,삼척시,정라동,소계,5638,3756,1391,2195,81,1,28,5,1,1,2,4,1,1,3711,45,1882
4200,강원도,4205,삼척시,,관내사전투표,947,947,322,603,12,0,6,1,0,0,0,1,0,0,945,2,0
4200,강원도,4205,삼척시,,정라동제1투,904,510,139,341,14,1,1,0,1,0,1,1,0,1,500,10,394
4200,강원도,4205,삼척시,,정라동제2투,1646,931,326,561,18,0,9,0,0,1,0,2,0,0,917,14,715
4200,강원도,4205,삼척시,,정라동제3투,1447,905,422,435,24,0,6,3,0,0,1,0,0,0,891,14,542
4200,강원도,4205,삼척시,,정라동제4투,694,463,182,255,13,0,6,1,0,0,0,0,1,0,458,5,231
4200,강원도,4205,삼척시,잘못 투입·구분된 투표지,,0,0,0,0,0,0,0,0,0,0,0,0,0,0,0,0,0
4200,강원도,4206,태백시,합계,,35551,27039,10846,15101,489,11,295,8,1,5,21,24,18,18,26837,202,8512
4200,강원도,4206,태백시,거소·선상투표,,62,59,22,29,1,0,3,0,0,0,0,0,0,0,55,4,3
4200,강원도,4206,태백시,관외사전투표,,2631,2631,1189,1284,54,2,52,1,0,0,2,4,2,1,2591,40,0
4200,강원도,4206,태백시,재외투표,,92,70,42,16,2,0,3,0,0,0,1,0,0,0,64,6,22
4200,강원도,4206,태백시,황지동,소계,5699,4482,1848,2463,76,0,48,3,0,1,1,7,2,0,4449,33,1217
4200,강원도,4206,태백시,,관내사전투표,2696,2696,1222,1384,44,0,24,2,0,0,1,5,0,0,2682,14,0
4200,강원도,4206,태백시,,황지동제1투,1208,770,231,506,9,0,8,0,0,1,0,1,2,0,758,12,438
4200,강원도,4206,태백시,,황지동제2투,1250,690,271,383,21,0,9,1,0,0,0,1,0,0,686,4,560
4200,강원도,4206,태백시,,황지동제3투,545,326,124,190,2,0,7,0,0,0,0,0,0,0,323,3,219
4200,강원도,4206,태백시,황연동,소계,4051,3079,1111,1861,47,0,29,1,0,0,3,5,1,2,3060,19,972
4200,강원도,4206,태백시,,관내사전투표,1698,1698,652,996,26,0,11,0,0,0,1,2,0,2,1690,8,0
4200,강원도,4206,태백시,,황연동제1투,888,533,184,327,10,0,6,1,0,0,0,1,0,0,529,4,355
4200,강원도,4206,태백시,,황연동제2투,514,274,93,165,5,0,7,0,0,0,0,1,0,0,271,3,240
4200,강원도,4206,태백시,,황연동제3투,951,574,182,373,6,0,5,0,0,0,2,1,1,0,570,4,377
4200,강원도,4206,태백시,삼수동,소계,4375,3002,1165,1736,44,1,25,0,0,1,5,4,3,4,2988,14,1373
4200,강원도,4206,태백시,,관내사전투표,1406,1406,548,829,16,0,7,0,0,1,1,0,1,1,1404,2,0
4200,강원도,4206,태백시,,삼수동제1투,1576,785,311,439,17,0,8,0,0,0,1,2,0,1,779,6,791
4200,강원도,4206,태백시,,삼수동제2투,1032,559,226,309,10,0,8,0,0,0,0,2,1,1,557,2,473
4200,강원도,4206,태백시,,삼수동제3투,361,252,80,159,1,1,2,0,0,0,3,0,1,1,248,4,109
4200,강원도,4206,태백시,상장동,소계,8456,5937,2681,3021,140,3,54,0,0,1,0,2,1,4,5907,30,2519
4200,강원도,4206,태백시,,관내사전투표,2630,2630,1261,1282,56,0,18,0,0,0,0,1,1,1,2620,10,0
4200,강원도,4206,태백시,,상장동제1투,1014,595,192,378,12,0,7,0,0,0,0,1,0,1,591,4,419
4200,강원도,4206,태백시,,상장동제2투,1810,1029,500,485,32,1,6,0,0,0,0,0,0,0,1024,5,781
4200,강원도,4206,태백시,,상장동제3투,912,593,275,281,21,0,12,0,0,0,0,0,0,0,589,4,319
4200,강원도,4206,태백시,,상장동제4투,745,421,143,262,3,0,8,0,0,0,0,0,0,2,418,3,324
4200,강원도,4206,태백시,,상장동제5투,1345,669,310,333,16,2,3,0,0,1,0,0,0,0,665,4,676
4200,강원도,4206,태백시,문곡소도동,소계,3062,2249,876,1283,36,2,19,0,1,0,4,2,2,1,2226,23,813
4200,강원도,4206,태백시,,관내사전투표,996,996,439,532,12,2,5,0,1,0,1,1,0,0,993,3,0
4200,강원도,4206,태백시,,문곡소도동제1투,404,207,70,118,7,0,5,0,0,0,2,0,0,0,202,5,197
4200,강원도,4206,태백시,,문곡소도동제2투,789,515,188,304,8,0,6,0,0,0,0,1,1,0,508,7,274
4200,강원도,4206,태백시,,문곡소도동제3투,873,531,179,329,9,0,3,0,0,0,1,0,1,1,523,8,342
4200,강원도,4206,태백시,장성동,소계,3130,2455,962,1426,29,1,23,0,0,0,1,0,2,1,2445,10,675
4200,강원도,4206,태백시,,관내사전투표,1600,1600,623,948,16,0,7,0,0,0,0,0,1,0,1595,5,0
4200,강원도,4206,태백시,,장성동제1투,271,128,47,75,1,0,1,0,0,0,1,0,1,1,127,1,143
4200,강원도,4206,태백시,,장성동제2투,791,431,183,226,9,1,10,0,0,0,0,0,0,0,429,2,360
4200,강원도,4206,태백시,,장성동제3투,468,296,109,177,3,0,5,0,0,0,0,0,0,0,294,2,172
4200,강원도,4206,태백시,구문소동,소계,2141,1652,527,1039,36,2,22,2,0,2,2,0,4,5,1641,11,489
4200,강원도,4206,태백시,,관내사전투표,910,910,306,563,20,1,7,1,0,1,0,0,3,3,905,5,0
4200,강원도,4206,태백시,,구문소동제1투,728,409,131,249,12,0,11,0,0,0,0,0,0,2,405,4,319
4200,강원도,4206,태백시,,구문소동제2투,503,333,90,227,4,1,4,1,0,1,2,0,1,0,331,2,170
4200,강원도,4206,태백시,철암동,소계,1852,1423,423,943,24,0,17,1,0,0,2,0,1,0,1411,12,429
4200,강원도,4206,태백시,,관내사전투표,821,821,252,542,15,0,8,1,0,0,0,0,0,0,818,3,0
4200,강원도,4206,태백시,,철암동제1투,570,349,97,236,4,0,6,0,0,0,2,0,0,0,345,4,221
4200,강원도,4206,태백시,,철암동제2투,461,253,74,165,5,0,3,0,0,0,0,0,1,0,248,5,208
4200,강원도,4206,태백시,잘못 투입·구분된 투표지,,0,0,0,0,0,0,0,0,0,0,0,0,0,0,0,0,0
4200,강원도,4207,정선군,합계,,32101,24898,10103,13643,494,8,297,4,1,6,21,43,28,18,24666,232,7203
4200,강원도,4207,정선군,거소·선상투표,,87,83,31,32,2,0,2,0,1,1,0,0,0,1,70,13,4
4200,강원도,4207,정선군,관외사전투표,,2882,2882,1256,1454,82,2,45,1,0,0,2,9,1,0,2852,30,0
4200,강원도,4207,정선군,재외투표,,68,42,24,11,3,0,0,0,0,0,0,0,0,0,38,4,26
4200,강원도,4207,정선군,정선읍,소계,8127,6139,2714,3135,140,3,73,0,0,2,5,6,6,5,6089,50,1988
4200,강원도,4207,정선군,,관내사전투표,2897,2897,1472,1298,72,2,32,0,0,1,1,3,2,0,2883,14,0
4200,강원도,4207,정선군,,정선읍제1투,1019,571,202,341,9,1,6,0,0,1,2,0,0,1,563,8,448
4200,강원도,4207,정선군,,정선읍제2투,1194,767,285,441,19,0,10,0,0,0,0,0,0,0,755,12,427
4200,강원도,4207,정선군,,정선읍제3투,1261,738,338,374,11,0,7,0,0,0,2,0,0,2,734,4,523
4200,강원도,4207,정선군,,정선읍제4투,777,444,168,248,15,0,6,0,0,0,0,1,0,0,438,6,333
4200,강원도,4207,정선군,,정선읍제5투,531,389,115,255,8,0,6,0,0,0,0,0,1,1,386,3,142
4200,강원도,4207,정선군,,정선읍제6투,231,173,58,104,3,0,4,0,0,0,0,0,0,1,170,3,58
4200,강원도,4207,정선군,,정선읍제7투,217,160,76,74,3,0,2,0,0,0,0,2,3,0,160,0,57
4200,강원도,4207,정선군,고한읍,소계,3598,2565,1115,1343,55,0,23,0,0,1,3,4,1,1,2546,19,1033
4200,강원도,4207,정선군,,관내사전투표,1399,1399,646,697,33,0,12,0,0,0,0,0,1,0,1389,10,0
4200,강원도,4207,정선군,,고한읍제1투,512,255,91,156,3,0,2,0,0,0,0,1,0,0,253,2,257
4200,강원도,4207,정선군,,고한읍제2투,1052,557,236,289,13,0,7,0,0,1,3,2,0,0,551,6,495
4200,강원도,4207,정선군,,고한읍제3투,635,354,142,201,6,0,2,0,0,0,0,1,0,1,353,1,281
4200,강원도,4207,정선군,사북읍,소계,3885,2806,1131,1562,43,0,37,0,0,1,4,3,3,1,2785,21,1079
4200,강원도,4207,정선군,,관내사전투표,1582,1582,714,815,25,0,13,0,0,0,1,3,1,0,1572,10,0
4200,강원도,4207,정선군,,사북읍제1투,1561,832,322,464,14,0,16,0,0,1,3,0,1,1,822,10,729
4200,강원도,4207,정선군,,사북읍제2투,742,392,95,283,4,0,8,0,0,0,0,0,1,0,391,1,350
4200,강원도,4207,정선군,신동읍,소계,2827,2184,873,1194,43,2,36,1,0,0,1,3,3,3,2159,25,643
4200,강원도,4207,정선군,,관내사전투표,893,893,401,465,15,2,5,0,0,0,0,0,1,2,891,2,0
4200,강원도,4207,정선군,,신동읍제1투,788,555,208,303,12,0,14,1,0,0,0,2,1,1,542,13,233
4200,강원도,4207,정선군,,신동읍제2투,543,321,122,177,10,0,4,0,0,0,1,0,0,0,314,7,222
4200,강원도,4207,정선군,,신동읍제3투,264,169,48,110,2,0,7,0,0,0,0,0,1,0,168,1,95
4200,강원도,4207,정선군,,신동읍제4투,339,246,94,139,4,0,6,0,0,0,0,1,0,0,244,2,93
4200,강원도,4207,정선군,화암면,소계,1323,993,371,576,19,0,15,0,0,0,0,3,1,2,987,6,330
4200,강원도,4207,정선군,,관내사전투표,494,494,207,269,10,0,6,0,0,0,0,0,0,1,493,1,0
4200,강원도,4207,정선군,,화암면제1투,635,385,130,233,7,0,9,0,0,0,0,1,1,1,382,3,250
4200,강원도,4207,정선군,,화암면제2투,194,114,34,74,2,0,0,0,0,0,0,2,0,0,112,2,80
4200,강원도,4207,정선군,남면,소계,2563,1897,750,1085,27,0,19,0,0,0,2,2,2,0,1887,10,666
4200,강원도,4207,정선군,,관내사전투표,775,775,338,412,12,0,7,0,0,0,0,0,1,0,770,5,0
4200,강원도,4207,정선군,,남면제1투,451,251,93,146,6,0,4,0,0,0,0,2,0,0,251,0,200
4200,강원도,4207,정선군,,남면제2투,1040,650,225,408,6,0,5,0,0,0,2,0,0,0,646,4,390
4200,강원도,4207,정선군,,남면제3투,297,221,94,119,3,0,3,0,0,0,0,0,1,0,220,1,76
4200,강원도,4207,정선군,여량면,소계,1713,1356,419,867,17,0,20,1,0,0,0,7,3,2,1336,20,357
4200,강원도,4207,정선군,,관내사전투표,774,774,261,475,10,0,9,1,0,0,0,3,3,1,763,11,0
4200,강원도,4207,정선군,,여량면제1투,764,459,125,310,5,0,8,0,0,0,0,2,0,1,451,8,305
4200,강원도,4207,정선군,,여량면제2투,175,123,33,82,2,0,3,0,0,0,0,2,0,0,122,1,52
4200,강원도,4207,정선군,북평면,소계,2085,1605,609,931,29,1,16,1,0,0,3,1,1,1,1593,12,480
4200,강원도,4207,정선군,,관내사전투표,890,890,369,478,22,0,13,1,0,0,1,0,0,1,885,5,0
4200,강원도,4207,정선군,,북평면제1투,778,472,151,307,6,0,2,0,0,0,2,1,0,0,469,3,306
4200,강원도,4207,정선군,,북평면제2투,417,243,89,146,1,1,1,0,0,0,0,0,1,0,239,4,174
4200,강원도,4207,정선군,임계면,소계,2943,2346,810,1453,34,0,11,0,0,1,1,5,7,2,2324,22,597
4200,강원도,4207,정선군,,관내사전투표,1199,1199,451,712,17,0,6,0,0,1,0,0,5,2,1194,5,0
4200,강원도,4207,정선군,,임계면제1투,573,365,114,240,4,0,3,0,0,0,1,0,1,0,363,2,208
4200,강원도,4207,정선군,,임계면제2투,229,156,52,98,3,0,0,0,0,0,0,2,0,0,155,1,73
4200,강원도,4207,정선군,,임계면제3투,417,259,71,174,6,0,0,0,0,0,0,1,1,0,253,6,158
4200,강원도,4207,정선군,,임계면제4투,247,169,64,102,1,0,0,0,0,0,0,0,0,0,167,2,78
4200,강원도,4207,정선군,,임계면제5투,278,198,58,127,3,0,2,0,0,0,0,2,0,0,192,6,80
4200,강원도,4207,정선군,잘못 투입·구분된 투표지,,0,0,0,0,0,0,0,0,0,0,0,0,0,0,0,0,0
4200,강원도,4208,속초시,합계,,71571,52516,21713,28342,1230,16,627,17,6,13,23,37,17,18,52059,457,19055
4200,강원도,4208,속초시,거소·선상투표,,339,309,107,146,4,0,8,0,0,0,0,0,0,0,265,44,30
4200,강원도,4208,속초시,관외사전투표,,5691,5688,2542,2791,186,3,87,3,1,2,2,3,2,6,5628,60,3
4200,강원도,4208,속초시,재외투표,,213,162,90,55,4,0,0,0,0,0,0,0,0,0,149,13,51
4200,강원도,4208,속초시,영랑동,소계,4655,3594,1458,2016,72,0,20,1,1,1,0,7,1,1,3578,16,1061
4200,강원도,4208,속초시,,관내사전투표,1992,1992,933,986,52,0,9,0,1,0,0,3,0,1,1985,7,0
4200,강원도,4208,속초시,,영랑동제1투,1072,679,226,434,8,0,5,0,0,1,0,1,1,0,676,3,393
4200,강원도,4208,속초시,,영랑동제2투,1591,923,299,596,12,0,6,1,0,0,0,3,0,0,917,6,668
4200,강원도,4208,속초시,동명동,소계,2791,2016,745,1193,40,0,28,1,0,0,1,1,0,0,2009,7,775
4200,강원도,4208,속초시,,관내사전투표,1058,1058,422,603,19,0,8,1,0,0,0,0,0,0,1053,5,0
4200,강원도,4208,속초시,,동명동제1투,1209,692,248,410,17,0,15,0,0,0,0,1,0,0,691,1,517
4200,강원도,4208,속초시,,동명동제2투,524,266,75,180,4,0,5,0,0,0,1,0,0,0,265,1,258
4200,강원도,4208,속초시,금호동,소계,5156,3702,1319,2250,64,0,40,1,0,1,3,1,0,0,3679,23,1454
4200,강원도,4208,속초시,,관내사전투표,1901,1901,731,1121,32,0,10,0,0,0,1,0,0,0,1895,6,0
4200,강원도,4208,속초시,,금호동제1투,854,419,127,276,7,0,5,0,0,0,0,0,0,0,415,4,435
4200,강원도,4208,속초시,,금호동제2투,630,315,100,197,7,0,5,0,0,1,0,0,0,0,310,5,315
4200,강원도,4208,속초시,,금호동제3투,1051,614,170,412,10,0,11,1,0,0,2,1,0,0,607,7,437
4200,강원도,4208,속초시,,금호동제4투,720,453,191,244,8,0,9,0,0,0,0,0,0,0,452,1,267
4200,강원도,4208,속초시,교동,소계,8083,5695,2200,3222,131,4,82,1,0,1,3,5,4,2,5655,40,2388
4200,강원도,4208,속초시,,관내사전투표,2726,2726,1141,1469,76,2,24,0,0,1,1,1,2,2,2719,7,0
4200,강원도,4208,속초시,,교동제1투,2206,1160,387,709,18,2,26,1,0,0,0,2,1,0,1146,14,1046
4200,강원도,4208,속초시,,교동제2투,1888,1066,426,584,27,0,15,0,0,0,2,2,1,0,1057,9,822
4200,강원도,4208,속초시,,교동제3투,1263,743,246,460,10,0,17,0,0,0,0,0,0,0,733,10,520
4200,강원도,4208,속초시,노학동,소계,16808,11764,4888,6343,289,1,137,3,1,3,8,6,2,3,11684,80,5044
4200,강원도,4208,속초시,,관내사전투표,5251,5251,2367,2698,115,0,37,2,1,0,2,0,1,1,5224,27,0
4200,강원도,4208,속초시,,노학동제1투,2254,1273,498,688,47,0,25,0,0,0,1,2,0,1,1262,11,981
4200,강원도,4208,속초시,,노학동제2투,1661,849,307,490,28,1,12,0,0,0,1,0,0,1,840,9,812
4200,강원도,4208,속초시,,노학동제3투,2359,1236,484,683,30,0,23,1,0,1,2,1,0,0,1225,11,1123
4200,강원도,4208,속초시,,노학동제4투,1220,700,276,388,16,0,12,0,0,0,1,2,0,0,695,5,520
4200,강원도,4208,속초시,,노학동제5투,1541,914,277,607,12,0,10,0,0,2,1,1,0,0,910,4,627
4200,강원도,4208,속초시,,노학동제6투,2522,1541,679,789,41,0,18,0,0,0,0,0,1,0,1528,13,981
4200,강원도,4208,속초시,조양동,소계,20580,14130,6343,7162,310,4,161,6,3,5,5,8,2,3,14012,118,6450
4200,강원도,4208,속초시,,관내사전투표,5191,5189,2609,2394,100,1,40,4,2,0,1,3,1,2,5157,32,2
4200,강원도,4208,속초시,,조양동제1투,2130,1260,534,653,35,1,15,1,0,2,1,0,0,0,1242,18,870
4200,강원도,4208,속초시,,조양동제2투,1944,1136,487,595,27,0,16,0,0,0,0,0,1,0,1126,10,808
4200,강원도,4208,속초시,,조양동제3투,1621,834,328,460,23,0,14,0,1,0,0,1,0,0,827,7,787
4200,강원도,4208,속초시,,조양동제4투,3749,2076,898,1075,52,1,30,0,0,2,2,1,0,1,2062,14,1673
4200,강원도,4208,속초시,,조양동제5투,2028,1286,521,717,20,1,13,0,0,1,0,3,0,0,1276,10,742
4200,강원도,4208,속초시,,조양동제6투,2647,1622,636,911,38,0,19,0,0,0,1,0,0,0,1605,17,1025
4200,강원도,4208,속초시,,조양동제7투,1270,727,330,357,15,0,14,1,0,0,0,0,0,0,717,10,543
4200,강원도,4208,속초시,청호동,소계,4445,3285,1299,1807,89,4,41,1,0,0,1,5,5,1,3253,32,1160
4200,강원도,4208,속초시,,관내사전투표,1721,1721,753,885,50,2,16,0,0,0,0,2,0,0,1708,13,0
4200,강원도,4208,속초시,,청호동제1투,1943,1091,396,635,23,1,17,1,0,0,1,3,4,1,1082,9,852
4200,강원도,4208,속초시,,청호동제2투,781,473,150,287,16,1,8,0,0,0,0,0,1,0,463,10,308
4200,강원도,4208,속초시,대포동,소계,2810,2170,722,1356,41,0,23,0,0,0,0,1,1,2,2146,24,640
4200,강원도,4208,속초시,,관내사전투표,929,929,389,508,18,0,8,0,0,0,0,1,0,0,924,5,0
4200,강원도,4208,속초시,,대포동제1투,766,487,127,337,8,0,6,0,0,0,0,0,1,0,479,8,279
4200,강원도,4208,속초시,,대포동제2투,1115,754,206,511,15,0,9,0,0,0,0,0,0,2,743,11,361
4200,강원도,4208,속초시,잘못 투입·구분된 투표지,,0,1,0,1,0,0,0,0,0,0,0,0,0,0,1,0,-1
4200,강원도,4209,고성군,합계,,24668,19218,7433,10840,427,8,216,5,2,3,10,20,18,18,19000,218,5450
4200,강원도,4209,고성군,거소·선상투표,,255,237,84,102,4,0,12,0,0,0,0,2,1,0,205,32,18
4200,강원도,4209,고성군,관외사전투표,,2349,2348,1065,1163,58,2,31,0,0,0,2,2,0,1,2324,24,1
4200,강원도,4209,고성군,재외투표,,71,54,26,14,2,0,0,0,0,0,0,0,0,0,42,12,17
4200,강원도,4209,고성군,간성읍,소계,5486,4177,1728,2215,122,3,52,1,1,2,0,3,4,4,4135,42,1309
4200,강원도,4209,고성군,,관내사전투표,2048,2047,981,965,56,2,20,1,1,1,0,2,3,1,2033,14,1
4200,강원도,4209,고성군,,간성읍제1투,705,413,139,248,11,0,7,0,0,0,0,1,1,0,407,6,292
4200,강원도,4209,고성군,,간성읍제2투,1687,974,380,524,36,0,16,0,0,0,0,0,0,2,958,16,713
4200,강원도,4209,고성군,,간성읍제3투,716,481,149,302,16,1,8,0,0,0,0,0,0,0,476,5,235
4200,강원도,4209,고성군,,간성읍제4투,187,143,47,92,1,0,1,0,0,0,0,0,0,1,142,1,44
4200,강원도,4209,고성군,,간성읍제5투,143,119,32,84,2,0,0,0,0,1,0,0,0,0,119,0,24
4200,강원도,4209,고성군,거진읍,소계,5093,3748,1339,2254,60,2,36,1,0,0,1,7,3,7,3710,38,1345
4200,강원도,4209,고성군,,관내사전투표,1330,1330,545,740,24,0,13,1,0,0,0,1,0,2,1326,4,0
4200,강원도,4209,고성군,,거진읍제1투,954,623,208,398,9,0,3,0,0,0,0,0,0,1,619,4,331
4200,강원도,4209,고성군,,거진읍제2투,808,512,130,346,6,1,11,0,0,0,1,4,0,1,500,12,296
4200,강원도,4209,고성군,,거진읍제3투,520,305,126,165,7,0,1,0,0,0,0,1,0,0,300,5,215
4200,강원도,4209,고성군,,거진읍제4투,275,198,58,129,2,1,1,0,0,0,0,0,1,2,194,4,77
4200,강원도,4209,고성군,,거진읍제5투,408,251,89,154,3,0,3,0,0,0,0,0,0,0,249,2,157
4200,강원도,4209,고성군,,거진읍제6투,798,529,183,322,9,0,4,0,0,0,0,1,2,1,522,7,269
4200,강원도,4209,고성군,현내면,소계,1984,1567,530,965,32,0,13,1,0,0,0,2,2,4,1549,18,417
4200,강원도,4209,고성군,,관내사전투표,571,571,240,308,12,0,5,0,0,0,0,1,1,1,568,3,0
4200,강원도,4209,고성군,,현내면제1투,457,316,95,204,7,0,3,0,0,0,0,0,0,1,310,6,141
4200,강원도,4209,고성군,,현내면제2투,490,334,88,230,8,0,1,1,0,0,0,1,0,2,331,3,156
4200,강원도,4209,고성군,,현내면제3투,260,180,56,116,3,0,3,0,0,0,0,0,0,0,178,2,80
4200,강원도,4209,고성군,,현내면제4투,206,166,51,107,2,0,1,0,0,0,0,0,1,0,162,4,40
4200,강원도,4209,고성군,죽왕면,소계,2910,2238,772,1380,37,0,19,1,0,0,0,2,4,2,2217,21,672
4200,강원도,4209,고성군,,관내사전투표,903,903,351,518,17,0,8,0,0,0,0,1,0,0,895,8,0
4200,강원도,4209,고성군,,죽왕면제1투,536,334,110,213,5,0,2,0,0,0,0,0,0,0,330,4,202
4200,강원도,4209,고성군,,죽왕면제2투,411,297,89,194,3,0,4,0,0,0,0,1,2,1,294,3,114
4200,강원도,4209,고성군,,죽왕면제3투,712,461,137,305,11,0,4,1,0,0,0,0,0,0,458,3,251
4200,강원도,4209,고성군,,죽왕면제4투,348,243,85,150,1,0,1,0,0,0,0,0,2,1,240,3,105
4200,강원도,4209,고성군,토성면,소계,6520,4849,1889,2747,112,1,53,1,1,1,7,2,4,0,4818,31,1671
4200,강원도,4209,고성군,,관내사전투표,2120,2120,926,1119,51,0,17,1,0,0,0,0,1,0,2115,5,0
4200,강원도,4209,고성군,,토성면제1투,1871,1099,398,640,25,0,18,0,1,1,4,1,0,0,1088,11,772
4200,강원도,4209,고성군,,토성면제2투,828,579,185,382,6,0,3,0,0,0,0,0,0,0,576,3,249
4200,강원도,4209,고성군,,토성면제3투,728,462,163,270,14,0,3,0,0,0,1,1,2,0,454,8,266
4200,강원도,4209,고성군,,토성면제4투,973,589,217,336,16,1,12,0,0,0,2,0,1,0,585,4,384
4200,강원도,4209,고성군,잘못 투입·구분된 투표지,,0,0,0,0,0,0,0,0,0,0,0,0,0,0,0,0,0
4200,강원도,4210,양양군,합계,,25257,19716,7343,11495,434,4,222,3,8,2,13,10,14,6,19554,162,5541
4200,강원도,4210,양양군,거소·선상투표,,89,85,23,50,0,0,0,0,0,0,0,0,0,0,73,12,4
4200,강원도,4210,양양군,관외사전투표,,2346,2344,1008,1219,68,1,25,1,1,0,2,1,0,0,2326,18,2
4200,강원도,4210,양양군,재외투표,,63,46,29,10,3,0,0,0,0,0,0,0,0,0,42,4,17
4200,강원도,4210,양양군,양양읍,소계,10123,7563,2925,4332,168,2,76,0,4,1,5,4,4,2,7523,40,2560
4200,강원도,4210,양양군,,관내사전투표,3632,3630,1541,1955,85,1,24,0,1,0,1,0,3,2,3613,17,2
4200,강원도,4210,양양군,,양양읍제1투,2771,1554,598,887,41,0,13,0,1,1,2,2,1,0,1546,8,1217
4200,강원도,4210,양양군,,양양읍제2투,1822,1104,409,644,22,0,19,0,2,0,0,1,0,0,1097,7,718
4200,강원도,4210,양양군,,양양읍제3투,766,486,124,338,10,0,8,0,0,0,2,1,0,0,483,3,280
4200,강원도,4210,양양군,,양양읍제4투,576,388,134,237,6,1,7,0,0,0,0,0,0,0,385,3,188
4200,강원도,4210,양양군,,양양읍제5투,556,401,119,271,4,0,5,0,0,0,0,0,0,0,399,2,155
4200,강원도,4210,양양군,서면,소계,2394,1841,595,1146,45,0,21,0,1,0,0,2,5,0,1815,26,553
4200,강원도,4210,양양군,,관내사전투표,875,875,281,550,25,0,9,0,0,0,0,2,2,0,869,6,0
4200,강원도,4210,양양군,,서면제1투,621,321,122,183,5,0,2,0,0,0,0,0,1,0,313,8,300
4200,강원도,4210,양양군,,서면제2투,390,275,99,151,8,0,6,0,0,0,0,0,1,0,265,10,115
4200,강원도,4210,양양군,,서면제3투,308,220,65,143,6,0,2,0,1,0,0,0,1,0,218,2,88
4200,강원도,4210,양양군,,서면제4투,200,150,28,119,1,0,2,0,0,0,0,0,0,0,150,0,50
4200,강원도,4210,양양군,손양면,소계,2002,1558,578,916,31,0,21,0,0,0,0,1,1,0,1548,10,444
4200,강원도,4210,양양군,,관내사전투표,752,752,313,410,13,0,10,0,0,0,0,0,1,0,747,5,0
4200,강원도,4210,양양군,,손양면제1투,641,384,148,216,11,0,7,0,0,0,0,0,0,0,382,2,257
4200,강원도,4210,양양군,,손양면제2투,609,422,117,290,7,0,4,0,0,0,0,1,0,0,419,3,187
4200,강원도,4210,양양군,현북면,소계,2117,1643,602,974,26,0,25,0,1,0,1,1,3,0,1633,10,474
4200,강원도,4210,양양군,,관내사전투표,627,627,257,350,9,0,8,0,0,0,0,0,0,0,624,3,0
4200,강원도,4210,양양군,,현북면제1투,608,374,128,226,5,0,11,0,1,0,1,1,0,0,373,1,234
4200,강원도,4210,양양군,,현북면제2투,311,227,90,127,6,0,3,0,0,0,0,0,0,0,226,1,84
4200,강원도,4210,양양군,,현북면제3투,332,231,80,143,3,0,3,0,0,0,0,0,1,0,230,1,101
4200,강원도,4210,양양군,,현북면제4투,239,184,47,128,3,0,0,0,0,0,0,0,2,0,180,4,55
4200,강원도,4210,양양군,현남면,소계,2410,1802,524,1197,41,1,16,0,1,0,1,0,1,3,1785,17,608
4200,강원도,4210,양양군,,관내사전투표,749,749,220,495,19,0,8,0,0,0,0,0,1,1,744,5,0
4200,강원도,4210,양양군,,현남면제1투,558,340,93,233,5,1,2,0,1,0,1,0,0,0,336,4,218
4200,강원도,4210,양양군,,현남면제2투,686,437,137,273,14,0,5,0,0,0,0,0,0,2,431,6,249
4200,강원도,4210,양양군,,현남면제3투,417,276,74,196,3,0,1,0,0,0,0,0,0,0,274,2,141
4200,강원도,4210,양양군,강현면,소계,3713,2831,1056,1651,52,0,38,2,0,1,4,1,0,1,2806,25,882
4200,강원도,4210,양양군,,관내사전투표,1241,1241,536,655,22,0,12,2,0,0,0,1,0,0,1228,13,0
4200,강원도,4210,양양군,,강현면제1투,1108,684,235,413,17,0,10,0,0,1,3,0,0,0,679,5,424
4200,강원도,4210,양양군,,강현면제2투,476,324,105,199,7,0,7,0,0,0,0,0,0,1,319,5,152
4200,강원도,4210,양양군,,강현면제3투,300,168,59,105,0,0,3,0,0,0,0,0,0,0,167,1,132
4200,강원도,4210,양양군,,강현면제4투,588,414,121,279,6,0,6,0,0,0,1,0,0,0,413,1,174
4200,강원도,4210,양양군,잘못 투입·구분된 투표지,,0,3,3,0,0,0,0,0,0,0,0,0,0,0,3,0,-3
4200,강원도,4211,인제군,합계,,27897,21836,8937,11591,501,20,333,4,4,8,14,36,14,25,21487,349,6061
4200,강원도,4211,인제군,거소·선상투표,,193,188,64,73,2,0,3,0,0,0,0,0,0,0,142,46,5
4200,강원도,4211,인제군,관외사전투표,,2639,2639,1124,1377,68,0,29,0,0,0,0,3,2,5,2608,31,0
4200,강원도,4211,인제군,재외투표,,65,47,21,18,2,0,0,0,0,0,0,0,0,0,41,6,18
4200,강원도,4211,인제군,인제읍,소계,8138,6149,2776,3056,141,6,83,0,0,3,5,12,2,3,6087,62,1989
4200,강원도,4211,인제군,,관내사전투표,3012,3012,1437,1418,74,4,40,0,0,0,2,5,0,2,2982,30,0
4200,강원도,4211,인제군,,인제읍제1투,733,433,178,237,3,0,8,0,0,0,0,1,1,0,428,5,300
4200,강원도,4211,인제군,,인제읍제2투,1627,977,452,479,23,0,5,0,0,2,2,2,0,0,965,12,650
4200,강원도,4211,인제군,,인제읍제3투,1896,1091,483,542,32,1,19,0,0,1,1,3,0,1,1083,8,805
4200,강원도,4211,인제군,,인제읍제4투,487,340,109,218,2,0,4,0,0,0,0,0,1,0,334,6,147
4200,강원도,4211,인제군,,인제읍제5투,383,296,117,162,7,1,7,0,0,0,0,1,0,0,295,1,87
4200,강원도,4211,인제군,남면,소계,2911,2118,823,1172,51,1,33,0,0,0,4,2,1,4,2091,27,793
4200,강원도,4211,인제군,,관내사전투표,1122,1122,468,605,18,1,13,0,0,0,2,1,0,4,1112,10,0
4200,강원도,4211,인제군,,남면제1투,1076,593,210,339,21,0,10,0,0,0,2,0,1,0,583,10,483
4200,강원도,4211,인제군,,남면제2투,713,403,145,228,12,0,10,0,0,0,0,1,0,0,396,7,310
4200,강원도,4211,인제군,북면,소계,6393,4825,1979,2598,98,4,74,0,1,2,2,9,3,6,4776,49,1568
4200,강원도,4211,인제군,,관내사전투표,2364,2364,1059,1193,48,2,32,0,0,1,1,4,2,1,2343,21,0
4200,강원도,4211,인제군,,북면제1투,1326,763,335,388,19,0,11,0,0,0,0,1,0,3,757,6,563
4200,강원도,4211,인제군,,북면제2투,1262,773,292,435,15,2,14,0,0,0,0,1,0,1,760,13,489
4200,강원도,4211,인제군,,북면제3투,431,268,101,146,5,0,9,0,0,1,0,1,0,0,263,5,163
4200,강원도,4211,인제군,,북면제4투,364,248,64,177,3,0,2,0,1,0,0,0,0,0,247,1,116
4200,강원도,4211,인제군,,북면제5투,646,409,128,259,8,0,6,0,0,0,1,2,1,1,406,3,237
4200,강원도,4211,인제군,기린면,소계,3901,3091,1123,1741,78,5,51,3,2,2,1,5,5,5,3021,70,810
4200,강원도,4211,인제군,,관내사전투표,1345,1345,520,754,35,2,18,0,0,0,0,1,1,1,1332,13,0
4200,강원도,4211,인제군,,기린면제1투,611,407,166,220,8,0,10,0,0,0,0,0,0,0,404,3,204
4200,강원도,4211,인제군,,기린면제2투,303,217,64,139,5,0,4,0,0,0,0,0,0,0,212,5,86
4200,강원도,4211,인제군,,기린면제3투,231,168,54,108,2,0,1,0,0,0,0,0,0,0,165,3,63
4200,강원도,4211,인제군,,기린면제4투,238,180,56,111,2,0,6,1,0,0,1,2,0,0,179,1,58
4200,강원도,4211,인제군,,기린면제5투,349,272,101,100,9,3,4,2,2,2,0,2,4,4,233,39,77
4200,강원도,4211,인제군,,기린면제6투,824,502,162,309,17,0,8,0,0,0,0,0,0,0,496,6,322
4200,강원도,4211,인제군,서화면,소계,2018,1552,572,856,41,4,34,1,1,1,1,4,1,1,1517,35,466
4200,강원도,4211,인제군,,관내사전투표,798,797,322,397,24,4,26,1,0,0,1,1,1,1,778,19,1
4200,강원도,4211,인제군,,서화면제1투,725,416,122,267,9,0,6,0,1,1,0,1,0,0,407,9,309
4200,강원도,4211,인제군,,서화면제2투,286,199,81,107,5,0,2,0,0,0,0,0,0,0,195,4,87
4200,강원도,4211,인제군,,서화면제3투,209,140,47,85,3,0,0,0,0,0,0,2,0,0,137,3,69
4200,강원도,4211,인제군,상남면,소계,1639,1226,455,699,20,0,26,0,0,0,1,1,0,1,1203,23,413
4200,강원도,4211,인제군,,관내사전투표,645,645,253,349,12,0,15,0,0,0,0,1,0,1,631,14,0
4200,강원도,4211,인제군,,상남면제1투,638,356,109,227,4,0,9,0,0,0,1,0,0,0,350,6,282
4200,강원도,4211,인제군,,상남면제2투,356,225,93,123,4,0,2,0,0,0,0,0,0,0,222,3,131
4200,강원도,4211,인제군,잘못 투입·구분된 투표지,,0,1,0,1,0,0,0,0,0,0,0,0,0,0,1,0,-1
4200,강원도,4212,홍천군,합계,,60872,46697,18418,25851,1049,37,593,15,11,19,31,144,32,34,46234,463,14175
4200,강원도,4212,홍천군,거소·선상투표,,184,170,58,83,8,1,4,1,0,1,0,0,0,0,156,14,14
4200,강원도,4212,홍천군,관외사전투표,,5517,5516,2352,2891,129,3,71,0,1,0,0,11,2,4,5464,52,1
4200,강원도,4212,홍천군,재외투표,,190,136,70,45,4,0,0,0,0,0,3,0,0,0,122,14,54
4200,강원도,4212,홍천군,홍천읍,소계,26190,18848,7963,9924,476,11,232,2,7,8,13,31,7,10,18684,164,7342
4200,강원도,4212,홍천군,,관내사전투표,7908,7906,3663,3907,179,6,72,1,3,6,3,15,1,3,7859,47,2
4200,강원도,4212,홍천군,,홍천읍제1투,914,553,211,313,10,0,10,0,0,1,0,0,0,1,546,7,361
4200,강원도,4212,홍천군,,홍천읍제2투,875,547,164,341,20,0,11,0,0,0,1,1,1,0,539,8,328
4200,강원도,4212,홍천군,,홍천읍제3투,1234,693,213,433,19,0,13,0,3,0,0,0,1,0,682,11,541
4200,강원도,4212,홍천군,,홍천읍제4투,1389,829,326,457,24,3,8,0,0,0,0,3,0,0,821,8,560
4200,강원도,4212,홍천군,,홍천읍제5투,1282,780,258,481,13,0,11,0,0,1,3,1,0,0,768,12,502
4200,강원도,4212,홍천군,,홍천읍제6투,565,357,133,203,7,0,5,0,1,0,0,2,1,1,353,4,208
4200,강원도,4212,홍천군,,홍천읍제7투,2306,1431,613,728,47,1,25,0,0,0,1,3,2,1,1421,10,875
4200,강원도,4212,홍천군,,홍천읍제8투,1486,929,415,468,24,0,11,0,0,0,0,1,1,0,920,9,557
4200,강원도,4212,홍천군,,홍천읍제9투,1690,913,358,495,25,0,22,1,0,0,1,1,0,2,905,8,777
4200,강원도,4212,홍천군,,홍천읍제10투,2325,1321,578,681,34,1,16,0,0,0,0,0,0,0,1310,11,1004
4200,강원도,4212,홍천군,,홍천읍제11투,1259,767,284,435,25,0,6,0,0,0,3,3,0,1,757,10,492
4200,강원도,4212,홍천군,,홍천읍제12투,2957,1822,747,982,49,0,22,0,0,0,1,1,0,1,1803,19,1135
4200,강원도,4212,홍천군,화촌면,소계,3817,2901,1100,1650,46,3,52,0,0,2,1,12,0,3,2869,32,916
4200,강원도,4212,홍천군,,관내사전투표,1416,1416,555,787,19,2,36,0,0,0,0,1,0,2,1402,14,0
4200,강원도,4212,홍천군,,화촌면제1투,1021,617,248,328,13,0,9,0,0,2,0,6,0,0,606,11,404
4200,강원도,4212,홍천군,,화촌면제2투,473,297,109,179,5,0,0,0,0,0,0,0,0,0,293,4,176
4200,강원도,4212,홍천군,,화촌면제3투,390,251,83,158,2,0,3,0,0,0,0,4,0,0,250,1,139
4200,강원도,4212,홍천군,,화촌면제4투,517,320,105,198,7,1,4,0,0,0,1,1,0,1,318,2,197
4200,강원도,4212,홍천군,두촌면,소계,2043,1562,521,981,26,0,9,3,0,0,0,0,5,2,1547,15,481
4200,강원도,4212,홍천군,,관내사전투표,818,818,300,493,12,0,4,1,0,0,0,0,3,1,814,4,0
4200,강원도,4212,홍천군,,두촌면제1투,784,462,134,303,8,0,2,2,0,0,0,0,2,1,452,10,322
4200,강원도,4212,홍천군,,두촌면제2투,441,282,87,185,6,0,3,0,0,0,0,0,0,0,281,1,159
4200,강원도,4212,홍천군,내촌면,소계,1980,1543,507,966,36,1,12,1,0,2,1,0,0,3,1529,14,437
4200,강원도,4212,홍천군,,관내사전투표,826,826,294,498,15,1,5,1,0,1,0,0,0,2,817,9,0
4200,강원도,4212,홍천군,,내촌면제1투,453,272,80,181,7,0,2,0,0,0,0,0,0,0,270,2,181
4200,강원도,4212,홍천군,,내촌면제2투,412,284,89,178,10,0,3,0,0,0,1,0,0,0,281,3,128
4200,강원도,4212,홍천군,,내촌면제3투,289,161,44,109,4,0,2,0,0,1,0,0,0,1,161,0,128
4200,강원도,4212,홍천군,서석면,소계,3159,2430,907,1403,51,4,36,0,1,1,0,4,3,0,2410,20,729
4200,강원도,4212,홍천군,,관내사전투표,1095,1095,466,579,26,1,10,0,1,0,0,3,2,0,1088,7,0
4200,강원도,4212,홍천군,,서석면제1투,747,463,144,286,9,1,17,0,0,1,0,0,1,0,459,4,284
4200,강원도,4212,홍천군,,서석면제2투,630,406,153,234,13,1,2,0,0,0,0,0,0,0,403,3,224
4200,강원도,4212,홍천군,,서석면제3투,382,253,90,153,2,0,5,0,0,0,0,1,0,0,251,2,129
4200,강원도,4212,홍천군,,서석면제4투,305,213,54,151,1,1,2,0,0,0,0,0,0,0,209,4,92
4200,강원도,4212,홍천군,남면,소계,5073,3760,1376,2149,81,5,74,2,1,1,3,27,3,1,3723,37,1313
4200,강원도,4212,홍천군,,관내사전투표,1939,1939,790,1018,44,4,43,1,0,1,1,15,1,0,1918,21,0
4200,강원도,4212,홍천군,,남면제1투,1219,692,223,444,12,1,3,0,0,0,0,2,1,0,686,6,527
4200,강원도,4212,홍천군,,남면제2투,696,387,137,232,7,0,6,0,0,0,1,1,0,1,385,2,309
4200,강원도,4212,홍천군,,남면제3투,1219,742,226,455,18,0,22,1,1,0,1,9,1,0,734,8,477
4200,강원도,4212,홍천군,서면,소계,3027,2236,751,1400,41,2,17,1,0,0,1,5,1,1,2220,16,791
4200,강원도,4212,홍천군,,관내사전투표,979,979,395,548,22,1,6,1,0,0,1,2,0,0,976,3,0
4200,강원도,4212,홍천군,,서면제1투,632,350,82,255,5,0,1,0,0,0,0,1,0,0,344,6,282
4200,강원도,4212,홍천군,,서면제2투,377,221,70,143,6,0,0,0,0,0,0,0,0,0,219,2,156
4200,강원도,4212,홍천군,,서면제3투,1039,686,204,454,8,1,10,0,0,0,0,2,1,1,681,5,353
4200,강원도,4212,홍천군,북방면,소계,3628,2837,1032,1667,56,3,33,2,0,1,4,5,3,3,2809,28,791
4200,강원도,4212,홍천군,,관내사전투표,1433,1433,581,792,27,3,16,1,0,0,1,1,0,1,1423,10,0
4200,강원도,4212,홍천군,,북방면제1투,1225,735,232,457,18,0,14,0,0,0,3,4,0,1,729,6,490
4200,강원도,4212,홍천군,,북방면제2투,599,415,119,276,3,0,3,1,0,0,0,0,3,1,406,9,184
4200,강원도,4212,홍천군,,북방면제3투,371,254,100,142,8,0,0,0,0,1,0,0,0,0,251,3,117
4200,강원도,4212,홍천군,내면,소계,2452,1917,707,1121,26,1,24,3,0,2,4,5,1,3,1897,20,535
4200,강원도,4212,홍천군,,관내사전투표,874,874,351,488,9,1,9,2,0,1,0,2,1,0,864,10,0
4200,강원도,4212,홍천군,,내면제1투,709,424,160,241,7,0,6,0,0,0,0,3,0,1,418,6,285
4200,강원도,4212,홍천군,,내면제2투,459,330,107,205,5,0,7,0,0,1,2,0,0,0,327,3,129
4200,강원도,4212,홍천군,,내면제3투,410,289,89,187,5,0,2,1,0,0,2,0,0,2,288,1,121
4200,강원도,4212,홍천군,영귀미면,소계,3612,2838,1074,1568,69,3,29,0,1,1,1,44,7,4,2801,37,774
4200,강원도,4212,홍천군,,관내사전투표,1468,1468,603,791,31,0,11,0,0,0,0,15,2,2,1455,13,0
4200,강원도,4212,홍천군,,영귀미면제1투,1379,835,271,499,21,1,10,0,0,1,1,19,4,0,827,8,544
4200,강원도,4212,홍천군,,영귀미면제2투,475,316,112,175,8,1,3,0,1,0,0,6,1,0,307,9,159
4200,강원도,4212,홍천군,,영귀미면제3투,290,219,88,103,9,1,5,0,0,0,0,4,0,2,212,7,71
4200,강원도,4212,홍천군,잘못 투입·구분된 투표지,,0,3,0,3,0,0,0,0,0,0,0,0,0,0,3,0,-3
4200,강원도,4213,횡성군,합계,,41685,32625,12557,18546,676,19,405,12,4,7,30,40,25,18,32339,286,9060
4200,강원도,4213,횡성군,거소·선상투표,,61,58,19,30,0,0,0,0,0,0,1,0,0,0,50,8,3
4200,강원도,4213,횡성군,관외사전투표,,3960,3959,1634,2140,105,1,43,2,1,0,3,4,3,0,3936,23,1
4200,강원도,4213,횡성군,재외투표,,151,116,79,28,2,0,0,0,0,0,0,0,0,0,109,7,35
4200,강원도,4213,횡성군,횡성읍,소계,16350,12076,4972,6496,295,7,147,4,1,1,8,12,4,7,11954,122,4274
4200,강원도,4213,횡성군,,관내사전투표,6054,6044,2688,3110,141,3,56,3,0,0,2,6,1,1,6011,33,10
4200,강원도,4213,횡성군,,횡성읍제1투,2789,1572,590,885,45,0,21,0,0,0,4,2,0,2,1549,23,1217
4200,강원도,4213,횡성군,,횡성읍제2투,503,349,101,229,12,0,2,0,0,0,1,1,0,1,347,2,154
4200,강원도,4213,횡성군,,횡성읍제3투,468,322,92,218,4,0,2,0,0,0,0,0,1,0,317,5,146
4200,강원도,4213,횡성군,,횡성읍제4투,759,517,148,341,12,1,6,1,1,0,1,0,0,0,511,6,242
4200,강원도,4213,횡성군,,횡성읍제5투,2910,1603,652,847,37,2,32,0,0,1,0,1,1,1,1574,29,1307
4200,강원도,4213,횡성군,,횡성읍제6투,1376,810,352,408,20,0,17,0,0,0,0,1,0,2,800,10,566
4200,강원도,4213,횡성군,,횡성읍제7투,1491,859,349,458,24,1,11,0,0,0,0,1,1,0,845,14,632
4200,강원도,4213,횡성군,우천면,소계,3798,2902,1036,1715,46,1,64,1,0,2,5,5,2,2,2879,23,896
4200,강원도,4213,횡성군,,관내사전투표,1430,1430,568,798,20,0,25,1,0,0,0,4,2,1,1419,11,0
4200,강원도,4213,횡성군,,우천면제1투,780,464,155,286,7,0,13,0,0,0,0,1,0,0,462,2,316
4200,강원도,4213,횡성군,,우천면제2투,790,478,118,326,10,1,14,0,0,0,4,0,0,1,474,4,312
4200,강원도,4213,횡성군,,우천면제3투,798,530,195,305,9,0,12,0,0,2,1,0,0,0,524,6,268
4200,강원도,4213,횡성군,안흥면,소계,2390,1893,695,1133,26,0,18,0,0,0,1,5,2,1,1881,12,497
4200,강원도,4213,횡성군,,관내사전투표,987,987,388,578,12,0,4,0,0,0,0,2,2,0,986,1,0
4200,강원도,4213,횡성군,,안흥면제1투,1049,669,240,399,9,0,8,0,0,0,1,2,0,1,660,9,380
4200,강원도,4213,횡성군,,안흥면제2투,354,237,67,156,5,0,6,0,0,0,0,1,0,0,235,2,117
4200,강원도,4213,횡성군,둔내면,소계,4844,3701,1385,2147,66,1,61,1,0,1,8,1,4,1,3676,25,1143
4200,강원도,4213,횡성군,,관내사전투표,1981,1981,835,1080,34,0,20,0,0,1,4,1,0,0,1975,6,0
4200,강원도,4213,횡성군,,둔내면제1투,998,557,198,328,10,0,11,0,0,0,3,0,2,0,552,5,441
4200,강원도,4213,횡성군,,둔내면제2투,347,236,68,157,3,0,5,0,0,0,0,0,1,0,234,2,111
4200,강원도,4213,횡성군,,둔내면제3투,1188,707,222,435,15,0,22,1,0,0,1,0,1,0,697,10,481
4200,강원도,4213,횡성군,,둔내면제4투,330,220,62,147,4,1,3,0,0,0,0,0,0,1,218,2,110
4200,강원도,4213,횡성군,갑천면,소계,2029,1563,520,976,33,2,9,2,0,2,1,1,3,2,1551,12,466
4200,강원도,4213,횡성군,,관내사전투표,793,793,308,450,18,1,7,0,0,2,0,1,0,0,787,6,0
4200,강원도,4213,횡성군,,갑천면제1투,790,462,117,319,10,1,2,2,0,0,1,0,3,1,456,6,328
4200,강원도,4213,횡성군,,갑천면제2투,446,308,95,207,5,0,0,0,0,0,0,0,0,1,308,0,138
4200,강원도,4213,횡성군,청일면,소계,1949,1479,486,928,27,0,13,0,0,0,0,6,2,2,1464,15,470
4200,강원도,4213,횡성군,,관내사전투표,732,732,273,442,10,0,5,0,0,0,0,1,0,0,731,1,0
4200,강원도,4213,횡성군,,청일면제1투,310,177,39,125,6,0,2,0,0,0,0,0,0,1,173,4,133
4200,강원도,4213,횡성군,,청일면제2투,398,256,66,172,6,0,2,0,0,0,0,5,1,1,253,3,142
4200,강원도,4213,횡성군,,청일면제3투,509,314,108,189,5,0,4,0,0,0,0,0,1,0,307,7,195
4200,강원도,4213,횡성군,공근면,소계,2992,2354,815,1433,33,5,36,1,1,1,1,3,3,3,2335,19,638
4200,강원도,4213,횡성군,,관내사전투표,1275,1275,496,736,16,5,11,0,0,1,1,3,0,1,1270,5,0
4200,강원도,4213,횡성군,,공근면제1투,1066,642,193,408,7,0,20,0,1,0,0,0,2,2,633,9,424
4200,강원도,4213,횡성군,,공근면제2투,651,437,126,289,10,0,5,1,0,0,0,0,1,0,432,5,214
4200,강원도,4213,횡성군,서원면,소계,1751,1390,492,841,27,1,9,1,1,0,1,2,2,0,1377,13,361
4200,강원도,4213,횡성군,,관내사전투표,674,674,265,386,11,0,6,1,1,0,1,0,0,0,671,3,0
4200,강원도,4213,횡성군,,서원면제1투,534,340,94,228,10,0,1,0,0,0,0,2,0,0,335,5,194
4200,강원도,4213,횡성군,,서원면제2투,543,376,133,227,6,1,2,0,0,0,0,0,2,0,371,5,167
4200,강원도,4213,횡성군,강림면,소계,1410,1133,424,678,16,1,5,0,0,0,1,1,0,0,1126,7,277
4200,강원도,4213,횡성군,,관내사전투표,661,661,280,366,9,0,2,0,0,0,1,1,0,0,659,2,0
4200,강원도,4213,횡성군,,강림면투표소,749,472,144,312,7,1,3,0,0,0,0,0,0,0,467,5,277
4200,강원도,4213,횡성군,잘못 투입·구분된 투표지,,0,1,0,1,0,0,0,0,0,0,0,0,0,0,1,0,-1
4200,강원도,4214,영월군,합계,,34306,26925,10758,14904,536,13,309,14,2,13,39,43,27,15,26673,252,7381
4200,강원도,4214,영월군,거소·선상투표,,134,126,44,54,3,2,0,0,0,0,2,2,1,0,108,18,8
4200,강원도,4214,영월군,관외사전투표,,3497,3487,1547,1750,75,2,58,0,0,0,4,6,4,1,3447,40,10
4200,강원도,4214,영월군,재외투표,,104,85,51,22,4,0,0,0,0,0,0,0,0,0,77,8,19
4200,강원도,4214,영월군,영월읍,소계,16136,11903,5192,6204,243,3,123,5,0,5,12,16,8,3,11814,89,4233
4200,강원도,4214,영월군,,관내사전투표,5566,5566,2716,2655,110,3,44,2,0,1,2,7,2,1,5543,23,0
4200,강원도,4214,영월군,,영월읍제1투,1035,587,208,359,13,0,1,0,0,0,1,0,0,0,582,5,448
4200,강원도,4214,영월군,,영월읍제2투,1473,885,357,489,18,0,7,1,0,0,2,2,0,0,876,9,588
4200,강원도,4214,영월군,,영월읍제3투,2309,1347,589,681,36,0,17,2,0,0,3,2,1,0,1331,16,962
4200,강원도,4214,영월군,,영월읍제4투,1564,948,400,491,19,0,25,0,0,2,0,1,2,0,940,8,616
4200,강원도,4214,영월군,,영월읍제5투,882,484,177,290,9,0,3,0,0,0,0,1,0,1,481,3,398
4200,강원도,4214,영월군,,영월읍제6투,449,287,86,187,3,0,3,0,0,0,1,2,1,1,284,3,162
4200,강원도,4214,영월군,,영월읍제7투,296,182,60,116,2,0,3,0,0,0,0,0,1,0,182,0,114
4200,강원도,4214,영월군,,영월읍제8투,954,617,233,349,13,0,10,0,0,1,1,1,0,0,608,9,337
4200,강원도,4214,영월군,,영월읍제9투,1608,1000,366,587,20,0,10,0,0,1,2,0,1,0,987,13,608
4200,강원도,4214,영월군,상동읍,소계,876,680,267,378,17,0,4,0,0,1,0,3,2,0,672,8,196
4200,강원도,4214,영월군,,관내사전투표,373,373,160,196,10,0,1,0,0,1,0,1,0,0,369,4,0
4200,강원도,4214,영월군,,상동읍제1투,127,80,26,50,2,0,2,0,0,0,0,0,0,0,80,0,47
4200,강원도,4214,영월군,,상동읍제2투,153,85,41,42,1,0,0,0,0,0,0,0,0,0,84,1,68
4200,강원도,4214,영월군,,상동읍제3투,223,142,40,90,4,0,1,0,0,0,0,2,2,0,139,3,81
4200,강원도,4214,영월군,김삿갓면,소계,1426,1129,402,679,19,0,14,2,0,1,1,2,1,2,1123,6,297
4200,강원도,4214,영월군,,관내사전투표,615,615,246,347,12,0,4,0,0,1,1,1,0,1,613,2,0
4200,강원도,4214,영월군,,김삿갓면제1투,430,268,83,171,3,0,5,0,0,0,0,1,1,1,265,3,162
4200,강원도,4214,영월군,,김삿갓면제2투,381,246,73,161,4,0,5,2,0,0,0,0,0,0,245,1,135
4200,강원도,4214,영월군,북면,소계,1730,1313,461,778,27,2,22,1,0,1,4,3,1,0,1300,13,417
4200,강원도,4214,영월군,,관내사전투표,512,512,225,262,13,1,3,0,0,1,1,1,0,0,507,5,0
4200,강원도,4214,영월군,,북면제1투,424,262,79,166,7,1,4,0,0,0,2,0,1,0,260,2,162
4200,강원도,4214,영월군,,북면제2투,451,311,86,204,6,0,9,1,0,0,0,1,0,0,307,4,140
4200,강원도,4214,영월군,,북면제3투,343,228,71,146,1,0,6,0,0,0,1,1,0,0,226,2,115
4200,강원도,4214,영월군,남면,소계,2204,1795,657,1049,31,2,21,1,0,2,3,4,3,4,1777,18,409
4200,강원도,4214,영월군,,관내사전투표,945,945,365,543,18,2,9,0,0,1,1,2,0,0,941,4,0
4200,강원도,4214,영월군,,남면제1투,745,474,160,274,6,0,10,1,0,1,1,1,3,3,460,14,271
4200,강원도,4214,영월군,,남면제2투,371,271,91,169,6,0,2,0,0,0,1,1,0,1,271,0,100
4200,강원도,4214,영월군,,남면제3투,143,105,41,63,1,0,0,0,0,0,0,0,0,0,105,0,38
4200,강원도,4214,영월군,한반도면,소계,2261,1765,612,1069,32,0,20,1,0,1,4,1,1,3,1744,21,496
4200,강원도,4214,영월군,,관내사전투표,631,631,231,375,15,0,6,0,0,1,1,0,0,0,629,2,0
4200,강원도,4214,영월군,,한반도면제1투,526,324,119,189,5,0,4,0,0,0,0,0,1,2,320,4,202
4200,강원도,4214,영월군,,한반도면제2투,1104,810,262,505,12,0,10,1,0,0,3,1,0,1,795,15,294
4200,강원도,4214,영월군,주천면,소계,3211,2499,864,1545,43,2,17,0,1,1,3,3,2,1,2482,17,712
4200,강원도,4214,영월군,,관내사전투표,1278,1278,484,754,23,1,4,0,1,0,0,3,2,0,1272,6,0
4200,강원도,4214,영월군,,주천면제1투,1105,637,170,432,13,1,12,0,0,1,2,0,0,1,632,5,468
4200,강원도,4214,영월군,,주천면제2투,258,178,67,106,2,0,0,0,0,0,1,0,0,0,176,2,80
4200,강원도,4214,영월군,,주천면제3투,570,406,143,253,5,0,1,0,0,0,0,0,0,0,402,4,164
4200,강원도,4214,영월군,무릉도원면,소계,1490,1185,361,771,19,0,17,3,1,0,2,1,2,0,1177,8,305
4200,강원도,4214,영월군,,관내사전투표,533,533,189,321,13,0,6,1,0,0,1,0,0,0,531,2,0
4200,강원도,4214,영월군,,무릉도원면제1투,487,303,93,193,4,0,7,1,0,0,1,0,0,0,299,4,184
4200,강원도,4214,영월군,,무릉도원면제2투,470,349,79,257,2,0,4,1,1,0,0,1,2,0,347,2,121
4200,강원도,4214,영월군,산솔면,소계,1237,958,300,605,23,0,13,1,0,1,4,2,2,1,952,6,279
4200,강원도,4214,영월군,,관내사전투표,375,375,141,214,11,0,4,1,0,0,2,0,0,1,374,1,0
4200,강원도,4214,영월군,,산솔면제1투,448,289,93,180,7,0,6,0,0,0,0,0,0,0,286,3,159
4200,강원도,4214,영월군,,산솔면제2투,414,294,66,211,5,0,3,0,0,1,2,2,2,0,292,2,120
4200,강원도,4214,영월군,잘못 투입·구분된 투표지,,0,0,0,0,0,0,0,0,0,0,0,0,0,0,0,0,0
4200,강원도,4215,평창군,합계,,37325,29353,11463,16571,564,17,366,5,8,7,34,33,26,25,29119,234,7972
4200,강원도,4215,평창군,거소·선상투표,,64,61,16,32,0,0,1,0,0,0,0,0,0,0,49,12,3
4200,강원도,4215,평창군,관외사전투표,,3934,3933,1571,2189,69,3,49,2,0,2,2,4,1,5,3897,36,1
4200,강원도,4215,평창군,재외투표,,142,100,59,31,3,0,1,0,0,0,0,0,0,0,94,6,42
4200,강원도,4215,평창군,평창읍,소계,6820,5336,2127,2966,110,3,64,1,0,2,7,7,5,5,5297,39,1484
4200,강원도,4215,평창군,,관내사전투표,2743,2743,1213,1411,69,2,33,0,0,0,2,3,2,0,2735,8,0
4200,강원도,4215,평창군,,평창읍제1투,956,545,199,317,9,1,5,1,0,0,1,1,0,0,534,11,411
4200,강원도,4215,평창군,,평창읍제2투,1392,821,322,461,13,0,10,0,0,0,1,0,2,2,811,10,571
4200,강원도,4215,평창군,,평창읍제3투,208,133,39,92,1,0,0,0,0,0,0,1,0,0,133,0,75
4200,강원도,4215,평창군,,평창읍제4투,393,295,109,172,7,0,3,0,0,0,1,1,0,1,294,1,98
4200,강원도,4215,평창군,,평창읍제5투,418,299,94,186,6,0,6,0,0,1,0,0,1,0,294,5,119
4200,강원도,4215,평창군,,평창읍제6투,424,298,93,189,4,0,5,0,0,0,2,1,0,1,295,3,126
4200,강원도,4215,평창군,,평창읍제7투,286,202,58,138,1,0,2,0,0,1,0,0,0,1,201,1,84
4200,강원도,4215,평창군,미탄면,소계,1409,1141,425,679,12,2,9,0,0,0,0,1,2,2,1132,9,268
4200,강원도,4215,평창군,,관내사전투표,676,676,273,386,5,1,3,0,0,0,0,1,1,1,671,5,0
4200,강원도,4215,평창군,,미탄면제1투,639,392,132,241,7,0,6,0,0,0,0,0,1,1,388,4,247
4200,강원도,4215,평창군,,미탄면제2투,94,73,20,52,0,1,0,0,0,0,0,0,0,0,73,0,21
4200,강원도,4215,평창군,방림면,소계,2064,1597,635,883,30,4,16,1,3,0,12,2,3,2,1591,6,467
4200,강원도,4215,평창군,,관내사전투표,606,606,271,315,13,1,4,0,0,0,0,0,1,0,605,1,0
4200,강원도,4215,평창군,,방림면제1투,441,271,113,148,4,0,3,0,0,0,0,0,1,0,269,2,170
4200,강원도,4215,평창군,,방림면제2투,321,236,86,142,5,0,0,0,0,0,2,0,0,0,235,1,85
4200,강원도,4215,평창군,,방림면제3투,696,484,165,278,8,3,9,1,3,0,10,2,1,2,482,2,212
4200,강원도,4215,평창군,대화면,소계,4196,3149,1297,1710,58,1,42,1,2,0,3,2,5,3,3124,25,1047
4200,강원도,4215,평창군,,관내사전투표,1589,1589,701,831,22,0,15,0,0,0,1,1,4,2,1577,12,0
4200,강원도,4215,평창군,,대화면제1투,1096,610,240,340,17,0,6,0,0,0,1,1,0,0,605,5,486
4200,강원도,4215,평창군,,대화면제2투,540,328,123,190,6,0,3,0,2,0,0,0,0,0,324,4,212
4200,강원도,4215,평창군,,대화면제3투,749,467,192,240,12,1,16,1,0,0,1,0,1,1,465,2,282
4200,강원도,4215,평창군,,대화면제4투,222,155,41,109,1,0,2,0,0,0,0,0,0,0,153,2,67
4200,강원도,4215,평창군,봉평면,소계,4482,3396,1285,1966,67,1,53,0,1,0,1,1,2,1,3378,18,1086
4200,강원도,4215,평창군,,관내사전투표,1809,1807,754,991,37,1,15,0,1,0,0,0,1,1,1801,6,2
4200,강원도,4215,평창군,,봉평면제1투,1161,686,244,406,13,0,14,0,0,0,0,0,0,0,677,9,475
4200,강원도,4215,평창군,,봉평면제2투,639,406,128,261,5,0,9,0,0,0,0,1,0,0,404,2,233
4200,강원도,4215,평창군,,봉평면제3투,873,497,159,308,12,0,15,0,0,0,1,0,1,0,496,1,376
4200,강원도,4215,평창군,용평면,소계,2474,1950,743,1148,23,0,13,0,0,0,0,2,2,2,1933,17,524
4200,강원도,4215,평창군,,관내사전투표,924,924,406,492,11,0,6,0,0,0,0,0,1,2,918,6,0
4200,강원도,4215,평창군,,용평면제1투,417,290,96,187,1,0,3,0,0,0,0,0,0,0,287,3,127
4200,강원도,4215,평창군,,용평면제2투,437,312,98,201,4,0,2,0,0,0,0,2,1,0,308,4,125
4200,강원도,4215,평창군,,용평면제3투,696,424,143,268,7,0,2,0,0,0,0,0,0,0,420,4,272
4200,강원도,4215,평창군,진부면,소계,7101,5337,2088,2993,122,2,68,0,1,2,5,10,2,2,5295,42,1764
4200,강원도,4215,평창군,,관내사전투표,2536,2536,1099,1346,49,1,20,0,0,0,1,5,1,0,2522,14,0
4200,강원도,4215,평창군,,진부면제1투,833,508,177,294,17,0,10,0,0,2,1,1,0,0,502,6,325
4200,강원도,4215,평창군,,진부면제2투,1213,711,271,391,17,0,20,0,0,0,0,1,0,0,700,11,502
4200,강원도,4215,평창군,,진부면제3투,1280,738,281,414,21,0,9,0,1,0,3,3,0,1,733,5,542
4200,강원도,4215,평창군,,진부면제4투,328,223,78,136,2,0,3,0,0,0,0,0,1,0,220,3,105
4200,강원도,4215,평창군,,진부면제5투,382,251,70,171,7,0,2,0,0,0,0,0,0,0,250,1,131
4200,강원도,4215,평창군,,진부면제6투,300,212,72,129,5,0,4,0,0,0,0,0,0,0,210,2,88
4200,강원도,4215,평창군,,진부면제7투,229,158,40,112,4,1,0,0,0,0,0,0,0,1,158,0,71
4200,강원도,4215,평창군,대관령면,소계,4639,3352,1216,1974,70,1,50,0,1,1,4,4,4,3,3328,24,1287
4200,강원도,4215,평창군,,관내사전투표,1667,1667,676,929,29,0,18,0,1,0,0,3,1,1,1658,9,0
4200,강원도,4215,평창군,,대관령면제1투,1222,686,186,449,20,1,19,0,0,1,2,0,1,1,680,6,536
4200,강원도,4215,평창군,,대관령면제2투,1449,791,280,469,17,0,12,0,0,0,2,1,2,0,783,8,658
4200,강원도,4215,평창군,,대관령면제3투,301,208,74,127,4,0,1,0,0,0,0,0,0,1,207,1,93
4200,강원도,4215,평창군,잘못 투입·구분된 투표지,,0,1,1,0,0,0,0,0,0,0,0,0,0,0,1,0,-1
4200,강원도,4216,화천군,합계,,21088,16494,6445,9009,433,12,283,6,6,4,18,26,7,18,16267,227,4594
4200,강원도,4216,화천군,거소·선상투표,,227,219,47,107,3,0,21,0,1,0,0,0,0,2,181,38,8
4200,강원도,4216,화천군,관외사전투표,,2263,2263,968,1174,57,3,28,1,2,1,1,1,0,2,2238,25,0
4200,강원도,4216,화천군,재외투표,,55,38,18,17,1,0,0,0,0,0,0,0,0,0,36,2,17
4200,강원도,4216,화천군,화천읍,소계,6258,4710,1924,2506,132,2,68,3,1,1,7,6,0,7,4657,53,1548
4200,강원도,4216,화천군,,관내사전투표,2285,2285,999,1156,65,0,41,1,1,1,2,2,0,0,2268,17,0
4200,강원도,4216,화천군,,화천읍제1투,1204,711,250,414,20,0,9,0,0,0,2,2,0,4,701,10,493
4200,강원도,4216,화천군,,화천읍제2투,1783,1080,437,568,34,1,10,2,0,0,2,2,0,3,1059,21,703
4200,강원도,4216,화천군,,화천읍제3투,481,306,118,178,3,0,6,0,0,0,0,0,0,0,305,1,175
4200,강원도,4216,화천군,,화천읍제4투,505,328,120,190,10,1,2,0,0,0,1,0,0,0,324,4,177
4200,강원도,4216,화천군,간동면,소계,2138,1639,621,942,25,2,20,0,0,0,4,6,4,3,1627,12,499
4200,강원도,4216,화천군,,관내사전투표,740,740,326,386,11,2,5,0,0,0,2,2,1,2,737,3,0
4200,강원도,4216,화천군,,간동면제1투,449,260,84,167,3,0,2,0,0,0,1,1,1,0,259,1,189
4200,강원도,4216,화천군,,간동면제2투,464,305,98,189,7,0,4,0,0,0,1,2,2,1,304,1,159
4200,강원도,4216,화천군,,간동면제3투,366,255,90,149,3,0,7,0,0,0,0,0,0,0,249,6,111
4200,강원도,4216,화천군,,간동면제4투,119,79,23,51,1,0,2,0,0,0,0,1,0,0,78,1,40
4200,강원도,4216,화천군,하남면,소계,2423,1928,749,1081,43,1,28,0,0,1,2,2,3,0,1910,18,495
4200,강원도,4216,화천군,,관내사전투표,926,926,402,473,24,1,14,0,0,1,0,1,1,0,917,9,0
4200,강원도,4216,화천군,,하남면제1투,744,450,154,276,9,0,8,0,0,0,0,0,1,0,448,2,294
4200,강원도,4216,화천군,,하남면제2투,488,360,144,200,6,0,4,0,0,0,0,1,1,0,356,4,128
4200,강원도,4216,화천군,,하남면제3투,265,192,49,132,4,0,2,0,0,0,2,0,0,0,189,3,73
4200,강원도,4216,화천군,상서면,소계,3066,2246,802,1271,65,2,54,0,1,1,1,6,0,1,2204,42,820
4200,강원도,4216,화천군,,관내사전투표,1012,1012,376,541,32,1,33,0,0,0,0,2,0,1,986,26,0
4200,강원도,4216,화천군,,상서면제1투,498,332,119,194,8,0,6,0,1,1,0,2,0,0,331,1,166
4200,강원도,4216,화천군,,상서면제2투,315,205,73,122,6,1,3,0,0,0,0,0,0,0,205,0,110
4200,강원도,4216,화천군,,상서면제3투,282,207,73,117,8,0,2,0,0,0,1,1,0,0,202,5,75
4200,강원도,4216,화천군,,상서면제4투,501,237,87,136,5,0,4,0,0,0,0,1,0,0,233,4,264
4200,강원도,4216,화천군,,상서면제5투,219,133,45,81,1,0,2,0,0,0,0,0,0,0,129,4,86
4200,강원도,4216,화천군,,상서면제6투,239,120,29,80,5,0,4,0,0,0,0,0,0,0,118,2,119
4200,강원도,4216,화천군,사내면,소계,4658,3451,1316,1911,107,2,64,2,1,0,3,5,0,3,3414,37,1207
4200,강원도,4216,화천군,,관내사전투표,1914,1914,796,989,57,1,36,2,0,0,1,3,0,2,1887,27,0
4200,강원도,4216,화천군,,사내면제1투,1429,755,284,419,27,1,19,0,1,0,1,1,0,0,753,2,674
4200,강원도,4216,화천군,,사내면제2투,499,322,110,204,4,0,2,0,0,0,0,0,0,1,321,1,177
4200,강원도,4216,화천군,,사내면제3투,301,162,47,106,4,0,2,0,0,0,0,0,0,0,159,3,139
4200,강원도,4216,화천군,,사내면제4투,515,298,79,193,15,0,5,0,0,0,1,1,0,0,294,4,217
4200,강원도,4216,화천군,잘못 투입·구분된 투표지,,0,0,0,0,0,0,0,0,0,0,0,0,0,0,0,0,0
4200,강원도,4217,양구군,합계,,18565,14529,5689,7878,387,13,260,4,8,2,14,23,16,20,14314,215,4036
4200,강원도,4217,양구군,거소·선상투표,,306,299,96,119,6,1,15,0,0,0,1,2,0,1,241,58,7
4200,강원도,4217,양구군,관외사전투표,,1685,1684,746,831,46,1,29,0,1,0,1,3,0,2,1660,24,1
4200,강원도,4217,양구군,재외투표,,43,27,17,9,1,0,0,0,0,0,0,0,0,0,27,0,16
4200,강원도,4217,양구군,양구읍,소계,9998,7532,3026,4020,222,8,127,3,5,1,7,15,6,9,7449,83,2466
4200,강원도,4217,양구군,,관내사전투표,3733,3733,1607,1907,99,4,53,1,4,1,3,9,2,4,3694,39,0
4200,강원도,4217,양구군,,양구읍제1투,421,294,91,190,1,0,5,0,0,0,0,0,1,1,289,5,127
4200,강원도,4217,양구군,,양구읍제2투,396,246,105,127,4,0,5,0,0,0,1,0,1,1,244,2,150
4200,강원도,4217,양구군,,양구읍제3투,1076,668,247,384,21,0,8,0,0,0,2,0,0,1,663,5,408
4200,강원도,4217,양구군,,양구읍제4투,638,387,143,220,11,1,8,0,0,0,0,0,0,1,384,3,251
4200,강원도,4217,양구군,,양구읍제5투,2093,1265,497,668,48,2,28,0,0,0,0,3,0,1,1247,18,828
4200,강원도,4217,양구군,,양구읍제6투,1384,755,274,411,32,1,20,2,1,0,1,3,1,0,746,9,629
4200,강원도,4217,양구군,,양구읍제7투,100,71,15,53,1,0,0,0,0,0,0,0,1,0,70,1,29
4200,강원도,4217,양구군,,양구읍제8투,157,113,47,60,5,0,0,0,0,0,0,0,0,0,112,1,44
4200,강원도,4217,양구군,동면,소계,1699,1313,477,758,29,1,20,0,0,0,1,2,1,4,1293,20,386
4200,강원도,4217,양구군,,관내사전투표,589,589,249,311,13,0,9,0,0,0,0,0,0,1,583,6,0
4200,강원도,4217,양구군,,동면제1투,362,236,66,151,4,0,5,0,0,0,0,0,0,1,227,9,126
4200,강원도,4217,양구군,,동면제2투,479,299,95,186,9,1,2,0,0,0,1,2,1,0,297,2,180
4200,강원도,4217,양구군,,동면제3투,269,189,67,110,3,0,4,0,0,0,0,0,0,2,186,3,80
4200,강원도,4217,양구군,방산면,소계,1061,830,328,459,17,0,17,0,0,0,0,0,2,1,824,6,231
4200,강원도,4217,양구군,,관내사전투표,358,358,154,182,7,0,10,0,0,0,0,0,1,1,355,3,0
4200,강원도,4217,양구군,,방산면제1투,257,185,67,112,3,0,3,0,0,0,0,0,0,0,185,0,72
4200,강원도,4217,양구군,,방산면제2투,255,180,62,110,3,0,1,0,0,0,0,0,1,0,177,3,75
4200,강원도,4217,양구군,,방산면제3투,191,107,45,55,4,0,3,0,0,0,0,0,0,0,107,0,84
4200,강원도,4217,양구군,해안면,소계,1033,797,332,415,21,0,16,0,0,1,1,1,3,1,791,6,236
4200,강원도,4217,양구군,,관내사전투표,438,438,197,215,15,0,7,0,0,0,0,1,2,0,437,1,0
4200,강원도,4217,양구군,,해안면투표소,595,359,135,200,6,0,9,0,0,1,1,0,1,1,354,5,236
4200,강원도,4217,양구군,국토정중앙면,소계,2740,2047,667,1267,45,2,36,1,2,0,3,0,4,2,2029,18,693
4200,강원도,4217,양구군,,관내사전투표,844,844,318,481,14,2,19,0,0,0,1,0,1,1,837,7,0
4200,강원도,4217,양구군,,국토정중앙면제1투,315,204,61,134,6,0,2,0,0,0,0,0,0,0,203,1,111
4200,강원도,4217,양구군,,국토정중앙면제2투,737,427,137,260,11,0,10,0,1,0,1,0,1,1,422,5,310
4200,강원도,4217,양구군,,국토정중앙면제3투,566,368,105,244,8,0,3,1,1,0,1,0,2,0,365,3,198
4200,강원도,4217,양구군,,국토정중앙면제4투,278,204,46,148,6,0,2,0,0,0,0,0,0,0,202,2,74
4200,강원도,4217,양구군,잘못 투입·구분된 투표지,,0,0,0,0,0,0,0,0,0,0,0,0,0,0,0,0,0
4200,강원도,4218,철원군,합계,,37248,27846,11039,15194,722,16,367,5,7,7,20,26,16,20,27439,407,9402
4200,강원도,4218,철원군,거소·선상투표,,562,470,128,182,13,1,30,2,1,2,4,3,1,4,371,99,92
4200,강원도,4218,철원군,관외사전투표,,2783,2783,1253,1343,104,3,36,0,1,0,2,2,3,1,2748,35,0
4200,강원도,4218,철원군,재외투표,,121,87,42,27,4,0,0,0,0,0,0,0,0,0,73,14,34
4200,강원도,4218,철원군,철원읍,소계,4251,3174,1353,1665,78,0,31,1,0,0,4,2,2,4,3140,34,1077
4200,강원도,4218,철원군,,관내사전투표,1560,1560,718,772,36,0,15,1,0,0,2,0,0,0,1544,16,0
4200,강원도,4218,철원군,,철원읍제1투,607,338,125,192,11,0,3,0,0,0,0,0,1,0,332,6,269
4200,강원도,4218,철원군,,철원읍제2투,985,566,248,287,21,0,4,0,0,0,0,1,0,0,561,5,419
4200,강원도,4218,철원군,,철원읍제3투,169,118,42,73,0,0,0,0,0,0,1,1,0,1,118,0,51
4200,강원도,4218,철원군,,철원읍제4투,353,250,100,134,5,0,5,0,0,0,1,0,1,2,248,2,103
4200,강원도,4218,철원군,,철원읍제5투,577,342,120,207,5,0,4,0,0,0,0,0,0,1,337,5,235
4200,강원도,4218,철원군,김화읍,소계,2545,1892,729,1066,42,1,29,0,0,0,1,3,1,1,1873,19,653
4200,강원도,4218,철원군,,관내사전투표,850,850,326,481,19,0,14,0,0,0,1,2,1,1,845,5,0
4200,강원도,4218,철원군,,김화읍제1투,370,207,77,120,3,1,5,0,0,0,0,1,0,0,207,0,163
4200,강원도,4218,철원군,,김화읍제2투,173,128,68,58,0,0,0,0,0,0,0,0,0,0,126,2,45
4200,강원도,4218,철원군,,김화읍제3투,915,540,183,327,12,0,9,0,0,0,0,0,0,0,531,9,375
4200,강원도,4218,철원군,,김화읍제4투,237,167,75,80,8,0,1,0,0,0,0,0,0,0,164,3,70
4200,강원도,4218,철원군,갈말읍,소계,9362,6811,2617,3860,181,3,64,0,2,0,5,5,5,7,6749,62,2551
4200,강원도,4218,철원군,,관내사전투표,2683,2683,1160,1403,75,0,28,0,0,0,0,2,0,1,2669,14,0
4200,강원도,4218,철원군,,갈말읍제1투,781,460,170,272,6,0,6,0,0,0,1,0,0,1,456,4,321
4200,강원도,4218,철원군,,갈말읍제2투,760,479,183,272,8,0,6,0,0,0,0,0,1,1,471,8,281
4200,강원도,4218,철원군,,갈말읍제3투,825,428,144,262,8,0,7,0,0,0,0,1,1,0,423,5,397
4200,강원도,4218,철원군,,갈말읍제4투,471,290,108,166,8,0,3,0,1,0,1,0,0,1,288,2,181
4200,강원도,4218,철원군,,갈말읍제5투,607,435,119,297,11,0,1,0,1,0,0,1,0,0,430,5,172
4200,강원도,4218,철원군,,갈말읍제6투,501,341,80,243,8,2,2,0,0,0,0,0,2,1,338,3,160
4200,강원도,4218,철원군,,갈말읍제7투,1611,1015,416,548,32,0,5,0,0,0,0,0,1,2,1004,11,596
4200,강원도,4218,철원군,,갈말읍제8투,967,554,203,312,21,1,5,0,0,0,3,1,0,0,546,8,413
4200,강원도,4218,철원군,,갈말읍제9투,156,126,34,85,4,0,1,0,0,0,0,0,0,0,124,2,30
4200,강원도,4218,철원군,동송읍,소계,11228,7932,3111,4429,190,4,97,0,1,4,3,8,2,3,7852,80,3296
4200,강원도,4218,철원군,,관내사전투표,2748,2748,1164,1473,64,2,24,0,0,1,0,3,0,1,2732,16,0
4200,강원도,4218,철원군,,동송읍제1투,2086,1158,480,605,33,1,20,0,0,0,0,2,0,0,1141,17,928
4200,강원도,4218,철원군,,동송읍제2투,858,496,187,277,8,0,13,0,0,2,0,0,0,0,487,9,362
4200,강원도,4218,철원군,,동송읍제3투,1327,803,344,409,29,0,10,0,0,0,2,0,0,0,794,9,524
4200,강원도,4218,철원군,,동송읍제4투,879,540,177,339,11,0,6,0,0,0,0,0,0,0,533,7,339
4200,강원도,4218,철원군,,동송읍제5투,367,270,83,178,4,0,2,0,0,0,0,1,0,0,268,2,97
4200,강원도,4218,철원군,,동송읍제6투,704,469,143,288,17,1,11,0,0,0,1,1,0,0,462,7,235
4200,강원도,4218,철원군,,동송읍제7투,405,251,70,170,5,0,1,0,0,0,0,1,0,0,247,4,154
4200,강원도,4218,철원군,,동송읍제8투,1115,677,257,393,13,0,4,0,1,1,0,0,1,1,671,6,438
4200,강원도,4218,철원군,,동송읍제9투,464,325,115,204,3,0,0,0,0,0,0,0,1,0,323,2,139
4200,강원도,4218,철원군,,동송읍제10투,275,195,91,93,3,0,6,0,0,0,0,0,0,1,194,1,80
4200,강원도,4218,철원군,서면,소계,4541,3305,1298,1823,76,3,58,2,2,0,1,1,2,0,3266,39,1236
4200,강원도,4218,철원군,,관내사전투표,1520,1520,626,811,33,1,29,2,1,0,0,0,0,0,1503,17,0
4200,강원도,4218,철원군,,서면제1투,949,565,218,314,11,2,10,0,1,0,1,0,0,0,557,8,384
4200,강원도,4218,철원군,,서면제2투,1016,577,226,321,10,0,9,0,0,0,0,1,1,0,568,9,439
4200,강원도,4218,철원군,,서면제3투,1056,643,228,377,22,0,10,0,0,0,0,0,1,0,638,5,413
4200,강원도,4218,철원군,근남면,소계,1728,1284,463,743,32,1,21,0,0,1,0,0,0,0,1261,23,444
4200,강원도,4218,철원군,,관내사전투표,464,464,176,255,12,1,9,0,0,0,0,0,0,0,453,11,0
4200,강원도,4218,철원군,,근남면제1투,246,158,53,97,4,0,1,0,0,0,0,0,0,0,155,3,88
4200,강원도,4218,철원군,,근남면제2투,646,387,137,219,15,0,8,0,0,1,0,0,0,0,380,7,259
4200,강원도,4218,철원군,,근남면제3투,372,275,97,172,1,0,3,0,0,0,0,0,0,0,273,2,97
4200,강원도,4218,철원군,근북면,소계,127,108,45,56,2,0,1,0,0,0,0,2,0,0,106,2,19
4200,강원도,4218,철원군,,관내사전투표,62,62,25,33,1,0,1,0,0,0,0,1,0,0,61,1,0
4200,강원도,4218,철원군,,근북면투표소,65,46,20,23,1,0,0,0,0,0,0,1,0,0,45,1,19
4200,강원도,4218,철원군,잘못 투입·구분된 투표지,,0,0,0,0,0,0,0,0,0,0,0,0,0,0,0,0,04300,충청북도,4301,청주시상당구,합계,,162949,122198,55852,59685,3548,89,1267,61,23,34,87,112,45,73,120876,1322,40751
4300,충청북도,4301,청주시상당구,거소·선상투표,,413,379,134,160,11,3,4,0,1,0,2,1,3,2,321,58,34
4300,충청북도,4301,청주시상당구,관외사전투표,,13853,13847,6787,6227,440,17,172,9,5,3,7,16,7,11,13701,146,6
4300,충청북도,4301,청주시상당구,재외투표,,488,338,202,83,14,0,2,0,0,0,0,0,0,0,301,37,150
4300,충청북도,4301,청주시상당구,중앙동,소계,5491,3903,1507,2189,124,3,39,0,0,1,1,1,0,2,3867,36,1588
4300,충청북도,4301,청주시상당구,,관내사전투표,1619,1619,743,801,57,0,13,0,0,0,0,1,0,0,1615,4,0
4300,충청북도,4301,청주시상당구,,중앙동제1투,2223,1268,449,745,38,0,15,0,0,0,1,0,0,1,1249,19,955
4300,충청북도,4301,청주시상당구,,중앙동제2투,1649,1016,315,643,29,3,11,0,0,1,0,0,0,1,1003,13,633
4300,충청북도,4301,청주시상당구,성안동,소계,6620,4893,1907,2722,135,2,54,5,3,1,7,3,0,4,4843,50,1727
4300,충청북도,4301,청주시상당구,,관내사전투표,2329,2329,1056,1141,89,1,16,2,0,1,1,2,0,1,2310,19,0
4300,충청북도,4301,청주시상당구,,성안동제1투,2402,1434,508,859,30,1,17,3,1,0,1,0,0,0,1420,14,968
4300,충청북도,4301,청주시상당구,,성안동제2투,1889,1130,343,722,16,0,21,0,2,0,5,1,0,3,1113,17,759
4300,충청북도,4301,청주시상당구,탑·대성동,소계,6291,4266,1559,2473,120,3,49,2,2,2,4,3,1,1,4219,47,2025
4300,충청북도,4301,청주시상당구,,관내사전투표,1899,1899,763,1059,42,1,17,1,2,0,1,0,0,1,1887,12,0
4300,충청북도,4301,청주시상당구,,탑·대성동제1투,2226,1191,380,730,36,2,19,0,0,1,2,2,1,0,1173,18,1035
4300,충청북도,4301,청주시상당구,,탑·대성동제2투,2166,1176,416,684,42,0,13,1,0,1,1,1,0,0,1159,17,990
4300,충청북도,4301,청주시상당구,용담·명암·산성동,소계,10190,7907,3960,3590,208,5,60,4,1,1,4,6,0,2,7841,66,2283
4300,충청북도,4301,청주시상당구,,관내사전투표,3881,3881,2116,1619,96,3,20,2,0,0,2,1,0,0,3859,22,0
4300,충청북도,4301,청주시상당구,,용담·명암·산성동제1투,1687,895,307,531,21,1,12,2,0,0,1,3,0,1,879,16,792
4300,충청북도,4301,청주시상당구,,용담·명암·산성동제2투,1892,1256,558,630,37,1,14,0,1,1,1,0,0,0,1243,13,636
4300,충청북도,4301,청주시상당구,,용담·명암·산성동제3투,2730,1875,979,810,54,0,14,0,0,0,0,2,0,1,1860,15,855
4300,충청북도,4301,청주시상당구,금천동,소계,24502,18081,8386,8786,505,6,187,8,1,6,11,14,2,9,17921,160,6421
4300,충청북도,4301,청주시상당구,,관내사전투표,6687,6687,3321,3095,182,0,48,2,1,1,2,3,0,1,6656,31,0
4300,충청북도,4301,청주시상당구,,금천동제1투,2427,1535,601,849,41,1,26,1,0,1,1,2,0,1,1524,11,892
4300,충청북도,4301,청주시상당구,,금천동제2투,1686,986,364,557,22,0,21,1,0,0,1,0,0,1,967,19,700
4300,충청북도,4301,청주시상당구,,금천동제3투,2844,1932,829,996,62,1,21,0,0,2,1,0,0,0,1912,20,912
4300,충청북도,4301,청주시상당구,,금천동제4투,2047,1184,515,601,28,0,20,0,0,0,3,2,0,2,1171,13,863
4300,충청북도,4301,청주시상당구,,금천동제5투,1916,1236,538,634,34,0,16,2,0,0,1,1,1,1,1228,8,680
4300,충청북도,4301,청주시상당구,,금천동제6투,2842,1744,839,794,60,1,19,1,0,0,2,5,0,1,1722,22,1098
4300,충청북도,4301,청주시상당구,,금천동제7투,2075,1391,687,631,38,0,9,1,0,0,0,1,0,2,1369,22,684
4300,충청북도,4301,청주시상당구,,금천동제8투,1978,1386,692,629,38,3,7,0,0,2,0,0,1,0,1372,14,592
4300,충청북도,4301,청주시상당구,영운동,소계,9111,6425,2684,3388,181,5,78,2,1,1,6,4,4,3,6357,68,2686
4300,충청북도,4301,청주시상당구,,관내사전투표,2923,2923,1336,1457,74,2,27,0,1,0,3,3,4,1,2908,15,0
4300,충청북도,4301,청주시상당구,,영운동제1투,1863,995,345,593,27,2,13,0,0,0,1,0,0,0,981,14,868
4300,충청북도,4301,청주시상당구,,영운동제2투,2416,1390,577,723,41,1,21,1,0,0,1,1,0,2,1368,22,1026
4300,충청북도,4301,청주시상당구,,영운동제3투,1909,1117,426,615,39,0,17,1,0,1,1,0,0,0,1100,17,792
4300,충청북도,4301,청주시상당구,용암제1동,소계,38453,26945,13117,12404,802,25,272,7,5,11,21,19,3,5,26691,254,11508
4300,충청북도,4301,청주시상당구,,관내사전투표,7988,7987,4155,3515,203,6,46,4,2,2,2,5,2,1,7943,44,1
4300,충청북도,4301,청주시상당구,,용암제1동제1투,2299,1340,525,740,40,2,17,0,0,2,2,2,0,0,1330,10,959
4300,충청북도,4301,청주시상당구,,용암제1동제2투,1853,1049,431,548,36,2,15,0,1,1,2,3,0,0,1039,10,804
4300,충청북도,4301,청주시상당구,,용암제1동제3투,2050,1286,556,651,40,2,16,1,0,1,0,1,0,0,1268,18,764
4300,충청북도,4301,청주시상당구,,용암제1동제4투,1898,1082,489,516,33,2,18,0,0,1,0,0,1,1,1061,21,816
4300,충청북도,4301,청주시상당구,,용암제1동제5투,2588,1617,676,831,55,3,19,0,1,2,5,1,0,0,1593,24,971
4300,충청북도,4301,청주시상당구,,용암제1동제6투,3077,1863,891,858,61,1,29,1,1,1,2,3,0,1,1849,14,1214
4300,충청북도,4301,청주시상당구,,용암제1동제7투,2517,1526,717,716,48,1,25,0,0,0,2,0,0,0,1509,17,991
4300,충청북도,4301,청주시상당구,,용암제1동제8투,2581,1267,609,585,32,1,20,0,0,0,2,1,0,0,1250,17,1314
4300,충청북도,4301,청주시상당구,,용암제1동제9투,3252,2106,991,1004,64,0,17,0,0,0,2,1,0,1,2080,26,1146
4300,충청북도,4301,청주시상당구,,용암제1동제10투,2552,1860,994,786,56,1,11,0,0,0,0,0,0,0,1848,12,692
4300,충청북도,4301,청주시상당구,,용암제1동제11투,3143,2165,1156,891,64,2,23,1,0,1,1,1,0,1,2141,24,978
4300,충청북도,4301,청주시상당구,,용암제1동제12투,2655,1797,927,763,70,2,16,0,0,0,1,1,0,0,1780,17,858
4300,충청북도,4301,청주시상당구,용암제2동,소계,28235,20620,10176,9307,695,3,197,11,1,4,4,22,7,15,20442,178,7615
4300,충청북도,4301,청주시상당구,,관내사전투표,6437,6437,3455,2699,190,1,44,4,0,1,1,8,1,6,6410,27,0
4300,충청북도,4301,청주시상당구,,용암제2동제1투,2003,1069,456,544,37,0,16,0,0,0,0,2,2,0,1057,12,934
4300,충청북도,4301,청주시상당구,,용암제2동제2투,2788,1807,776,912,63,1,15,2,0,0,1,2,2,3,1777,30,981
4300,충청북도,4301,청주시상당구,,용암제2동제3투,2736,1907,887,906,72,0,21,1,0,0,0,0,0,1,1888,19,829
4300,충청북도,4301,청주시상당구,,용암제2동제4투,2784,1624,788,715,68,0,29,0,1,2,1,1,0,1,1606,18,1160
4300,충청북도,4301,청주시상당구,,용암제2동제5투,2612,2017,971,944,77,0,11,0,0,0,0,1,0,1,2005,12,595
4300,충청북도,4301,청주시상당구,,용암제2동제6투,3018,2171,1064,1011,61,1,9,0,0,0,0,3,0,1,2150,21,847
4300,충청북도,4301,청주시상당구,,용암제2동제7투,2648,1609,747,750,53,0,26,2,0,1,0,3,1,2,1585,24,1039
4300,충청북도,4301,청주시상당구,,용암제2동제8투,3209,1979,1032,826,74,0,26,2,0,0,1,2,1,0,1964,15,1230
4300,충청북도,4301,청주시상당구,낭성면,소계,2079,1635,553,996,33,5,13,1,0,2,2,1,2,1,1609,26,444
4300,충청북도,4301,청주시상당구,,관내사전투표,968,968,380,539,18,3,9,1,0,1,1,0,2,0,954,14,0
4300,충청북도,4301,청주시상당구,,낭성면투표소,1111,667,173,457,15,2,4,0,0,1,1,1,0,1,655,12,444
4300,충청북도,4301,청주시상당구,미원면,소계,4198,3108,1069,1867,56,3,29,3,0,1,3,12,7,7,3057,51,1090
4300,충청북도,4301,청주시상당구,,관내사전투표,1716,1716,616,1019,29,0,9,1,0,0,0,6,4,4,1688,28,0
4300,충청북도,4301,청주시상당구,,미원면제1투,868,423,142,257,6,1,8,0,0,0,0,1,1,1,417,6,445
4300,충청북도,4301,청주시상당구,,미원면제2투,1105,599,205,346,13,2,10,0,0,1,2,5,0,0,584,15,506
4300,충청북도,4301,청주시상당구,,미원면제3투,509,370,106,245,8,0,2,2,0,0,1,0,2,2,368,2,139
4300,충청북도,4301,청주시상당구,가덕면,소계,3437,2583,941,1494,45,1,31,2,1,0,3,3,3,6,2530,53,854
4300,충청북도,4301,청주시상당구,,관내사전투표,1245,1245,506,690,17,0,5,1,1,0,0,1,0,4,1225,20,0
4300,충청북도,4301,청주시상당구,,가덕면제1투,923,564,159,362,13,0,14,0,0,0,1,0,0,1,550,14,359
4300,충청북도,4301,청주시상당구,,가덕면제2투,536,316,127,166,3,0,6,0,0,0,0,0,1,1,304,12,220
4300,충청북도,4301,청주시상당구,,가덕면제3투,733,458,149,276,12,1,6,1,0,0,2,2,2,0,451,7,275
4300,충청북도,4301,청주시상당구,남일면,소계,6188,4691,1941,2501,122,4,50,5,2,1,5,4,1,3,4639,52,1497
4300,충청북도,4301,청주시상당구,,관내사전투표,2527,2527,1180,1232,61,3,18,4,0,0,3,2,0,2,2505,22,0
4300,충청북도,4301,청주시상당구,,남일면제1투,1639,937,316,570,26,1,11,0,0,1,1,0,0,0,926,11,702
4300,충청북도,4301,청주시상당구,,남일면제2투,572,382,128,224,11,0,6,1,2,0,0,2,0,1,375,7,190
4300,충청북도,4301,청주시상당구,,남일면제3투,1450,845,317,475,24,0,15,0,0,0,1,0,1,0,833,12,605
4300,충청북도,4301,청주시상당구,문의면,소계,3400,2572,925,1497,57,4,30,2,0,0,7,3,5,2,2532,40,828
4300,충청북도,4301,청주시상당구,,관내사전투표,1370,1370,525,778,33,0,11,1,0,0,3,2,0,0,1353,17,0
4300,충청북도,4301,청주시상당구,,문의면제1투,1468,831,277,494,17,3,15,0,0,0,3,0,3,1,813,18,637
4300,충청북도,4301,청주시상당구,,문의면제2투,562,371,123,225,7,1,4,1,0,0,1,1,2,1,366,5,191
4300,충청북도,4301,청주시상당구,잘못 투입·구분된 투표지,,0,5,4,1,0,0,0,0,0,0,0,0,0,0,5,0,-5
4300,충청북도,4314,청주시서원구,합계,,165206,124726,56323,61745,3499,94,1240,54,34,24,66,123,41,64,123307,1419,40480
4300,충청북도,4314,청주시서원구,거소·선상투표,,451,427,136,197,9,2,17,2,1,1,0,1,2,3,371,56,24
4300,충청북도,4314,청주시서원구,관외사전투표,,15395,15391,7306,7133,475,15,205,6,8,3,7,22,5,8,15193,198,4
4300,충청북도,4314,청주시서원구,재외투표,,540,377,215,113,18,0,1,0,0,0,0,0,0,0,347,30,163
4300,충청북도,4314,청주시서원구,남이면,소계,7655,5645,2321,3081,132,4,48,4,4,0,1,6,4,4,5609,36,2010
4300,충청북도,4314,청주시서원구,,관내사전투표,1867,1867,822,983,34,4,9,1,2,0,0,1,1,2,1859,8,0
4300,충청북도,4314,청주시서원구,,남이면제1투,1783,980,320,608,22,0,14,0,0,0,1,1,1,1,968,12,803
4300,충청북도,4314,청주시서원구,,남이면제2투,845,536,181,326,15,0,7,0,0,0,0,1,2,1,533,3,309
4300,충청북도,4314,청주시서원구,,남이면제3투,1211,784,270,478,17,0,9,1,2,0,0,2,0,0,779,5,427
4300,충청북도,4314,청주시서원구,,남이면제4투,1949,1478,728,686,44,0,9,2,0,0,0,1,0,0,1470,8,471
4300,충청북도,4314,청주시서원구,현도면,소계,2645,1922,632,1192,36,2,22,1,0,2,4,1,4,5,1901,21,723
4300,충청북도,4314,청주시서원구,,관내사전투표,921,921,328,554,16,1,8,1,0,2,1,0,2,1,914,7,0
4300,충청북도,4314,청주시서원구,,현도면제1투,1047,647,211,404,13,0,7,0,0,0,2,1,1,0,639,8,400
4300,충청북도,4314,청주시서원구,,현도면제2투,677,354,93,234,7,1,7,0,0,0,1,0,1,4,348,6,323
4300,충청북도,4314,청주시서원구,사직제1동,소계,5325,3791,1478,2130,95,2,40,1,1,2,5,1,0,1,3756,35,1534
4300,충청북도,4314,청주시서원구,,관내사전투표,1411,1411,611,751,28,0,7,0,0,0,0,0,0,1,1398,13,0
4300,충청북도,4314,청주시서원구,,사직제1동제1투,598,243,71,155,6,1,5,0,0,0,3,0,0,0,241,2,355
4300,충청북도,4314,청주시서원구,,사직제1동제2투,1395,824,332,435,35,0,12,0,0,0,1,0,0,0,815,9,571
4300,충청북도,4314,청주시서원구,,사직제1동제3투,1921,1313,464,789,26,1,16,1,1,2,1,1,0,0,1302,11,608
4300,충청북도,4314,청주시서원구,사직제2동,소계,9445,7185,3023,3875,152,2,53,1,2,1,3,4,1,3,7120,65,2260
4300,충청북도,4314,청주시서원구,,관내사전투표,2097,2097,966,1063,38,0,11,0,1,0,1,2,0,1,2083,14,0
4300,충청북도,4314,청주시서원구,,사직제2동제1투,1071,675,246,393,9,1,12,0,0,0,0,1,0,2,664,11,396
4300,충청북도,4314,청주시서원구,,사직제2동제2투,1211,681,263,383,18,0,7,0,0,1,0,0,1,0,673,8,530
4300,충청북도,4314,청주시서원구,,사직제2동제3투,2666,1980,772,1136,41,0,12,1,0,0,1,1,0,0,1964,16,686
4300,충청북도,4314,청주시서원구,,사직제2동제4투,2400,1752,776,900,46,1,11,0,1,0,1,0,0,0,1736,16,648
4300,충청북도,4314,청주시서원구,사창동,소계,14546,10501,4237,5680,302,6,105,4,3,3,9,7,0,4,10360,141,4045
4300,충청북도,4314,청주시서원구,,관내사전투표,5559,5558,2455,2849,158,3,32,4,2,2,3,2,0,1,5511,47,1
4300,충청북도,4314,청주시서원구,,사창동제1투,2554,1252,442,697,43,1,29,0,0,0,1,2,0,0,1215,37,1302
4300,충청북도,4314,청주시서원구,,사창동제2투,2552,1499,563,837,55,0,22,0,1,1,3,1,0,1,1484,15,1053
4300,충청북도,4314,청주시서원구,,사창동제3투,2483,1443,491,881,29,2,15,0,0,0,1,1,0,0,1420,23,1040
4300,충청북도,4314,청주시서원구,,사창동제4투,1398,749,286,416,17,0,7,0,0,0,1,1,0,2,730,19,649
4300,충청북도,4314,청주시서원구,모충동,소계,12461,8555,3455,4616,234,7,97,3,2,2,4,9,4,2,8435,120,3906
4300,충청북도,4314,청주시서원구,,관내사전투표,2708,2708,1181,1386,80,4,20,1,1,0,0,1,2,2,2678,30,0
4300,충청북도,4314,청주시서원구,,모충동제1투,2406,1373,515,778,29,2,25,0,0,1,3,2,0,0,1355,18,1033
4300,충청북도,4314,청주시서원구,,모충동제2투,1312,734,237,448,25,0,9,1,0,1,0,1,0,0,722,12,578
4300,충청북도,4314,청주시서원구,,모충동제3투,2826,1724,739,886,53,0,21,0,0,0,0,3,2,0,1704,20,1102
4300,충청북도,4314,청주시서원구,,모충동제4투,2003,1175,416,703,15,1,15,0,0,0,1,1,0,0,1152,23,828
4300,충청북도,4314,청주시서원구,,모충동제5투,1206,841,367,415,32,0,7,1,1,0,0,1,0,0,824,17,365
4300,충청북도,4314,청주시서원구,산남동,소계,18486,13827,6831,6386,371,6,88,4,1,1,3,4,1,6,13702,125,4659
4300,충청북도,4314,청주시서원구,,관내사전투표,5365,5364,2979,2203,129,3,21,1,0,0,0,3,0,1,5340,24,1
4300,충청북도,4314,청주시서원구,,산남동제1투,2298,1308,520,722,37,0,6,1,0,0,0,0,0,3,1289,19,990
4300,충청북도,4314,청주시서원구,,산남동제2투,2334,1573,589,914,29,0,19,0,0,1,1,0,0,0,1553,20,761
4300,충청북도,4314,청주시서원구,,산남동제3투,3138,2068,1046,913,66,0,15,0,0,0,1,1,1,0,2043,25,1070
4300,충청북도,4314,청주시서원구,,산남동제4투,2782,1758,766,896,58,0,19,0,1,0,1,0,0,1,1742,16,1024
4300,충청북도,4314,청주시서원구,,산남동제5투,2569,1756,931,738,52,3,8,2,0,0,0,0,0,1,1735,21,813
4300,충청북도,4314,청주시서원구,분평동,소계,23089,17308,8446,7942,538,13,143,10,7,1,11,23,3,7,17144,164,5781
4300,충청북도,4314,청주시서원구,,관내사전투표,7782,7781,4131,3301,220,7,44,3,1,0,3,13,1,4,7728,53,1
4300,충청북도,4314,청주시서원구,,분평동제1투,749,482,190,268,11,0,7,0,0,0,1,0,0,0,477,5,267
4300,충청북도,4314,청주시서원구,,분평동제2투,2604,1593,705,793,58,1,14,1,1,0,2,1,0,2,1578,15,1011
4300,충청북도,4314,청주시서원구,,분평동제3투,2528,1526,677,754,46,2,22,3,0,1,1,1,0,0,1507,19,1002
4300,충청북도,4314,청주시서원구,,분평동제4투,2430,1531,722,704,55,1,18,0,1,0,2,2,2,0,1507,24,899
4300,충청북도,4314,청주시서원구,,분평동제5투,2262,1353,572,700,54,2,5,2,0,0,1,0,0,1,1337,16,909
4300,충청북도,4314,청주시서원구,,분평동제6투,2182,1400,615,703,47,0,19,1,2,0,0,0,0,0,1387,13,782
4300,충청북도,4314,청주시서원구,,분평동제7투,2552,1642,834,719,47,0,14,0,2,0,1,6,0,0,1623,19,910
4300,충청북도,4314,청주시서원구,수곡제1동,소계,11145,7780,3217,4109,218,9,111,3,1,1,2,11,7,6,7695,85,3365
4300,충청북도,4314,청주시서원구,,관내사전투표,3015,3015,1388,1493,71,6,33,3,0,1,0,4,1,2,3002,13,0
4300,충청북도,4314,청주시서원구,,수곡제1동제1투,2121,1254,479,663,44,0,27,0,0,0,2,2,2,3,1222,32,867
4300,충청북도,4314,청주시서원구,,수곡제1동제2투,2042,1188,491,617,40,2,16,0,1,0,0,2,2,0,1171,17,854
4300,충청북도,4314,청주시서원구,,수곡제1동제3투,2025,1169,432,673,32,1,14,0,0,0,0,2,0,1,1155,14,856
4300,충청북도,4314,청주시서원구,,수곡제1동제4투,1942,1154,427,663,31,0,21,0,0,0,0,1,2,0,1145,9,788
4300,충청북도,4314,청주시서원구,수곡제2동,소계,13078,9659,4168,4967,260,8,98,4,0,1,6,3,5,7,9527,132,3419
4300,충청북도,4314,청주시서원구,,관내사전투표,3766,3766,1741,1867,89,3,23,4,0,0,1,0,2,2,3732,34,0
4300,충청북도,4314,청주시서원구,,수곡제2동제1투,2030,1169,499,610,29,0,14,0,0,0,3,1,0,0,1156,13,861
4300,충청북도,4314,청주시서원구,,수곡제2동제2투,2140,1298,515,710,35,2,18,0,0,0,0,0,1,1,1282,16,842
4300,충청북도,4314,청주시서원구,,수곡제2동제3투,1872,1110,433,608,29,1,15,0,0,1,0,2,0,0,1089,21,762
4300,충청북도,4314,청주시서원구,,수곡제2동제4투,1671,1045,401,567,21,2,17,0,0,0,2,0,1,3,1014,31,626
4300,충청북도,4314,청주시서원구,,수곡제2동제5투,1599,1271,579,605,57,0,11,0,0,0,0,0,1,1,1254,17,328
4300,충청북도,4314,청주시서원구,성화·개신·죽림동,소계,30945,22356,10857,10323,659,18,212,11,4,6,11,31,5,8,22145,211,8589
4300,충청북도,4314,청주시서원구,,관내사전투표,6979,6979,3746,2982,143,7,41,4,1,0,1,10,1,4,6940,39,0
4300,충청북도,4314,청주시서원구,,성화·개신·죽림동제1투,3311,2025,978,909,64,3,32,1,0,1,0,2,1,2,1993,32,1286
4300,충청북도,4314,청주시서원구,,성화·개신·죽림동제2투,2204,1563,592,877,59,0,13,0,0,0,4,2,1,0,1548,15,641
4300,충청북도,4314,청주시서원구,,성화·개신·죽림동제3투,2498,1591,597,907,42,2,18,1,1,0,1,0,0,0,1569,22,907
4300,충청북도,4314,청주시서원구,,성화·개신·죽림동제4투,3086,2186,1089,973,80,4,13,0,0,2,1,3,0,1,2166,20,900
4300,충청북도,4314,청주시서원구,,성화·개신·죽림동제5투,2681,1721,801,800,65,1,20,1,0,0,3,3,1,1,1696,25,960
4300,충청북도,4314,청주시서원구,,성화·개신·죽림동제6투,1802,1210,600,525,43,0,18,1,1,2,0,2,0,0,1192,18,592
4300,충청북도,4314,청주시서원구,,성화·개신·죽림동제7투,1988,1131,550,520,38,0,14,0,0,0,1,3,0,0,1126,5,857
4300,충청북도,4314,청주시서원구,,성화·개신·죽림동제8투,2362,1424,662,684,47,0,14,0,0,0,0,2,1,0,1410,14,938
4300,충청북도,4314,청주시서원구,,성화·개신·죽림동제9투,2008,1056,526,476,25,0,15,2,1,0,0,3,0,0,1048,8,952
4300,충청북도,4314,청주시서원구,,성화·개신·죽림동제10투,2026,1470,716,670,53,1,14,1,0,1,0,1,0,0,1457,13,556
4300,충청북도,4314,청주시서원구,잘못 투입·구분된 투표지,,0,2,1,1,0,0,0,0,0,0,0,0,0,0,2,0,-2
4300,충청북도,4302,청주시흥덕구,합계,,223335,163683,76940,77952,4770,96,1745,41,28,33,94,140,59,63,161961,1722,59652
4300,충청북도,4302,청주시흥덕구,거소·선상투표,,428,385,145,164,9,2,14,2,1,0,0,0,1,1,339,46,43
4300,충청북도,4302,청주시흥덕구,관외사전투표,,19795,19795,9457,9170,591,13,262,6,4,5,8,21,15,14,19566,229,0
4300,충청북도,4302,청주시흥덕구,재외투표,,726,478,272,146,19,0,1,0,0,0,0,0,1,0,439,39,248
4300,충청북도,4302,청주시흥덕구,오송읍,소계,17082,12577,6375,5494,383,5,134,1,1,4,12,14,1,2,12426,151,4505
4300,충청북도,4302,청주시흥덕구,,관내사전투표,3925,3925,2207,1572,86,1,20,1,0,1,0,4,0,1,3893,32,0
4300,충청북도,4302,청주시흥덕구,,오송읍제1투,1131,630,250,350,15,0,6,0,0,1,1,2,0,0,625,5,501
4300,충청북도,4302,청주시흥덕구,,오송읍제2투,882,540,191,311,18,0,7,0,0,0,5,0,0,0,532,8,342
4300,충청북도,4302,청주시흥덕구,,오송읍제3투,2078,1287,551,654,45,0,17,0,0,2,0,2,1,0,1272,15,791
4300,충청북도,4302,청주시흥덕구,,오송읍제4투,2069,1421,813,506,52,1,23,0,0,0,3,4,0,1,1403,18,648
4300,충청북도,4302,청주시흥덕구,,오송읍제5투,2540,1780,887,798,45,1,20,0,1,0,2,1,0,0,1755,25,760
4300,충청북도,4302,청주시흥덕구,,오송읍제6투,2212,1595,845,636,68,2,10,0,0,0,1,0,0,0,1562,33,617
4300,충청북도,4302,청주시흥덕구,,오송읍제7투,2245,1399,631,667,54,0,31,0,0,0,0,1,0,0,1384,15,846
4300,충청북도,4302,청주시흥덕구,강내면,소계,9007,6837,3192,3331,181,4,55,0,2,0,7,5,2,3,6782,55,2170
4300,충청북도,4302,청주시흥덕구,,관내사전투표,3733,3733,1838,1750,92,1,22,0,1,0,3,4,1,0,3712,21,0
4300,충청북도,4302,청주시흥덕구,,강내면제1투,1840,1067,486,522,28,2,10,0,1,0,3,1,0,0,1053,14,773
4300,충청북도,4302,청주시흥덕구,,강내면제2투,1153,692,255,410,11,0,7,0,0,0,1,0,1,0,685,7,461
4300,충청북도,4302,청주시흥덕구,,강내면제3투,2281,1345,613,649,50,1,16,0,0,0,0,0,0,3,1332,13,936
4300,충청북도,4302,청주시흥덕구,옥산면,소계,13794,9987,4849,4612,283,5,118,4,5,4,3,8,4,5,9900,87,3807
4300,충청북도,4302,청주시흥덕구,,관내사전투표,3830,3830,1944,1736,92,2,25,1,2,0,0,2,2,1,3807,23,0
4300,충청북도,4302,청주시흥덕구,,옥산면제1투,1403,786,309,444,13,0,10,0,1,0,0,0,0,0,777,9,617
4300,충청북도,4302,청주시흥덕구,,옥산면제2투,2931,1551,649,786,51,2,31,2,1,2,2,2,1,2,1531,20,1380
4300,충청북도,4302,청주시흥덕구,,옥산면제3투,2086,1406,725,580,58,1,23,1,1,1,1,1,0,0,1392,14,680
4300,충청북도,4302,청주시흥덕구,,옥산면제4투,3544,2414,1222,1066,69,0,29,0,0,1,0,3,1,2,2393,21,1130
4300,충청북도,4302,청주시흥덕구,운천·신봉동,소계,13289,9220,4076,4687,244,8,87,4,0,0,4,12,0,2,9124,96,4069
4300,충청북도,4302,청주시흥덕구,,관내사전투표,2782,2782,1372,1316,64,2,14,1,0,0,0,2,0,0,2771,11,0
4300,충청북도,4302,청주시흥덕구,,운천·신봉동제1투,1758,1023,367,594,32,1,14,0,0,0,1,3,0,0,1012,11,735
4300,충청북도,4302,청주시흥덕구,,운천·신봉동제2투,2511,1552,696,782,33,1,11,0,0,0,1,4,0,0,1528,24,959
4300,충청북도,4302,청주시흥덕구,,운천·신봉동제3투,2515,1567,643,823,51,1,25,1,0,0,0,3,0,1,1548,19,948
4300,충청북도,4302,청주시흥덕구,,운천·신봉동제4투,1200,687,281,367,16,2,8,0,0,0,2,0,0,0,676,11,513
4300,충청북도,4302,청주시흥덕구,,운천·신봉동제5투,2523,1609,717,805,48,1,15,2,0,0,0,0,0,1,1589,20,914
4300,충청북도,4302,청주시흥덕구,복대제1동,소계,36581,26135,12557,12271,755,11,234,4,3,3,7,21,8,10,25884,251,10446
4300,충청북도,4302,청주시흥덕구,,관내사전투표,8129,8129,4287,3520,201,3,48,2,1,0,3,7,1,2,8075,54,0
4300,충청북도,4302,청주시흥덕구,,복대제1동제1투,2446,1318,636,582,59,0,14,0,0,0,0,1,1,1,1294,24,1128
4300,충청북도,4302,청주시흥덕구,,복대제1동제2투,2208,1458,702,667,47,1,23,0,1,1,0,2,1,0,1445,13,750
4300,충청북도,4302,청주시흥덕구,,복대제1동제3투,2843,1626,719,798,60,1,21,0,0,0,0,1,2,1,1603,23,1217
4300,충청북도,4302,청주시흥덕구,,복대제1동제4투,1290,707,241,415,15,0,18,0,0,1,0,2,2,1,695,12,583
4300,충청북도,4302,청주시흥덕구,,복대제1동제5투,1318,582,219,329,15,0,11,0,0,0,1,0,0,0,575,7,736
4300,충청북도,4302,청주시흥덕구,,복대제1동제6투,2818,1446,666,684,44,2,23,0,0,0,0,1,0,0,1420,26,1372
4300,충청북도,4302,청주시흥덕구,,복대제1동제7투,2469,1589,857,647,50,1,14,0,0,0,0,1,0,2,1572,17,880
4300,충청북도,4302,청주시흥덕구,,복대제1동제8투,2437,1719,804,822,54,1,16,1,0,0,1,2,1,0,1702,17,718
4300,충청북도,4302,청주시흥덕구,,복대제1동제9투,2734,1766,905,755,68,1,15,0,1,1,1,1,0,3,1751,15,968
4300,충청북도,4302,청주시흥덕구,,복대제1동제10투,3614,2692,1011,1583,61,1,16,1,0,0,0,1,0,0,2674,18,922
4300,충청북도,4302,청주시흥덕구,,복대제1동제11투,3030,2302,1167,1051,54,0,11,0,0,0,1,1,0,0,2285,17,728
4300,충청북도,4302,청주시흥덕구,,복대제1동제12투,1245,801,343,418,27,0,4,0,0,0,0,1,0,0,793,8,444
4300,충청북도,4302,청주시흥덕구,복대제2동,소계,13414,8923,3724,4724,223,10,101,3,2,3,6,12,2,7,8817,106,4491
4300,충청북도,4302,청주시흥덕구,,관내사전투표,3317,3317,1516,1667,64,2,31,3,0,0,1,3,0,0,3287,30,0
4300,충청북도,4302,청주시흥덕구,,복대제2동제1투,2226,1339,542,706,55,2,12,0,0,1,0,1,1,1,1321,18,887
4300,충청북도,4302,청주시흥덕구,,복대제2동제2투,1633,894,348,507,18,1,8,0,0,0,2,0,0,1,885,9,739
4300,충청북도,4302,청주시흥덕구,,복대제2동제3투,2263,1244,479,686,29,2,21,0,1,0,1,4,1,2,1226,18,1019
4300,충청북도,4302,청주시흥덕구,,복대제2동제4투,2176,1179,433,672,32,1,15,0,1,1,2,2,0,1,1160,19,997
4300,충청북도,4302,청주시흥덕구,,복대제2동제5투,1799,950,406,486,25,2,14,0,0,1,0,2,0,2,938,12,849
4300,충청북도,4302,청주시흥덕구,가경동,소계,39293,28306,13278,13585,851,13,248,6,4,3,30,20,7,7,28052,254,10987
4300,충청북도,4302,청주시흥덕구,,관내사전투표,8199,8199,4186,3677,213,3,61,1,1,0,5,7,1,1,8156,43,0
4300,충청북도,4302,청주시흥덕구,,가경동제1투,1378,724,245,428,17,0,9,0,0,1,5,0,1,1,707,17,654
4300,충청북도,4302,청주시흥덕구,,가경동제2투,2127,1414,555,791,38,1,14,2,0,0,1,0,0,0,1402,12,713
4300,충청북도,4302,청주시흥덕구,,가경동제3투,2411,1430,579,768,42,0,18,0,1,1,3,1,1,0,1414,16,981
4300,충청북도,4302,청주시흥덕구,,가경동제4투,2707,1773,808,856,58,1,20,1,0,0,3,1,2,0,1750,23,934
4300,충청북도,4302,청주시흥덕구,,가경동제5투,2748,1660,702,871,49,0,22,0,1,1,1,3,0,1,1651,9,1088
4300,충청북도,4302,청주시흥덕구,,가경동제6투,2926,1911,901,877,91,1,17,0,0,0,0,3,0,0,1890,21,1015
4300,충청북도,4302,청주시흥덕구,,가경동제7투,2433,1519,675,768,41,1,14,0,0,0,2,1,0,0,1502,17,914
4300,충청북도,4302,청주시흥덕구,,가경동제8투,3461,2304,1116,1070,66,3,16,1,0,0,0,1,0,3,2276,28,1157
4300,충청북도,4302,청주시흥덕구,,가경동제9투,4210,2796,1360,1308,77,0,24,0,0,0,2,1,1,0,2773,23,1414
4300,충청북도,4302,청주시흥덕구,,가경동제10투,3344,2128,958,1052,67,3,18,1,1,0,7,0,0,0,2107,21,1216
4300,충청북도,4302,청주시흥덕구,,가경동제11투,3349,2448,1193,1119,92,0,15,0,0,0,1,2,1,1,2424,24,901
4300,충청북도,4302,청주시흥덕구,봉명제1동,소계,8403,5361,2352,2702,152,2,77,1,2,1,2,9,2,2,5304,57,3042
4300,충청북도,4302,청주시흥덕구,,관내사전투표,2342,2342,1151,1097,55,1,18,1,1,0,0,3,0,1,2328,14,0
4300,충청북도,4302,청주시흥덕구,,봉명제1동제1투,2299,1060,415,567,38,1,25,0,0,0,0,0,0,1,1047,13,1239
4300,충청북도,4302,청주시흥덕구,,봉명제1동제2투,2454,1306,533,688,40,0,21,0,1,1,1,2,1,0,1288,18,1148
4300,충청북도,4302,청주시흥덕구,,봉명제1동제3투,1308,653,253,350,19,0,13,0,0,0,1,4,1,0,641,12,655
4300,충청북도,4302,청주시흥덕구,봉명제2·송정동,소계,19018,12301,5546,6068,339,8,164,5,3,2,5,10,9,2,12161,140,6717
4300,충청북도,4302,청주시흥덕구,,관내사전투표,4630,4630,2242,2184,110,4,37,3,0,0,1,4,5,2,4592,38,0
4300,충청북도,4302,청주시흥덕구,,봉명제2·송정동제1투,2260,1180,424,679,30,0,28,0,0,0,2,0,0,0,1163,17,1080
4300,충청북도,4302,청주시흥덕구,,봉명제2·송정동제2투,1944,1039,400,562,37,0,17,0,2,0,0,2,1,0,1021,18,905
4300,충청북도,4302,청주시흥덕구,,봉명제2·송정동제3투,3029,1441,631,736,38,0,18,0,0,1,1,1,1,0,1427,14,1588
4300,충청북도,4302,청주시흥덕구,,봉명제2·송정동제4투,1784,1009,446,479,41,2,15,1,1,0,1,0,0,0,986,23,775
4300,충청북도,4302,청주시흥덕구,,봉명제2·송정동제5투,2333,1648,791,776,47,2,12,0,0,1,0,1,1,0,1631,17,685
4300,충청북도,4302,청주시흥덕구,,봉명제2·송정동제6투,3038,1354,612,652,36,0,37,1,0,0,0,2,1,0,1341,13,1684
4300,충청북도,4302,청주시흥덕구,강서제1동,소계,23262,16419,7696,7866,503,10,177,4,1,5,7,5,5,5,16284,135,6843
4300,충청북도,4302,청주시흥덕구,,관내사전투표,6361,6361,3245,2855,174,3,40,0,0,2,3,3,2,1,6328,33,0
4300,충청북도,4302,청주시흥덕구,,강서제1동제1투,4555,2332,992,1172,97,4,35,0,0,2,2,1,0,0,2305,27,2223
4300,충청북도,4302,청주시흥덕구,,강서제1동제2투,727,462,137,310,5,0,6,0,0,0,0,0,0,1,459,3,265
4300,충청북도,4302,청주시흥덕구,,강서제1동제3투,969,622,227,372,10,0,7,0,0,0,0,0,0,1,617,5,347
4300,충청북도,4302,청주시흥덕구,,강서제1동제4투,3193,2004,975,908,68,0,32,1,1,0,0,0,0,1,1986,18,1189
4300,충청북도,4302,청주시흥덕구,,강서제1동제5투,3614,2260,1045,1086,70,1,28,2,0,0,1,1,0,0,2234,26,1354
4300,충청북도,4302,청주시흥덕구,,강서제1동제6투,3843,2378,1075,1163,79,2,29,1,0,1,1,0,3,1,2355,23,1465
4300,충청북도,4302,청주시흥덕구,강서제2동,소계,9243,6959,3421,3132,237,5,73,1,0,3,3,3,2,3,6883,76,2284
4300,충청북도,4302,청주시흥덕구,,관내사전투표,2988,2988,1595,1245,95,2,25,1,0,0,0,1,0,2,2966,22,0
4300,충청북도,4302,청주시흥덕구,,강서제2동제1투,2068,1184,443,678,31,1,13,0,0,2,1,1,0,0,1170,14,884
4300,충청북도,4302,청주시흥덕구,,강서제2동제2투,2177,1338,627,619,51,1,17,0,0,1,1,1,1,1,1320,18,839
4300,충청북도,4302,청주시흥덕구,,강서제2동제3투,2010,1449,756,590,60,1,18,0,0,0,1,0,1,0,1427,22,561
4300,충청북도,4302,청주시흥덕구,잘못 투입·구분된 투표지,,0,0,0,0,0,0,0,0,0,0,0,0,0,0,0,0,0
4300,충청북도,4306,청주시청원구,합계,,159671,117836,56679,54855,3331,54,1283,35,20,31,94,123,56,70,116631,1205,41835
4300,충청북도,4306,청주시청원구,거소·선상투표,,344,301,119,126,8,3,7,0,0,0,1,0,0,0,264,37,43
4300,충청북도,4306,청주시청원구,관외사전투표,,14108,14102,6822,6465,411,6,194,3,4,6,5,20,3,13,13952,150,6
4300,충청북도,4306,청주시청원구,재외투표,,515,343,210,93,10,0,1,1,0,0,1,0,0,0,316,27,172
4300,충청북도,4306,청주시청원구,내수읍,소계,14911,10322,4850,4888,281,5,147,2,2,0,11,11,10,8,10215,107,4589
4300,충청북도,4306,청주시청원구,,관내사전투표,4120,4120,2040,1898,99,1,31,0,1,0,4,3,5,4,4086,34,0
4300,충청북도,4306,청주시청원구,,내수읍제1투,1604,867,447,363,29,0,18,0,0,0,2,0,0,0,859,8,737
4300,충청북도,4306,청주시청원구,,내수읍제2투,1133,688,257,397,12,2,8,0,0,0,2,1,0,1,680,8,445
4300,충청북도,4306,청주시청원구,,내수읍제3투,662,412,174,218,11,0,6,0,0,0,0,0,2,0,411,1,250
4300,충청북도,4306,청주시청원구,,내수읍제4투,2485,1475,710,656,46,1,29,1,1,0,2,4,1,0,1451,24,1010
4300,충청북도,4306,청주시청원구,,내수읍제5투,1585,967,410,504,21,0,18,0,0,0,1,2,1,1,958,9,618
4300,충청북도,4306,청주시청원구,,내수읍제6투,2354,1270,594,588,42,1,29,0,0,0,0,1,0,1,1256,14,1084
4300,충청북도,4306,청주시청원구,,내수읍제7투,968,523,218,264,21,0,8,1,0,0,0,0,1,1,514,9,445
4300,충청북도,4306,청주시청원구,오창읍,소계,47912,34132,18301,14145,980,7,334,5,4,5,17,24,10,12,33844,288,13780
4300,충청북도,4306,청주시청원구,,관내사전투표,7888,7888,4513,3079,168,0,46,2,1,4,4,6,3,3,7829,59,0
4300,충청북도,4306,청주시청원구,,오창읍제1투,1716,896,349,501,22,1,12,0,0,0,1,2,1,0,889,7,820
4300,충청북도,4306,청주시청원구,,오창읍제2투,1623,923,382,493,20,1,11,0,0,0,0,1,1,0,909,14,700
4300,충청북도,4306,청주시청원구,,오창읍제3투,761,469,159,290,10,0,3,0,0,0,0,1,0,0,463,6,292
4300,충청북도,4306,청주시청원구,,오창읍제4투,2659,1849,960,797,66,1,11,0,0,0,0,1,1,1,1838,11,810
4300,충청북도,4306,청주시청원구,,오창읍제5투,2148,1668,853,743,46,0,12,0,1,0,1,0,1,0,1657,11,480
4300,충청북도,4306,청주시청원구,,오창읍제6투,2254,1695,1015,596,50,0,13,0,0,0,1,0,0,2,1677,18,559
4300,충청북도,4306,청주시청원구,,오창읍제7투,2588,1948,1129,715,60,1,21,0,1,1,1,4,0,2,1935,13,640
4300,충청북도,4306,청주시청원구,,오창읍제8투,2307,1659,1006,578,50,0,14,0,0,0,0,0,0,0,1648,11,648
4300,충청북도,4306,청주시청원구,,오창읍제9투,2468,1858,1095,653,64,0,22,1,0,0,0,0,2,2,1839,19,610
4300,충청북도,4306,청주시청원구,,오창읍제10투,2542,1371,632,646,48,0,27,1,0,0,3,1,0,0,1358,13,1171
4300,충청북도,4306,청주시청원구,,오창읍제11투,2532,1274,547,629,45,1,29,0,0,0,0,3,0,0,1254,20,1258
4300,충청북도,4306,청주시청원구,,오창읍제12투,3172,1496,618,787,38,1,31,0,0,0,1,2,0,1,1479,17,1676
4300,충청북도,4306,청주시청원구,,오창읍제13투,2835,1722,981,662,47,0,22,0,0,0,1,1,0,0,1714,8,1113
4300,충청북도,4306,청주시청원구,,오창읍제14투,2041,1428,780,561,49,1,16,1,0,0,0,0,0,0,1408,20,613
4300,충청북도,4306,청주시청원구,,오창읍제15투,2713,1764,984,689,65,0,15,0,1,0,0,0,0,0,1754,10,949
4300,충청북도,4306,청주시청원구,,오창읍제16투,1978,1562,839,653,51,0,5,0,0,0,0,1,0,0,1549,13,416
4300,충청북도,4306,청주시청원구,,오창읍제17투,3687,2662,1459,1073,81,0,24,0,0,0,4,1,1,1,2644,18,1025
4300,충청북도,4306,청주시청원구,북이면,소계,3909,2821,1051,1618,49,3,29,2,1,2,5,12,4,5,2781,40,1088
4300,충청북도,4306,청주시청원구,,관내사전투표,1108,1108,494,550,22,1,13,1,0,2,3,7,2,2,1097,11,0
4300,충청북도,4306,청주시청원구,,북이면제1투,640,368,113,234,9,0,3,0,0,0,0,0,0,1,360,8,272
4300,충청북도,4306,청주시청원구,,북이면제2투,628,392,120,257,3,1,4,0,1,0,1,0,0,0,387,5,236
4300,충청북도,4306,청주시청원구,,북이면제3투,750,466,165,277,7,0,4,0,0,0,1,1,1,0,456,10,284
4300,충청북도,4306,청주시청원구,,북이면제4투,783,487,159,300,8,1,5,1,0,0,0,4,1,2,481,6,296
4300,충청북도,4306,청주시청원구,우암동,소계,10183,6903,2597,3938,157,6,82,1,1,1,14,10,8,4,6819,84,3280
4300,충청북도,4306,청주시청원구,,관내사전투표,2823,2823,1134,1571,57,4,28,1,0,1,1,4,4,1,2806,17,0
4300,충청북도,4306,청주시청원구,,우암동제1투,1651,816,279,473,20,0,20,0,1,0,3,1,2,0,799,17,835
4300,충청북도,4306,청주시청원구,,우암동제2투,1735,997,352,585,25,1,11,0,0,0,2,3,0,1,980,17,738
4300,충청북도,4306,청주시청원구,,우암동제3투,1694,959,304,602,23,1,7,0,0,0,7,0,1,0,945,14,735
4300,충청북도,4306,청주시청원구,,우암동제4투,2280,1308,528,707,32,0,16,0,0,0,1,2,1,2,1289,19,972
4300,충청북도,4306,청주시청원구,내덕제1동,소계,8604,6339,2614,3417,154,3,68,4,1,6,5,7,3,2,6284,55,2265
4300,충청북도,4306,청주시청원구,,관내사전투표,3470,3470,1629,1712,75,1,25,2,0,2,2,3,2,1,3454,16,0
4300,충청북도,4306,청주시청원구,,내덕제1동제1투,1689,853,284,515,15,0,19,1,1,1,3,1,0,1,841,12,836
4300,충청북도,4306,청주시청원구,,내덕제1동제2투,1759,996,330,595,39,2,12,0,0,2,0,3,1,0,984,12,763
4300,충청북도,4306,청주시청원구,,내덕제1동제3투,1686,1020,371,595,25,0,12,1,0,1,0,0,0,0,1005,15,666
4300,충청북도,4306,청주시청원구,내덕제2동,소계,10731,7746,3416,3928,209,6,74,1,2,2,8,7,6,3,7662,84,2985
4300,충청북도,4306,청주시청원구,,관내사전투표,3507,3507,1633,1723,94,3,21,1,1,0,1,3,2,1,3483,24,0
4300,충청북도,4306,청주시청원구,,내덕제2동제1투,1655,884,318,518,17,1,11,0,0,0,3,0,0,1,869,15,771
4300,충청북도,4306,청주시청원구,,내덕제2동제2투,2055,1118,455,596,24,1,14,0,0,2,1,2,1,0,1096,22,937
4300,충청북도,4306,청주시청원구,,내덕제2동제3투,3514,2237,1010,1091,74,1,28,0,1,0,3,2,3,1,2214,23,1277
4300,충청북도,4306,청주시청원구,율량·사천동,소계,35880,25561,12113,12033,800,10,262,11,5,8,22,25,9,19,25317,244,10319
4300,충청북도,4306,청주시청원구,,관내사전투표,7569,7569,3967,3288,212,2,36,2,1,2,4,7,4,2,7527,42,0
4300,충청북도,4306,청주시청원구,,율량·사천동제1투,2169,1345,601,652,45,0,16,1,0,0,3,0,0,4,1322,23,824
4300,충청북도,4306,청주시청원구,,율량·사천동제2투,2440,1298,554,645,41,2,28,0,1,3,3,1,0,0,1278,20,1142
4300,충청북도,4306,청주시청원구,,율량·사천동제3투,2713,1640,677,852,53,3,25,0,0,0,2,2,0,2,1616,24,1073
4300,충청북도,4306,청주시청원구,,율량·사천동제4투,1578,1146,484,598,36,0,6,0,0,0,3,0,0,0,1127,19,432
4300,충청북도,4306,청주시청원구,,율량·사천동제5투,2675,1603,732,765,53,1,24,0,0,0,2,2,0,3,1582,21,1072
4300,충청북도,4306,청주시청원구,,율량·사천동제6투,3201,2095,1025,964,63,0,20,3,0,0,3,0,0,1,2079,16,1106
4300,충청북도,4306,청주시청원구,,율량·사천동제7투,2342,1574,706,779,57,0,13,1,1,0,0,1,1,1,1560,14,768
4300,충청북도,4306,청주시청원구,,율량·사천동제8투,1752,1101,420,615,34,0,13,1,2,1,1,0,0,1,1088,13,651
4300,충청북도,4306,청주시청원구,,율량·사천동제9투,2153,1406,638,705,33,1,12,2,0,1,0,0,0,1,1393,13,747
4300,충청북도,4306,청주시청원구,,율량·사천동제10투,1849,1095,511,513,41,1,15,0,0,0,0,2,2,2,1087,8,754
4300,충청북도,4306,청주시청원구,,율량·사천동제11투,1970,1391,624,679,48,0,26,1,0,0,0,0,0,2,1380,11,579
4300,충청북도,4306,청주시청원구,,율량·사천동제12투,1688,1151,599,470,46,0,15,0,0,0,1,7,2,0,1140,11,537
4300,충청북도,4306,청주시청원구,,율량·사천동제13투,1781,1147,575,508,38,0,13,0,0,1,0,3,0,0,1138,9,634
4300,충청북도,4306,청주시청원구,오근장동,소계,12574,9263,4585,4202,272,5,85,5,0,1,5,7,3,4,9174,89,3311
4300,충청북도,4306,청주시청원구,,관내사전투표,2995,2995,1548,1330,76,1,13,2,0,0,0,1,3,3,2977,18,0
4300,충청북도,4306,청주시청원구,,오근장동제1투,1640,840,298,491,22,1,10,0,0,1,3,0,0,1,827,13,800
4300,충청북도,4306,청주시청원구,,오근장동제2투,2788,2034,1043,869,84,1,12,2,0,0,0,1,0,0,2012,22,754
4300,충청북도,4306,청주시청원구,,오근장동제3투,2939,1829,865,843,51,1,37,0,0,0,0,4,0,0,1801,28,1110
4300,충청북도,4306,청주시청원구,,오근장동제4투,2212,1565,831,669,39,1,13,1,0,0,2,1,0,0,1557,8,647
4300,충청북도,4306,청주시청원구,잘못 투입·구분된 투표지,,0,3,1,2,0,0,0,0,0,0,0,0,0,0,3,0,-3
4300,충청북도,4303,충주시,합계,,180976,135848,58801,70382,3270,75,1509,53,29,45,110,122,104,89,134589,1259,45128
4300,충청북도,4303,충주시,거소·선상투표,,457,426,163,165,13,1,15,1,2,1,3,2,3,2,371,55,31
4300,충청북도,4303,충주시,관외사전투표,,10562,10560,4752,5185,286,6,156,8,0,0,5,17,8,10,10433,127,2
4300,충청북도,4303,충주시,재외투표,,532,392,225,112,21,0,4,1,0,0,0,0,0,0,363,29,140
4300,충청북도,4303,충주시,주덕읍,소계,4461,3323,1274,1894,75,2,24,3,0,2,0,3,4,4,3285,38,1138
4300,충청북도,4303,충주시,,관내사전투표,1813,1813,735,1010,38,1,9,1,0,1,0,2,2,2,1801,12,0
4300,충청북도,4303,충주시,,주덕읍제1투,817,479,174,274,13,1,6,1,0,1,0,1,0,0,471,8,338
4300,충청북도,4303,충주시,,주덕읍제2투,995,528,200,302,12,0,5,0,0,0,0,0,0,0,519,9,467
4300,충청북도,4303,충주시,,주덕읍제3투,836,503,165,308,12,0,4,1,0,0,0,0,2,2,494,9,333
4300,충청북도,4303,충주시,살미면,소계,1951,1564,574,929,33,1,10,1,0,1,3,0,1,1,1554,10,387
4300,충청북도,4303,충주시,,관내사전투표,885,885,356,492,19,1,8,0,0,0,2,0,0,0,878,7,0
4300,충청북도,4303,충주시,,살미면투표소,1066,679,218,437,14,0,2,1,0,1,1,0,1,1,676,3,387
4300,충청북도,4303,충주시,수안보면,소계,2654,2071,704,1275,28,3,23,1,0,2,3,6,4,3,2052,19,583
4300,충청북도,4303,충주시,,관내사전투표,1086,1086,426,618,15,3,13,0,0,0,1,2,0,1,1079,7,0
4300,충청북도,4303,충주시,,수안보면제1투,1100,635,161,443,10,0,3,1,0,2,1,3,2,1,627,8,465
4300,충청북도,4303,충주시,,수안보면제2투,468,350,117,214,3,0,7,0,0,0,1,1,2,1,346,4,118
4300,충청북도,4303,충주시,대소원면,소계,7641,5236,2373,2585,101,7,90,1,2,1,9,3,9,3,5184,52,2405
4300,충청북도,4303,충주시,,관내사전투표,2606,2606,1310,1198,41,2,26,0,2,0,1,0,4,0,2584,22,0
4300,충청북도,4303,충주시,,대소원면제1투,3251,1577,728,737,37,4,48,0,0,0,6,1,0,2,1563,14,1674
4300,충청북도,4303,충주시,,대소원면제2투,1361,761,239,471,18,1,13,1,0,1,2,1,3,0,750,11,600
4300,충청북도,4303,충주시,,대소원면제3투,423,292,96,179,5,0,3,0,0,0,0,1,2,1,287,5,131
4300,충청북도,4303,충주시,신니면,소계,2725,2105,750,1250,51,3,20,1,0,0,2,1,2,0,2080,25,620
4300,충청북도,4303,충주시,,관내사전투표,1114,1114,426,647,20,2,6,0,0,0,1,1,1,0,1104,10,0
4300,충청북도,4303,충주시,,신니면제1투,858,490,137,319,15,0,9,0,0,0,1,0,0,0,481,9,368
4300,충청북도,4303,충주시,,신니면제2투,753,501,187,284,16,1,5,1,0,0,0,0,1,0,495,6,252
4300,충청북도,4303,충주시,노은면,소계,2097,1619,610,961,19,2,8,0,0,0,0,0,1,1,1602,17,478
4300,충청북도,4303,충주시,,관내사전투표,1065,1065,407,634,15,2,0,0,0,0,0,0,0,1,1059,6,0
4300,충청북도,4303,충주시,,노은면투표소,1032,554,203,327,4,0,8,0,0,0,0,0,1,0,543,11,478
4300,충청북도,4303,충주시,앙성면,소계,3455,2576,874,1616,42,1,17,0,1,2,2,2,0,3,2560,16,879
4300,충청북도,4303,충주시,,관내사전투표,1342,1342,492,810,24,1,7,0,0,1,0,1,0,1,1337,5,0
4300,충청북도,4303,충주시,,앙성면제1투,498,311,82,220,3,0,3,0,0,0,1,0,0,0,309,2,187
4300,충청북도,4303,충주시,,앙성면제2투,1194,679,226,425,10,0,7,0,0,1,1,0,0,1,671,8,515
4300,충청북도,4303,충주시,,앙성면제3투,421,244,74,161,5,0,0,0,1,0,0,1,0,1,243,1,177
4300,충청북도,4303,충주시,중앙탑면,소계,9429,6484,3142,3031,174,2,68,1,1,0,4,5,0,4,6432,52,2945
4300,충청북도,4303,충주시,,관내사전투표,2581,2581,1362,1145,50,0,14,0,0,0,1,0,0,0,2572,9,0
4300,충청북도,4303,충주시,,중앙탑면제1투,545,354,102,232,7,0,3,1,0,0,0,1,0,2,348,6,191
4300,충청북도,4303,충주시,,중앙탑면제2투,854,486,159,292,20,0,5,0,0,0,1,3,0,0,480,6,368
4300,충청북도,4303,충주시,,중앙탑면제3투,2708,1490,741,656,50,2,25,0,0,0,1,1,0,1,1477,13,1218
4300,충청북도,4303,충주시,,중앙탑면제4투,2741,1573,778,706,47,0,21,0,1,0,1,0,0,1,1555,18,1168
4300,충청북도,4303,충주시,금가면,소계,3300,2512,1019,1347,75,3,28,0,0,2,3,1,2,1,2481,31,788
4300,충청북도,4303,충주시,,관내사전투표,1419,1419,620,731,39,2,14,0,0,0,1,0,1,1,1409,10,0
4300,충청북도,4303,충주시,,금가면제1투,779,493,178,285,11,0,6,0,0,0,2,1,0,0,483,10,286
4300,충청북도,4303,충주시,,금가면제2투,1102,600,221,331,25,1,8,0,0,2,0,0,1,0,589,11,502
4300,충청북도,4303,충주시,동량면,소계,3141,2385,843,1427,50,2,20,3,0,0,1,9,4,5,2364,21,756
4300,충청북도,4303,충주시,,관내사전투표,1272,1272,509,708,24,2,7,3,0,0,0,5,1,2,1261,11,0
4300,충청북도,4303,충주시,,동량면제1투,776,456,131,303,8,0,8,0,0,0,1,2,1,0,454,2,320
4300,충청북도,4303,충주시,,동량면제2투,1093,657,203,416,18,0,5,0,0,0,0,2,2,3,649,8,436
4300,충청북도,4303,충주시,산척면,소계,2253,1840,643,1132,32,1,12,4,0,0,2,2,5,1,1834,6,413
4300,충청북도,4303,충주시,,관내사전투표,1135,1135,438,663,22,1,3,4,0,0,0,1,1,1,1134,1,0
4300,충청북도,4303,충주시,,산척면투표소,1118,705,205,469,10,0,9,0,0,0,2,1,4,0,700,5,413
4300,충청북도,4303,충주시,엄정면,소계,2867,2228,716,1403,34,2,34,2,1,1,2,1,6,4,2206,22,639
4300,충청북도,4303,충주시,,관내사전투표,1333,1333,462,826,17,2,13,0,0,0,0,0,3,2,1325,8,0
4300,충청북도,4303,충주시,,엄정면투표소,1534,895,254,577,17,0,21,2,1,1,2,1,3,2,881,14,639
4300,충청북도,4303,충주시,소태면,소계,1506,1185,418,733,14,0,4,0,0,0,1,2,2,0,1174,11,321
4300,충청북도,4303,충주시,,관내사전투표,531,531,202,310,9,0,3,0,0,0,0,2,0,0,526,5,0
4300,충청북도,4303,충주시,,소태면제1투,541,358,122,227,2,0,1,0,0,0,1,0,1,0,354,4,183
4300,충청북도,4303,충주시,,소태면제2투,434,296,94,196,3,0,0,0,0,0,0,0,1,0,294,2,138
4300,충청북도,4303,충주시,성내·충인동,소계,3119,2424,795,1547,32,1,26,1,1,0,2,2,2,1,2410,14,695
4300,충청북도,4303,충주시,,관내사전투표,1470,1470,517,906,21,1,13,1,1,0,1,0,2,1,1464,6,0
4300,충청북도,4303,충주시,,성내·충인동제1투,439,254,56,191,0,0,3,0,0,0,0,1,0,0,251,3,185
4300,충청북도,4303,충주시,,성내·충인동제2투,1210,700,222,450,11,0,10,0,0,0,1,1,0,0,695,5,510
4300,충청북도,4303,충주시,교현·안림동,소계,18105,13232,6031,6608,303,6,150,2,4,8,12,10,9,3,13146,86,4873
4300,충청북도,4303,충주시,,관내사전투표,5801,5801,2913,2708,111,3,35,2,0,3,1,0,2,1,5779,22,0
4300,충청북도,4303,충주시,,교현·안림동제1투,1249,762,263,446,21,0,15,0,1,2,3,0,2,0,753,9,487
4300,충청북도,4303,충주시,,교현·안림동제2투,1500,854,319,470,24,1,20,0,0,1,4,5,1,1,846,8,646
4300,충청북도,4303,충주시,,교현·안림동제3투,1834,1126,453,607,33,0,12,0,1,0,2,2,1,1,1112,14,708
4300,충청북도,4303,충주시,,교현·안림동제4투,1590,927,338,534,21,0,23,0,0,1,0,2,1,0,920,7,663
4300,충청북도,4303,충주시,,교현·안림동제5투,1912,1160,488,627,24,1,11,0,1,0,0,0,0,0,1152,8,752
4300,충청북도,4303,충주시,,교현·안림동제6투,2058,1156,452,640,27,0,18,0,1,1,2,1,2,0,1144,12,902
4300,충청북도,4303,충주시,,교현·안림동제7투,2161,1446,805,576,42,1,16,0,0,0,0,0,0,0,1440,6,715
4300,충청북도,4303,충주시,교현2동,소계,5935,4188,1679,2300,104,3,42,3,0,2,6,2,4,6,4151,37,1747
4300,충청북도,4303,충주시,,관내사전투표,1927,1927,876,968,48,3,12,3,0,1,2,1,0,2,1916,11,0
4300,충청북도,4303,충주시,,교현2동제1투,906,508,184,298,7,0,5,0,0,0,1,1,3,2,501,7,398
4300,충청북도,4303,충주시,,교현2동제2투,1374,693,234,420,22,0,10,0,0,0,0,0,0,1,687,6,681
4300,충청북도,4303,충주시,,교현2동제3투,1728,1060,385,614,27,0,15,0,0,1,3,0,1,1,1047,13,668
4300,충청북도,4303,충주시,용산동,소계,11008,7909,3775,3762,190,6,89,0,2,3,8,11,2,7,7855,54,3099
4300,충청북도,4303,충주시,,관내사전투표,3664,3664,1807,1707,80,2,32,0,2,1,1,5,1,2,3640,24,0
4300,충청북도,4303,충주시,,용산동제1투,1351,760,318,397,19,1,15,0,0,0,1,0,0,0,751,9,591
4300,충청북도,4303,충주시,,용산동제2투,1675,931,466,411,28,1,13,0,0,1,4,0,0,0,924,7,744
4300,충청북도,4303,충주시,,용산동제3투,1509,905,381,482,17,2,11,0,0,1,1,2,1,1,899,6,604
4300,충청북도,4303,충주시,,용산동제4투,2809,1649,803,765,46,0,18,0,0,0,1,4,0,4,1641,8,1160
4300,충청북도,4303,충주시,지현동,소계,4469,3371,1459,1733,82,0,47,1,0,2,3,6,3,2,3338,33,1098
4300,충청북도,4303,충주시,,관내사전투표,1726,1726,869,777,41,0,18,0,0,2,1,3,2,2,1715,11,0
4300,충청북도,4303,충주시,,지현동제1투,1091,627,241,351,20,0,11,1,0,0,0,0,0,0,624,3,464
4300,충청북도,4303,충주시,,지현동제2투,1652,1018,349,605,21,0,18,0,0,0,2,3,1,0,999,19,634
4300,충청북도,4303,충주시,문화동,소계,8539,6458,2339,3820,153,1,70,2,0,2,3,2,3,4,6399,59,2081
4300,충청북도,4303,충주시,,관내사전투표,2772,2771,1134,1527,62,0,26,0,0,0,1,1,1,2,2754,17,1
4300,충청북도,4303,충주시,,문화동제1투,1358,778,271,483,9,0,9,0,0,0,0,0,1,0,773,5,580
4300,충청북도,4303,충주시,,문화동제2투,1539,1134,363,719,27,1,9,0,0,1,1,0,0,0,1121,13,405
4300,충청북도,4303,충주시,,문화동제3투,1362,855,259,543,24,0,10,2,0,1,0,0,0,1,840,15,507
4300,충청북도,4303,충주시,,문화동제4투,1508,920,312,548,31,0,16,0,0,0,1,1,1,1,911,9,588
4300,충청북도,4303,충주시,호암·직동,소계,14132,10487,5353,4566,338,6,113,4,4,2,5,5,2,2,10400,87,3645
4300,충청북도,4303,충주시,,관내사전투표,5014,5014,2737,2050,138,4,34,3,3,2,1,0,1,2,4975,39,0
4300,충청북도,4303,충주시,,호암·직동제1투,2501,1419,677,658,42,1,22,0,0,0,1,3,0,0,1404,15,1082
4300,충청북도,4303,충주시,,호암·직동제2투,1608,900,370,471,31,1,16,0,0,0,2,1,1,0,893,7,708
4300,충청북도,4303,충주시,,호암·직동제3투,2273,1353,675,593,53,0,22,1,1,0,1,1,0,0,1347,6,920
4300,충청북도,4303,충주시,,호암·직동제4투,2736,1801,894,794,74,0,19,0,0,0,0,0,0,0,1781,20,935
4300,충청북도,4303,충주시,달천동,소계,3406,2477,949,1421,43,2,18,3,1,2,2,2,1,0,2444,33,929
4300,충청북도,4303,충주시,,관내사전투표,1329,1329,547,730,23,2,5,1,1,0,1,1,1,0,1312,17,0
4300,충청북도,4303,충주시,,달천동제1투,1445,771,269,469,12,0,7,2,0,2,1,1,0,0,763,8,674
4300,충청북도,4303,충주시,,달천동제2투,632,377,133,222,8,0,6,0,0,0,0,0,0,0,369,8,255
4300,충청북도,4303,충주시,봉방동,소계,8237,6198,2603,3320,141,1,63,3,2,1,6,5,6,2,6153,45,2039
4300,충청북도,4303,충주시,,관내사전투표,3475,3475,1576,1774,68,1,24,2,2,0,1,3,4,1,3456,19,0
4300,충청북도,4303,충주시,,봉방동제1투,1152,675,244,398,8,0,12,0,0,1,1,1,1,0,666,9,477
4300,충청북도,4303,충주시,,봉방동제2투,1873,1092,422,604,42,0,12,0,0,0,1,0,1,1,1083,9,781
4300,충청북도,4303,충주시,,봉방동제3투,1737,956,361,544,23,0,15,1,0,0,3,1,0,0,948,8,781
4300,충청북도,4303,충주시,칠금·금릉동,소계,12119,9181,4213,4518,246,0,101,2,3,2,9,6,6,4,9110,71,2938
4300,충청북도,4303,충주시,,관내사전투표,4223,4223,2140,1918,107,0,28,0,1,0,1,2,2,1,4200,23,0
4300,충청북도,4303,충주시,,칠금·금릉동제1투,721,474,177,277,10,0,5,0,0,0,2,0,1,0,472,2,247
4300,충청북도,4303,충주시,,칠금·금릉동제2투,1258,773,316,412,17,0,15,0,1,2,1,0,1,1,766,7,485
4300,충청북도,4303,충주시,,칠금·금릉동제3투,1748,1008,411,535,31,0,12,2,1,0,3,1,0,1,997,11,740
4300,충청북도,4303,충주시,,칠금·금릉동제4투,1923,1173,518,580,30,0,25,0,0,0,1,0,0,0,1154,19,750
4300,충청북도,4303,충주시,,칠금·금릉동제5투,2246,1530,651,796,51,0,16,0,0,0,1,3,2,1,1521,9,716
4300,충청북도,4303,충주시,연수동,소계,27597,19467,8626,9893,483,11,202,4,5,9,12,14,9,14,19282,185,8130
4300,충청북도,4303,충주시,,관내사전투표,7226,7226,3451,3499,152,2,53,2,1,1,3,7,4,5,7180,46,0
4300,충청북도,4303,충주시,,연수동제1투,1735,929,354,525,22,1,11,0,0,3,1,0,0,1,918,11,806
4300,충청북도,4303,충주시,,연수동제2투,2563,1530,686,757,44,0,22,0,1,0,1,3,1,4,1519,11,1033
4300,충청북도,4303,충주시,,연수동제3투,2269,1546,645,832,53,1,6,0,0,1,1,0,0,0,1539,7,723
4300,충청북도,4303,충주시,,연수동제4투,1571,1008,432,525,22,1,12,0,0,0,2,0,0,1,995,13,563
4300,충청북도,4303,충주시,,연수동제5투,1497,872,356,469,20,0,17,0,0,0,2,0,1,1,866,6,625
4300,충청북도,4303,충주시,,연수동제6투,1376,678,237,393,15,1,11,0,1,0,1,0,2,1,662,16,698
4300,충청북도,4303,충주시,,연수동제7투,1731,1099,533,500,40,2,8,1,2,0,0,1,0,0,1087,12,632
4300,충청북도,4303,충주시,,연수동제8투,1788,1060,445,566,13,1,18,0,0,0,0,1,0,0,1044,16,728
4300,충청북도,4303,충주시,,연수동제9투,2409,1294,550,656,32,1,22,1,0,2,0,1,1,1,1267,27,1115
4300,충청북도,4303,충주시,,연수동제10투,1593,1068,460,554,31,0,11,0,0,0,0,1,0,0,1057,11,525
4300,충청북도,4303,충주시,,연수동제11투,1839,1157,477,617,39,1,11,0,0,2,1,0,0,0,1148,9,682
4300,충청북도,4303,충주시,목행·용탄동,소계,5279,3949,1899,1848,107,2,55,1,0,0,2,3,6,2,3925,24,1330
4300,충청북도,4303,충주시,,관내사전투표,2018,2018,1054,878,49,0,22,1,0,0,0,2,2,0,2008,10,0
4300,충청북도,4303,충주시,,목행·용탄동제1투,1655,988,492,441,37,2,9,0,0,0,1,0,1,1,984,4,667
4300,충청북도,4303,충주시,,목행·용탄동제2투,1606,943,353,529,21,0,24,0,0,0,1,1,3,1,933,10,663
4300,충청북도,4303,충주시,잘못 투입·구분된 투표지,,0,1,0,1,0,0,0,0,0,0,0,0,0,0,1,0,-1
4300,충청북도,4304,제천시,합계,,114317,87091,36442,46482,1922,44,1000,28,14,15,93,97,83,74,86294,797,27226
4300,충청북도,4304,제천시,거소·선상투표,,211,197,75,89,1,1,4,1,0,0,1,0,1,0,173,24,14
4300,충청북도,4304,제천시,관외사전투표,,7103,7103,3188,3472,211,7,109,4,2,0,2,9,2,11,7017,86,0
4300,충청북도,4304,제천시,재외투표,,302,222,137,54,7,0,2,0,0,0,0,1,1,0,202,20,80
4300,충청북도,4304,제천시,봉양읍,소계,5651,4273,1655,2406,90,5,33,2,0,1,2,11,9,10,4224,49,1378
4300,충청북도,4304,제천시,,관내사전투표,2092,2092,886,1113,35,4,17,1,0,1,2,4,1,5,2069,23,0
4300,충청북도,4304,제천시,,봉양읍제1투,1883,1007,331,618,26,0,7,0,0,0,0,3,5,2,992,15,876
4300,충청북도,4304,제천시,,봉양읍제2투,1103,761,313,412,21,0,7,1,0,0,0,0,0,0,754,7,342
4300,충청북도,4304,제천시,,봉양읍제3투,573,413,125,263,8,1,2,0,0,0,0,4,3,3,409,4,160
4300,충청북도,4304,제천시,금성면,소계,1786,1404,523,813,20,1,17,1,0,0,1,5,2,1,1384,20,382
4300,충청북도,4304,제천시,,관내사전투표,722,722,269,421,12,0,8,1,0,0,0,2,2,1,716,6,0
4300,충청북도,4304,제천시,,금성면제1투,489,296,111,162,3,0,8,0,0,0,1,2,0,0,287,9,193
4300,충청북도,4304,제천시,,금성면제2투,575,386,143,230,5,1,1,0,0,0,0,1,0,0,381,5,189
4300,충청북도,4304,제천시,청풍면,소계,1144,942,306,596,14,0,10,0,0,0,2,1,2,1,932,10,202
4300,충청북도,4304,제천시,,관내사전투표,496,496,197,280,9,0,7,0,0,0,0,0,0,0,493,3,0
4300,충청북도,4304,제천시,,청풍면제1투,502,328,81,234,3,0,2,0,0,0,2,0,1,0,323,5,174
4300,충청북도,4304,제천시,,청풍면제2투,146,118,28,82,2,0,1,0,0,0,0,1,1,1,116,2,28
4300,충청북도,4304,제천시,수산면,소계,1777,1381,473,855,22,0,9,0,0,1,2,3,0,1,1366,15,396
4300,충청북도,4304,제천시,,관내사전투표,746,746,280,437,14,0,6,0,0,1,0,1,0,0,739,7,0
4300,충청북도,4304,제천시,,수산면제1투,806,478,142,316,7,0,3,0,0,0,2,1,0,1,472,6,328
4300,충청북도,4304,제천시,,수산면제2투,225,157,51,102,1,0,0,0,0,0,0,1,0,0,155,2,68
4300,충청북도,4304,제천시,덕산면,소계,1815,1452,573,805,27,2,10,0,2,1,3,1,5,3,1432,20,363
4300,충청북도,4304,제천시,,관내사전투표,805,805,369,396,15,2,5,0,1,1,0,1,4,1,795,10,0
4300,충청북도,4304,제천시,,덕산면제1투,718,447,150,274,8,0,4,0,1,0,3,0,1,0,441,6,271
4300,충청북도,4304,제천시,,덕산면제2투,292,200,54,135,4,0,1,0,0,0,0,0,0,2,196,4,92
4300,충청북도,4304,제천시,한수면,소계,566,431,143,273,9,0,1,1,0,0,0,1,0,0,428,3,135
4300,충청북도,4304,제천시,,관내사전투표,204,204,76,119,5,0,1,0,0,0,0,1,0,0,202,2,0
4300,충청북도,4304,제천시,,한수면투표소,362,227,67,154,4,0,0,1,0,0,0,0,0,0,226,1,135
4300,충청북도,4304,제천시,백운면,소계,2906,2256,791,1356,50,1,18,2,0,1,2,3,3,2,2229,27,650
4300,충청북도,4304,제천시,,관내사전투표,1138,1138,433,648,30,0,7,2,0,0,1,3,1,1,1126,12,0
4300,충청북도,4304,제천시,,백운면제1투,1121,675,247,394,12,1,8,0,0,1,1,0,2,1,667,8,446
4300,충청북도,4304,제천시,,백운면제2투,647,443,111,314,8,0,3,0,0,0,0,0,0,0,436,7,204
4300,충청북도,4304,제천시,송학면,소계,4081,3111,1101,1876,48,1,36,0,2,2,2,7,3,1,3079,32,970
4300,충청북도,4304,제천시,,관내사전투표,1488,1488,589,848,28,1,12,0,0,0,1,2,1,0,1482,6,0
4300,충청북도,4304,제천시,,송학면제1투,1470,874,283,546,13,0,13,0,1,0,1,3,0,0,860,14,596
4300,충청북도,4304,제천시,,송학면제2투,815,532,165,343,6,0,9,0,1,0,0,2,2,0,528,4,283
4300,충청북도,4304,제천시,,송학면제3투,308,217,64,139,1,0,2,0,0,2,0,0,0,1,209,8,91
4300,충청북도,4304,제천시,교동,소계,13214,9554,4438,4681,219,4,106,1,1,0,10,7,10,8,9485,69,3660
4300,충청북도,4304,제천시,,관내사전투표,3871,3871,1990,1747,85,3,23,0,0,0,1,2,3,1,3855,16,0
4300,충청북도,4304,제천시,,교동제1투,1405,883,305,544,8,1,11,0,1,0,1,3,1,0,875,8,522
4300,충청북도,4304,제천시,,교동제2투,2924,1697,757,835,45,0,31,0,0,0,4,1,2,3,1678,19,1227
4300,충청북도,4304,제천시,,교동제3투,2844,1763,813,854,50,0,23,1,0,0,1,1,3,3,1749,14,1081
4300,충청북도,4304,제천시,,교동제4투,2170,1340,573,701,31,0,18,0,0,0,3,0,1,1,1328,12,830
4300,충청북도,4304,제천시,남현동,소계,4384,3264,1202,1920,60,0,40,0,0,1,7,3,6,2,3241,23,1120
4300,충청북도,4304,제천시,,관내사전투표,1724,1724,659,1007,28,0,15,0,0,0,0,2,3,1,1715,9,0
4300,충청북도,4304,제천시,,남현동제1투,996,590,202,363,8,0,6,0,0,1,1,1,3,1,586,4,406
4300,충청북도,4304,제천시,,남현동제2투,1664,950,341,550,24,0,19,0,0,0,6,0,0,0,940,10,714
4300,충청북도,4304,제천시,영서동,소계,8327,6174,2637,3240,140,2,76,1,0,0,23,5,3,3,6130,44,2153
4300,충청북도,4304,제천시,,관내사전투표,3032,3032,1384,1527,65,2,26,0,0,0,4,3,0,2,3013,19,0
4300,충청북도,4304,제천시,,영서동제1투,1008,567,173,363,9,0,11,0,0,0,2,1,1,0,560,7,441
4300,충청북도,4304,제천시,,영서동제2투,2363,1331,491,769,34,0,20,1,0,0,1,1,1,1,1319,12,1032
4300,충청북도,4304,제천시,,영서동제3투,1924,1244,589,581,32,0,19,0,0,0,16,0,1,0,1238,6,680
4300,충청북도,4304,제천시,용두동,소계,13819,10116,4607,5065,209,3,117,5,1,2,6,7,9,5,10036,80,3703
4300,충청북도,4304,제천시,,관내사전투표,4729,4729,2333,2223,83,2,45,3,1,1,1,3,5,3,4703,26,0
4300,충청북도,4304,제천시,,용두동제1투,1689,996,399,547,27,0,12,0,0,0,0,0,0,0,985,11,693
4300,충청북도,4304,제천시,,용두동제2투,1897,1154,494,606,23,0,15,0,0,0,1,1,0,0,1140,14,743
4300,충청북도,4304,제천시,,용두동제3투,1862,908,348,514,15,1,14,1,0,1,1,1,3,0,899,9,954
4300,충청북도,4304,제천시,,용두동제4투,2085,1405,591,750,41,0,13,1,0,0,0,1,1,1,1399,6,680
4300,충청북도,4304,제천시,,용두동제5투,1557,924,442,425,20,0,18,0,0,0,3,1,0,1,910,14,633
4300,충청북도,4304,제천시,신백동,소계,8994,6517,2822,3314,179,1,100,3,3,4,2,9,6,7,6450,67,2477
4300,충청북도,4304,제천시,,관내사전투표,2833,2833,1342,1333,72,1,34,3,1,4,0,2,2,5,2799,34,0
4300,충청북도,4304,제천시,,신백동제1투,1665,1027,470,487,35,0,22,0,0,0,2,2,1,0,1019,8,638
4300,충청북도,4304,제천시,,신백동제2투,1327,661,258,357,21,0,18,0,1,0,0,0,1,0,656,5,666
4300,충청북도,4304,제천시,,신백동제3투,1586,990,416,515,38,0,13,0,0,0,0,0,0,0,982,8,596
4300,충청북도,4304,제천시,,신백동제4투,1022,673,239,408,6,0,7,0,1,0,0,1,2,2,666,7,349
4300,충청북도,4304,제천시,,신백동제5투,561,333,97,214,7,0,6,0,0,0,0,4,0,0,328,5,228
4300,충청북도,4304,제천시,청전동,소계,12980,9606,3585,5613,190,4,117,2,2,0,9,9,6,3,9540,66,3374
4300,충청북도,4304,제천시,,관내사전투표,4395,4395,1834,2406,84,1,33,1,1,0,4,4,3,0,4371,24,0
4300,충청북도,4304,제천시,,청전동제1투,1540,936,321,564,21,1,20,0,0,0,1,1,0,1,930,6,604
4300,충청북도,4304,제천시,,청전동제2투,1389,895,316,540,15,0,12,0,0,0,0,0,1,0,884,11,494
4300,충청북도,4304,제천시,,청전동제3투,1059,666,204,428,17,0,11,0,0,0,0,1,0,2,663,3,393
4300,충청북도,4304,제천시,,청전동제4투,1732,841,263,533,17,1,15,0,0,0,1,2,1,0,833,8,891
4300,충청북도,4304,제천시,,청전동제5투,1642,1137,390,697,22,0,17,1,0,0,3,1,1,0,1132,5,505
4300,충청북도,4304,제천시,,청전동제6투,1223,736,257,445,14,1,9,0,1,0,0,0,0,0,727,9,487
4300,충청북도,4304,제천시,화산동,소계,11171,8092,3572,4167,181,3,88,1,0,1,11,7,8,8,8047,45,3079
4300,충청북도,4304,제천시,,관내사전투표,3077,3077,1445,1527,60,1,24,0,0,0,2,4,2,1,3066,11,0
4300,충청북도,4304,제천시,,화산동제1투,2149,1263,503,695,35,1,14,0,0,0,3,0,3,1,1255,8,886
4300,충청북도,4304,제천시,,화산동제2투,1935,1230,536,626,26,1,18,1,0,1,3,1,3,4,1220,10,705
4300,충청북도,4304,제천시,,화산동제3투,1284,749,210,495,23,0,9,0,0,0,2,0,0,2,741,8,535
4300,충청북도,4304,제천시,,화산동제4투,2726,1773,878,824,37,0,23,0,0,0,1,2,0,0,1765,8,953
4300,충청북도,4304,제천시,의림지동,소계,8665,6895,3175,3407,168,5,67,3,1,1,4,5,3,3,6842,53,1770
4300,충청북도,4304,제천시,,관내사전투표,3712,3712,1852,1720,84,4,24,2,1,0,0,1,2,0,3690,22,0
4300,충청북도,4304,제천시,,의림지동제1투,2434,1620,713,819,49,0,21,1,0,0,4,0,1,1,1609,11,814
4300,충청북도,4304,제천시,,의림지동제2투,858,550,217,298,17,1,9,0,0,0,0,0,0,1,543,7,308
4300,충청북도,4304,제천시,,의림지동제3투,1661,1013,393,570,18,0,13,0,0,1,0,4,0,1,1000,13,648
4300,충청북도,4304,제천시,중앙동,소계,5421,4101,1439,2480,77,4,40,1,0,0,4,3,4,5,4057,44,1320
4300,충청북도,4304,제천시,,관내사전투표,2295,2295,876,1335,45,0,16,0,0,0,0,1,2,4,2279,16,0
4300,충청북도,4304,제천시,,중앙동제1투,2009,1215,372,777,23,3,14,1,0,0,4,1,1,0,1196,19,794
4300,충청북도,4304,제천시,,중앙동제2투,1117,591,191,368,9,1,10,0,0,0,0,1,1,1,582,9,526
4300,충청북도,4304,제천시,잘못 투입·구분된 투표지,,0,0,0,0,0,0,0,0,0,0,0,0,0,0,0,0,0
4300,충청북도,4305,단양군,합계,,25748,20193,7271,11969,387,12,207,7,6,9,33,32,64,26,20023,170,5555
4300,충청북도,4305,단양군,거소·선상투표,,92,85,29,42,2,1,0,1,1,0,0,0,0,1,77,8,7
4300,충청북도,4305,단양군,관외사전투표,,2191,2191,908,1159,55,0,28,3,2,2,1,5,4,2,2169,22,0
4300,충청북도,4305,단양군,재외투표,,87,71,46,20,2,0,1,0,0,0,0,0,0,0,69,2,16
4300,충청북도,4305,단양군,단양읍,소계,8182,6168,2366,3541,129,4,44,1,1,3,8,8,15,9,6129,39,2014
4300,충청북도,4305,단양군,,관내사전투표,3074,3074,1369,1588,72,3,12,1,0,0,4,5,5,2,3061,13,0
4300,충청북도,4305,단양군,,단양읍제1투,1439,863,273,555,14,0,7,0,0,0,2,1,1,4,857,6,576
4300,충청북도,4305,단양군,,단양읍제2투,1165,730,202,509,10,0,2,0,0,2,0,0,0,1,726,4,435
4300,충청북도,4305,단양군,,단양읍제3투,2504,1501,522,889,33,1,23,0,1,1,2,2,9,2,1485,16,1003
4300,충청북도,4305,단양군,매포읍,소계,4428,3410,1275,1967,59,0,45,2,2,2,7,4,13,4,3380,30,1018
4300,충청북도,4305,단양군,,관내사전투표,1637,1637,659,919,20,0,15,0,1,0,2,2,5,1,1624,13,0
4300,충청북도,4305,단양군,,매포읍제1투,1565,995,352,590,17,0,16,2,1,1,4,0,4,2,989,6,570
4300,충청북도,4305,단양군,,매포읍제2투,668,394,135,231,11,0,9,0,0,0,0,2,1,0,389,5,274
4300,충청북도,4305,단양군,,매포읍제3투,558,384,129,227,11,0,5,0,0,1,1,0,3,1,378,6,174
4300,충청북도,4305,단양군,단성면,소계,1399,1057,353,659,20,2,11,0,0,0,1,0,3,0,1049,8,342
4300,충청북도,4305,단양군,,관내사전투표,585,585,218,339,16,2,4,0,0,0,0,0,0,0,579,6,0
4300,충청북도,4305,단양군,,단성면제1투,521,268,78,178,2,0,5,0,0,0,1,0,2,0,266,2,253
4300,충청북도,4305,단양군,,단성면제2투,293,204,57,142,2,0,2,0,0,0,0,0,1,0,204,0,89
4300,충청북도,4305,단양군,대강면,소계,2208,1702,497,1132,32,0,19,0,0,1,1,0,5,1,1688,14,506
4300,충청북도,4305,단양군,,관내사전투표,978,978,296,649,17,0,6,0,0,1,1,0,1,0,971,7,0
4300,충청북도,4305,단양군,,대강면제1투,832,452,134,295,7,0,10,0,0,0,0,0,2,1,449,3,380
4300,충청북도,4305,단양군,,대강면제2투,398,272,67,188,8,0,3,0,0,0,0,0,2,0,268,4,126
4300,충청북도,4305,단양군,가곡면,소계,1729,1363,480,821,22,0,13,0,0,0,3,6,1,3,1349,14,366
4300,충청북도,4305,단양군,,관내사전투표,772,772,298,441,14,0,6,0,0,0,0,5,0,2,766,6,0
4300,충청북도,4305,단양군,,가곡면투표소,957,591,182,380,8,0,7,0,0,0,3,1,1,1,583,8,366
4300,충청북도,4305,단양군,영춘면,소계,2691,2074,618,1362,25,1,18,0,0,1,6,5,17,3,2056,18,617
4300,충청북도,4305,단양군,,관내사전투표,867,867,296,536,12,0,4,0,0,0,1,4,10,0,863,4,0
4300,충청북도,4305,단양군,,영춘면제1투,1047,673,145,497,6,0,9,0,0,1,4,0,6,2,670,3,374
4300,충청북도,4305,단양군,,영춘면제2투,135,106,29,75,0,0,0,0,0,0,0,0,0,1,105,1,29
4300,충청북도,4305,단양군,,영춘면제3투,642,428,148,254,7,1,5,0,0,0,1,1,1,0,418,10,214
4300,충청북도,4305,단양군,어상천면,소계,1602,1208,436,708,23,2,21,0,0,0,3,1,3,1,1198,10,394
4300,충청북도,4305,단양군,,관내사전투표,619,619,242,354,10,1,5,0,0,0,1,0,2,0,615,4,0
4300,충청북도,4305,단양군,,어상천면투표소,983,589,194,354,13,1,16,0,0,0,2,1,1,1,583,6,394
4300,충청북도,4305,단양군,적성면,소계,1139,864,263,558,18,2,7,0,0,0,3,3,3,2,859,5,275
4300,충청북도,4305,단양군,,관내사전투표,287,287,95,180,8,1,3,0,0,0,0,0,0,0,287,0,0
4300,충청북도,4305,단양군,,적성면제1투,332,204,60,133,4,0,1,0,0,0,1,2,0,0,201,3,128
4300,충청북도,4305,단양군,,적성면제2투,520,373,108,245,6,1,3,0,0,0,2,1,3,2,371,2,147
4300,충청북도,4305,단양군,잘못 투입·구분된 투표지,,0,0,0,0,0,0,0,0,0,0,0,0,0,0,0,0,0
4300,충청북도,4307,영동군,합계,,41165,31795,12029,18238,664,11,347,20,4,14,26,49,33,24,31459,336,9370
4300,충청북도,4307,영동군,거소·선상투표,,97,93,37,47,2,0,2,0,0,0,0,0,0,0,88,5,4
4300,충청북도,4307,영동군,관외사전투표,,3733,3733,1577,1934,99,4,60,0,1,1,2,10,0,2,3690,43,0
4300,충청북도,4307,영동군,재외투표,,145,85,38,36,3,0,0,0,0,0,0,0,0,0,77,8,60
4300,충청북도,4307,영동군,영동읍,소계,14846,10728,4383,5820,230,2,113,14,1,4,11,16,8,5,10607,121,4118
4300,충청북도,4307,영동군,,관내사전투표,4835,4835,2130,2501,102,0,40,5,0,2,7,6,1,4,4798,37,0
4300,충청북도,4307,영동군,,영동읍제1투,1539,926,343,533,19,1,13,1,1,0,0,0,1,0,912,14,613
4300,충청북도,4307,영동군,,영동읍제2투,1607,956,327,583,19,0,7,1,0,1,1,1,1,0,941,15,651
4300,충청북도,4307,영동군,,영동읍제3투,951,587,208,353,6,0,7,4,0,0,0,1,0,0,579,8,364
4300,충청북도,4307,영동군,,영동읍제4투,2226,1289,508,714,28,0,16,2,0,0,0,3,1,0,1272,17,937
4300,충청북도,4307,영동군,,영동읍제5투,1852,1042,457,529,21,0,18,1,0,1,0,4,2,1,1034,8,810
4300,충청북도,4307,영동군,,영동읍제6투,1836,1093,410,607,35,1,12,0,0,0,3,1,2,0,1071,22,743
4300,충청북도,4307,영동군,용산면,소계,2952,2245,831,1314,45,1,27,1,1,1,1,2,4,4,2232,13,707
4300,충청북도,4307,영동군,,관내사전투표,1514,1514,593,868,30,1,11,0,0,1,0,0,2,1,1507,7,0
4300,충청북도,4307,영동군,,용산면투표소,1438,731,238,446,15,0,16,1,1,0,1,2,2,3,725,6,707
4300,충청북도,4307,영동군,황간면,소계,3524,2720,951,1646,56,0,38,1,0,0,3,4,1,1,2701,19,804
4300,충청북도,4307,영동군,,관내사전투표,1531,1531,568,905,37,0,9,1,0,0,0,3,1,0,1524,7,0
4300,충청북도,4307,영동군,,황간면제1투,1176,698,228,430,12,0,17,0,0,0,1,1,0,0,689,9,478
4300,충청북도,4307,영동군,,황간면제2투,817,491,155,311,7,0,12,0,0,0,2,0,0,1,488,3,326
4300,충청북도,4307,영동군,추풍령면,소계,1895,1469,425,983,21,0,15,1,0,1,2,1,4,2,1455,14,426
4300,충청북도,4307,영동군,,관내사전투표,758,758,230,503,7,0,6,1,0,1,0,1,2,1,752,6,0
4300,충청북도,4307,영동군,,추풍령면투표소,1137,711,195,480,14,0,9,0,0,0,2,0,2,1,703,8,426
4300,충청북도,4307,영동군,매곡면,소계,1590,1199,364,780,24,0,11,0,0,2,0,1,1,2,1185,14,391
4300,충청북도,4307,영동군,,관내사전투표,659,659,213,419,17,0,4,0,0,1,0,0,1,1,656,3,0
4300,충청북도,4307,영동군,,매곡면투표소,931,540,151,361,7,0,7,0,0,1,0,1,0,1,529,11,391
4300,충청북도,4307,영동군,상촌면,소계,1914,1494,493,944,24,0,14,0,0,1,0,1,1,2,1480,14,420
4300,충청북도,4307,영동군,,관내사전투표,889,889,329,528,14,0,7,0,0,0,0,1,1,1,881,8,0
4300,충청북도,4307,영동군,,상촌면투표소,1025,605,164,416,10,0,7,0,0,1,0,0,0,1,599,6,420
4300,충청북도,4307,영동군,양강면,소계,3068,2390,899,1378,48,1,26,1,0,0,1,8,2,2,2366,24,678
4300,충청북도,4307,영동군,,관내사전투표,1594,1594,647,882,33,1,12,1,0,0,0,5,1,1,1583,11,0
4300,충청북도,4307,영동군,,양강면투표소,1474,796,252,496,15,0,14,0,0,0,1,3,1,1,783,13,678
4300,충청북도,4307,영동군,용화면,소계,792,619,252,342,10,0,3,0,1,1,1,0,2,1,613,6,173
4300,충청북도,4307,영동군,,관내사전투표,381,381,159,208,6,0,2,0,1,1,1,0,1,1,380,1,0
4300,충청북도,4307,영동군,,용화면투표소,411,238,93,134,4,0,1,0,0,0,0,0,1,0,233,5,173
4300,충청북도,4307,영동군,학산면,소계,2342,1772,648,1054,35,1,13,0,0,0,1,2,2,2,1758,14,570
4300,충청북도,4307,영동군,,관내사전투표,1026,1026,416,573,21,1,6,0,0,0,0,1,2,0,1020,6,0
4300,충청북도,4307,영동군,,학산면투표소,1316,746,232,481,14,0,7,0,0,0,1,1,0,2,738,8,570
4300,충청북도,4307,영동군,양산면,소계,1623,1250,441,756,22,0,9,1,0,0,2,1,2,0,1234,16,373
4300,충청북도,4307,영동군,,관내사전투표,796,796,294,473,16,0,4,1,0,0,1,1,2,0,792,4,0
4300,충청북도,4307,영동군,,양산면투표소,827,454,147,283,6,0,5,0,0,0,1,0,0,0,442,12,373
4300,충청북도,4307,영동군,심천면,소계,2644,1998,690,1204,45,2,16,1,0,3,2,3,6,1,1973,25,646
4300,충청북도,4307,영동군,,관내사전투표,1102,1102,396,645,30,1,8,1,0,3,0,3,4,1,1092,10,0
4300,충청북도,4307,영동군,,심천면제1투,1195,658,235,386,14,1,8,0,0,0,2,0,2,0,648,10,537
4300,충청북도,4307,영동군,,심천면제2투,347,238,59,173,1,0,0,0,0,0,0,0,0,0,233,5,109
4300,충청북도,4307,영동군,잘못 투입·구분된 투표지,,0,0,0,0,0,0,0,0,0,0,0,0,0,0,0,0,0
4300,충청북도,4308,보은군,합계,,28971,22717,8757,12754,525,12,275,8,10,9,26,29,37,28,22470,247,6254
4300,충청북도,4308,보은군,거소·선상투표,,115,108,31,54,3,0,2,0,3,0,0,0,0,1,94,14,7
4300,충청북도,4308,보은군,관외사전투표,,2580,2580,1090,1325,88,2,36,0,0,0,2,5,2,1,2551,29,0
4300,충청북도,4308,보은군,재외투표,,91,65,36,24,0,0,0,0,0,0,0,0,0,0,60,5,26
4300,충청북도,4308,보은군,보은읍,소계,11182,8271,3317,4496,192,2,126,1,3,4,11,13,10,4,8179,92,2911
4300,충청북도,4308,보은군,,관내사전투표,4461,4461,1897,2352,97,2,49,1,3,3,3,6,9,3,4425,36,0
4300,충청북도,4308,보은군,,보은읍제1투,1069,575,204,335,16,0,16,0,0,0,0,0,0,0,571,4,494
4300,충청북도,4308,보은군,,보은읍제2투,732,429,131,269,7,0,5,0,0,0,2,2,1,0,417,12,303
4300,충청북도,4308,보은군,,보은읍제3투,1314,733,249,431,25,0,13,0,0,0,4,0,0,0,722,11,581
4300,충청북도,4308,보은군,,보은읍제4투,2186,1239,478,684,27,0,29,0,0,1,1,5,0,0,1225,14,947
4300,충청북도,4308,보은군,,보은읍제5투,1420,834,358,425,20,0,14,0,0,0,1,0,0,1,819,15,586
4300,충청북도,4308,보은군,속리산면,소계,1611,1295,481,767,22,0,10,1,1,0,0,3,1,1,1287,8,316
4300,충청북도,4308,보은군,,관내사전투표,808,808,333,448,14,0,3,0,0,0,0,2,1,1,802,6,0
4300,충청북도,4308,보은군,,속리산면투표소,803,487,148,319,8,0,7,1,1,0,0,1,0,0,485,2,316
4300,충청북도,4308,보은군,장안면,소계,1293,1014,420,537,26,1,14,1,0,0,2,0,3,4,1008,6,279
4300,충청북도,4308,보은군,,관내사전투표,651,651,265,347,18,1,9,1,0,0,1,0,3,2,647,4,0
4300,충청북도,4308,보은군,,장안면투표소,642,363,155,190,8,0,5,0,0,0,1,0,0,2,361,2,279
4300,충청북도,4308,보은군,마로면,소계,1927,1520,572,865,32,0,17,1,0,0,1,2,2,2,1494,26,407
4300,충청북도,4308,보은군,,관내사전투표,748,748,288,424,14,0,11,0,0,0,1,0,1,2,741,7,0
4300,충청북도,4308,보은군,,마로면제1투,735,471,172,275,10,0,1,0,0,0,0,0,1,0,459,12,264
4300,충청북도,4308,보은군,,마로면제2투,444,301,112,166,8,0,5,1,0,0,0,2,0,0,294,7,143
4300,충청북도,4308,보은군,탄부면,소계,1375,1039,369,613,26,2,6,0,1,0,1,2,7,3,1030,9,336
4300,충청북도,4308,보은군,,관내사전투표,578,578,223,324,13,2,4,0,1,0,0,0,5,2,574,4,0
4300,충청북도,4308,보은군,,탄부면투표소,797,461,146,289,13,0,2,0,0,0,1,2,2,1,456,5,336
4300,충청북도,4308,보은군,삼승면,소계,1924,1463,597,788,33,1,18,2,0,2,1,1,4,3,1450,13,461
4300,충청북도,4308,보은군,,관내사전투표,988,988,415,532,11,1,10,2,0,2,1,1,4,3,982,6,0
4300,충청북도,4308,보은군,,삼승면투표소,936,475,182,256,22,0,8,0,0,0,0,0,0,0,468,7,461
4300,충청북도,4308,보은군,수한면,소계,1998,1602,605,927,37,1,11,0,0,0,3,1,1,2,1588,14,396
4300,충청북도,4308,보은군,,관내사전투표,1147,1147,469,633,28,0,8,0,0,0,1,1,0,1,1141,6,0
4300,충청북도,4308,보은군,,수한면투표소,851,455,136,294,9,1,3,0,0,0,2,0,1,1,447,8,396
4300,충청북도,4308,보은군,회남면,소계,580,468,136,318,4,1,4,0,1,0,1,0,0,1,466,2,112
4300,충청북도,4308,보은군,,관내사전투표,270,270,71,192,3,0,2,0,0,0,0,0,0,1,269,1,0
4300,충청북도,4308,보은군,,회남면투표소,310,198,65,126,1,1,2,0,1,0,1,0,0,0,197,1,112
4300,충청북도,4308,보은군,회인면,소계,1456,1094,318,726,20,0,8,1,1,0,1,1,2,2,1080,14,362
4300,충청북도,4308,보은군,,관내사전투표,613,613,203,378,14,0,3,1,1,0,1,0,1,1,603,10,0
4300,충청북도,4308,보은군,,회인면투표소,843,481,115,348,6,0,5,0,0,0,0,1,1,1,477,4,362
4300,충청북도,4308,보은군,내북면,소계,1357,1025,384,586,23,2,12,1,0,1,3,1,4,3,1020,5,332
4300,충청북도,4308,보은군,,관내사전투표,555,555,237,293,14,1,5,1,0,0,0,1,0,1,553,2,0
4300,충청북도,4308,보은군,,내북면제1투,430,245,83,148,4,1,3,0,0,1,3,0,2,0,245,0,185
4300,충청북도,4308,보은군,,내북면제2투,372,225,64,145,5,0,4,0,0,0,0,0,2,2,222,3,147
4300,충청북도,4308,보은군,산외면,소계,1482,1173,401,728,19,0,11,0,0,2,0,0,1,1,1163,10,309
4300,충청북도,4308,보은군,,관내사전투표,640,640,219,401,15,0,3,0,0,0,0,0,1,0,639,1,0
4300,충청북도,4308,보은군,,산외면제1투,458,283,107,163,2,0,3,0,0,2,0,0,0,0,277,6,175
4300,충청북도,4308,보은군,,산외면제2투,384,250,75,164,2,0,5,0,0,0,0,0,0,1,247,3,134
4300,충청북도,4308,보은군,잘못 투입·구분된 투표지,,0,0,0,0,0,0,0,0,0,0,0,0,0,0,0,0,0
4300,충청북도,4309,옥천군,합계,,44671,34242,14138,18241,864,31,400,15,5,13,32,67,55,28,33889,353,10429
4300,충청북도,4309,옥천군,거소·선상투표,,137,120,49,54,1,0,1,0,1,1,0,0,0,0,107,13,17
4300,충청북도,4309,옥천군,관외사전투표,,3723,3723,1656,1856,98,4,72,1,2,1,1,4,0,1,3696,27,0
4300,충청북도,4309,옥천군,재외투표,,130,87,61,15,1,0,0,0,0,0,1,0,0,0,78,9,43
4300,충청북도,4309,옥천군,옥천읍,소계,22537,16465,7497,8091,460,10,186,7,1,4,13,17,13,14,16313,152,6072
4300,충청북도,4309,옥천군,,관내사전투표,7658,7658,3720,3598,201,4,62,2,1,2,3,9,6,4,7612,46,0
4300,충청북도,4309,옥천군,,옥천읍제1투,1909,1049,480,495,46,0,9,1,0,0,1,0,1,4,1037,12,860
4300,충청북도,4309,옥천군,,옥천읍제2투,1630,1098,470,571,22,0,14,1,0,0,2,1,3,0,1084,14,532
4300,충청북도,4309,옥천군,,옥천읍제3투,2676,1507,743,684,47,0,16,0,0,0,1,1,0,0,1492,15,1169
4300,충청북도,4309,옥천군,,옥천읍제4투,1565,963,366,548,13,0,14,0,0,1,0,1,0,3,946,17,602
4300,충청북도,4309,옥천군,,옥천읍제5투,1309,693,238,429,7,2,9,0,0,0,0,0,0,0,685,8,616
4300,충청북도,4309,옥천군,,옥천읍제6투,2453,1461,561,795,50,2,21,2,0,0,5,3,3,3,1445,16,992
4300,충청북도,4309,옥천군,,옥천읍제7투,3337,2036,919,971,74,2,41,1,0,1,1,2,0,0,2012,24,1301
4300,충청북도,4309,옥천군,동이면,소계,2844,2239,850,1273,48,2,24,1,1,0,7,3,7,3,2219,20,605
4300,충청북도,4309,옥천군,,관내사전투표,1214,1214,499,668,24,0,11,0,1,0,0,2,2,0,1207,7,0
4300,충청북도,4309,옥천군,,동이면제1투,940,557,205,312,12,2,9,1,0,0,3,0,1,2,547,10,383
4300,충청북도,4309,옥천군,,동이면제2투,243,175,47,119,4,0,0,0,0,0,2,0,2,1,175,0,68
4300,충청북도,4309,옥천군,,동이면제3투,447,293,99,174,8,0,4,0,0,0,2,1,2,0,290,3,154
4300,충청북도,4309,옥천군,안남면,소계,1237,975,363,552,25,3,11,0,0,1,0,8,0,1,964,11,262
4300,충청북도,4309,옥천군,,관내사전투표,537,537,210,294,15,3,5,0,0,0,0,6,0,0,533,4,0
4300,충청북도,4309,옥천군,,안남면투표소,700,438,153,258,10,0,6,0,0,1,0,2,0,1,431,7,262
4300,충청북도,4309,옥천군,안내면,소계,1640,1299,382,844,27,3,17,2,0,1,0,7,5,1,1289,10,341
4300,충청북도,4309,옥천군,,관내사전투표,790,790,234,513,13,3,10,0,0,1,0,6,2,1,783,7,0
4300,충청북도,4309,옥천군,,안내면투표소,850,509,148,331,14,0,7,2,0,0,0,1,3,0,506,3,341
4300,충청북도,4309,옥천군,청성면,소계,1760,1259,414,757,31,4,12,0,0,3,1,14,4,3,1243,16,501
4300,충청북도,4309,옥천군,,관내사전투표,738,738,254,430,18,2,8,0,0,2,1,9,3,2,729,9,0
4300,충청북도,4309,옥천군,,청성면투표소,1022,521,160,327,13,2,4,0,0,1,0,5,1,1,514,7,501
4300,충청북도,4309,옥천군,청산면,소계,2599,2067,678,1285,34,1,16,0,0,1,2,5,9,1,2032,35,532
4300,충청북도,4309,옥천군,,관내사전투표,1162,1162,383,726,19,1,4,0,0,1,1,4,4,0,1143,19,0
4300,충청북도,4309,옥천군,,청산면제1투,579,347,118,205,6,0,10,0,0,0,1,0,0,1,341,6,232
4300,충청북도,4309,옥천군,,청산면제2투,329,207,78,117,5,0,1,0,0,0,0,0,2,0,203,4,122
4300,충청북도,4309,옥천군,,청산면제3투,529,351,99,237,4,0,1,0,0,0,0,1,3,0,345,6,178
4300,충청북도,4309,옥천군,이원면,소계,3609,2652,956,1563,58,2,29,0,0,1,2,3,7,1,2622,30,957
4300,충청북도,4309,옥천군,,관내사전투표,1518,1518,577,877,22,1,15,0,0,0,2,2,4,0,1500,18,0
4300,충청북도,4309,옥천군,,이원면제1투,1305,660,229,386,25,1,10,0,0,1,0,0,1,1,654,6,645
4300,충청북도,4309,옥천군,,이원면제2투,786,474,150,300,11,0,4,0,0,0,0,1,2,0,468,6,312
4300,충청북도,4309,옥천군,군서면,소계,1943,1508,548,882,34,1,18,1,0,0,2,4,2,1,1493,15,435
4300,충청북도,4309,옥천군,,관내사전투표,844,844,327,466,23,1,10,1,0,0,0,3,2,1,834,10,0
4300,충청북도,4309,옥천군,,군서면투표소,1099,664,221,416,11,0,8,0,0,0,2,1,0,0,659,5,435
4300,충청북도,4309,옥천군,군북면,소계,2512,1848,684,1069,47,1,14,3,0,0,3,2,8,2,1833,15,664
4300,충청북도,4309,옥천군,,관내사전투표,888,888,355,502,18,0,1,1,0,0,2,0,4,2,885,3,0
4300,충청북도,4309,옥천군,,군북면제1투,1047,570,209,318,18,1,8,2,0,0,1,2,2,0,561,9,477
4300,충청북도,4309,옥천군,,군북면제2투,247,184,65,108,5,0,4,0,0,0,0,0,0,0,182,2,63
4300,충청북도,4309,옥천군,,군북면제3투,330,206,55,141,6,0,1,0,0,0,0,0,2,0,205,1,124
4300,충청북도,4309,옥천군,잘못 투입·구분된 투표지,,0,0,0,0,0,0,0,0,0,0,0,0,0,0,0,0,0
4300,충청북도,4310,음성군,합계,,80946,58316,26700,28700,1310,33,700,23,15,28,43,66,41,43,57702,614,22630
4300,충청북도,4310,음성군,거소·선상투표,,298,242,111,75,9,2,6,0,2,0,2,1,2,1,211,31,56
4300,충청북도,4310,음성군,관외사전투표,,6857,6856,3165,3292,188,3,104,3,0,1,6,13,3,1,6779,77,1
4300,충청북도,4310,음성군,재외투표,,197,144,98,30,3,0,0,0,0,0,0,0,0,0,131,13,53
4300,충청북도,4310,음성군,음성읍,소계,13616,9749,4311,4982,228,4,95,4,2,4,9,14,4,8,9665,84,3867
4300,충청북도,4310,음성군,,관내사전투표,4776,4776,2304,2282,101,2,31,4,1,1,5,8,1,6,4746,30,0
4300,충청북도,4310,음성군,,음성읍제1투,2076,1210,520,617,34,1,18,0,0,1,2,1,0,0,1194,16,866
4300,충청북도,4310,음성군,,음성읍제2투,1749,1127,422,652,26,0,11,0,0,1,1,1,0,2,1116,11,622
4300,충청북도,4310,음성군,,음성읍제3투,2564,1230,527,635,29,1,18,0,0,1,1,1,1,0,1214,16,1334
4300,충청북도,4310,음성군,,음성읍제4투,669,367,122,235,8,0,1,0,0,0,0,1,0,0,367,0,302
4300,충청북도,4310,음성군,,음성읍제5투,1782,1039,416,561,30,0,16,0,1,0,0,2,2,0,1028,11,743
4300,충청북도,4310,음성군,금왕읍,소계,15588,10738,5193,5031,222,5,152,1,1,8,5,11,4,8,10641,97,4850
4300,충청북도,4310,음성군,,관내사전투표,4965,4965,2638,2138,101,3,43,0,1,2,0,2,3,2,4933,32,0
4300,충청북도,4310,음성군,,금왕읍제1투,3941,2127,986,1028,45,0,32,1,0,1,3,4,0,2,2102,25,1814
4300,충청북도,4310,음성군,,금왕읍제2투,2619,1317,624,613,26,1,32,0,0,3,1,3,1,0,1304,13,1302
4300,충청북도,4310,음성군,,금왕읍제3투,2023,1149,555,523,27,0,24,0,0,1,1,1,0,2,1134,15,874
4300,충청북도,4310,음성군,,금왕읍제4투,861,490,169,289,15,0,12,0,0,0,0,0,0,0,485,5,371
4300,충청북도,4310,음성군,,금왕읍제5투,1179,690,221,440,8,1,9,0,0,1,0,1,0,2,683,7,489
4300,충청북도,4310,음성군,소이면,소계,2505,1929,775,1047,52,3,20,1,1,0,0,6,3,2,1910,19,576
4300,충청북도,4310,음성군,,관내사전투표,1147,1147,512,572,31,2,10,1,1,0,0,4,2,1,1136,11,0
4300,충청북도,4310,음성군,,소이면투표소,1358,782,263,475,21,1,10,0,0,0,0,2,1,1,774,8,576
4300,충청북도,4310,음성군,원남면,소계,2529,1859,700,1092,27,2,9,0,0,0,1,1,2,4,1838,21,670
4300,충청북도,4310,음성군,,관내사전투표,1023,1023,429,557,18,1,4,0,0,0,0,0,0,3,1012,11,0
4300,충청북도,4310,음성군,,원남면제1투,861,462,158,292,4,0,2,0,0,0,0,0,0,1,457,5,399
4300,충청북도,4310,음성군,,원남면제2투,645,374,113,243,5,1,3,0,0,0,1,1,2,0,369,5,271
4300,충청북도,4310,음성군,맹동면,소계,9302,6070,3205,2526,182,3,62,3,1,3,5,7,6,4,6007,63,3232
4300,충청북도,4310,음성군,,관내사전투표,2757,2757,1517,1099,68,1,25,3,0,0,1,5,2,2,2723,34,0
4300,충청북도,4310,음성군,,맹동면제1투,2345,782,316,420,22,1,7,0,1,1,2,0,3,1,774,8,1563
4300,충청북도,4310,음성군,,맹동면제2투,2025,1178,602,508,40,1,11,0,0,1,2,1,1,0,1167,11,847
4300,충청북도,4310,음성군,,맹동면제3투,2175,1353,770,499,52,0,19,0,0,1,0,1,0,1,1343,10,822
4300,충청북도,4310,음성군,대소면,소계,12255,8129,3998,3744,175,5,112,3,3,4,5,5,2,5,8061,68,4126
4300,충청북도,4310,음성군,,관내사전투표,3776,3776,2060,1577,79,1,33,2,0,1,0,3,1,2,3759,17,0
4300,충청북도,4310,음성군,,대소면제1투,1645,912,372,483,20,1,22,0,1,0,1,0,0,1,901,11,733
4300,충청북도,4310,음성군,,대소면제2투,854,518,179,316,6,0,10,0,0,0,0,0,0,1,512,6,336
4300,충청북도,4310,음성군,,대소면제3투,3835,1948,944,896,51,3,29,1,2,3,2,2,0,1,1934,14,1887
4300,충청북도,4310,음성군,,대소면제4투,2145,975,443,472,19,0,18,0,0,0,2,0,1,0,955,20,1170
4300,충청북도,4310,음성군,삼성면,소계,5690,3921,1585,2164,65,0,58,1,3,3,3,2,5,3,3892,29,1769
4300,충청북도,4310,음성군,,관내사전투표,2035,2035,880,1090,24,0,24,1,0,2,1,2,2,2,2028,7,0
4300,충청북도,4310,음성군,,삼성면제1투,2167,1094,431,594,28,0,22,0,2,1,2,0,1,1,1082,12,1073
4300,충청북도,4310,음성군,,삼성면제2투,1488,792,274,480,13,0,12,0,1,0,0,0,2,0,782,10,696
4300,충청북도,4310,음성군,생극면,소계,4015,2984,1215,1617,52,4,27,3,0,2,3,1,4,2,2930,54,1031
4300,충청북도,4310,음성군,,관내사전투표,1527,1527,673,769,31,2,14,2,0,2,2,0,3,1,1499,28,0
4300,충청북도,4310,음성군,,생극면제1투,1645,904,337,524,12,1,10,1,0,0,1,1,0,0,887,17,741
4300,충청북도,4310,음성군,,생극면제2투,843,553,205,324,9,1,3,0,0,0,0,0,1,1,544,9,290
4300,충청북도,4310,음성군,감곡면,소계,8094,5693,2343,3099,107,2,55,4,2,3,4,5,6,5,5635,58,2401
4300,충청북도,4310,음성군,,관내사전투표,2753,2753,1221,1427,55,1,22,2,1,2,1,3,1,3,2739,14,0
4300,충청북도,4310,음성군,,감곡면제1투,2565,1315,566,665,29,1,21,1,1,1,1,2,1,2,1291,24,1250
4300,충청북도,4310,음성군,,감곡면제2투,1741,968,348,584,13,0,5,0,0,0,1,0,4,0,955,13,773
4300,충청북도,4310,음성군,,감곡면제3투,1035,657,208,423,10,0,7,1,0,0,1,0,0,0,650,7,378
4300,충청북도,4310,음성군,잘못 투입·구분된 투표지,,0,2,1,1,0,0,0,0,0,0,0,0,0,0,2,0,-2
4300,충청북도,4311,진천군,합계,,71306,51932,25402,23759,1361,34,672,17,8,17,28,73,30,33,51434,498,19374
4300,충청북도,4311,진천군,거소·선상투표,,143,129,58,50,2,0,5,0,0,0,0,0,0,0,115,14,14
4300,충청북도,4311,진천군,관외사전투표,,5884,5884,2938,2602,159,5,98,5,0,2,4,4,1,3,5821,63,0
4300,충청북도,4311,진천군,재외투표,,140,100,64,19,3,0,0,0,0,0,0,0,0,0,86,14,40
4300,충청북도,4311,진천군,진천읍,소계,24038,16821,8068,7821,467,14,223,6,4,5,13,27,9,11,16668,153,7217
4300,충청북도,4311,진천군,,관내사전투표,7329,7329,3841,3145,187,7,67,4,2,2,3,14,3,4,7279,50,0
4300,충청북도,4311,진천군,,진천읍제1투,1882,1024,361,601,27,0,14,1,0,1,1,3,0,0,1009,15,858
4300,충청북도,4311,진천군,,진천읍제2투,921,611,213,361,18,0,10,0,0,0,0,0,2,0,604,7,310
4300,충청북도,4311,진천군,,진천읍제3투,1849,1069,508,498,36,1,16,0,0,1,0,1,1,0,1062,7,780
4300,충청북도,4311,진천군,,진천읍제4투,1780,994,386,553,19,1,11,1,0,0,4,2,1,2,980,14,786
4300,충청북도,4311,진천군,,진천읍제5투,2318,1200,576,548,31,1,29,0,0,0,1,3,0,1,1190,10,1118
4300,충청북도,4311,진천군,,진천읍제6투,2725,1552,738,715,51,2,22,0,1,0,2,2,1,1,1535,17,1173
4300,충청북도,4311,진천군,,진천읍제7투,1391,836,371,412,21,1,15,0,0,1,1,1,1,0,824,12,555
4300,충청북도,4311,진천군,,진천읍제8투,1315,706,289,368,24,1,12,0,1,0,0,0,0,1,696,10,609
4300,충청북도,4311,진천군,,진천읍제9투,2528,1500,785,620,53,0,27,0,0,0,1,1,0,2,1489,11,1028
4300,충청북도,4311,진천군,초평면,소계,2663,2022,865,1056,40,1,21,1,0,0,1,8,3,4,2000,22,641
4300,충청북도,4311,진천군,,관내사전투표,990,990,471,470,19,1,10,0,0,0,0,5,1,4,981,9,0
4300,충청북도,4311,진천군,,초평면제1투,1055,617,259,327,12,0,7,1,0,0,1,3,0,0,610,7,438
4300,충청북도,4311,진천군,,초평면제2투,618,415,135,259,9,0,4,0,0,0,0,0,2,0,409,6,203
4300,충청북도,4311,진천군,문백면,소계,2970,2176,858,1187,59,2,31,0,1,1,0,4,2,2,2147,29,794
4300,충청북도,4311,진천군,,관내사전투표,923,923,410,468,21,1,12,0,0,0,0,1,1,2,916,7,0
4300,충청북도,4311,진천군,,문백면제1투,1213,678,235,400,22,0,11,0,0,0,0,0,1,0,669,9,535
4300,충청북도,4311,진천군,,문백면제2투,834,575,213,319,16,1,8,0,1,1,0,3,0,0,562,13,259
4300,충청북도,4311,진천군,백곡면,소계,1852,1473,512,891,35,1,17,0,0,1,1,1,2,1,1462,11,379
4300,충청북도,4311,진천군,,관내사전투표,820,820,305,474,23,1,7,0,0,1,0,0,2,1,814,6,0
4300,충청북도,4311,진천군,,백곡면투표소,1032,653,207,417,12,0,10,0,0,0,1,1,0,0,648,5,379
4300,충청북도,4311,진천군,이월면,소계,5382,3839,1609,2031,92,1,43,0,0,1,2,6,1,4,3790,49,1543
4300,충청북도,4311,진천군,,관내사전투표,2072,2072,940,1042,47,1,16,0,0,0,1,3,1,4,2055,17,0
4300,충청북도,4311,진천군,,이월면제1투,1709,926,331,528,28,0,14,0,0,1,1,3,0,0,906,20,783
4300,충청북도,4311,진천군,,이월면제2투,1601,841,338,461,17,0,13,0,0,0,0,0,0,0,829,12,760
4300,충청북도,4311,진천군,광혜원면,소계,8259,5736,2807,2664,130,6,68,3,1,3,2,8,3,4,5699,37,2523
4300,충청북도,4311,진천군,,관내사전투표,3039,3039,1560,1368,62,3,26,2,1,0,0,3,0,2,3027,12,0
4300,충청북도,4311,진천군,,광혜원면제1투,1771,893,374,477,17,1,8,1,0,2,1,3,2,0,886,7,878
4300,충청북도,4311,진천군,,광혜원면제2투,1772,848,386,412,20,2,14,0,0,1,0,1,0,1,837,11,924
4300,충청북도,4311,진천군,,광혜원면제3투,1677,956,487,407,31,0,20,0,0,0,1,1,1,1,949,7,721
4300,충청북도,4311,진천군,덕산읍,소계,19975,13752,7623,5438,374,4,166,2,2,4,5,15,9,4,13646,106,6223
4300,충청북도,4311,진천군,,관내사전투표,5594,5594,3315,2063,130,3,45,0,0,3,0,6,1,1,5567,27,0
4300,충청북도,4311,진천군,,덕산읍제1투,1904,963,399,503,21,0,20,2,0,0,0,0,1,0,946,17,941
4300,충청북도,4311,진천군,,덕산읍제2투,2144,919,370,491,19,0,18,0,0,0,1,3,3,1,906,13,1225
4300,충청북도,4311,진천군,,덕산읍제3투,1734,1006,508,447,35,0,6,0,0,1,0,2,0,0,999,7,728
4300,충청북도,4311,진천군,,덕산읍제4투,1917,1186,727,386,36,1,17,0,1,0,0,2,3,2,1175,11,731
4300,충청북도,4311,진천군,,덕산읍제5투,2279,1333,769,469,52,0,22,0,1,0,2,1,1,0,1317,16,946
4300,충청북도,4311,진천군,,덕산읍제6투,2940,1835,1047,702,62,0,16,0,0,0,1,0,0,0,1828,7,1105
4300,충청북도,4311,진천군,,덕산읍제7투,1463,916,488,377,19,0,22,0,0,0,1,1,0,0,908,8,547
4300,충청북도,4311,진천군,잘못 투입·구분된 투표지,,0,0,0,0,0,0,0,0,0,0,0,0,0,0,0,0,0
4300,충청북도,4312,괴산군,합계,,34819,27419,10304,15895,546,22,245,18,9,11,23,34,30,27,27164,255,7400
4300,충청북도,4312,괴산군,거소·선상투표,,94,92,29,48,1,0,2,0,1,0,0,0,1,0,82,10,2
4300,충청북도,4312,괴산군,관외사전투표,,3881,3881,1685,2025,102,2,31,3,2,0,0,3,1,1,3855,26,0
4300,충청북도,4312,괴산군,재외투표,,100,73,41,27,0,0,0,0,0,0,0,0,0,0,68,5,27
4300,충청북도,4312,괴산군,괴산읍,소계,7730,5810,2482,3076,116,4,59,4,0,1,1,6,3,4,5756,54,1920
4300,충청북도,4312,괴산군,,관내사전투표,3258,3258,1530,1588,76,3,27,3,0,0,1,4,1,0,3233,25,0
4300,충청북도,4312,괴산군,,괴산읍제1투,2086,1212,457,708,17,1,14,0,0,1,0,0,1,1,1200,12,874
4300,충청북도,4312,괴산군,,괴산읍제2투,1438,820,306,477,15,0,7,0,0,0,0,1,1,1,808,12,618
4300,충청북도,4312,괴산군,,괴산읍제3투,948,520,189,303,8,0,11,1,0,0,0,1,0,2,515,5,428
4300,충청북도,4312,괴산군,감물면,소계,1661,1262,394,818,20,0,4,0,0,0,2,5,3,0,1246,16,399
4300,충청북도,4312,괴산군,,관내사전투표,695,695,245,425,13,0,2,0,0,0,1,4,1,0,691,4,0
4300,충청북도,4312,괴산군,,감물면투표소,966,567,149,393,7,0,2,0,0,0,1,1,2,0,555,12,399
4300,충청북도,4312,괴산군,장연면,소계,1480,1102,353,706,18,2,7,0,0,0,0,5,5,0,1096,6,378
4300,충청북도,4312,괴산군,,관내사전투표,636,636,207,402,11,0,4,0,0,0,0,5,3,0,632,4,0
4300,충청북도,4312,괴산군,,장연면투표소,844,466,146,304,7,2,3,0,0,0,0,0,2,0,464,2,378
4300,충청북도,4312,괴산군,연풍면,소계,2023,1562,480,1018,22,2,16,0,0,0,0,2,1,7,1548,14,461
4300,충청북도,4312,괴산군,,관내사전투표,908,908,300,575,15,0,5,0,0,0,0,2,1,5,903,5,0
4300,충청북도,4312,괴산군,,연풍면투표소,1115,654,180,443,7,2,11,0,0,0,0,0,0,2,645,9,461
4300,충청북도,4312,괴산군,칠성면,소계,2670,2095,773,1227,42,2,20,1,1,3,0,1,2,2,2074,21,575
4300,충청북도,4312,괴산군,,관내사전투표,1352,1352,522,781,26,1,5,0,1,0,0,0,2,1,1339,13,0
4300,충청북도,4312,괴산군,,칠성면투표소,1318,743,251,446,16,1,15,1,0,3,0,1,0,1,735,8,575
4300,충청북도,4312,괴산군,문광면,소계,2069,1618,634,903,37,0,17,0,0,1,1,2,5,1,1601,17,451
4300,충청북도,4312,괴산군,,관내사전투표,1022,1022,405,579,21,0,7,0,0,0,0,0,2,1,1015,7,0
4300,충청북도,4312,괴산군,,문광면투표소,1047,596,229,324,16,0,10,0,0,1,1,2,3,0,586,10,451
4300,충청북도,4312,괴산군,청천면,소계,4117,3185,1032,2010,57,5,22,6,4,4,7,2,4,5,3158,27,932
4300,충청북도,4312,괴산군,,관내사전투표,1374,1374,452,864,20,4,7,3,4,2,2,1,2,1,1362,12,0
4300,충청북도,4312,괴산군,,청천면제1투,1505,867,270,558,16,1,9,1,0,1,2,1,2,1,862,5,638
4300,충청북도,4312,괴산군,,청천면제2투,528,395,113,263,8,0,3,0,0,0,0,0,0,0,387,8,133
4300,충청북도,4312,괴산군,,청천면제3투,710,549,197,325,13,0,3,2,0,1,3,0,0,3,547,2,161
4300,충청북도,4312,괴산군,청안면,소계,2695,1977,673,1225,38,2,13,0,0,0,1,4,3,3,1962,15,718
4300,충청북도,4312,괴산군,,관내사전투표,886,886,332,517,19,0,5,0,0,0,1,2,3,1,880,6,0
4300,충청북도,4312,괴산군,,청안면제1투,963,516,170,319,11,2,4,0,0,0,0,2,0,1,509,7,447
4300,충청북도,4312,괴산군,,청안면제2투,846,575,171,389,8,0,4,0,0,0,0,0,0,1,573,2,271
4300,충청북도,4312,괴산군,사리면,소계,2248,1688,573,1034,35,2,11,1,0,0,3,3,0,3,1665,23,560
4300,충청북도,4312,괴산군,,관내사전투표,818,818,294,501,12,2,2,1,0,0,1,1,0,0,814,4,0
4300,충청북도,4312,괴산군,,사리면제1투,913,525,181,312,13,0,4,0,0,0,0,1,0,1,512,13,388
4300,충청북도,4312,괴산군,,사리면제2투,517,345,98,221,10,0,5,0,0,0,2,1,0,2,339,6,172
4300,충청북도,4312,괴산군,소수면,소계,1718,1292,556,662,31,1,26,2,0,1,4,0,1,0,1284,8,426
4300,충청북도,4312,괴산군,,관내사전투표,726,726,317,375,17,1,8,1,0,0,1,0,1,0,721,5,0
4300,충청북도,4312,괴산군,,소수면투표소,992,566,239,287,14,0,18,1,0,1,3,0,0,0,563,3,426
4300,충청북도,4312,괴산군,불정면,소계,2333,1782,599,1116,27,0,17,1,1,1,4,1,1,1,1769,13,551
4300,충청북도,4312,괴산군,,관내사전투표,1090,1090,375,678,19,0,7,1,1,0,0,1,1,1,1084,6,0
4300,충청북도,4312,괴산군,,불정면투표소,1243,692,224,438,8,0,10,0,0,1,4,0,0,0,685,7,551
4300,충청북도,4312,괴산군,잘못 투입·구분된 투표지,,0,0,0,0,0,0,0,0,0,0,0,0,0,0,0,0,0
4300,충청북도,4313,증평군,합계,,30953,22653,10215,11264,560,7,275,5,8,5,24,16,20,11,22410,243,8300
4300,충청북도,4313,증평군,거소·선상투표,,56,50,21,19,2,0,3,0,0,0,0,0,0,0,45,5,6
4300,충청북도,4313,증평군,관외사전투표,,2589,2589,1226,1188,90,1,38,0,0,0,0,0,2,2,2547,42,0
4300,충청북도,4313,증평군,재외투표,,100,78,43,24,1,0,1,0,0,0,0,0,0,0,69,9,22
4300,충청북도,4313,증평군,증평읍,소계,26413,18553,8359,9284,441,6,216,4,8,4,23,12,14,9,18380,173,7860
4300,충청북도,4313,증평군,,관내사전투표,8559,8558,4169,4030,198,4,66,2,3,2,6,5,7,1,8493,65,1
4300,충청북도,4313,증평군,,증평읍제1투,1631,913,355,502,31,0,8,1,2,0,3,0,0,1,903,10,718
4300,충청북도,4313,증평군,,증평읍제2투,1660,1003,336,622,15,0,11,0,2,1,1,0,1,1,990,13,657
4300,충청북도,4313,증평군,,증평읍제3투,1758,1023,378,586,24,0,11,0,1,1,2,0,1,1,1005,18,735
4300,충청북도,4313,증평군,,증평읍제4투,2484,1205,597,542,27,0,25,0,0,0,1,2,0,0,1194,11,1279
4300,충청북도,4313,증평군,,증평읍제5투,1882,1080,457,564,33,1,11,0,0,0,1,0,2,1,1070,10,802
4300,충청북도,4313,증평군,,증평읍제6투,1570,834,461,320,25,1,18,0,0,0,3,0,1,0,829,5,736
4300,충청북도,4313,증평군,,증평읍제7투,1682,896,352,499,15,0,15,0,0,0,3,2,0,1,887,9,786
4300,충청북도,4313,증평군,,증평읍제8투,992,657,212,408,14,0,12,0,0,0,0,0,1,2,649,8,335
4300,충청북도,4313,증평군,,증평읍제9투,1854,1072,435,586,27,0,10,0,0,0,3,0,0,1,1062,10,782
4300,충청북도,4313,증평군,,증평읍제10투,2341,1312,607,625,32,0,29,1,0,0,0,3,1,0,1298,14,1029
4300,충청북도,4313,증평군,도안면,소계,1795,1383,566,749,26,0,17,1,0,1,1,4,4,0,1369,14,412
4300,충청북도,4313,증평군,,관내사전투표,828,828,399,396,15,0,8,0,0,0,1,1,0,0,820,8,0
4300,충청북도,4313,증평군,,도안면투표소,967,555,167,353,11,0,9,1,0,1,0,3,4,0,549,6,412
4300,충청북도,4313,증평군,잘못 투입·구분된 투표지,,0,0,0,0,0,0,0,0,0,0,0,0,0,0,0,0,04400,충청남도,4417,천안시서북구,합계,,329610,238154,115553,110141,6568,152,2673,59,32,39,134,200,63,122,235736,2418,91456
4400,충청남도,4417,천안시서북구,거소·선상투표,,499,469,171,195,13,1,14,0,0,0,0,1,0,2,397,72,30
4400,충청남도,4417,천안시서북구,관외사전투표,,25884,25878,12503,11977,667,19,338,4,5,5,12,32,8,31,25601,277,6
4400,충청남도,4417,천안시서북구,재외투표,,998,701,395,217,27,0,1,0,0,0,0,0,0,0,640,61,297
4400,충청남도,4417,천안시서북구,성환읍,소계,20015,14175,6026,7397,351,9,176,8,4,2,25,12,5,11,14026,149,5840
4400,충청남도,4417,천안시서북구,,관내사전투표,5473,5473,2607,2648,107,2,50,2,1,1,7,5,1,1,5432,41,0
4400,충청남도,4417,천안시서북구,,성환읍제1투,1450,868,308,499,27,0,12,1,1,0,2,0,0,2,852,16,582
4400,충청남도,4417,천안시서북구,,성환읍제2투,2088,1146,408,655,47,2,16,1,1,0,2,2,1,0,1135,11,942
4400,충청남도,4417,천안시서북구,,성환읍제3투,1428,943,450,444,29,3,6,1,0,0,2,0,0,1,936,7,485
4400,충청남도,4417,천안시서북구,,성환읍제4투,634,410,134,258,9,0,6,0,0,0,1,0,0,0,408,2,224
4400,충청남도,4417,천안시서북구,,성환읍제5투,797,546,174,346,16,0,5,1,0,0,2,1,0,0,545,1,251
4400,충청남도,4417,천안시서북구,,성환읍제6투,1410,844,280,514,13,1,13,1,0,1,3,2,1,1,830,14,566
4400,충청남도,4417,천안시서북구,,성환읍제7투,1849,922,317,538,25,0,19,0,0,0,1,0,1,1,902,20,927
4400,충청남도,4417,천안시서북구,,성환읍제8투,605,389,125,245,6,0,7,0,0,0,0,1,1,0,385,4,216
4400,충청남도,4417,천안시서북구,,성환읍제9투,2269,1324,544,697,37,1,21,1,1,0,2,1,0,2,1307,17,945
4400,충청남도,4417,천안시서북구,,성환읍제10투,2012,1310,679,553,35,0,21,0,0,0,3,0,0,3,1294,16,702
4400,충청남도,4417,천안시서북구,성거읍,소계,15510,10308,5003,4738,285,9,146,4,2,3,7,8,4,4,10213,95,5202
4400,충청남도,4417,천안시서북구,,관내사전투표,3546,3542,1888,1511,79,4,30,2,1,1,1,3,1,2,3523,19,4
4400,충청남도,4417,천안시서북구,,성거읍제1투,2457,1273,616,591,36,0,17,0,0,0,1,0,1,0,1262,11,1184
4400,충청남도,4417,천안시서북구,,성거읍제2투,1459,817,306,457,18,0,20,0,1,0,1,1,0,0,804,13,642
4400,충청남도,4417,천안시서북구,,성거읍제3투,3174,1887,970,789,65,0,32,0,0,1,0,1,0,1,1859,28,1287
4400,충청남도,4417,천안시서북구,,성거읍제4투,2280,1263,530,640,46,3,24,1,0,0,3,2,1,1,1251,12,1017
4400,충청남도,4417,천안시서북구,,성거읍제5투,1243,663,233,397,13,2,12,0,0,1,0,0,1,0,659,4,580
4400,충청남도,4417,천안시서북구,,성거읍제6투,1351,863,460,353,28,0,11,1,0,0,1,1,0,0,855,8,488
4400,충청남도,4417,천안시서북구,직산읍,소계,17468,12097,5868,5624,270,12,177,3,0,1,8,19,4,7,11993,104,5371
4400,충청남도,4417,천안시서북구,,관내사전투표,5440,5440,2938,2306,102,2,46,1,0,0,2,5,1,5,5408,32,0
4400,충청남도,4417,천안시서북구,,직산읍제1투,1176,776,247,494,13,1,9,1,0,0,1,1,0,1,768,8,400
4400,충청남도,4417,천안시서북구,,직산읍제2투,3202,1698,854,732,48,2,39,1,0,0,0,4,0,0,1680,18,1504
4400,충청남도,4417,천안시서북구,,직산읍제3투,1958,1131,377,687,19,4,19,0,0,1,4,2,1,1,1115,16,827
4400,충청남도,4417,천안시서북구,,직산읍제4투,1524,746,352,358,19,0,11,0,0,0,0,0,0,0,740,6,778
4400,충청남도,4417,천안시서북구,,직산읍제5투,1924,998,480,449,28,0,24,0,0,0,0,5,1,0,987,11,926
4400,충청남도,4417,천안시서북구,,직산읍제6투,2244,1308,620,598,41,3,29,0,0,0,1,2,1,0,1295,13,936
4400,충청남도,4417,천안시서북구,입장면,소계,7608,5497,2274,2960,124,3,72,0,0,2,2,8,1,4,5450,47,2111
4400,충청남도,4417,천안시서북구,,관내사전투표,2698,2697,1198,1404,50,2,21,0,0,2,1,3,1,3,2685,12,1
4400,충청남도,4417,천안시서북구,,입장면제1투,1710,944,384,488,37,0,19,0,0,0,0,1,0,0,929,15,766
4400,충청남도,4417,천안시서북구,,입장면제2투,727,472,184,267,10,0,5,0,0,0,0,3,0,0,469,3,255
4400,충청남도,4417,천안시서북구,,입장면제3투,1857,979,370,556,19,0,22,0,0,0,0,1,0,1,969,10,878
4400,충청남도,4417,천안시서북구,,입장면제4투,616,405,138,245,8,1,5,0,0,0,1,0,0,0,398,7,211
4400,충청남도,4417,천안시서북구,성정1동,소계,13967,8602,3447,4711,184,5,133,3,2,2,13,9,6,5,8520,82,5365
4400,충청남도,4417,천안시서북구,,관내사전투표,2559,2559,1194,1269,41,3,25,0,0,1,2,4,3,2,2544,15,0
4400,충청남도,4417,천안시서북구,,성정1동제1투,1820,1034,373,590,29,0,18,1,1,0,2,1,0,2,1017,17,786
4400,충청남도,4417,천안시서북구,,성정1동제2투,3367,1541,605,857,29,0,31,0,0,0,2,1,0,0,1525,16,1826
4400,충청남도,4417,천안시서북구,,성정1동제3투,2001,910,354,488,21,0,23,0,0,0,2,2,3,0,893,17,1091
4400,충청남도,4417,천안시서북구,,성정1동제4투,1564,779,267,471,15,0,16,0,0,0,3,1,0,1,774,5,785
4400,충청남도,4417,천안시서북구,,성정1동제5투,2656,1779,654,1036,49,2,20,2,1,1,2,0,0,0,1767,12,877
4400,충청남도,4417,천안시서북구,성정2동,소계,22433,12072,5605,5698,344,14,219,1,1,1,9,13,4,6,11915,157,10361
4400,충청남도,4417,천안시서북구,,관내사전투표,4338,4338,2201,1935,113,6,44,0,1,0,0,4,1,2,4307,31,0
4400,충청남도,4417,천안시서북구,,성정2동제1투,1385,625,303,259,18,0,26,0,0,1,1,1,0,1,610,15,760
4400,충청남도,4417,천안시서북구,,성정2동제2투,3442,1799,739,938,46,1,34,0,0,0,2,2,1,1,1764,35,1643
4400,충청남도,4417,천안시서북구,,성정2동제3투,3001,1592,709,774,52,2,29,0,0,0,0,1,1,1,1569,23,1409
4400,충청남도,4417,천안시서북구,,성정2동제4투,2823,1093,468,547,35,2,26,0,0,0,2,2,1,0,1083,10,1730
4400,충청남도,4417,천안시서북구,,성정2동제5투,4560,1712,769,829,44,2,40,0,0,0,1,2,0,1,1688,24,2848
4400,충청남도,4417,천안시서북구,,성정2동제6투,2884,913,416,416,36,1,20,1,0,0,3,1,0,0,894,19,1971
4400,충청남도,4417,천안시서북구,쌍용1동,소계,11232,7959,3517,4024,225,8,104,1,2,1,5,6,2,4,7899,60,3273
4400,충청남도,4417,천안시서북구,,관내사전투표,3032,3032,1478,1410,83,4,33,0,0,0,1,3,1,2,3015,17,0
4400,충청남도,4417,천안시서북구,,쌍용1동제1투,1999,1155,495,604,26,1,19,0,1,0,0,0,1,1,1148,7,844
4400,충청남도,4417,천안시서북구,,쌍용1동제2투,1957,1068,418,576,41,1,17,0,1,0,0,0,0,0,1054,14,889
4400,충청남도,4417,천안시서북구,,쌍용1동제3투,2075,1289,558,668,31,0,16,0,0,1,2,2,0,1,1279,10,786
4400,충청남도,4417,천안시서북구,,쌍용1동제4투,2169,1415,568,766,44,2,19,1,0,0,2,1,0,0,1403,12,754
4400,충청남도,4417,천안시서북구,쌍용2동,소계,26774,19373,9320,9051,580,7,183,6,2,1,14,14,5,8,19191,182,7401
4400,충청남도,4417,천안시서북구,,관내사전투표,6187,6186,3335,2607,174,2,28,1,1,0,2,2,2,3,6157,29,1
4400,충청남도,4417,천안시서북구,,쌍용2동제1투,2660,1612,645,881,35,0,30,0,0,0,2,1,0,0,1594,18,1048
4400,충청남도,4417,천안시서북구,,쌍용2동제2투,2186,1308,544,689,34,1,13,2,0,0,1,2,0,1,1287,21,878
4400,충청남도,4417,천안시서북구,,쌍용2동제3투,1896,980,478,436,29,0,19,1,0,0,1,1,0,0,965,15,916
4400,충청남도,4417,천안시서북구,,쌍용2동제4투,3198,2183,1087,962,92,2,14,1,0,1,4,2,1,1,2167,16,1015
4400,충청남도,4417,천안시서북구,,쌍용2동제5투,1488,876,404,409,25,0,19,1,1,0,2,1,0,1,863,13,612
4400,충청남도,4417,천안시서북구,,쌍용2동제6투,2601,1735,783,860,50,0,13,0,0,0,1,2,1,2,1712,23,866
4400,충청남도,4417,천안시서북구,,쌍용2동제7투,2609,1907,900,891,69,1,19,0,0,0,0,1,1,0,1882,25,702
4400,충청남도,4417,천안시서북구,,쌍용2동제8투,3949,2586,1144,1316,72,1,28,0,0,0,1,2,0,0,2564,22,1363
4400,충청남도,4417,천안시서북구,쌍용3동,소계,15635,11730,5657,5528,313,7,90,3,0,1,3,11,0,10,11623,107,3905
4400,충청남도,4417,천안시서북구,,관내사전투표,4948,4948,2682,2094,112,2,20,2,0,0,2,5,0,3,4922,26,0
4400,충청남도,4417,천안시서북구,,쌍용3동제1투,2159,1372,536,764,50,0,8,0,0,0,1,0,0,1,1360,12,787
4400,충청남도,4417,천안시서북구,,쌍용3동제2투,1904,1110,478,556,31,0,19,0,0,1,0,2,0,1,1088,22,794
4400,충청남도,4417,천안시서북구,,쌍용3동제3투,1342,802,350,402,26,1,11,0,0,0,0,0,0,0,790,12,540
4400,충청남도,4417,천안시서북구,,쌍용3동제4투,1743,998,508,428,28,3,13,0,0,0,0,1,0,1,982,16,745
4400,충청남도,4417,천안시서북구,,쌍용3동제5투,1853,1173,634,453,53,1,12,1,0,0,0,3,0,3,1160,13,680
4400,충청남도,4417,천안시서북구,,쌍용3동제6투,1686,1327,469,831,13,0,7,0,0,0,0,0,0,1,1321,6,359
4400,충청남도,4417,천안시서북구,백석동,소계,27559,20682,10896,8890,540,13,140,4,3,4,9,11,9,3,20522,160,6877
4400,충청남도,4417,천안시서북구,,관내사전투표,5229,5229,3024,2032,129,2,17,1,1,0,5,2,1,1,5215,14,0
4400,충청남도,4417,천안시서북구,,백석동제1투,2071,1248,645,535,32,1,16,1,0,0,1,0,0,1,1232,16,823
4400,충청남도,4417,천안시서북구,,백석동제2투,1788,1299,569,665,38,1,11,0,1,2,0,1,0,1,1289,10,489
4400,충청남도,4417,천안시서북구,,백석동제3투,2657,1803,882,831,47,3,24,0,0,2,0,1,1,0,1791,12,854
4400,충청남도,4417,천안시서북구,,백석동제4투,3407,2187,1104,952,61,2,25,0,0,0,0,1,3,0,2148,39,1220
4400,충청남도,4417,천안시서북구,,백석동제5투,2721,1900,1027,810,39,0,8,1,0,0,1,1,3,0,1890,10,821
4400,충청남도,4417,천안시서북구,,백석동제6투,2865,1985,997,899,54,0,12,0,1,0,1,3,1,0,1968,17,880
4400,충청남도,4417,천안시서북구,,백석동제7투,2749,2174,1152,930,62,0,9,1,0,0,0,1,0,0,2155,19,575
4400,충청남도,4417,천안시서북구,,백석동제8투,2321,1694,929,701,44,1,7,0,0,0,1,0,0,0,1683,11,627
4400,충청남도,4417,천안시서북구,,백석동제9투,1751,1163,567,535,34,3,11,0,0,0,0,1,0,0,1151,12,588
4400,충청남도,4417,천안시서북구,부성1동,소계,35750,23770,11792,10586,771,13,270,8,4,5,12,22,7,11,23501,269,11980
4400,충청남도,4417,천안시서북구,,관내사전투표,6985,6982,3878,2793,189,1,52,2,3,0,3,2,2,3,6928,54,3
4400,충청남도,4417,천안시서북구,,부성1동제1투,4758,2750,1290,1295,95,5,24,1,1,0,1,3,0,0,2715,35,2008
4400,충청남도,4417,천안시서북구,,부성1동제2투,2528,1430,631,704,44,1,26,1,0,1,0,3,0,0,1411,19,1098
4400,충청남도,4417,천안시서북구,,부성1동제3투,722,476,195,257,10,0,6,1,0,0,3,0,0,0,472,4,246
4400,충청남도,4417,천안시서북구,,부성1동제4투,2054,1420,662,690,38,0,12,0,0,0,1,2,0,1,1406,14,634
4400,충청남도,4417,천안시서북구,,부성1동제5투,2782,1521,780,640,61,1,18,0,0,1,0,0,1,0,1502,19,1261
4400,충청남도,4417,천안시서북구,,부성1동제6투,1274,802,391,356,33,1,12,0,0,0,0,0,0,0,793,9,472
4400,충청남도,4417,천안시서북구,,부성1동제7투,2227,1224,603,530,54,0,19,0,0,0,0,3,1,2,1212,12,1003
4400,충청남도,4417,천안시서북구,,부성1동제8투,2233,1415,619,704,52,0,12,2,0,1,2,1,1,4,1398,17,818
4400,충청남도,4417,천안시서북구,,부성1동제9투,4267,1725,797,775,67,1,42,0,0,0,0,6,2,0,1690,35,2542
4400,충청남도,4417,천안시서북구,,부성1동제10투,2465,1790,905,785,58,2,14,0,0,2,1,0,0,0,1767,23,675
4400,충청남도,4417,천안시서북구,,부성1동제11투,3455,2235,1041,1057,70,1,33,1,0,0,1,2,0,1,2207,28,1220
4400,충청남도,4417,천안시서북구,부성2동,소계,41235,28543,15046,11928,845,19,371,8,1,6,5,14,5,9,28257,286,12692
4400,충청남도,4417,천안시서북구,,관내사전투표,6868,6868,3897,2671,200,6,51,2,0,0,0,4,2,2,6835,33,0
4400,충청남도,4417,천안시서북구,,부성2동제1투,3130,2125,1179,808,80,1,32,0,0,1,0,1,1,0,2103,22,1005
4400,충청남도,4417,천안시서북구,,부성2동제2투,3142,2195,1067,1013,61,0,30,1,0,0,0,1,0,1,2174,21,947
4400,충청남도,4417,천안시서북구,,부성2동제3투,3422,2282,1192,977,55,0,28,1,0,1,0,2,0,1,2257,25,1140
4400,충청남도,4417,천안시서북구,,부성2동제4투,2776,1192,531,559,31,1,40,0,1,1,0,1,0,0,1165,27,1584
4400,충청남도,4417,천안시서북구,,부성2동제5투,2998,1571,772,683,45,2,38,0,0,1,4,0,0,2,1547,24,1427
4400,충청남도,4417,천안시서북구,,부성2동제6투,2171,970,413,483,28,0,32,0,0,0,0,2,0,0,958,12,1201
4400,충청남도,4417,천안시서북구,,부성2동제7투,2706,1778,876,789,64,2,24,0,0,0,0,2,1,0,1758,20,928
4400,충청남도,4417,천안시서북구,,부성2동제8투,2760,1677,909,684,39,2,27,1,0,1,0,0,0,1,1664,13,1083
4400,충청남도,4417,천안시서북구,,부성2동제9투,1972,1394,810,512,37,0,10,0,0,0,0,0,1,1,1371,23,578
4400,충청남도,4417,천안시서북구,,부성2동제10투,3856,2432,1212,1086,81,3,20,1,0,0,1,1,0,0,2405,27,1424
4400,충청남도,4417,천안시서북구,,부성2동제11투,2852,2153,1183,857,60,1,21,1,0,0,0,0,0,1,2124,29,699
4400,충청남도,4417,천안시서북구,,부성2동제12투,2582,1906,1005,806,64,1,18,1,0,1,0,0,0,0,1896,10,676
4400,충청남도,4417,천안시서북구,불당1동,소계,23048,17627,8876,7922,502,7,126,3,1,5,4,10,2,6,17464,163,5421
4400,충청남도,4417,천안시서북구,,관내사전투표,5536,5536,3149,2163,138,2,27,3,0,4,2,1,0,2,5491,45,0
4400,충청남도,4417,천안시서북구,,불당1동제1투,3071,2214,1126,964,73,2,21,0,0,0,0,3,1,1,2191,23,857
4400,충청남도,4417,천안시서북구,,불당1동제2투,2229,1681,839,774,47,0,8,0,0,0,0,1,0,0,1669,12,548
4400,충청남도,4417,천안시서북구,,불당1동제3투,1918,1273,588,610,48,1,11,0,1,1,0,1,0,0,1261,12,645
4400,충청남도,4417,천안시서북구,,불당1동제4투,2612,1647,707,853,47,0,15,0,0,0,0,3,1,0,1626,21,965
4400,충청남도,4417,천안시서북구,,불당1동제5투,1438,942,404,480,36,0,8,0,0,0,1,0,0,1,930,12,496
4400,충청남도,4417,천안시서북구,,불당1동제6투,2802,1859,796,992,44,1,12,0,0,0,1,0,0,0,1846,13,943
4400,충청남도,4417,천안시서북구,,불당1동제7투,3442,2475,1267,1086,69,1,24,0,0,0,0,1,0,2,2450,25,967
4400,충청남도,4417,천안시서북구,불당2동,소계,23995,18663,9153,8691,527,6,113,3,5,0,6,10,1,1,18516,147,5332
4400,충청남도,4417,천안시서북구,,관내사전투표,6911,6911,3835,2826,179,5,25,1,0,0,2,3,1,0,6877,34,0
4400,충청남도,4417,천안시서북구,,불당2동제1투,3473,2545,1074,1338,79,0,24,1,2,0,0,2,0,1,2521,24,928
4400,충청남도,4417,천안시서북구,,불당2동제2투,2418,1667,679,904,53,0,10,1,0,0,1,3,0,0,1651,16,751
4400,충청남도,4417,천안시서북구,,불당2동제3투,2339,1644,691,884,39,1,8,0,1,0,0,0,0,0,1624,20,695
4400,충청남도,4417,천안시서북구,,불당2동제4투,3166,2175,1049,1051,55,0,6,0,0,0,1,0,0,0,2162,13,991
4400,충청남도,4417,천안시서북구,,불당2동제5투,2879,1702,803,781,59,0,28,0,1,0,1,2,0,0,1675,27,1177
4400,충청남도,4417,천안시서북구,,불당2동제6투,2809,2019,1022,907,63,0,12,0,1,0,1,0,0,0,2006,13,790
4400,충청남도,4417,천안시서북구,잘못 투입·구분된 투표지,,0,8,4,4,0,0,0,0,0,0,0,0,0,0,8,0,-8
4400,충청남도,4418,천안시동남구,합계,,216193,157433,71851,77739,4085,83,1775,48,22,38,97,150,47,88,156023,1410,58760
4400,충청남도,4418,천안시동남구,거소·선상투표,,355,338,124,161,9,2,7,0,0,0,0,1,0,0,304,34,17
4400,충청남도,4418,천안시동남구,관외사전투표,,17450,17447,8421,8086,469,11,205,7,2,3,10,19,4,12,17249,198,3
4400,충청남도,4418,천안시동남구,재외투표,,775,548,342,128,26,0,0,1,1,0,1,0,0,0,499,49,227
4400,충청남도,4418,천안시동남구,목천읍,소계,18589,12506,6017,5841,312,5,170,2,2,4,13,15,7,6,12394,112,6083
4400,충청남도,4418,천안시동남구,,관내사전투표,3879,3879,2053,1697,71,0,29,1,0,2,0,3,2,1,3859,20,0
4400,충청남도,4418,천안시동남구,,목천읍제1투,2349,1243,415,751,35,2,15,0,1,0,4,3,2,1,1229,14,1106
4400,충청남도,4418,천안시동남구,,목천읍제2투,1673,995,368,580,27,0,12,0,0,1,0,1,0,0,989,6,678
4400,충청남도,4418,천안시동남구,,목천읍제3투,710,475,164,296,8,0,3,0,0,0,0,0,0,0,471,4,235
4400,충청남도,4418,천안시동남구,,목천읍제4투,2153,1327,616,635,25,1,28,1,0,0,6,1,1,1,1315,12,826
4400,충청남도,4418,천안시동남구,,목천읍제5투,2743,1755,943,666,72,2,32,0,0,1,1,6,1,2,1726,29,988
4400,충청남도,4418,천안시동남구,,목천읍제6투,1237,738,395,302,14,0,14,0,0,0,1,1,1,1,729,9,499
4400,충청남도,4418,천안시동남구,,목천읍제7투,3845,2094,1063,914,60,0,37,0,1,0,1,0,0,0,2076,18,1751
4400,충청남도,4418,천안시동남구,풍세면,소계,3883,2887,1078,1686,67,0,23,1,0,0,3,2,2,8,2870,17,996
4400,충청남도,4418,천안시동남구,,관내사전투표,1401,1401,609,740,28,0,7,1,0,0,2,0,2,4,1393,8,0
4400,충청남도,4418,천안시동남구,,풍세면제1투,877,497,164,304,15,0,9,0,0,0,0,0,0,3,495,2,380
4400,충청남도,4418,천안시동남구,,풍세면제2투,510,347,101,230,11,0,2,0,0,0,1,1,0,0,346,1,163
4400,충청남도,4418,천안시동남구,,풍세면제3투,1095,642,204,412,13,0,5,0,0,0,0,1,0,1,636,6,453
4400,충청남도,4418,천안시동남구,광덕면,소계,3718,2768,922,1750,45,0,23,0,0,5,2,4,1,2,2754,14,950
4400,충청남도,4418,천안시동남구,,관내사전투표,1108,1108,479,605,15,0,1,0,0,0,0,2,1,0,1103,5,0
4400,충청남도,4418,천안시동남구,,광덕면제1투,1106,745,156,559,10,0,10,0,0,2,1,1,0,1,740,5,361
4400,충청남도,4418,천안시동남구,,광덕면제2투,851,526,143,360,11,0,6,0,0,1,1,1,0,1,524,2,325
4400,충청남도,4418,천안시동남구,,광덕면제3투,653,389,144,226,9,0,6,0,0,2,0,0,0,0,387,2,264
4400,충청남도,4418,천안시동남구,북면,소계,3365,2218,804,1282,51,3,37,2,2,1,0,3,2,6,2193,25,1147
4400,충청남도,4418,천안시동남구,,관내사전투표,822,822,331,452,15,0,11,1,1,1,0,1,1,1,815,7,0
4400,충청남도,4418,천안시동남구,,북면제1투,1628,851,316,486,22,2,16,0,0,0,0,1,0,2,845,6,777
4400,충청남도,4418,천안시동남구,,북면제2투,915,545,157,344,14,1,10,1,1,0,0,1,1,3,533,12,370
4400,충청남도,4418,천안시동남구,성남면,소계,3037,2286,865,1322,42,1,25,2,0,1,0,2,2,3,2265,21,751
4400,충청남도,4418,천안시동남구,,관내사전투표,1191,1191,568,579,22,0,7,1,0,0,0,2,2,2,1183,8,0
4400,충청남도,4418,천안시동남구,,성남면제1투,728,470,135,306,8,0,11,1,0,0,0,0,0,1,462,8,258
4400,충청남도,4418,천안시동남구,,성남면제2투,1118,625,162,437,12,1,7,0,0,1,0,0,0,0,620,5,493
4400,충청남도,4418,천안시동남구,수신면,소계,2195,1660,619,981,24,2,16,2,0,2,2,2,0,0,1650,10,535
4400,충청남도,4418,천안시동남구,,관내사전투표,904,904,384,494,15,1,1,0,0,2,0,2,0,0,899,5,0
4400,충청남도,4418,천안시동남구,,수신면제1투,879,498,155,320,4,1,11,2,0,0,2,0,0,0,495,3,381
4400,충청남도,4418,천안시동남구,,수신면제2투,412,258,80,167,5,0,4,0,0,0,0,0,0,0,256,2,154
4400,충청남도,4418,천안시동남구,병천면,소계,5680,4113,1627,2319,82,0,39,1,0,4,4,4,5,2,4087,26,1567
4400,충청남도,4418,천안시동남구,,관내사전투표,2116,2116,963,1075,38,0,15,1,0,3,2,2,2,1,2102,14,0
4400,충청남도,4418,천안시동남구,,병천면제1투,2049,1049,376,631,17,0,13,0,0,1,1,1,0,1,1041,8,1000
4400,충청남도,4418,천안시동남구,,병천면제2투,951,569,171,379,13,0,4,0,0,0,0,0,1,0,568,1,382
4400,충청남도,4418,천안시동남구,,병천면제3투,564,379,117,234,14,0,7,0,0,0,1,1,2,0,376,3,185
4400,충청남도,4418,천안시동남구,동면,소계,1841,1338,433,845,25,0,13,2,0,1,0,2,3,1,1325,13,503
4400,충청남도,4418,천안시동남구,,관내사전투표,741,741,248,465,13,0,5,1,0,1,0,2,2,1,738,3,0
4400,충청남도,4418,천안시동남구,,동면투표소,1100,597,185,380,12,0,8,1,0,0,0,0,1,0,587,10,503
4400,충청남도,4418,천안시동남구,중앙동,소계,5176,3688,1337,2199,66,1,48,2,1,0,2,2,0,1,3659,29,1488
4400,충청남도,4418,천안시동남구,,관내사전투표,1762,1762,709,1004,27,1,11,1,0,0,0,1,0,1,1755,7,0
4400,충청남도,4418,천안시동남구,,중앙동제1투,1852,1041,299,688,19,0,21,0,0,0,2,1,0,0,1030,11,811
4400,충청남도,4418,천안시동남구,,중앙동제2투,1562,885,329,507,20,0,16,1,1,0,0,0,0,0,874,11,677
4400,충청남도,4418,천안시동남구,문성동,소계,3993,2855,1174,1541,74,3,32,1,1,2,0,2,1,0,2831,24,1138
4400,충청남도,4418,천안시동남구,,관내사전투표,1652,1652,722,862,38,2,15,1,0,0,0,2,0,0,1642,10,0
4400,충청남도,4418,천안시동남구,,문성동제1투,1233,606,232,336,17,0,10,0,1,2,0,0,0,0,598,8,627
4400,충청남도,4418,천안시동남구,,문성동제2투,1108,597,220,343,19,1,7,0,0,0,0,0,1,0,591,6,511
4400,충청남도,4418,천안시동남구,원성1동,소계,7744,5496,2218,3040,103,4,69,1,1,1,4,4,3,4,5452,44,2248
4400,충청남도,4418,천안시동남구,,관내사전투표,2590,2590,1158,1357,41,0,17,0,0,0,3,1,1,2,2580,10,0
4400,충청남도,4418,천안시동남구,,원성1동제1투,1544,858,304,506,9,0,22,0,0,0,0,0,0,2,843,15,686
4400,충청남도,4418,천안시동남구,,원성1동제2투,956,527,186,314,13,1,8,0,0,1,1,0,0,0,524,3,429
4400,충청남도,4418,천안시동남구,,원성1동제3투,1178,608,220,356,12,1,9,0,1,0,0,0,1,0,600,8,570
4400,충청남도,4418,천안시동남구,,원성1동제4투,1476,913,350,507,28,2,13,1,0,0,0,3,1,0,905,8,563
4400,충청남도,4418,천안시동남구,원성2동,소계,8595,6108,2424,3417,125,5,72,1,1,0,5,3,2,2,6057,51,2487
4400,충청남도,4418,천안시동남구,,관내사전투표,2926,2926,1304,1519,57,2,24,0,0,0,2,1,0,0,2909,17,0
4400,충청남도,4418,천안시동남구,,원성2동제1투,421,247,69,169,5,0,2,0,0,0,0,0,0,0,245,2,174
4400,충청남도,4418,천안시동남구,,원성2동제2투,2334,1387,513,798,30,2,19,0,0,0,3,2,1,2,1370,17,947
4400,충청남도,4418,천안시동남구,,원성2동제3투,1207,617,218,376,13,0,6,1,0,0,0,0,0,0,614,3,590
4400,충청남도,4418,천안시동남구,,원성2동제4투,1707,931,320,555,20,1,21,0,1,0,0,0,1,0,919,12,776
4400,충청남도,4418,천안시동남구,봉명동,소계,14166,9138,4068,4591,246,8,133,1,0,3,6,5,1,2,9064,74,5028
4400,충청남도,4418,천안시동남구,,관내사전투표,2964,2964,1479,1365,68,4,28,1,0,0,1,4,1,1,2952,12,0
4400,충청남도,4418,천안시동남구,,봉명동제1투,1787,841,342,444,21,1,19,0,0,1,0,0,0,0,828,13,946
4400,충청남도,4418,천안시동남구,,봉명동제2투,2161,1260,527,663,31,0,21,0,0,1,0,0,0,0,1243,17,901
4400,충청남도,4418,천안시동남구,,봉명동제3투,1998,1086,386,650,31,1,7,0,0,1,2,0,0,0,1078,8,912
4400,충청남도,4418,천안시동남구,,봉명동제4투,1469,722,273,414,16,0,13,0,0,0,0,0,0,0,716,6,747
4400,충청남도,4418,천안시동남구,,봉명동제5투,1831,1133,494,579,31,0,21,0,0,0,1,1,0,1,1128,5,698
4400,충청남도,4418,천안시동남구,,봉명동제6투,1956,1132,567,476,48,2,24,0,0,0,2,0,0,0,1119,13,824
4400,충청남도,4418,천안시동남구,일봉동,소계,15064,10500,4767,5229,268,5,116,2,2,1,10,10,5,5,10420,80,4564
4400,충청남도,4418,천안시동남구,,관내사전투표,3196,3196,1538,1552,60,2,23,0,0,0,1,3,1,3,3183,13,0
4400,충청남도,4418,천안시동남구,,일봉동제1투,2225,1122,407,645,28,1,24,1,2,0,1,2,1,0,1112,10,1103
4400,충청남도,4418,천안시동남구,,일봉동제2투,2563,1452,599,773,36,0,23,0,0,1,6,0,1,1,1440,12,1111
4400,충청남도,4418,천안시동남구,,일봉동제3투,1043,619,256,325,17,0,8,0,0,0,1,2,0,0,609,10,424
4400,충청남도,4418,천안시동남구,,일봉동제4투,2649,1843,813,929,56,1,21,0,0,0,1,1,0,1,1823,20,806
4400,충청남도,4418,천안시동남구,,일봉동제5투,3388,2268,1154,1005,71,1,17,1,0,0,0,2,2,0,2253,15,1120
4400,충청남도,4418,천안시동남구,신방동,소계,33613,23802,12562,10060,666,9,267,8,3,4,7,17,3,12,23618,184,9811
4400,충청남도,4418,천안시동남구,,관내사전투표,7980,7979,4712,2976,167,6,53,4,2,0,1,5,1,5,7932,47,1
4400,충청남도,4418,천안시동남구,,신방동제1투,2088,1419,622,729,41,0,15,0,0,0,0,1,0,1,1409,10,669
4400,충청남도,4418,천안시동남구,,신방동제2투,2619,1776,887,795,53,0,27,0,0,0,0,2,0,2,1766,10,843
4400,충청남도,4418,천안시동남구,,신방동제3투,2848,1865,989,765,71,2,19,2,0,1,2,2,0,0,1853,12,983
4400,충청남도,4418,천안시동남구,,신방동제4투,2415,1674,897,704,53,1,10,0,0,1,1,0,0,0,1667,7,741
4400,충청남도,4418,천안시동남구,,신방동제5투,1889,885,410,417,21,0,21,0,0,0,0,1,0,2,872,13,1004
4400,충청남도,4418,천안시동남구,,신방동제6투,1868,838,381,412,24,0,9,0,0,0,0,2,0,0,828,10,1030
4400,충청남도,4418,천안시동남구,,신방동제7투,1162,672,315,322,23,0,7,0,0,0,0,0,0,0,667,5,490
4400,충청남도,4418,천안시동남구,,신방동제8투,2643,1904,937,862,53,0,26,0,1,0,0,1,0,2,1882,22,739
4400,충청남도,4418,천안시동남구,,신방동제9투,3949,2369,1239,993,72,0,34,1,0,1,2,2,1,0,2345,24,1580
4400,충청남도,4418,천안시동남구,,신방동제10투,4152,2421,1173,1085,88,0,46,1,0,1,1,1,1,0,2397,24,1731
4400,충청남도,4418,천안시동남구,청룡동,소계,38198,27124,12994,12761,775,12,289,7,2,4,9,41,5,12,26911,213,11074
4400,충청남도,4418,천안시동남구,,관내사전투표,7281,7281,3858,3155,179,3,28,2,0,1,0,7,2,5,7240,41,0
4400,충청남도,4418,천안시동남구,,청룡동제1투,2390,1612,614,914,48,0,19,0,1,1,2,1,0,0,1600,12,778
4400,충청남도,4418,천안시동남구,,청룡동제2투,2546,1541,612,828,52,0,26,1,0,0,1,4,1,1,1526,15,1005
4400,충청남도,4418,천안시동남구,,청룡동제3투,1929,1432,633,739,35,0,11,0,0,0,0,5,0,0,1423,9,497
4400,충청남도,4418,천안시동남구,,청룡동제4투,3477,2334,1038,1161,87,1,30,0,0,0,0,1,0,1,2319,15,1143
4400,충청남도,4418,천안시동남구,,청룡동제5투,3198,1934,760,1068,50,1,26,1,0,0,1,7,0,2,1916,18,1264
4400,충청남도,4418,천안시동남구,,청룡동제6투,928,486,148,316,6,0,8,0,0,2,1,0,0,0,481,5,442
4400,충청남도,4418,천안시동남구,,청룡동제7투,4066,2503,1254,1099,81,0,40,2,0,0,1,2,0,1,2480,23,1563
4400,충청남도,4418,천안시동남구,,청룡동제8투,1658,1068,560,439,31,1,19,1,0,0,2,5,0,0,1058,10,590
4400,충청남도,4418,천안시동남구,,청룡동제9투,3573,2017,1004,902,59,4,24,0,0,0,1,4,0,0,1998,19,1556
4400,충청남도,4418,천안시동남구,,청룡동제10투,2292,1489,773,633,39,0,23,0,1,0,0,0,2,0,1471,18,803
4400,충청남도,4418,천안시동남구,,청룡동제11투,2865,2111,1118,888,66,0,20,0,0,0,0,1,0,2,2095,16,754
4400,충청남도,4418,천안시동남구,,청룡동제12투,1995,1316,622,619,42,2,15,0,0,0,0,4,0,0,1304,12,679
4400,충청남도,4418,천안시동남구,신안동,소계,28756,20609,9055,10496,610,12,191,5,4,2,19,12,1,10,20417,192,8147
4400,충청남도,4418,천안시동남구,,관내사전투표,6719,6719,3373,3043,214,6,41,1,2,0,2,4,1,4,6691,28,0
4400,충청남도,4418,천안시동남구,,신안동제1투,2068,1080,421,603,22,0,14,0,0,0,1,4,0,0,1065,15,988
4400,충청남도,4418,천안시동남구,,신안동제2투,2705,1785,758,911,63,1,23,1,1,0,2,0,0,1,1761,24,920
4400,충청남도,4418,천안시동남구,,신안동제3투,2041,1012,387,568,20,0,16,1,0,1,2,1,0,0,996,16,1029
4400,충청남도,4418,천안시동남구,,신안동제4투,2224,1536,587,874,49,1,13,0,1,0,2,0,0,0,1527,9,688
4400,충청남도,4418,천안시동남구,,신안동제5투,2676,1832,765,957,64,0,19,0,0,0,3,1,0,2,1811,21,844
4400,충청남도,4418,천안시동남구,,신안동제6투,3012,1808,801,900,51,1,22,1,0,1,5,1,0,1,1784,24,1204
4400,충청남도,4418,천안시동남구,,신안동제7투,2427,1629,687,861,45,0,17,1,0,0,2,0,0,1,1614,15,798
4400,충청남도,4418,천안시동남구,,신안동제8투,2505,1530,608,847,38,1,11,0,0,0,0,1,0,0,1506,24,975
4400,충청남도,4418,천안시동남구,,신안동제9투,2379,1678,668,932,44,2,15,0,0,0,0,0,0,1,1662,16,701
4400,충청남도,4418,천안시동남구,잘못 투입·구분된 투표지,,0,4,0,4,0,0,0,0,0,0,0,0,0,0,4,0,-4
4400,충청남도,4402,공주시,합계,,91684,68872,28472,37339,1423,43,695,21,6,16,57,89,48,42,68251,621,22812
4400,충청남도,4402,공주시,거소·선상투표,,187,177,58,98,2,0,5,0,0,0,0,0,0,0,163,14,10
4400,충청남도,4402,공주시,관외사전투표,,7347,7346,3536,3405,205,8,94,1,1,2,5,7,2,6,7272,74,1
4400,충청남도,4402,공주시,재외투표,,390,281,168,92,5,0,1,0,0,0,1,1,0,0,268,13,109
4400,충청남도,4402,공주시,유구읍,소계,6195,4544,1403,2966,60,3,48,0,0,1,5,6,5,2,4499,45,1651
4400,충청남도,4402,공주시,,관내사전투표,1941,1942,668,1189,29,1,21,0,0,0,3,5,3,1,1920,22,-1
4400,충청남도,4402,공주시,,유구읍제1투,1941,1146,316,792,16,1,8,0,0,1,0,1,1,0,1136,10,795
4400,충청남도,4402,공주시,,유구읍제2투,1355,857,240,582,12,1,15,0,0,0,0,0,1,0,851,6,498
4400,충청남도,4402,공주시,,유구읍제3투,958,599,179,403,3,0,4,0,0,0,2,0,0,1,592,7,359
4400,충청남도,4402,공주시,이인면,소계,2717,2002,748,1184,18,1,19,0,1,0,0,3,6,0,1980,22,715
4400,충청남도,4402,공주시,,관내사전투표,868,868,361,481,7,1,8,0,0,0,0,1,0,0,859,9,0
4400,충청남도,4402,공주시,,이인면제1투,955,581,177,382,8,0,3,0,0,0,0,2,2,0,574,7,374
4400,충청남도,4402,공주시,,이인면제2투,894,553,210,321,3,0,8,0,1,0,0,0,4,0,547,6,341
4400,충청남도,4402,공주시,탄천면,소계,2507,1776,624,1048,40,2,15,2,0,2,4,3,4,1,1745,31,731
4400,충청남도,4402,공주시,,관내사전투표,858,858,336,472,20,2,6,2,0,1,1,1,3,0,844,14,0
4400,충청남도,4402,공주시,,탄천면제1투,1009,499,157,309,11,0,8,0,0,0,0,1,1,0,487,12,510
4400,충청남도,4402,공주시,,탄천면제2투,640,419,131,267,9,0,1,0,0,1,3,1,0,1,414,5,221
4400,충청남도,4402,공주시,계룡면,소계,4433,3253,1178,1973,41,0,30,0,0,0,1,1,0,0,3224,29,1180
4400,충청남도,4402,공주시,,관내사전투표,1372,1372,593,740,19,0,10,0,0,0,0,1,0,0,1363,9,0
4400,충청남도,4402,공주시,,계룡면제1투,1010,556,183,349,11,0,6,0,0,0,0,0,0,0,549,7,454
4400,충청남도,4402,공주시,,계룡면제2투,393,272,89,178,0,0,2,0,0,0,1,0,0,0,270,2,121
4400,충청남도,4402,공주시,,계룡면제3투,605,398,101,281,4,0,7,0,0,0,0,0,0,0,393,5,207
4400,충청남도,4402,공주시,,계룡면제4투,1053,655,212,425,7,0,5,0,0,0,0,0,0,0,649,6,398
4400,충청남도,4402,공주시,반포면,소계,3494,2587,900,1572,46,4,27,3,3,0,1,2,2,0,2560,27,907
4400,충청남도,4402,공주시,,관내사전투표,1184,1184,476,669,23,0,6,2,1,0,1,0,2,0,1180,4,0
4400,충청남도,4402,공주시,,반포면제1투,1328,729,220,462,13,2,12,1,0,0,0,1,0,0,711,18,599
4400,충청남도,4402,공주시,,반포면제2투,982,674,204,441,10,2,9,0,2,0,0,1,0,0,669,5,308
4400,충청남도,4402,공주시,의당면,소계,4303,3190,1391,1671,55,1,31,1,0,0,3,7,2,1,3163,27,1113
4400,충청남도,4402,공주시,,관내사전투표,1758,1758,811,886,32,0,12,0,0,0,2,3,1,0,1747,11,0
4400,충청남도,4402,공주시,,의당면제1투,1344,668,296,344,9,0,8,0,0,0,1,3,0,0,661,7,676
4400,충청남도,4402,공주시,,의당면제2투,518,348,137,194,3,1,6,1,0,0,0,0,0,0,342,6,170
4400,충청남도,4402,공주시,,의당면제3투,683,416,147,247,11,0,5,0,0,0,0,1,1,1,413,3,267
4400,충청남도,4402,공주시,정안면,소계,3908,2855,1065,1676,41,4,28,2,0,0,8,1,6,1,2832,23,1053
4400,충청남도,4402,공주시,,관내사전투표,1331,1331,558,736,15,1,6,0,0,0,1,0,4,1,1322,9,0
4400,충청남도,4402,공주시,,정안면제1투,819,460,137,296,7,1,6,1,0,0,6,0,2,0,456,4,359
4400,충청남도,4402,공주시,,정안면제2투,594,375,124,230,7,0,9,1,0,0,1,0,0,0,372,3,219
4400,충청남도,4402,공주시,,정안면제3투,1164,689,246,414,12,2,7,0,0,0,0,1,0,0,682,7,475
4400,충청남도,4402,공주시,우성면,소계,4375,3299,1218,1961,57,0,23,2,1,0,2,6,1,5,3276,23,1076
4400,충청남도,4402,공주시,,관내사전투표,1163,1163,505,621,22,0,5,0,0,0,0,2,0,1,1156,7,0
4400,충청남도,4402,공주시,,우성면제1투,689,428,143,268,9,0,4,0,0,0,1,0,0,2,427,1,261
4400,충청남도,4402,공주시,,우성면제2투,828,573,181,371,8,0,4,0,0,0,1,0,0,0,565,8,255
4400,충청남도,4402,공주시,,우성면제3투,1085,724,276,420,11,0,6,1,1,0,0,3,0,2,720,4,361
4400,충청남도,4402,공주시,,우성면제4투,610,411,113,281,7,0,4,1,0,0,0,1,1,0,408,3,199
4400,충청남도,4402,공주시,사곡면,소계,2338,1711,581,1071,25,2,13,0,0,1,1,3,1,2,1700,11,627
4400,충청남도,4402,공주시,,관내사전투표,816,816,297,499,11,2,4,0,0,0,0,0,0,1,814,2,0
4400,충청남도,4402,공주시,,사곡면제1투,813,434,123,292,7,0,7,0,0,0,1,0,0,0,430,4,379
4400,충청남도,4402,공주시,,사곡면제2투,709,461,161,280,7,0,2,0,0,1,0,3,1,1,456,5,248
4400,충청남도,4402,공주시,신풍면,소계,2508,1858,633,1155,35,1,11,1,0,1,2,2,4,1,1846,12,650
4400,충청남도,4402,공주시,,관내사전투표,932,932,367,535,15,1,4,0,0,1,2,1,1,0,927,5,0
4400,충청남도,4402,공주시,,신풍면제1투,1026,576,173,376,11,0,6,1,0,0,0,1,2,0,570,6,450
4400,충청남도,4402,공주시,,신풍면제2투,550,350,93,244,9,0,1,0,0,0,0,0,1,1,349,1,200
4400,충청남도,4402,공주시,중학동,소계,4084,2988,1239,1623,56,2,30,1,0,1,3,3,3,2,2963,25,1096
4400,충청남도,4402,공주시,,관내사전투표,1417,1417,674,676,41,1,11,0,0,0,1,1,2,1,1408,9,0
4400,충청남도,4402,공주시,,중학동제1투,561,326,119,192,8,0,2,0,0,0,1,0,0,1,323,3,235
4400,충청남도,4402,공주시,,중학동제2투,568,325,108,204,2,0,6,0,0,1,0,0,1,0,322,3,243
4400,충청남도,4402,공주시,,중학동제3투,817,491,162,313,2,0,8,0,0,0,0,2,0,0,487,4,326
4400,충청남도,4402,공주시,,중학동제4투,721,429,176,238,3,1,3,1,0,0,1,0,0,0,423,6,292
4400,충청남도,4402,공주시,웅진동,소계,7192,5327,2190,2909,111,1,50,2,0,2,3,7,4,3,5282,45,1865
4400,충청남도,4402,공주시,,관내사전투표,2917,2917,1261,1555,59,0,20,1,0,2,0,1,4,1,2904,13,0
4400,충청남도,4402,공주시,,웅진동제1투,668,395,149,224,10,0,5,0,0,0,0,1,0,2,391,4,273
4400,충청남도,4402,공주시,,웅진동제2투,840,476,159,303,7,0,4,0,0,0,0,2,0,0,475,1,364
4400,충청남도,4402,공주시,,웅진동제3투,1343,731,287,397,16,0,12,1,0,0,0,1,0,0,714,17,612
4400,충청남도,4402,공주시,,웅진동제4투,1424,808,334,430,19,1,9,0,0,0,3,2,0,0,798,10,616
4400,충청남도,4402,공주시,금학동,소계,4087,2881,1251,1479,78,3,37,1,0,0,0,2,1,3,2855,26,1206
4400,충청남도,4402,공주시,,관내사전투표,1378,1378,660,647,47,1,14,0,0,0,0,0,0,2,1371,7,0
4400,충청남도,4402,공주시,,금학동제1투,1752,982,442,485,19,2,16,1,0,0,0,2,0,1,968,14,770
4400,충청남도,4402,공주시,,금학동제2투,957,521,149,347,12,0,7,0,0,0,0,0,1,0,516,5,436
4400,충청남도,4402,공주시,옥룡동,소계,6614,4713,1816,2694,86,2,48,1,0,1,6,4,2,7,4667,46,1901
4400,충청남도,4402,공주시,,관내사전투표,2133,2133,870,1192,40,1,15,0,0,0,0,2,1,4,2125,8,0
4400,충청남도,4402,공주시,,옥룡동제1투,835,449,150,278,7,0,7,0,0,0,0,0,0,1,443,6,386
4400,충청남도,4402,공주시,,옥룡동제2투,1693,920,330,526,20,1,19,1,0,1,4,1,1,1,905,15,773
4400,충청남도,4402,공주시,,옥룡동제3투,1145,717,298,393,9,0,4,0,0,0,2,1,0,0,707,10,428
4400,충청남도,4402,공주시,,옥룡동제4투,808,494,168,305,10,0,3,0,0,0,0,0,0,1,487,7,314
4400,충청남도,4402,공주시,신관동,소계,13936,9673,4365,4833,245,4,110,2,0,3,6,15,3,5,9591,82,4263
4400,충청남도,4402,공주시,,관내사전투표,4485,4485,2194,2089,109,2,44,2,0,1,2,10,2,3,4458,27,0
4400,충청남도,4402,공주시,,신관동제1투,1458,765,310,412,16,1,11,0,0,0,3,0,0,0,753,12,693
4400,충청남도,4402,공주시,,신관동제2투,1797,976,445,486,19,0,18,0,0,1,0,1,1,1,972,4,821
4400,충청남도,4402,공주시,,신관동제3투,2036,1096,461,582,24,1,10,0,0,1,0,0,0,0,1079,17,940
4400,충청남도,4402,공주시,,신관동제4투,2232,1169,469,636,36,0,13,0,0,0,0,2,0,1,1157,12,1063
4400,충청남도,4402,공주시,,신관동제5투,1928,1182,486,628,41,0,14,0,0,0,1,2,0,0,1172,10,746
4400,충청남도,4402,공주시,월송동,소계,11069,8410,4108,3928,217,5,75,2,0,2,6,16,2,3,8364,46,2659
4400,충청남도,4402,공주시,,관내사전투표,4817,4817,2506,2125,114,4,34,2,0,0,3,9,1,1,4799,18,0
4400,충청남도,4402,공주시,,월송동제1투,1977,1165,525,583,34,1,7,0,0,2,1,2,0,1,1156,9,812
4400,충청남도,4402,공주시,,월송동제2투,1814,1026,465,509,26,0,16,0,0,0,0,2,1,0,1019,7,788
4400,충청남도,4402,공주시,,월송동제3투,502,305,86,209,7,0,1,0,0,0,0,0,0,1,304,1,197
4400,충청남도,4402,공주시,,월송동제4투,1959,1097,526,502,36,0,17,0,0,0,2,3,0,0,1086,11,862
4400,충청남도,4402,공주시,잘못 투입·구분된 투표지,,0,1,0,1,0,0,0,0,0,0,0,0,0,0,1,0,-1
4400,충청남도,4403,보령시,합계,,86253,65715,26207,36419,1367,37,655,28,14,18,55,103,59,70,65032,683,20538
4400,충청남도,4403,보령시,거소·선상투표,,271,244,70,129,8,1,4,2,1,0,1,0,2,2,220,24,27
4400,충청남도,4403,보령시,관외사전투표,,6179,6177,2815,3024,170,8,69,5,0,1,2,7,6,8,6115,62,2
4400,충청남도,4403,보령시,재외투표,,248,182,113,53,3,0,0,0,0,0,0,0,0,0,169,13,66
4400,충청남도,4403,보령시,웅천읍,소계,5232,4005,1370,2476,55,2,37,1,1,0,2,4,8,8,3964,41,1227
4400,충청남도,4403,보령시,,관내사전투표,1967,1967,739,1159,26,2,14,0,0,0,2,3,3,4,1952,15,0
4400,충청남도,4403,보령시,,웅천읍제1투,1247,768,239,491,13,0,10,1,1,0,0,1,1,1,758,10,479
4400,충청남도,4403,보령시,,웅천읍제2투,992,586,163,396,9,0,7,0,0,0,0,0,3,2,580,6,406
4400,충청남도,4403,보령시,,웅천읍제3투,1026,684,229,430,7,0,6,0,0,0,0,0,1,1,674,10,342
4400,충청남도,4403,보령시,주포면,소계,1451,1153,412,681,23,1,15,0,0,2,0,3,1,2,1140,13,298
4400,충청남도,4403,보령시,,관내사전투표,680,680,284,364,16,1,5,0,0,0,0,1,1,2,674,6,0
4400,충청남도,4403,보령시,,주포면투표소,771,473,128,317,7,0,10,0,0,2,0,2,0,0,466,7,298
4400,충청남도,4403,보령시,주교면,소계,4323,3093,1216,1666,63,6,22,2,6,3,3,2,4,15,3008,85,1230
4400,충청남도,4403,보령시,,관내사전투표,1584,1584,692,738,39,6,11,2,6,3,0,1,3,13,1514,70,0
4400,충청남도,4403,보령시,,주교면제1투,1568,822,309,476,12,0,10,0,0,0,2,1,1,2,813,9,746
4400,충청남도,4403,보령시,,주교면제2투,1171,687,215,452,12,0,1,0,0,0,1,0,0,0,681,6,484
4400,충청남도,4403,보령시,오천면,소계,3616,2602,854,1631,44,3,16,1,0,0,1,7,3,4,2564,38,1014
4400,충청남도,4403,보령시,,관내사전투표,714,714,247,438,15,2,3,0,0,0,0,3,1,0,709,5,0
4400,충청남도,4403,보령시,,오천면제1투,1018,596,207,363,12,0,6,0,0,0,0,1,0,0,589,7,422
4400,충청남도,4403,보령시,,오천면제2투,176,105,34,63,3,0,1,1,0,0,0,0,0,0,102,3,71
4400,충청남도,4403,보령시,,오천면제3투,663,466,107,335,6,0,5,0,0,0,0,1,0,2,456,10,197
4400,충청남도,4403,보령시,,오천면제4투,292,200,71,120,1,1,0,0,0,0,1,2,1,1,198,2,92
4400,충청남도,4403,보령시,,오천면제5투,125,93,21,68,3,0,0,0,0,0,0,0,0,0,92,1,32
4400,충청남도,4403,보령시,,오천면제6투,158,115,48,62,2,0,0,0,0,0,0,0,0,0,112,3,43
4400,충청남도,4403,보령시,,오천면제7투,118,91,29,58,1,0,0,0,0,0,0,0,1,0,89,2,27
4400,충청남도,4403,보령시,,오천면제8투,125,91,28,58,1,0,0,0,0,0,0,0,0,1,88,3,34
4400,충청남도,4403,보령시,,오천면제9투,227,131,62,66,0,0,1,0,0,0,0,0,0,0,129,2,96
4400,충청남도,4403,보령시,천북면,소계,2839,2115,730,1297,35,0,14,0,0,1,3,2,5,4,2091,24,724
4400,충청남도,4403,보령시,,관내사전투표,944,944,357,558,13,0,7,0,0,0,1,0,3,0,939,5,0
4400,충청남도,4403,보령시,,천북면제1투,1199,723,243,438,15,0,6,0,0,0,2,1,0,4,709,14,476
4400,충청남도,4403,보령시,,천북면제2투,696,448,130,301,7,0,1,0,0,1,0,1,2,0,443,5,248
4400,충청남도,4403,보령시,청소면,소계,2293,1733,520,1123,34,1,22,2,1,0,3,1,2,1,1710,23,560
4400,충청남도,4403,보령시,,관내사전투표,977,977,311,621,23,0,5,1,1,0,1,0,1,1,965,12,0
4400,충청남도,4403,보령시,,청소면투표소,1316,756,209,502,11,1,17,1,0,0,2,1,1,0,745,11,560
4400,충청남도,4403,보령시,청라면,소계,3224,2477,811,1559,43,2,27,0,0,0,3,5,3,0,2453,24,747
4400,충청남도,4403,보령시,,관내사전투표,1113,1113,403,663,19,0,11,0,0,0,0,4,3,0,1103,10,0
4400,충청남도,4403,보령시,,청라면제1투,618,364,94,256,7,0,2,0,0,0,3,0,0,0,362,2,254
4400,충청남도,4403,보령시,,청라면제2투,739,505,160,321,11,0,7,0,0,0,0,1,0,0,500,5,234
4400,충청남도,4403,보령시,,청라면제3투,754,495,154,319,6,2,7,0,0,0,0,0,0,0,488,7,259
4400,충청남도,4403,보령시,남포면,소계,4379,3210,1104,1989,46,2,29,1,0,2,2,4,4,3,3186,24,1169
4400,충청남도,4403,보령시,,관내사전투표,1631,1631,592,990,20,2,13,1,0,0,0,4,0,1,1623,8,0
4400,충청남도,4403,보령시,,남포면제1투,1094,614,197,393,10,0,7,0,0,2,0,0,0,0,609,5,480
4400,충청남도,4403,보령시,,남포면제2투,980,564,192,347,11,0,5,0,0,0,0,0,2,1,558,6,416
4400,충청남도,4403,보령시,,남포면제3투,674,401,123,259,5,0,4,0,0,0,2,0,2,1,396,5,273
4400,충청남도,4403,보령시,주산면,소계,2079,1603,530,1002,33,0,14,0,0,0,1,4,3,2,1589,14,476
4400,충청남도,4403,보령시,,관내사전투표,776,776,268,476,19,0,3,0,0,0,0,3,1,1,771,5,0
4400,충청남도,4403,보령시,,주산면제1투,920,575,170,378,10,0,9,0,0,0,1,1,1,1,571,4,345
4400,충청남도,4403,보령시,,주산면제2투,383,252,92,148,4,0,2,0,0,0,0,0,1,0,247,5,131
4400,충청남도,4403,보령시,미산면,소계,1376,1053,349,651,17,2,12,1,0,0,5,1,1,4,1043,10,323
4400,충청남도,4403,보령시,,관내사전투표,349,349,121,214,4,1,4,1,0,0,0,0,1,2,348,1,0
4400,충청남도,4403,보령시,,미산면제1투,331,223,75,137,5,0,1,0,0,0,0,0,0,0,218,5,108
4400,충청남도,4403,보령시,,미산면제2투,390,275,93,168,3,0,5,0,0,0,1,1,0,2,273,2,115
4400,충청남도,4403,보령시,,미산면제3투,306,206,60,132,5,1,2,0,0,0,4,0,0,0,204,2,100
4400,충청남도,4403,보령시,성주면,소계,2111,1639,639,912,35,0,22,0,0,2,3,1,3,1,1618,21,472
4400,충청남도,4403,보령시,,관내사전투표,872,872,385,449,19,0,9,0,0,0,0,1,1,1,865,7,0
4400,충청남도,4403,보령시,,성주면제1투,830,499,163,300,12,0,10,0,0,1,1,0,1,0,488,11,331
4400,충청남도,4403,보령시,,성주면제2투,409,268,91,163,4,0,3,0,0,1,2,0,1,0,265,3,141
4400,충청남도,4403,보령시,대천1동,소계,10559,7676,3076,4246,169,3,82,4,1,1,8,21,4,2,7617,59,2883
4400,충청남도,4403,보령시,,관내사전투표,3407,3407,1422,1846,71,2,26,1,0,0,1,10,0,1,3380,27,0
4400,충청남도,4403,보령시,,대천1동제1투,1029,556,175,368,5,0,3,1,0,1,1,0,0,0,554,2,473
4400,충청남도,4403,보령시,,대천1동제2투,889,502,175,308,8,0,6,0,1,0,0,2,0,0,500,2,387
4400,충청남도,4403,보령시,,대천1동제3투,1618,1013,353,609,24,1,6,1,0,0,0,3,3,1,1001,12,605
4400,충청남도,4403,보령시,,대천1동제4투,1633,1030,430,548,21,0,19,0,0,0,1,5,0,0,1024,6,603
4400,충청남도,4403,보령시,,대천1동제5투,1983,1168,521,567,40,0,22,1,0,0,5,1,1,0,1158,10,815
4400,충청남도,4403,보령시,대천2동,소계,6765,5349,2090,3043,105,2,47,3,0,0,2,12,3,1,5308,41,1416
4400,충청남도,4403,보령시,,관내사전투표,3460,3459,1440,1891,71,2,22,0,0,0,2,7,1,1,3437,22,1
4400,충청남도,4403,보령시,,대천2동제1투,955,522,165,328,12,0,9,0,0,0,0,3,1,0,518,4,433
4400,충청남도,4403,보령시,,대천2동제2투,631,368,88,261,4,0,8,1,0,0,0,0,1,0,363,5,263
4400,충청남도,4403,보령시,,대천2동제3투,1719,1000,397,563,18,0,8,2,0,0,0,2,0,0,990,10,719
4400,충청남도,4403,보령시,대천3동,소계,10995,7869,3656,3805,222,0,83,2,2,2,4,14,2,3,7795,74,3126
4400,충청남도,4403,보령시,,관내사전투표,3162,3161,1600,1430,83,0,22,2,0,0,1,6,0,2,3146,15,1
4400,충청남도,4403,보령시,,대천3동제1투,1281,668,248,379,17,0,7,0,0,0,2,1,0,0,654,14,613
4400,충청남도,4403,보령시,,대천3동제2투,1790,1162,518,592,22,0,14,0,0,1,0,2,0,0,1149,13,628
4400,충청남도,4403,보령시,,대천3동제3투,1795,1011,402,557,27,0,10,0,1,1,1,1,1,1,1002,9,784
4400,충청남도,4403,보령시,,대천3동제4투,1463,833,336,428,33,0,17,0,1,0,0,3,1,0,819,14,630
4400,충청남도,4403,보령시,,대천3동제5투,1504,1034,552,419,40,0,13,0,0,0,0,1,0,0,1025,9,470
4400,충청남도,4403,보령시,대천4동,소계,12805,9528,4392,4732,205,3,102,4,2,1,4,11,2,8,9466,62,3277
4400,충청남도,4403,보령시,,관내사전투표,4970,4969,2453,2321,110,1,44,1,1,0,3,6,0,5,4945,24,1
4400,충청남도,4403,보령시,,대천4동제1투,1675,873,311,509,16,1,15,1,1,0,0,2,1,3,860,13,802
4400,충청남도,4403,보령시,,대천4동제2투,1318,779,266,484,16,1,9,0,0,0,1,0,0,0,777,2,539
4400,충청남도,4403,보령시,,대천4동제3투,2461,1492,722,703,35,0,21,1,0,0,0,2,0,0,1484,8,969
4400,충청남도,4403,보령시,,대천4동제4투,2381,1415,640,715,28,0,13,1,0,1,0,1,1,0,1400,15,966
4400,충청남도,4403,보령시,대천5동,소계,5508,4006,1459,2400,57,1,38,0,0,3,8,4,3,2,3975,31,1502
4400,충청남도,4403,보령시,,관내사전투표,1893,1893,802,1018,34,1,17,0,0,0,1,3,3,1,1880,13,0
4400,충청남도,4403,보령시,,대천5동제1투,1032,551,188,346,6,0,7,0,0,0,2,0,0,0,549,2,481
4400,충청남도,4403,보령시,,대천5동제2투,1151,645,218,404,5,0,7,0,0,2,3,0,0,0,639,6,506
4400,충청남도,4403,보령시,,대천5동제3투,1432,917,251,632,12,0,7,0,0,1,2,1,0,1,907,10,515
4400,충청남도,4403,보령시,잘못 투입·구분된 투표지,,0,1,1,0,0,0,0,0,0,0,0,0,0,0,1,0,-1
4400,충청남도,4404,아산시,합계,,265136,192927,93262,89998,4976,104,2193,85,34,42,120,169,55,72,191110,1817,72209
4400,충청남도,4404,아산시,거소·선상투표,,475,445,179,165,10,3,18,1,1,0,2,1,0,1,381,64,30
4400,충청남도,4404,아산시,관외사전투표,,20670,20665,9896,9596,555,16,266,13,5,3,13,20,5,8,20396,269,5
4400,충청남도,4404,아산시,재외투표,,810,567,347,155,18,0,2,0,0,0,0,0,0,0,522,45,243
4400,충청남도,4404,아산시,염치읍,소계,5516,3801,1604,2022,85,4,48,0,0,4,1,4,4,1,3777,24,1715
4400,충청남도,4404,아산시,,관내사전투표,1602,1602,787,752,39,2,12,0,0,1,0,1,1,0,1595,7,0
4400,충청남도,4404,아산시,,염치읍제1투,869,510,166,318,8,0,12,0,0,1,0,1,1,0,507,3,359
4400,충청남도,4404,아산시,,염치읍제2투,1269,679,277,370,14,1,9,0,0,0,0,0,0,1,672,7,590
4400,충청남도,4404,아산시,,염치읍제3투,1776,1010,374,582,24,1,15,0,0,2,1,2,2,0,1003,7,766
4400,충청남도,4404,아산시,배방읍,소계,55763,39294,20982,16333,1140,18,401,9,6,5,21,42,7,12,38976,318,16469
4400,충청남도,4404,아산시,,관내사전투표,10172,10168,6180,3628,235,2,73,6,1,0,0,8,1,0,10134,34,4
4400,충청남도,4404,아산시,,배방읍제1투,760,493,184,288,6,0,5,0,0,0,1,2,0,1,487,6,267
4400,충청남도,4404,아산시,,배방읍제2투,3626,1976,936,938,50,2,23,1,0,1,1,5,0,1,1958,18,1650
4400,충청남도,4404,아산시,,배방읍제3투,2290,1524,859,590,37,1,17,0,0,0,2,2,0,0,1508,16,766
4400,충청남도,4404,아산시,,배방읍제4투,3243,2145,1128,913,62,0,18,1,0,0,2,2,0,0,2126,19,1098
4400,충청남도,4404,아산시,,배방읍제5투,4162,2173,1163,878,73,0,26,1,1,0,1,4,1,0,2148,25,1989
4400,충청남도,4404,아산시,,배방읍제6투,1783,1241,693,489,35,0,14,0,0,0,0,2,0,1,1234,7,542
4400,충청남도,4404,아산시,,배방읍제7투,3167,1719,856,764,59,2,18,0,1,0,0,3,0,0,1703,16,1448
4400,충청남도,4404,아산시,,배방읍제8투,1309,740,260,451,7,0,14,0,0,0,0,1,2,0,735,5,569
4400,충청남도,4404,아산시,,배방읍제9투,3137,2320,1270,945,68,1,18,0,2,0,1,1,1,1,2308,12,817
4400,충청남도,4404,아산시,,배방읍제10투,838,555,185,347,10,0,5,0,0,0,0,0,1,0,548,7,283
4400,충청남도,4404,아산시,,배방읍제11투,1737,1071,509,491,34,1,20,0,0,0,1,1,0,1,1058,13,666
4400,충청남도,4404,아산시,,배방읍제12투,4671,3097,1632,1261,115,5,37,0,1,1,2,3,0,0,3057,40,1574
4400,충청남도,4404,아산시,,배방읍제13투,3453,2410,1275,1005,86,0,16,0,0,0,5,4,0,1,2392,18,1043
4400,충청남도,4404,아산시,,배방읍제14투,2411,1870,822,975,48,0,6,0,0,0,1,0,0,1,1853,17,541
4400,충청남도,4404,아산시,,배방읍제15투,2537,1745,883,760,70,1,17,0,0,0,2,1,0,1,1735,10,792
4400,충청남도,4404,아산시,,배방읍제16투,1894,1130,556,490,33,0,23,0,0,1,2,2,0,2,1109,21,764
4400,충청남도,4404,아산시,,배방읍제17투,883,630,316,245,34,2,17,0,0,0,0,0,0,0,614,16,253
4400,충청남도,4404,아산시,,배방읍제18투,3690,2287,1275,875,78,1,34,0,0,2,0,1,1,2,2269,18,1403
4400,충청남도,4404,아산시,송악면,소계,3536,2697,1129,1451,63,1,19,5,0,1,1,2,1,3,2676,21,839
4400,충청남도,4404,아산시,,관내사전투표,1414,1414,685,671,36,0,8,3,0,0,1,1,1,1,1407,7,0
4400,충청남도,4404,아산시,,송악면제1투,977,570,194,345,15,0,4,1,0,0,0,1,0,1,561,9,407
4400,충청남도,4404,아산시,,송악면제2투,677,403,146,244,7,1,3,1,0,0,0,0,0,0,402,1,274
4400,충청남도,4404,아산시,,송악면제3투,468,310,104,191,5,0,4,0,0,1,0,0,0,1,306,4,158
4400,충청남도,4404,아산시,탕정면,소계,18245,13687,7253,5795,354,4,146,14,0,0,7,8,2,3,13586,101,4558
4400,충청남도,4404,아산시,,관내사전투표,5354,5354,3041,2119,108,2,47,8,0,0,0,3,0,0,5328,26,0
4400,충청남도,4404,아산시,,탕정면제1투,1227,571,206,340,10,0,8,0,0,0,0,0,0,0,564,7,656
4400,충청남도,4404,아산시,,탕정면제2투,2196,1159,574,505,30,1,26,6,0,0,0,1,1,1,1145,14,1037
4400,충청남도,4404,아산시,,탕정면제3투,884,392,132,228,9,0,11,0,0,0,0,0,0,0,380,12,492
4400,충청남도,4404,아산시,,탕정면제4투,3146,2369,1275,980,77,0,14,0,0,0,4,1,1,1,2353,16,777
4400,충청남도,4404,아산시,,탕정면제5투,2426,1834,1075,684,45,1,16,0,0,0,1,1,0,1,1824,10,592
4400,충청남도,4404,아산시,,탕정면제6투,3012,2008,950,939,75,0,24,0,0,0,2,2,0,0,1992,16,1004
4400,충청남도,4404,아산시,음봉면,소계,14405,9795,4766,4547,224,4,142,2,2,2,12,5,5,4,9715,80,4610
4400,충청남도,4404,아산시,,관내사전투표,2844,2844,1535,1211,57,1,26,1,0,0,1,1,2,1,2836,8,0
4400,충청남도,4404,아산시,,음봉면제1투,1002,551,161,359,9,0,9,0,1,1,4,0,0,2,546,5,451
4400,충청남도,4404,아산시,,음봉면제2투,2518,1404,632,690,33,1,31,1,0,0,0,1,1,0,1390,14,1114
4400,충청남도,4404,아산시,,음봉면제3투,1220,744,243,462,8,1,14,0,0,1,2,1,0,0,732,12,476
4400,충청남도,4404,아산시,,음봉면제4투,2824,1699,757,844,48,1,25,0,1,0,2,1,1,0,1680,19,1125
4400,충청남도,4404,아산시,,음봉면제5투,1155,556,299,218,15,0,15,0,0,0,2,1,0,0,550,6,599
4400,충청남도,4404,아산시,,음봉면제6투,2842,1997,1139,763,54,0,22,0,0,0,1,0,1,1,1981,16,845
4400,충청남도,4404,아산시,둔포면,소계,17483,11328,5443,5373,246,9,134,5,2,3,4,7,4,6,11236,92,6155
4400,충청남도,4404,아산시,,관내사전투표,4321,4321,2287,1887,74,3,47,1,0,0,0,2,2,3,4306,15,0
4400,충청남도,4404,아산시,,둔포면제1투,1584,728,265,418,19,1,9,0,0,0,0,1,1,2,716,12,856
4400,충청남도,4404,아산시,,둔포면제2투,792,491,160,315,8,0,2,0,0,0,0,0,0,0,485,6,301
4400,충청남도,4404,아산시,,둔포면제3투,1254,731,247,441,19,1,12,1,0,2,1,0,0,0,724,7,523
4400,충청남도,4404,아산시,,둔포면제4투,3791,1907,919,889,47,2,23,1,1,0,1,1,1,1,1886,21,1884
4400,충청남도,4404,아산시,,둔포면제5투,2255,1164,516,586,24,2,15,0,1,1,0,2,0,0,1147,17,1091
4400,충청남도,4404,아산시,,둔포면제6투,3486,1986,1049,837,55,0,26,2,0,0,2,1,0,0,1972,14,1500
4400,충청남도,4404,아산시,영인면,소계,5051,3792,1519,2075,70,4,37,3,2,0,2,5,2,2,3721,71,1259
4400,충청남도,4404,아산시,,관내사전투표,1730,1730,822,822,23,3,14,1,2,0,0,2,0,1,1690,40,0
4400,충청남도,4404,아산시,,영인면제1투,999,568,206,319,24,0,13,1,0,0,1,0,0,0,564,4,431
4400,충청남도,4404,아산시,,영인면제2투,767,489,151,309,10,0,3,0,0,0,0,1,2,0,476,13,278
4400,충청남도,4404,아산시,,영인면제3투,1015,640,209,408,9,1,4,1,0,0,1,1,0,1,635,5,375
4400,충청남도,4404,아산시,,영인면제4투,540,365,131,217,4,0,3,0,0,0,0,1,0,0,356,9,175
4400,충청남도,4404,아산시,인주면,소계,5252,3757,1705,1872,83,4,44,4,1,1,2,2,1,1,3720,37,1495
4400,충청남도,4404,아산시,,관내사전투표,1959,1958,989,896,39,1,12,1,1,0,1,1,0,1,1942,16,1
4400,충청남도,4404,아산시,,인주면제1투,1052,590,248,309,12,2,9,2,0,0,0,0,0,0,582,8,462
4400,충청남도,4404,아산시,,인주면제2투,1267,612,222,356,14,1,9,1,0,1,0,0,0,0,604,8,655
4400,충청남도,4404,아산시,,인주면제3투,974,597,246,311,18,0,14,0,0,0,1,1,1,0,592,5,377
4400,충청남도,4404,아산시,선장면,소계,2737,2049,676,1297,34,2,14,0,0,1,1,2,1,4,2032,17,688
4400,충청남도,4404,아산시,,관내사전투표,974,974,373,569,17,1,5,0,0,0,0,2,0,2,969,5,0
4400,충청남도,4404,아산시,,선장면제1투,697,413,113,284,7,0,2,0,0,0,0,0,0,2,408,5,284
4400,충청남도,4404,아산시,,선장면제2투,535,328,89,226,4,0,3,0,0,0,1,0,0,0,323,5,207
4400,충청남도,4404,아산시,,선장면제3투,531,334,101,218,6,1,4,0,0,1,0,0,1,0,332,2,197
4400,충청남도,4404,아산시,도고면,소계,4136,3104,1091,1891,54,0,26,1,0,1,0,2,3,3,3072,32,1032
4400,충청남도,4404,아산시,,관내사전투표,1440,1440,595,798,28,0,8,0,0,0,0,0,1,2,1432,8,0
4400,충청남도,4404,아산시,,도고면제1투,1151,687,231,429,12,0,10,0,0,0,0,1,0,0,683,4,464
4400,충청남도,4404,아산시,,도고면제2투,718,425,144,259,6,0,3,1,0,1,0,0,0,1,415,10,293
4400,충청남도,4404,아산시,,도고면제3투,827,552,121,405,8,0,5,0,0,0,0,1,2,0,542,10,275
4400,충청남도,4404,아산시,신창면,소계,14710,9750,4396,4860,232,2,143,4,3,5,9,7,5,6,9672,78,4960
4400,충청남도,4404,아산시,,관내사전투표,3335,3335,1743,1444,86,1,34,0,1,0,1,4,2,0,3316,19,0
4400,충청남도,4404,아산시,,신창면제1투,851,460,128,317,6,0,8,0,0,0,0,0,0,1,460,0,391
4400,충청남도,4404,아산시,,신창면제2투,528,326,84,229,6,0,1,0,0,0,0,0,1,1,322,4,202
4400,충청남도,4404,아산시,,신창면제3투,1501,868,258,573,14,0,9,0,0,0,1,0,0,1,856,12,633
4400,충청남도,4404,아산시,,신창면제4투,2113,1123,474,573,26,1,27,0,0,2,3,2,1,2,1111,12,990
4400,충청남도,4404,아산시,,신창면제5투,2360,1385,634,669,34,0,28,0,2,0,1,0,0,1,1369,16,975
4400,충청남도,4404,아산시,,신창면제6투,2396,1234,589,577,32,0,22,1,0,1,2,1,0,0,1225,9,1162
4400,충청남도,4404,아산시,,신창면제7투,1626,1019,486,478,28,0,14,3,0,2,1,0,1,0,1013,6,607
4400,충청남도,4404,아산시,온양1동,소계,8204,5899,2696,2939,137,3,61,4,1,1,8,6,1,0,5857,42,2305
4400,충청남도,4404,아산시,,관내사전투표,2952,2952,1378,1460,63,3,20,2,0,0,4,1,0,0,2931,21,0
4400,충청남도,4404,아산시,,온양1동제1투,957,474,142,321,7,0,1,0,0,0,0,0,0,0,471,3,483
4400,충청남도,4404,아산시,,온양1동제2투,1868,1005,402,542,19,0,28,0,0,0,2,2,1,0,996,9,863
4400,충청남도,4404,아산시,,온양1동제3투,722,348,102,231,8,0,2,0,1,1,0,0,0,0,345,3,374
4400,충청남도,4404,아산시,,온양1동제4투,1705,1120,672,385,40,0,10,2,0,0,2,3,0,0,1114,6,585
4400,충청남도,4404,아산시,온양2동,소계,10606,7457,3084,4025,166,2,81,1,3,5,3,5,2,1,7378,79,3149
4400,충청남도,4404,아산시,,관내사전투표,4237,4235,1897,2180,92,2,30,0,2,3,0,2,1,0,4209,26,2
4400,충청남도,4404,아산시,,온양2동제1투,1485,838,293,502,21,0,13,0,0,1,1,0,0,1,832,6,647
4400,충청남도,4404,아산시,,온양2동제2투,1790,985,354,568,17,0,22,1,1,1,2,3,0,0,969,16,805
4400,충청남도,4404,아산시,,온양2동제3투,1106,556,191,331,14,0,5,0,0,0,0,0,1,0,542,14,550
4400,충청남도,4404,아산시,,온양2동제4투,1988,843,349,444,22,0,11,0,0,0,0,0,0,0,826,17,1145
4400,충청남도,4404,아산시,온양3동,소계,26835,19114,9105,9071,530,11,188,6,0,4,9,23,5,8,18960,154,7721
4400,충청남도,4404,아산시,,관내사전투표,6900,6899,3492,3138,158,6,54,4,0,1,2,8,2,5,6870,29,1
4400,충청남도,4404,아산시,,온양3동제1투,3469,2144,984,1052,59,2,22,1,0,0,4,2,1,0,2127,17,1325
4400,충청남도,4404,아산시,,온양3동제2투,2978,1668,620,957,38,1,16,1,0,0,1,2,1,2,1639,29,1310
4400,충청남도,4404,아산시,,온양3동제3투,2541,1534,741,700,51,0,21,0,0,0,2,2,1,1,1519,15,1007
4400,충청남도,4404,아산시,,온양3동제4투,2734,1616,693,826,54,1,19,0,0,1,0,1,0,0,1595,21,1118
4400,충청남도,4404,아산시,,온양3동제5투,3375,1880,740,1031,55,1,32,0,0,0,0,0,0,0,1859,21,1495
4400,충청남도,4404,아산시,,온양3동제6투,3016,2105,1109,889,71,0,15,0,0,2,0,4,0,0,2090,15,911
4400,충청남도,4404,아산시,,온양3동제7투,1822,1268,726,478,44,0,9,0,0,0,0,4,0,0,1261,7,554
4400,충청남도,4404,아산시,온양4동,소계,14221,9887,4630,4765,257,8,112,4,4,2,6,15,2,4,9809,78,4334
4400,충청남도,4404,아산시,,관내사전투표,3489,3489,1753,1606,76,3,24,1,2,1,1,0,1,1,3469,20,0
4400,충청남도,4404,아산시,,온양4동제1투,2379,1554,712,763,45,1,9,2,0,0,0,3,1,2,1538,16,825
4400,충청남도,4404,아산시,,온양4동제2투,3538,2077,946,1006,69,1,29,0,1,0,1,7,0,0,2060,17,1461
4400,충청남도,4404,아산시,,온양4동제3투,1284,746,251,457,16,0,8,1,0,0,2,2,0,1,738,8,538
4400,충청남도,4404,아산시,,온양4동제4투,1917,994,443,486,23,2,27,0,1,1,1,3,0,0,987,7,923
4400,충청남도,4404,아산시,,온양4동제5투,1614,1027,525,447,28,1,15,0,0,0,1,0,0,0,1017,10,587
4400,충청남도,4404,아산시,온양5동,소계,15841,11050,5376,5111,315,3,129,4,2,2,8,7,1,1,10959,91,4791
4400,충청남도,4404,아산시,,관내사전투표,4151,4151,2301,1688,100,1,35,3,0,0,1,2,1,0,4132,19,0
4400,충청남도,4404,아산시,,온양5동제1투,3396,2220,1195,880,94,1,25,1,0,0,1,3,0,0,2200,20,1176
4400,충청남도,4404,아산시,,온양5동제2투,2430,1425,542,804,38,0,20,0,0,2,2,1,0,0,1409,16,1005
4400,충청남도,4404,아산시,,온양5동제3투,1172,717,250,439,11,0,6,0,2,0,1,0,0,0,709,8,455
4400,충청남도,4404,아산시,,온양5동제4투,3067,1855,759,991,59,1,20,0,0,0,0,1,0,1,1832,23,1212
4400,충청남도,4404,아산시,,온양5동제5투,1625,682,329,309,13,0,23,0,0,0,3,0,0,0,677,5,943
4400,충청남도,4404,아산시,온양6동,소계,20640,14782,7385,6648,403,6,182,5,2,2,11,6,4,4,14658,124,5858
4400,충청남도,4404,아산시,,관내사전투표,4494,4494,2538,1781,105,0,44,2,0,0,3,0,0,1,4474,20,0
4400,충청남도,4404,아산시,,온양6동제1투,2138,1200,491,637,46,0,9,1,1,0,1,0,0,0,1186,14,938
4400,충청남도,4404,아산시,,온양6동제2투,2152,1368,644,644,46,2,15,1,1,0,1,3,0,0,1357,11,784
4400,충청남도,4404,아산시,,온양6동제3투,1042,605,179,375,10,2,12,0,0,0,2,0,4,1,585,20,437
4400,충청남도,4404,아산시,,온양6동제4투,2433,1454,688,697,20,1,33,0,0,1,0,0,0,0,1440,14,979
4400,충청남도,4404,아산시,,온양6동제5투,2009,1194,539,606,13,0,24,0,0,0,1,0,0,2,1185,9,815
4400,충청남도,4404,아산시,,온양6동제6투,1945,1278,580,617,52,1,13,0,0,1,2,1,0,0,1267,11,667
4400,충청남도,4404,아산시,,온양6동제7투,2501,1864,1016,751,59,0,18,1,0,0,1,1,0,0,1847,17,637
4400,충청남도,4404,아산시,,온양6동제8투,1926,1325,710,540,52,0,14,0,0,0,0,1,0,0,1317,8,601
4400,충청남도,4404,아산시,잘못 투입·구분된 투표지,,0,7,0,7,0,0,0,0,0,0,0,0,0,0,7,0,-7
4400,충청남도,4405,서산시,합계,,148201,108990,48642,54892,2640,69,1264,61,19,21,69,111,59,73,107920,1070,39211
4400,충청남도,4405,서산시,거소·선상투표,,468,428,145,183,11,4,7,1,0,1,0,1,0,1,354,74,40
4400,충청남도,4405,서산시,관외사전투표,,9504,9502,4359,4567,251,12,133,6,2,2,5,9,3,8,9357,145,2
4400,충청남도,4405,서산시,재외투표,,376,256,156,76,5,0,2,0,0,0,0,0,0,0,239,17,120
4400,충청남도,4405,서산시,대산읍,소계,11017,7923,3698,3841,182,4,97,4,2,1,3,12,5,5,7854,69,3094
4400,충청남도,4405,서산시,,관내사전투표,3898,3898,1972,1767,76,3,38,1,2,1,1,5,3,1,3870,28,0
4400,충청남도,4405,서산시,,대산읍제1투,2095,1049,439,533,34,1,24,0,0,0,1,4,0,1,1037,12,1046
4400,충청남도,4405,서산시,,대산읍제2투,542,340,118,208,6,0,1,0,0,0,0,1,0,1,335,5,202
4400,충청남도,4405,서산시,,대산읍제3투,778,464,201,240,12,0,3,1,0,0,1,0,2,0,460,4,314
4400,충청남도,4405,서산시,,대산읍제4투,1077,700,351,314,20,0,12,0,0,0,0,0,0,0,697,3,377
4400,충청남도,4405,서산시,,대산읍제5투,1813,961,413,498,21,0,12,2,0,0,0,1,0,1,948,13,852
4400,충청남도,4405,서산시,,대산읍제6투,814,511,204,281,13,0,7,0,0,0,0,1,0,1,507,4,303
4400,충청남도,4405,서산시,인지면,소계,6234,4668,2008,2458,95,2,54,3,0,1,0,5,4,3,4633,35,1566
4400,충청남도,4405,서산시,,관내사전투표,2475,2475,1168,1213,50,2,21,2,0,1,0,1,2,2,2462,13,0
4400,충청남도,4405,서산시,,인지면제1투,2329,1290,563,658,29,0,26,1,0,0,0,3,1,1,1282,8,1039
4400,충청남도,4405,서산시,,인지면제2투,714,439,147,278,7,0,0,0,0,0,0,0,0,0,432,7,275
4400,충청남도,4405,서산시,,인지면제3투,716,464,130,309,9,0,7,0,0,0,0,1,1,0,457,7,252
4400,충청남도,4405,서산시,부석면,소계,4614,3312,1226,1940,68,1,26,2,1,1,1,4,3,4,3277,35,1302
4400,충청남도,4405,서산시,,관내사전투표,1358,1358,565,745,25,1,10,1,0,0,1,1,0,1,1350,8,0
4400,충청남도,4405,서산시,,부석면제1투,1028,574,205,339,13,0,6,0,0,0,0,1,0,0,564,10,454
4400,충청남도,4405,서산시,,부석면제2투,983,581,186,362,17,0,3,0,0,0,0,0,1,1,570,11,402
4400,충청남도,4405,서산시,,부석면제3투,587,354,102,237,5,0,3,0,1,0,0,1,0,1,350,4,233
4400,충청남도,4405,서산시,,부석면제4투,658,445,168,257,8,0,4,1,0,1,0,1,2,1,443,2,213
4400,충청남도,4405,서산시,팔봉면,소계,2914,2228,812,1327,38,1,14,1,0,0,5,3,3,3,2207,21,686
4400,충청남도,4405,서산시,,관내사전투표,1044,1044,429,572,22,1,2,1,0,0,2,3,0,1,1033,11,0
4400,충청남도,4405,서산시,,팔봉면제1투,1124,705,237,440,11,0,9,0,0,0,3,0,2,0,702,3,419
4400,충청남도,4405,서산시,,팔봉면제2투,689,445,134,295,4,0,2,0,0,0,0,0,1,2,438,7,244
4400,충청남도,4405,서산시,,팔봉면제3투,57,34,12,20,1,0,1,0,0,0,0,0,0,0,34,0,23
4400,충청남도,4405,서산시,지곡면,소계,6458,4524,1982,2321,90,1,64,1,1,1,1,15,2,4,4483,41,1934
4400,충청남도,4405,서산시,,관내사전투표,1892,1892,855,969,29,0,17,1,1,1,0,7,1,2,1883,9,0
4400,충청남도,4405,서산시,,지곡면제1투,1994,1150,376,720,21,0,12,0,0,0,0,4,0,1,1134,16,844
4400,충청남도,4405,서산시,,지곡면제2투,2572,1482,751,632,40,1,35,0,0,0,1,4,1,1,1466,16,1090
4400,충청남도,4405,서산시,성연면,소계,10650,7716,4275,3036,206,5,107,2,2,0,6,6,3,5,7653,63,2934
4400,충청남도,4405,서산시,,관내사전투표,3872,3872,2338,1358,102,3,40,1,0,0,2,4,1,2,3851,21,0
4400,충청남도,4405,서산시,,성연면제1투,1321,725,255,431,14,0,14,0,1,0,0,0,2,1,718,7,596
4400,충청남도,4405,서산시,,성연면제2투,2330,1307,660,571,38,2,19,1,1,0,2,1,0,0,1295,12,1023
4400,충청남도,4405,서산시,,성연면제3투,3127,1812,1022,676,52,0,34,0,0,0,2,1,0,2,1789,23,1315
4400,충청남도,4405,서산시,음암면,소계,7457,5185,2165,2726,113,6,73,5,1,2,5,14,6,6,5122,63,2272
4400,충청남도,4405,서산시,,관내사전투표,1947,1947,876,985,39,4,16,2,1,0,0,3,0,3,1929,18,0
4400,충청남도,4405,서산시,,음암면제1투,1506,773,276,459,11,1,6,0,0,2,1,4,2,1,763,10,733
4400,충청남도,4405,서산시,,음암면제2투,2105,1215,495,631,36,0,20,2,0,0,3,3,2,1,1193,22,890
4400,충청남도,4405,서산시,,음암면제3투,1214,797,376,367,21,1,20,1,0,0,0,1,2,1,790,7,417
4400,충청남도,4405,서산시,,음암면제4투,685,453,142,284,6,0,11,0,0,0,1,3,0,0,447,6,232
4400,충청남도,4405,서산시,운산면,소계,4355,3230,1149,1938,60,6,22,1,1,0,3,7,5,6,3198,32,1125
4400,충청남도,4405,서산시,,관내사전투표,1569,1569,620,891,30,3,9,1,0,0,1,2,1,2,1560,9,0
4400,충청남도,4405,서산시,,운산면제1투,1528,822,283,502,11,2,8,0,0,0,0,4,1,2,813,9,706
4400,충청남도,4405,서산시,,운산면제2투,605,421,101,303,7,1,2,0,0,0,2,1,2,0,419,2,184
4400,충청남도,4405,서산시,,운산면제3투,653,418,145,242,12,0,3,0,1,0,0,0,1,2,406,12,235
4400,충청남도,4405,서산시,해미면,소계,6760,4915,1865,2828,98,4,60,3,3,2,6,3,5,4,4881,34,1845
4400,충청남도,4405,서산시,,관내사전투표,2638,2638,1130,1403,57,1,28,1,1,0,2,1,1,2,2627,11,0
4400,충청남도,4405,서산시,,해미면제1투,1450,837,304,496,14,1,13,0,0,1,1,2,1,0,833,4,613
4400,충청남도,4405,서산시,,해미면제2투,955,537,149,361,10,1,8,2,0,0,2,0,1,0,534,3,418
4400,충청남도,4405,서산시,,해미면제3투,1717,903,282,568,17,1,11,0,2,1,1,0,2,2,887,16,814
4400,충청남도,4405,서산시,고북면,소계,4604,3185,1242,1793,72,2,22,0,0,1,4,5,4,4,3149,36,1419
4400,충청남도,4405,서산시,,관내사전투표,1297,1297,540,703,31,0,6,0,0,0,0,1,1,2,1284,13,0
4400,충청남도,4405,서산시,,고북면제1투,1393,787,267,474,16,2,6,0,0,0,2,3,0,2,772,15,606
4400,충청남도,4405,서산시,,고북면제2투,1086,579,249,294,21,0,9,0,0,0,1,0,1,0,575,4,507
4400,충청남도,4405,서산시,,고북면제3투,828,522,186,322,4,0,1,0,0,1,1,1,2,0,518,4,306
4400,충청남도,4405,서산시,부춘동,소계,16013,11505,5065,5876,294,4,134,6,3,3,4,10,6,6,11411,94,4508
4400,충청남도,4405,서산시,,관내사전투표,5876,5876,2735,2907,141,1,44,4,0,1,1,4,2,3,5843,33,0
4400,충청남도,4405,서산시,,부춘동제1투,1680,759,266,445,15,0,21,1,0,0,0,1,2,0,751,8,921
4400,충청남도,4405,서산시,,부춘동제2투,1880,1211,463,687,37,1,15,0,0,1,0,1,0,0,1205,6,669
4400,충청남도,4405,서산시,,부춘동제3투,2766,1529,631,800,45,0,22,0,2,0,0,2,1,2,1505,24,1237
4400,충청남도,4405,서산시,,부춘동제4투,1786,898,397,448,20,2,14,1,1,1,2,2,1,1,890,8,888
4400,충청남도,4405,서산시,,부춘동제5투,2025,1232,573,589,36,0,18,0,0,0,1,0,0,0,1217,15,793
4400,충청남도,4405,서산시,동문1동,소계,13403,9487,4126,4954,249,2,83,5,1,1,4,2,1,5,9433,54,3916
4400,충청남도,4405,서산시,,관내사전투표,4767,4767,2205,2393,105,2,32,3,0,0,1,1,0,3,4745,22,0
4400,충청남도,4405,서산시,,동문1동제1투,1678,758,263,452,26,0,12,0,0,0,0,0,0,1,754,4,920
4400,충청남도,4405,서산시,,동문1동제2투,2377,1246,440,757,27,0,13,0,1,0,1,1,0,0,1240,6,1131
4400,충청남도,4405,서산시,,동문1동제3투,2873,1622,744,792,54,0,12,2,0,1,2,0,0,1,1608,14,1251
4400,충청남도,4405,서산시,,동문1동제4투,1708,1094,474,560,37,0,14,0,0,0,0,0,1,0,1086,8,614
4400,충청남도,4405,서산시,동문2동,소계,7438,5317,2170,2890,127,3,64,4,1,1,5,3,0,0,5268,49,2121
4400,충청남도,4405,서산시,,관내사전투표,2535,2535,1175,1249,70,2,20,3,1,0,2,1,0,0,2523,12,0
4400,충청남도,4405,서산시,,동문2동제1투,970,498,158,312,9,0,8,0,0,0,1,0,0,0,488,10,472
4400,충청남도,4405,서산시,,동문2동제2투,1547,866,245,581,12,0,12,0,0,1,0,0,0,0,851,15,681
4400,충청남도,4405,서산시,,동문2동제3투,2386,1418,592,748,36,1,24,1,0,0,2,2,0,0,1406,12,968
4400,충청남도,4405,서산시,수석동,소계,12213,8752,3902,4401,241,4,103,3,1,2,5,3,6,6,8677,75,3461
4400,충청남도,4405,서산시,,관내사전투표,3824,3824,1904,1769,97,2,32,1,1,0,2,1,1,2,3812,12,0
4400,충청남도,4405,서산시,,수석동제1투,1859,1110,515,539,38,0,9,1,0,1,1,0,0,0,1104,6,749
4400,충청남도,4405,서산시,,수석동제2투,3466,1845,747,978,55,2,28,1,0,0,1,2,0,2,1816,29,1621
4400,충청남도,4405,서산시,,수석동제3투,929,557,173,359,8,0,6,0,0,0,0,0,2,2,550,7,372
4400,충청남도,4405,서산시,,수석동제4투,2135,1416,563,756,43,0,28,0,0,1,1,0,3,0,1395,21,719
4400,충청남도,4405,서산시,석남동,소계,23723,16856,8297,7736,440,8,199,14,0,2,12,9,3,3,16723,133,6867
4400,충청남도,4405,서산시,,관내사전투표,6754,6754,3631,2856,163,2,50,5,0,1,2,5,2,0,6717,37,0
4400,충청남도,4405,서산시,,석남동제1투,3304,1785,780,908,40,0,30,0,0,0,0,0,0,1,1759,26,1519
4400,충청남도,4405,서산시,,석남동제2투,3424,1839,837,908,50,3,31,1,0,0,3,1,0,0,1834,5,1585
4400,충청남도,4405,서산시,,석남동제3투,2163,1506,800,622,48,0,14,3,0,0,0,1,0,1,1489,17,657
4400,충청남도,4405,서산시,,석남동제4투,2250,1351,568,694,38,1,35,0,0,0,2,2,0,0,1340,11,899
4400,충청남도,4405,서산시,,석남동제5투,963,548,168,348,9,1,11,0,0,0,1,0,1,1,540,8,415
4400,충청남도,4405,서산시,,석남동제6투,3175,1852,895,851,55,0,24,5,0,1,4,0,0,0,1835,17,1323
4400,충청남도,4405,서산시,,석남동제7투,1690,1221,618,549,37,1,4,0,0,0,0,0,0,0,1209,12,469
4400,충청남도,4405,서산시,잘못 투입·구분된 투표지,,0,1,0,1,0,0,0,0,0,0,0,0,0,0,1,0,-1
4400,충청남도,4406,태안군,합계,,55320,42028,16678,23511,873,17,323,18,3,14,31,53,53,43,41617,411,13292
4400,충청남도,4406,태안군,거소·선상투표,,176,158,54,70,5,3,5,0,0,0,0,1,0,0,138,20,18
4400,충청남도,4406,태안군,관외사전투표,,4578,4578,1992,2347,120,0,51,3,0,1,4,8,1,1,4528,50,0
4400,충청남도,4406,태안군,재외투표,,161,119,71,33,6,0,0,0,0,0,0,0,0,0,110,9,42
4400,충청남도,4406,태안군,태안읍,소계,23052,16737,6913,9082,377,5,150,9,1,5,15,21,16,9,16603,134,6315
4400,충청남도,4406,태안군,,관내사전투표,8151,8151,3706,4118,182,4,56,4,0,1,6,10,7,3,8097,54,0
4400,충청남도,4406,태안군,,태안읍제1투,1609,866,307,503,22,1,11,1,1,0,1,4,0,2,853,13,743
4400,충청남도,4406,태안군,,태안읍제2투,1079,668,243,399,10,0,6,0,0,0,2,1,2,1,664,4,411
4400,충청남도,4406,태안군,,태안읍제3투,1371,873,281,549,15,0,11,0,0,2,1,2,1,1,863,10,498
4400,충청남도,4406,태안군,,태안읍제4투,660,458,144,292,9,0,4,1,0,0,0,0,0,0,450,8,202
4400,충청남도,4406,태안군,,태안읍제5투,1750,970,353,565,17,0,24,1,0,1,0,1,2,0,964,6,780
4400,충청남도,4406,태안군,,태안읍제6투,3266,1815,706,1020,52,0,17,0,0,0,2,2,2,0,1801,14,1451
4400,충청남도,4406,태안군,,태안읍제7투,1285,658,235,393,17,0,4,0,0,1,3,1,0,0,654,4,627
4400,충청남도,4406,태안군,,태안읍제8투,3881,2278,938,1243,53,0,17,2,0,0,0,0,2,2,2257,21,1603
4400,충청남도,4406,태안군,안면읍,소계,7014,5176,2059,2926,73,4,47,0,1,3,4,5,8,8,5138,38,1838
4400,충청남도,4406,태안군,,관내사전투표,2597,2597,1119,1397,29,2,18,0,0,2,1,3,5,5,2581,16,0
4400,충청남도,4406,태안군,,안면읍제1투,1736,930,344,535,17,2,17,0,0,1,1,2,0,2,921,9,806
4400,충청남도,4406,태안군,,안면읍제2투,817,478,185,277,9,0,4,0,0,0,0,0,0,0,475,3,339
4400,충청남도,4406,태안군,,안면읍제3투,1400,881,289,557,16,0,5,0,1,0,2,0,2,1,873,8,519
4400,충청남도,4406,태안군,,안면읍제4투,464,290,122,160,2,0,3,0,0,0,0,0,1,0,288,2,174
4400,충청남도,4406,태안군,고남면,소계,1949,1438,588,794,25,0,8,0,0,1,1,1,4,1,1423,15,511
4400,충청남도,4406,태안군,,관내사전투표,831,831,352,448,15,0,5,0,0,0,0,0,3,1,824,7,0
4400,충청남도,4406,태안군,,고남면투표소,1118,607,236,346,10,0,3,0,0,1,1,1,1,0,599,8,511
4400,충청남도,4406,태안군,남면,소계,3639,2739,1068,1549,57,4,18,1,1,2,2,3,2,3,2710,29,900
4400,충청남도,4406,태안군,,관내사전투표,1356,1356,580,729,27,2,6,0,0,0,0,3,0,1,1348,8,0
4400,충청남도,4406,태안군,,남면제1투,817,494,176,288,12,1,6,1,0,1,0,0,0,1,486,8,323
4400,충청남도,4406,태안군,,남면제2투,555,341,115,202,9,0,5,0,0,0,0,0,2,0,333,8,214
4400,충청남도,4406,태안군,,남면제3투,911,548,197,330,9,1,1,0,1,1,2,0,0,1,543,5,363
4400,충청남도,4406,태안군,근흥면,소계,4602,3424,1201,2096,50,0,15,3,0,0,0,5,6,7,3383,41,1178
4400,충청남도,4406,태안군,,관내사전투표,1735,1735,653,1031,26,0,7,1,0,0,0,1,3,0,1722,13,0
4400,충청남도,4406,태안군,,근흥면제1투,839,446,150,271,8,0,5,0,0,0,0,1,1,1,437,9,393
4400,충청남도,4406,태안군,,근흥면제2투,848,533,161,355,5,0,1,0,0,0,0,1,1,2,526,7,315
4400,충청남도,4406,태안군,,근흥면제3투,1116,662,234,397,10,0,2,1,0,0,0,2,1,4,651,11,454
4400,충청남도,4406,태안군,,근흥면제4투,64,48,3,42,1,0,0,1,0,0,0,0,0,0,47,1,16
4400,충청남도,4406,태안군,소원면,소계,4649,3476,1259,2078,71,0,15,2,0,0,2,4,7,8,3446,30,1173
4400,충청남도,4406,태안군,,관내사전투표,2011,2011,740,1194,39,0,8,1,0,0,1,2,4,4,1993,18,0
4400,충청남도,4406,태안군,,소원면제1투,1464,737,240,462,23,0,5,0,0,0,1,0,1,1,733,4,727
4400,충청남도,4406,태안군,,소원면제2투,1174,728,279,422,9,0,2,1,0,0,0,2,2,3,720,8,446
4400,충청남도,4406,태안군,원북면,소계,3692,2798,981,1705,50,1,11,0,0,2,1,3,7,2,2763,35,894
4400,충청남도,4406,태안군,,관내사전투표,1318,1318,512,760,17,1,6,0,0,1,1,0,1,0,1299,19,0
4400,충청남도,4406,태안군,,원북면제1투,1017,588,213,348,16,0,1,0,0,0,0,0,0,0,578,10,429
4400,충청남도,4406,태안군,,원북면제2투,694,456,124,304,11,0,4,0,0,0,0,3,4,1,451,5,238
4400,충청남도,4406,태안군,,원북면제3투,663,436,132,293,6,0,0,0,0,1,0,0,2,1,435,1,227
4400,충청남도,4406,태안군,이원면,소계,1808,1385,492,831,39,0,3,0,0,0,2,2,2,4,1375,10,423
4400,충청남도,4406,태안군,,관내사전투표,674,674,255,383,22,0,2,0,0,0,2,0,2,3,669,5,0
4400,충청남도,4406,태안군,,이원면제1투,577,355,114,225,10,0,1,0,0,0,0,1,0,1,352,3,222
4400,충청남도,4406,태안군,,이원면제2투,557,356,123,223,7,0,0,0,0,0,0,1,0,0,354,2,201
4400,충청남도,4406,태안군,잘못 투입·구분된 투표지,,0,0,0,0,0,0,0,0,0,0,0,0,0,0,0,0,0
4400,충청남도,4407,금산군,합계,,44799,33699,14002,18178,647,26,331,8,7,14,23,49,42,37,33364,335,11100
4400,충청남도,4407,금산군,거소·선상투표,,60,54,23,24,1,0,0,0,0,0,1,0,0,0,49,5,6
4400,충청남도,4407,금산군,관외사전투표,,3813,3811,1719,1902,92,6,49,1,1,2,1,6,0,2,3781,30,2
4400,충청남도,4407,금산군,재외투표,,138,99,51,39,1,0,0,0,0,0,0,0,0,0,91,8,39
4400,충청남도,4407,금산군,금산읍,소계,17894,13026,5825,6619,274,5,121,2,2,3,10,25,12,8,12906,120,4868
4400,충청남도,4407,금산군,,관내사전투표,5667,5667,2860,2564,140,3,44,1,0,2,4,15,2,1,5636,31,0
4400,충청남도,4407,금산군,,금산읍제1투,1531,855,311,504,17,0,8,0,1,0,0,1,1,2,845,10,676
4400,충청남도,4407,금산군,,금산읍제2투,1199,804,317,444,19,0,9,0,0,1,3,1,1,0,795,9,395
4400,충청남도,4407,금산군,,금산읍제3투,2085,1110,526,526,21,0,16,0,1,0,2,2,2,0,1096,14,975
4400,충청남도,4407,금산군,,금산읍제4투,1043,673,233,421,7,0,4,0,0,0,0,1,1,1,668,5,370
4400,충청남도,4407,금산군,,금산읍제5투,618,381,147,220,2,0,4,0,0,0,1,0,0,1,375,6,237
4400,충청남도,4407,금산군,,금산읍제6투,1237,750,276,434,13,1,8,0,0,0,0,1,4,2,739,11,487
4400,충청남도,4407,금산군,,금산읍제7투,3091,1869,889,894,44,0,16,1,0,0,0,2,1,0,1847,22,1222
4400,충청남도,4407,금산군,,금산읍제8투,1423,917,266,612,11,1,12,0,0,0,0,2,0,1,905,12,506
4400,충청남도,4407,금산군,금성면,소계,2738,1950,782,1082,32,2,22,1,1,2,2,0,2,1,1929,21,788
4400,충청남도,4407,금산군,,관내사전투표,861,861,395,439,10,1,5,1,0,0,1,0,0,0,852,9,0
4400,충청남도,4407,금산군,,금성면제1투,1146,661,226,392,16,1,12,0,0,1,1,0,1,1,651,10,485
4400,충청남도,4407,금산군,,금성면제2투,731,428,161,251,6,0,5,0,1,1,0,0,1,0,426,2,303
4400,충청남도,4407,금산군,제원면,소계,2375,1746,617,1052,23,1,17,0,1,2,0,0,3,4,1720,26,629
4400,충청남도,4407,금산군,,관내사전투표,870,870,361,483,10,0,4,0,1,1,0,0,1,0,861,9,0
4400,충청남도,4407,금산군,,제원면제1투,1054,592,169,385,10,1,6,0,0,1,0,0,1,3,576,16,462
4400,충청남도,4407,금산군,,제원면제2투,451,284,87,184,3,0,7,0,0,0,0,0,1,1,283,1,167
4400,충청남도,4407,금산군,부리면,소계,2032,1470,533,872,22,2,17,0,0,1,2,1,4,2,1456,14,562
4400,충청남도,4407,금산군,,관내사전투표,617,617,249,353,3,2,3,0,0,0,1,0,1,0,612,5,0
4400,충청남도,4407,금산군,,부리면제1투,890,521,159,332,13,0,4,0,0,1,0,1,3,2,515,6,369
4400,충청남도,4407,금산군,,부리면제2투,525,332,125,187,6,0,10,0,0,0,1,0,0,0,329,3,193
4400,충청남도,4407,금산군,군북면,소계,1894,1413,522,814,24,1,21,0,0,0,1,5,6,3,1397,16,481
4400,충청남도,4407,금산군,,관내사전투표,392,392,185,184,8,0,5,0,0,0,1,4,0,0,387,5,0
4400,충청남도,4407,금산군,,군북면제1투,412,264,72,173,8,0,4,0,0,0,0,0,3,2,262,2,148
4400,충청남도,4407,금산군,,군북면제2투,757,522,169,327,6,1,11,0,0,0,0,1,1,0,516,6,235
4400,충청남도,4407,금산군,,군북면제3투,333,235,96,130,2,0,1,0,0,0,0,0,2,1,232,3,98
4400,충청남도,4407,금산군,남일면,소계,2199,1651,626,955,25,2,14,1,1,0,0,1,4,2,1631,20,548
4400,충청남도,4407,금산군,,관내사전투표,817,817,381,409,11,1,6,1,0,0,0,1,3,0,813,4,0
4400,충청남도,4407,금산군,,남일면제1투,955,563,170,369,6,0,5,0,1,0,0,0,1,2,554,9,392
4400,충청남도,4407,금산군,,남일면제2투,427,271,75,177,8,1,3,0,0,0,0,0,0,0,264,7,156
4400,충청남도,4407,금산군,남이면,소계,1577,1111,467,595,22,0,6,0,0,0,1,3,2,6,1102,9,466
4400,충청남도,4407,금산군,,관내사전투표,457,457,206,231,14,0,1,0,0,0,0,0,1,3,456,1,0
4400,충청남도,4407,금산군,,남이면제1투,679,388,159,211,4,0,3,0,0,0,1,2,1,2,383,5,291
4400,충청남도,4407,금산군,,남이면제2투,441,266,102,153,4,0,2,0,0,0,0,1,0,1,263,3,175
4400,충청남도,4407,금산군,진산면,소계,2529,1880,693,1114,31,2,15,2,0,0,1,1,3,3,1865,15,649
4400,충청남도,4407,금산군,,관내사전투표,839,839,369,443,17,1,3,1,0,0,0,0,0,0,834,5,0
4400,충청남도,4407,금산군,,진산면제1투,1093,642,185,428,9,0,9,1,0,0,0,0,1,2,635,7,451
4400,충청남도,4407,금산군,,진산면제2투,597,399,139,243,5,1,3,0,0,0,1,1,2,1,396,3,198
4400,충청남도,4407,금산군,복수면,소계,2489,1874,640,1154,29,2,23,0,0,1,3,2,1,1,1856,18,615
4400,충청남도,4407,금산군,,관내사전투표,789,789,317,450,8,1,7,0,0,0,0,0,1,1,785,4,0
4400,충청남도,4407,금산군,,복수면제1투,806,481,131,321,8,0,9,0,0,0,3,2,0,0,474,7,325
4400,충청남도,4407,금산군,,복수면제2투,894,604,192,383,13,1,7,0,0,1,0,0,0,0,597,7,290
4400,충청남도,4407,금산군,추부면,소계,5061,3612,1504,1954,71,3,26,1,1,3,1,5,5,5,3579,33,1449
4400,충청남도,4407,금산군,,관내사전투표,1679,1679,775,850,30,1,6,0,0,0,1,4,2,1,1670,9,0
4400,충청남도,4407,금산군,,추부면제1투,1558,780,306,432,16,1,13,0,0,1,0,0,0,1,770,10,778
4400,충청남도,4407,금산군,,추부면제2투,903,548,210,313,12,1,2,1,0,1,0,0,1,3,544,4,355
4400,충청남도,4407,금산군,,추부면제3투,921,605,213,359,13,0,5,0,1,1,0,1,2,0,595,10,316
4400,충청남도,4407,금산군,잘못 투입·구분된 투표지,,0,2,0,2,0,0,0,0,0,0,0,0,0,0,2,0,-2
4400,충청남도,4409,논산시,합계,,100285,73512,33822,36203,1601,35,788,17,12,22,67,113,81,47,72808,704,26773
4400,충청남도,4409,논산시,거소·선상투표,,269,248,102,100,9,0,5,0,1,0,1,0,0,0,218,30,21
4400,충청남도,4409,논산시,관외사전투표,,7100,7098,3386,3282,207,5,95,1,2,2,5,13,7,2,7007,91,2
4400,충청남도,4409,논산시,재외투표,,342,251,122,86,8,0,2,0,0,0,0,0,1,0,219,32,91
4400,충청남도,4409,논산시,강경읍,소계,6910,4908,2632,2094,86,2,47,0,0,1,1,3,5,4,4875,33,2002
4400,충청남도,4409,논산시,,관내사전투표,2203,2203,1287,859,25,1,18,0,0,0,0,0,2,3,2195,8,0
4400,충청남도,4409,논산시,,강경읍제1투,787,421,174,228,11,0,5,0,0,0,1,0,0,0,419,2,366
4400,충청남도,4409,논산시,,강경읍제2투,490,298,137,153,4,0,1,0,0,0,0,0,0,0,295,3,192
4400,충청남도,4409,논산시,,강경읍제3투,1968,1163,593,521,23,0,12,0,0,1,0,3,1,0,1154,9,805
4400,충청남도,4409,논산시,,강경읍제4투,1462,823,441,333,23,1,11,0,0,0,0,0,2,1,812,11,639
4400,충청남도,4409,논산시,연무읍,소계,10848,7520,3652,3507,165,3,93,3,0,3,1,12,4,9,7452,68,3328
4400,충청남도,4409,논산시,,관내사전투표,3556,3556,1818,1575,87,2,36,1,0,2,1,5,2,4,3533,23,0
4400,충청남도,4409,논산시,,연무읍제1투,2373,1285,600,627,24,0,17,0,0,0,0,2,1,1,1272,13,1088
4400,충청남도,4409,논산시,,연무읍제2투,2365,1233,580,584,30,0,24,0,0,0,0,0,1,0,1219,14,1132
4400,충청남도,4409,논산시,,연무읍제3투,1210,609,241,337,13,0,5,1,0,0,0,1,0,2,600,9,601
4400,충청남도,4409,논산시,,연무읍제4투,1344,837,413,384,11,1,11,1,0,1,0,4,0,2,828,9,507
4400,충청남도,4409,논산시,성동면,소계,3562,2545,1026,1427,36,2,22,0,0,0,0,1,3,0,2517,28,1017
4400,충청남도,4409,논산시,,관내사전투표,957,957,451,480,16,0,2,0,0,0,0,1,0,0,950,7,0
4400,충청남도,4409,논산시,,성동면제1투,677,378,132,236,5,0,2,0,0,0,0,0,0,0,375,3,299
4400,충청남도,4409,논산시,,성동면제2투,870,505,208,270,7,1,9,0,0,0,0,0,0,0,495,10,365
4400,충청남도,4409,논산시,,성동면제3투,1058,705,235,441,8,1,9,0,0,0,0,0,3,0,697,8,353
4400,충청남도,4409,논산시,광석면,소계,3673,2720,1052,1568,49,0,20,3,0,1,1,3,7,1,2705,15,953
4400,충청남도,4409,논산시,,관내사전투표,1123,1123,504,582,19,0,4,2,0,0,1,2,3,1,1118,5,0
4400,충청남도,4409,논산시,,광석면제1투,1033,618,205,387,12,0,8,0,0,1,0,0,2,0,615,3,415
4400,충청남도,4409,논산시,,광석면제2투,568,370,137,217,8,0,2,0,0,0,0,1,1,0,366,4,198
4400,충청남도,4409,논산시,,광석면제3투,949,609,206,382,10,0,6,1,0,0,0,0,1,0,606,3,340
4400,충청남도,4409,논산시,노성면,소계,2426,1786,612,1112,31,1,15,0,0,0,3,1,2,1,1778,8,640
4400,충청남도,4409,논산시,,관내사전투표,719,719,289,410,9,0,4,0,0,0,3,0,1,0,716,3,0
4400,충청남도,4409,논산시,,노성면제1투,965,604,178,404,11,1,10,0,0,0,0,0,0,0,604,0,361
4400,충청남도,4409,논산시,,노성면제2투,742,463,145,298,11,0,1,0,0,0,0,1,1,1,458,5,279
4400,충청남도,4409,논산시,상월면,소계,3056,2210,978,1100,47,3,19,0,0,2,2,14,5,2,2172,38,846
4400,충청남도,4409,논산시,,관내사전투표,1132,1132,569,508,26,2,7,0,0,0,0,5,2,2,1121,11,0
4400,충청남도,4409,논산시,,상월면제1투,1019,589,227,314,14,1,3,0,0,1,1,7,1,0,569,20,430
4400,충청남도,4409,논산시,,상월면제2투,905,489,182,278,7,0,9,0,0,1,1,2,2,0,482,7,416
4400,충청남도,4409,논산시,부적면,소계,3282,2524,1114,1301,53,1,22,1,1,0,6,6,1,2,2508,16,758
4400,충청남도,4409,논산시,,관내사전투표,1257,1257,646,569,29,0,6,0,0,0,1,3,0,2,1256,1,0
4400,충청남도,4409,논산시,,부적면제1투,944,556,225,300,12,0,8,0,0,0,3,0,0,0,548,8,388
4400,충청남도,4409,논산시,,부적면제2투,601,403,147,236,5,1,6,1,0,0,1,0,1,0,398,5,198
4400,충청남도,4409,논산시,,부적면제3투,480,308,96,196,7,0,2,0,1,0,1,3,0,0,306,2,172
4400,충청남도,4409,논산시,연산면,소계,5328,3843,1440,2251,65,3,26,1,2,1,7,4,7,1,3808,35,1485
4400,충청남도,4409,논산시,,관내사전투표,1720,1720,741,912,30,2,8,1,0,1,1,0,4,1,1701,19,0
4400,충청남도,4409,논산시,,연산면제1투,1539,949,293,618,16,1,5,0,1,0,2,2,3,0,941,8,590
4400,충청남도,4409,논산시,,연산면제2투,1168,607,225,358,11,0,5,0,1,0,3,0,0,0,603,4,561
4400,충청남도,4409,논산시,,연산면제3투,901,567,181,363,8,0,8,0,0,0,1,2,0,0,563,4,334
4400,충청남도,4409,논산시,벌곡면,소계,2051,1531,571,902,20,3,11,2,0,1,1,2,3,5,1521,10,520
4400,충청남도,4409,논산시,,관내사전투표,690,690,296,367,7,3,4,2,0,1,0,1,2,2,685,5,0
4400,충청남도,4409,논산시,,벌곡면제1투,708,408,147,249,6,0,2,0,0,0,0,0,0,0,404,4,300
4400,충청남도,4409,논산시,,벌곡면제2투,653,433,128,286,7,0,5,0,0,0,1,1,1,3,432,1,220
4400,충청남도,4409,논산시,양촌면,소계,4610,3325,1322,1848,65,1,42,0,1,2,4,7,6,4,3302,23,1285
4400,충청남도,4409,논산시,,관내사전투표,1593,1593,717,814,30,1,9,0,1,1,1,3,2,1,1580,13,0
4400,충청남도,4409,논산시,,양촌면제1투,857,519,198,289,9,0,13,0,0,0,2,1,2,1,515,4,338
4400,충청남도,4409,논산시,,양촌면제2투,716,360,118,231,2,0,6,0,0,1,0,0,0,1,359,1,356
4400,충청남도,4409,논산시,,양촌면제3투,1444,853,289,514,24,0,14,0,0,0,1,3,2,1,848,5,591
4400,충청남도,4409,논산시,가야곡면,소계,3015,2197,884,1219,34,0,26,0,2,0,3,4,5,2,2179,18,818
4400,충청남도,4409,논산시,,관내사전투표,1016,1016,440,541,12,0,5,0,2,0,3,1,3,0,1007,9,0
4400,충청남도,4409,논산시,,가야곡면제1투,743,418,155,243,9,0,7,0,0,0,0,1,0,0,415,3,325
4400,충청남도,4409,논산시,,가야곡면제2투,597,398,142,233,6,0,8,0,0,0,0,1,2,1,393,5,199
4400,충청남도,4409,논산시,,가야곡면제3투,659,365,147,202,7,0,6,0,0,0,0,1,0,1,364,1,294
4400,충청남도,4409,논산시,은진면,소계,3693,2673,1198,1321,69,1,37,0,0,0,5,8,3,5,2647,26,1020
4400,충청남도,4409,논산시,,관내사전투표,1312,1312,642,602,34,1,11,0,0,0,3,5,0,3,1301,11,0
4400,충청남도,4409,논산시,,은진면제1투,971,524,216,283,9,0,8,0,0,0,1,0,1,0,518,6,447
4400,충청남도,4409,논산시,,은진면제2투,545,351,124,198,13,0,8,0,0,0,0,1,1,1,346,5,194
4400,충청남도,4409,논산시,,은진면제3투,865,486,216,238,13,0,10,0,0,0,1,2,1,1,482,4,379
4400,충청남도,4409,논산시,채운면,소계,2017,1567,726,772,28,1,11,0,0,1,1,3,5,4,1552,15,450
4400,충청남도,4409,논산시,,관내사전투표,716,716,392,303,7,1,5,0,0,0,0,2,2,1,713,3,0
4400,충청남도,4409,논산시,,채운면제1투,695,431,176,238,7,0,3,0,0,1,0,1,2,1,429,2,264
4400,충청남도,4409,논산시,,채운면제2투,606,420,158,231,14,0,3,0,0,0,1,0,1,2,410,10,186
4400,충청남도,4409,논산시,취암동,소계,26245,18349,9071,8419,434,5,217,3,2,3,19,21,9,3,18206,143,7896
4400,충청남도,4409,논산시,,관내사전투표,7412,7411,4107,3007,170,2,64,2,0,1,7,10,2,0,7372,39,1
4400,충청남도,4409,논산시,,취암동제1투,2026,1115,407,646,29,1,17,1,0,0,0,2,1,0,1104,11,911
4400,충청남도,4409,논산시,,취암동제2투,3163,1589,747,751,42,1,25,0,1,1,1,0,1,0,1570,19,1574
4400,충청남도,4409,논산시,,취암동제3투,3697,2041,896,1048,42,1,30,0,0,0,3,3,3,1,2027,14,1656
4400,충청남도,4409,논산시,,취암동제4투,1108,702,249,425,12,0,10,0,1,1,0,0,0,0,698,4,406
4400,충청남도,4409,논산시,,취암동제5투,1794,1178,529,586,23,0,23,0,0,0,0,3,1,2,1167,11,616
4400,충청남도,4409,논산시,,취암동제6투,1543,931,428,456,18,0,12,0,0,0,2,2,1,0,919,12,612
4400,충청남도,4409,논산시,,취암동제7투,2420,1453,724,647,42,0,16,0,0,0,5,1,0,0,1435,18,967
4400,충청남도,4409,논산시,,취암동제8투,3082,1929,984,853,56,0,20,0,0,0,1,0,0,0,1914,15,1153
4400,충청남도,4409,논산시,부창동,소계,11858,8215,3933,3893,195,4,78,3,1,5,7,11,8,2,8140,75,3643
4400,충청남도,4409,논산시,,관내사전투표,2851,2851,1504,1234,60,2,18,1,0,1,1,6,0,0,2827,24,0
4400,충청남도,4409,논산시,,부창동제1투,1965,1225,561,602,27,1,13,0,0,2,4,1,1,0,1212,13,740
4400,충청남도,4409,논산시,,부창동제2투,1385,808,310,464,16,1,3,0,0,1,0,0,1,1,797,11,577
4400,충청남도,4409,논산시,,부창동제3투,3096,1909,877,947,37,0,25,1,1,0,1,1,4,0,1894,15,1187
4400,충청남도,4409,논산시,,부창동제4투,2561,1422,681,646,55,0,19,1,0,1,1,3,2,1,1410,12,1139
4400,충청남도,4409,논산시,잘못 투입·구분된 투표지,,0,2,1,1,0,0,0,0,0,0,0,0,0,0,2,0,-2
4400,충청남도,4410,계룡시,합계,,34745,27992,11891,14718,799,22,243,5,4,14,13,32,4,14,27759,233,6753
4400,충청남도,4410,계룡시,거소·선상투표,,133,127,46,66,1,0,2,0,0,0,0,0,0,1,116,11,6
4400,충청남도,4410,계룡시,관외사전투표,,3893,3892,1642,2032,114,5,36,0,0,2,1,6,0,3,3841,51,1
4400,충청남도,4410,계룡시,재외투표,,163,124,65,37,7,0,0,0,0,0,0,0,0,0,109,15,39
4400,충청남도,4410,계룡시,두마면,소계,5711,4555,1993,2379,102,5,44,0,1,4,2,1,0,0,4531,24,1156
4400,충청남도,4410,계룡시,,관내사전투표,2367,2367,1156,1135,50,4,12,0,1,1,2,0,0,0,2361,6,0
4400,충청남도,4410,계룡시,,두마면제1투,1351,916,331,533,32,0,12,0,0,1,0,0,0,0,909,7,435
4400,충청남도,4410,계룡시,,두마면제2투,1993,1272,506,711,20,1,20,0,0,2,0,1,0,0,1261,11,721
4400,충청남도,4410,계룡시,엄사면,소계,13388,10008,4410,5093,290,7,97,5,2,6,3,20,4,4,9941,67,3380
4400,충청남도,4410,계룡시,,관내사전투표,4523,4523,2193,2158,115,2,22,2,0,1,1,8,1,3,4506,17,0
4400,충청남도,4410,계룡시,,엄사면제1투,3106,1932,779,1030,66,2,28,1,0,3,0,4,1,1,1915,17,1174
4400,충청남도,4410,계룡시,,엄사면제2투,1748,1022,407,549,31,0,21,0,0,1,0,4,0,0,1013,9,726
4400,충청남도,4410,계룡시,,엄사면제3투,1406,903,375,481,30,0,9,0,0,0,0,1,0,0,896,7,503
4400,충청남도,4410,계룡시,,엄사면제4투,1992,1222,510,633,37,2,16,1,2,1,2,3,2,0,1209,13,770
4400,충청남도,4410,계룡시,,엄사면제5투,613,406,146,242,11,1,1,1,0,0,0,0,0,0,402,4,207
4400,충청남도,4410,계룡시,신도안면,소계,5130,4179,1505,2441,148,1,37,0,1,0,0,1,0,3,4137,42,951
4400,충청남도,4410,계룡시,,관내사전투표,2637,2637,1000,1493,91,1,25,0,0,0,0,0,0,3,2613,24,0
4400,충청남도,4410,계룡시,,신도안면제1투,970,538,172,337,16,0,6,0,0,0,0,0,0,0,531,7,432
4400,충청남도,4410,계룡시,,신도안면제2투,1523,1004,333,611,41,0,6,0,1,0,0,1,0,0,993,11,519
4400,충청남도,4410,계룡시,금암동,소계,6327,5107,2230,2670,137,4,27,0,0,2,7,4,0,3,5084,23,1220
4400,충청남도,4410,계룡시,,관내사전투표,2621,2621,1272,1266,57,3,7,0,0,0,1,2,0,2,2610,11,0
4400,충청남도,4410,계룡시,,금암동제1투,2044,1323,538,712,46,1,14,0,0,1,3,2,0,0,1317,6,721
4400,충청남도,4410,계룡시,,금암동제2투,1662,1163,420,692,34,0,6,0,0,1,3,0,0,1,1157,6,499
4400,충청남도,4410,계룡시,잘못 투입·구분된 투표지,,0,0,0,0,0,0,0,0,0,0,0,0,0,0,0,0,0
4400,충청남도,4416,당진시,합계,,139481,100874,46903,49230,2258,35,1157,44,14,24,76,152,49,62,100004,870,38607
4400,충청남도,4416,당진시,거소·선상투표,,305,290,93,129,3,5,6,2,1,0,3,2,4,3,251,39,15
4400,충청남도,4416,당진시,관외사전투표,,9513,9512,4282,4733,221,8,138,3,2,2,7,12,4,8,9420,92,1
4400,충청남도,4416,당진시,재외투표,,329,227,145,59,4,0,1,0,0,0,0,0,0,0,209,18,102
4400,충청남도,4416,당진시,당진1동,소계,18337,12264,5740,5915,312,2,150,3,1,2,5,19,4,2,12155,109,6073
4400,충청남도,4416,당진시,,관내사전투표,5610,5610,2729,2663,129,1,41,0,1,0,1,9,2,1,5577,33,0
4400,충청남도,4416,당진시,,당진1동제1투,2150,1068,511,498,28,0,17,0,0,0,0,2,0,0,1056,12,1082
4400,충청남도,4416,당진시,,당진1동제2투,3489,1857,730,1027,39,0,36,0,0,1,0,5,1,0,1839,18,1632
4400,충청남도,4416,당진시,,당진1동제3투,2759,1454,564,796,37,0,31,1,0,1,3,1,0,1,1435,19,1305
4400,충청남도,4416,당진시,,당진1동제4투,4329,2275,1206,931,79,1,25,2,0,0,1,2,1,0,2248,27,2054
4400,충청남도,4416,당진시,합덕읍,소계,7757,5513,2086,3195,99,0,59,2,0,1,2,6,4,2,5456,57,2244
4400,충청남도,4416,당진시,,관내사전투표,2673,2673,1131,1439,37,0,34,1,0,1,0,4,1,0,2648,25,0
4400,충청남도,4416,당진시,,합덕읍제1투,801,494,143,330,13,0,5,0,0,0,0,1,0,0,492,2,307
4400,충청남도,4416,당진시,,합덕읍제2투,1055,584,194,361,14,0,3,0,0,0,0,1,1,1,575,9,471
4400,충청남도,4416,당진시,,합덕읍제3투,1660,794,319,439,16,0,11,1,0,0,0,0,0,0,786,8,866
4400,충청남도,4416,당진시,,합덕읍제4투,705,442,133,285,9,0,5,0,0,0,1,0,1,0,434,8,263
4400,충청남도,4416,당진시,,합덕읍제5투,863,526,166,341,10,0,1,0,0,0,1,0,1,1,521,5,337
4400,충청남도,4416,당진시,송악읍,소계,22543,15272,7977,6622,327,4,190,5,1,1,10,19,5,6,15167,105,7271
4400,충청남도,4416,당진시,,관내사전투표,6161,6160,3400,2557,120,3,43,2,0,0,2,7,1,4,6139,21,1
4400,충청남도,4416,당진시,,송악읍제1투,3947,2295,1275,892,62,0,38,2,0,0,3,5,0,0,2277,18,1652
4400,충청남도,4416,당진시,,송악읍제2투,718,411,126,261,9,0,10,0,0,0,0,0,0,0,406,5,307
4400,충청남도,4416,당진시,,송악읍제3투,2686,1490,621,788,43,0,21,0,1,0,3,0,2,1,1480,10,1196
4400,충청남도,4416,당진시,,송악읍제4투,1912,1000,349,593,19,0,23,0,0,0,1,0,1,0,986,14,912
4400,충청남도,4416,당진시,,송악읍제5투,3622,1964,1081,788,50,0,23,1,0,1,0,5,0,0,1949,15,1658
4400,충청남도,4416,당진시,,송악읍제6투,3497,1952,1125,743,24,1,32,0,0,0,1,2,1,1,1930,22,1545
4400,충청남도,4416,당진시,고대면,소계,5400,4154,1789,2192,71,1,51,1,0,0,0,4,2,4,4115,39,1246
4400,충청남도,4416,당진시,,관내사전투표,2383,2383,1192,1100,42,1,25,1,0,0,0,1,1,1,2364,19,0
4400,충청남도,4416,당진시,,고대면제1투,1149,667,226,407,19,0,11,0,0,0,0,1,0,0,664,3,482
4400,충청남도,4416,당진시,,고대면제2투,1105,662,220,414,4,0,12,0,0,0,0,0,0,1,651,11,443
4400,충청남도,4416,당진시,,고대면제3투,763,442,151,271,6,0,3,0,0,0,0,2,1,2,436,6,321
4400,충청남도,4416,당진시,석문면,소계,7552,5126,2369,2522,87,3,73,2,0,1,6,14,4,6,5087,39,2426
4400,충청남도,4416,당진시,,관내사전투표,2399,2399,1206,1102,35,0,32,0,0,1,3,4,2,2,2387,12,0
4400,충청남도,4416,당진시,,석문면제1투,2473,1271,579,622,34,1,18,2,0,0,2,4,0,0,1262,9,1202
4400,충청남도,4416,당진시,,석문면제2투,2112,1064,419,587,16,2,19,0,0,0,1,3,1,2,1050,14,1048
4400,충청남도,4416,당진시,,석문면제3투,123,90,24,62,0,0,0,0,0,0,0,1,1,1,89,1,33
4400,충청남도,4416,당진시,,석문면제4투,445,302,141,149,2,0,4,0,0,0,0,2,0,1,299,3,143
4400,충청남도,4416,당진시,대호지면,소계,2012,1448,487,900,20,1,12,1,0,1,1,4,1,4,1432,16,564
4400,충청남도,4416,당진시,,관내사전투표,596,596,218,361,4,1,3,0,0,1,0,1,0,2,591,5,0
4400,충청남도,4416,당진시,,대호지면제1투,813,457,137,297,7,0,4,0,0,0,1,2,1,0,449,8,356
4400,충청남도,4416,당진시,,대호지면제2투,603,395,132,242,9,0,5,1,0,0,0,1,0,2,392,3,208
4400,충청남도,4416,당진시,정미면,소계,2984,2151,730,1340,35,0,19,0,0,0,1,4,2,3,2134,17,833
4400,충청남도,4416,당진시,,관내사전투표,995,995,379,575,22,0,7,0,0,0,0,2,1,1,987,8,0
4400,충청남도,4416,당진시,,정미면제1투,1248,680,203,454,8,0,5,0,0,0,0,2,1,1,674,6,568
4400,충청남도,4416,당진시,,정미면제2투,741,476,148,311,5,0,7,0,0,0,1,0,0,1,473,3,265
4400,충청남도,4416,당진시,면천면,소계,3101,2317,819,1407,42,1,14,1,1,0,3,6,2,1,2297,20,784
4400,충청남도,4416,당진시,,관내사전투표,1181,1181,441,705,16,1,8,0,0,0,1,3,1,0,1176,5,0
4400,충청남도,4416,당진시,,면천면제1투,1262,720,237,449,18,0,5,0,0,0,1,2,0,1,713,7,542
4400,충청남도,4416,당진시,,면천면제2투,658,416,141,253,8,0,1,1,1,0,1,1,1,0,408,8,242
4400,충청남도,4416,당진시,순성면,소계,4347,3090,1237,1706,72,0,27,2,0,1,3,4,5,4,3061,29,1257
4400,충청남도,4416,당진시,,관내사전투표,1520,1520,688,768,38,0,11,0,0,0,1,2,1,2,1511,9,0
4400,충청남도,4416,당진시,,순성면제1투,1490,776,301,430,18,0,10,1,0,0,1,2,2,1,766,10,714
4400,충청남도,4416,당진시,,순성면제2투,629,362,102,241,6,0,5,0,0,0,0,0,1,1,356,6,267
4400,충청남도,4416,당진시,,순성면제3투,708,432,146,267,10,0,1,1,0,1,1,0,1,0,428,4,276
4400,충청남도,4416,당진시,우강면,소계,4340,3081,1093,1853,71,0,31,0,0,0,3,4,0,1,3056,25,1259
4400,충청남도,4416,당진시,,관내사전투표,1280,1280,525,691,42,0,13,0,0,0,0,1,0,0,1272,8,0
4400,충청남도,4416,당진시,,우강면제1투,2053,1125,359,714,23,0,12,0,0,0,3,2,0,0,1113,12,928
4400,충청남도,4416,당진시,,우강면제2투,460,331,103,215,4,0,6,0,0,0,0,1,0,0,329,2,129
4400,충청남도,4416,당진시,,우강면제3투,547,345,106,233,2,0,0,0,0,0,0,0,0,1,342,3,202
4400,충청남도,4416,당진시,신평면,소계,12181,8813,4059,4369,190,1,101,2,0,4,13,11,2,5,8757,56,3368
4400,충청남도,4416,당진시,,관내사전투표,3986,3985,2041,1803,85,0,29,0,0,2,4,3,1,4,3972,13,1
4400,충청남도,4416,당진시,,신평면제1투,1968,1228,473,698,21,0,19,1,0,2,2,1,0,0,1217,11,740
4400,충청남도,4416,당진시,,신평면제2투,3954,2202,1080,998,54,1,37,1,0,0,5,5,0,1,2182,20,1752
4400,충청남도,4416,당진시,,신평면제3투,867,533,168,346,10,0,7,0,0,0,0,1,0,0,532,1,334
4400,충청남도,4416,당진시,,신평면제4투,1406,865,297,524,20,0,9,0,0,0,2,1,1,0,854,11,541
4400,충청남도,4416,당진시,송산면,소계,9417,6604,3345,2945,137,2,92,8,1,3,3,10,0,1,6547,57,2813
4400,충청남도,4416,당진시,,관내사전투표,3180,3179,1751,1312,56,2,32,3,1,1,1,6,0,0,3165,14,1
4400,충청남도,4416,당진시,,송산면제1투,1591,929,394,495,20,0,7,1,0,0,2,1,0,1,921,8,662
4400,충청남도,4416,당진시,,송산면제2투,1378,717,283,386,26,0,13,1,0,1,0,0,0,0,710,7,661
4400,충청남도,4416,당진시,,송산면제3투,3268,1779,917,752,35,0,40,3,0,1,0,3,0,0,1751,28,1489
4400,충청남도,4416,당진시,당진2동,소계,15902,11020,5623,4842,293,5,111,6,3,7,12,20,7,5,10934,86,4882
4400,충청남도,4416,당진시,,관내사전투표,4292,4292,2467,1649,108,2,32,4,3,2,0,5,2,1,4275,17,0
4400,충청남도,4416,당진시,,당진2동제1투,484,321,108,203,5,0,2,0,0,1,0,0,0,0,319,2,163
4400,충청남도,4416,당진시,,당진2동제2투,2697,1464,629,747,33,2,22,1,0,0,2,3,0,1,1440,24,1233
4400,충청남도,4416,당진시,,당진2동제3투,1267,709,293,365,18,1,14,0,0,0,5,1,2,1,700,9,558
4400,충청남도,4416,당진시,,당진2동제4투,2647,1653,870,701,53,0,6,0,0,1,2,2,2,0,1637,16,994
4400,충청남도,4416,당진시,,당진2동제5투,4515,2581,1256,1177,76,0,35,1,0,3,3,9,1,2,2563,18,1934
4400,충청남도,4416,당진시,당진3동,소계,13461,9992,5029,4501,274,2,82,6,4,1,4,13,3,7,9926,66,3469
4400,충청남도,4416,당진시,,관내사전투표,4665,4664,2585,1883,133,0,22,1,2,1,3,5,1,5,4641,23,1
4400,충청남도,4416,당진시,,당진3동제1투,3468,2065,961,1025,44,0,18,1,0,0,0,2,0,0,2051,14,1403
4400,충청남도,4416,당진시,,당진3동제2투,2028,1298,597,628,42,0,12,3,1,0,0,1,0,0,1284,14,730
4400,충청남도,4416,당진시,,당진3동제3투,1325,858,395,412,33,1,9,0,0,0,1,1,1,0,853,5,467
4400,충청남도,4416,당진시,,당진3동제4투,1975,1107,491,553,22,1,21,1,1,0,0,4,1,2,1097,10,868
4400,충청남도,4416,당진시,잘못 투입·구분된 투표지,,0,0,0,0,0,0,0,0,0,0,0,0,0,0,0,0,0
4400,충청남도,4411,부여군,합계,,57573,43975,16813,25136,878,28,438,19,4,17,34,103,57,43,43570,405,13598
4400,충청남도,4411,부여군,거소·선상투표,,283,268,81,133,10,1,9,2,0,1,1,0,0,0,238,30,15
4400,충청남도,4411,부여군,관외사전투표,,4269,4268,1960,2069,114,5,54,2,1,1,2,8,4,4,4224,44,1
4400,충청남도,4411,부여군,재외투표,,182,119,79,30,5,0,0,0,0,0,0,0,0,0,114,5,63
4400,충청남도,4411,부여군,부여읍,소계,16046,11971,4489,6997,238,6,101,2,1,7,3,20,9,6,11879,92,4075
4400,충청남도,4411,부여군,,관내사전투표,5029,5029,2238,2583,127,3,38,0,0,1,0,11,3,1,5005,24,0
4400,충청남도,4411,부여군,,부여읍제1투,1342,778,269,487,11,0,4,0,0,0,0,0,0,0,771,7,564
4400,충청남도,4411,부여군,,부여읍제2투,1064,629,207,402,7,0,7,0,0,0,0,1,0,0,624,5,435
4400,충청남도,4411,부여군,,부여읍제3투,1197,820,251,544,7,0,6,0,1,1,1,4,0,2,817,3,377
4400,충청남도,4411,부여군,,부여읍제4투,887,571,163,391,3,1,5,0,0,0,0,0,0,0,563,8,316
4400,충청남도,4411,부여군,,부여읍제5투,1882,1280,441,781,24,0,12,0,0,2,1,0,1,0,1262,18,602
4400,충청남도,4411,부여군,,부여읍제6투,1260,799,309,442,26,0,10,1,0,0,0,0,1,1,790,9,461
4400,충청남도,4411,부여군,,부여읍제7투,1215,709,207,476,11,0,4,0,0,1,0,1,2,0,702,7,506
4400,충청남도,4411,부여군,,부여읍제8투,996,643,152,461,13,0,6,0,0,1,0,1,1,2,637,6,353
4400,충청남도,4411,부여군,,부여읍제9투,1174,713,252,430,9,2,9,1,0,1,1,2,1,0,708,5,461
4400,충청남도,4411,부여군,규암면,소계,8708,6232,2550,3355,146,3,95,1,0,2,4,13,2,3,6174,58,2476
4400,충청남도,4411,부여군,,관내사전투표,2678,2678,1205,1347,63,3,35,1,0,1,0,4,1,0,2660,18,0
4400,충청남도,4411,부여군,,규암면제1투,1703,995,351,601,20,0,11,0,0,0,2,3,1,1,990,5,708
4400,충청남도,4411,부여군,,규암면제2투,2296,1299,540,662,41,0,35,0,0,0,2,4,0,2,1286,13,997
4400,충청남도,4411,부여군,,규암면제3투,1129,684,266,382,13,0,9,0,0,0,0,2,0,0,672,12,445
4400,충청남도,4411,부여군,,규암면제4투,902,576,188,363,9,0,5,0,0,1,0,0,0,0,566,10,326
4400,충청남도,4411,부여군,은산면,소계,3211,2437,830,1506,40,1,23,1,1,1,0,6,8,3,2420,17,774
4400,충청남도,4411,부여군,,관내사전투표,1392,1392,495,838,27,1,9,0,1,0,0,3,5,2,1381,11,0
4400,충청남도,4411,부여군,,은산면제1투,934,549,180,343,11,0,7,0,0,0,0,2,1,1,545,4,385
4400,충청남도,4411,부여군,,은산면제2투,435,262,88,167,1,0,2,1,0,0,0,1,1,0,261,1,173
4400,충청남도,4411,부여군,,은산면제3투,450,234,67,158,1,0,5,0,0,1,0,0,1,0,233,1,216
4400,충청남도,4411,부여군,외산면,소계,2037,1582,553,959,29,3,12,0,0,1,2,1,3,1,1564,18,455
4400,충청남도,4411,부여군,,관내사전투표,913,913,343,543,9,1,3,0,0,1,0,0,1,1,902,11,0
4400,충청남도,4411,부여군,,외산면투표소,1124,669,210,416,20,2,9,0,0,0,2,1,2,0,662,7,455
4400,충청남도,4411,부여군,내산면,소계,1306,996,362,610,17,0,3,0,0,0,0,0,2,0,994,2,310
4400,충청남도,4411,부여군,,관내사전투표,544,544,217,320,6,0,0,0,0,0,0,0,1,0,544,0,0
4400,충청남도,4411,부여군,,내산면투표소,762,452,145,290,11,0,3,0,0,0,0,0,1,0,450,2,310
4400,충청남도,4411,부여군,구룡면,소계,2090,1523,601,854,38,0,13,0,0,0,1,4,2,0,1513,10,567
4400,충청남도,4411,부여군,,관내사전투표,737,737,326,386,16,0,3,0,0,0,1,2,1,0,735,2,0
4400,충청남도,4411,부여군,,구룡면투표소,1353,786,275,468,22,0,10,0,0,0,0,2,1,0,778,8,567
4400,충청남도,4411,부여군,홍산면,소계,2568,2007,748,1159,40,2,15,2,1,1,2,16,2,4,1992,15,561
4400,충청남도,4411,부여군,,관내사전투표,1104,1104,461,584,23,1,7,2,0,0,2,10,2,2,1094,10,0
4400,충청남도,4411,부여군,,홍산면제1투,1064,656,222,407,11,1,8,0,1,1,0,1,0,1,653,3,408
4400,충청남도,4411,부여군,,홍산면제2투,400,247,65,168,6,0,0,0,0,0,0,5,0,1,245,2,153
4400,충청남도,4411,부여군,옥산면,소계,1239,974,344,586,8,2,11,0,0,0,2,7,2,4,966,8,265
4400,충청남도,4411,부여군,,관내사전투표,560,560,237,299,5,2,3,0,0,0,1,3,2,3,555,5,0
4400,충청남도,4411,부여군,,옥산면투표소,679,414,107,287,3,0,8,0,0,0,1,4,0,1,411,3,265
4400,충청남도,4411,부여군,남면,소계,1586,1198,419,739,15,0,7,0,0,0,0,4,2,0,1186,12,388
4400,충청남도,4411,부여군,,관내사전투표,636,636,242,371,8,0,2,0,0,0,0,2,1,0,626,10,0
4400,충청남도,4411,부여군,,남면투표소,950,562,177,368,7,0,5,0,0,0,0,2,1,0,560,2,388
4400,충청남도,4411,부여군,충화면,소계,978,729,266,432,12,0,7,1,0,0,1,2,1,2,724,5,249
4400,충청남도,4411,부여군,,관내사전투표,388,388,168,202,8,0,4,1,0,0,0,0,1,1,385,3,0
4400,충청남도,4411,부여군,,충화면투표소,590,341,98,230,4,0,3,0,0,0,1,2,0,1,339,2,249
4400,충청남도,4411,부여군,양화면,소계,1451,1106,381,678,14,0,5,3,0,1,1,2,6,2,1093,13,345
4400,충청남도,4411,부여군,,관내사전투표,638,638,228,379,10,0,1,2,0,1,0,1,5,2,629,9,0
4400,충청남도,4411,부여군,,양화면제1투,330,185,42,138,1,0,2,0,0,0,0,1,0,0,184,1,145
4400,충청남도,4411,부여군,,양화면제2투,483,283,111,161,3,0,2,1,0,0,1,0,1,0,280,3,200
4400,충청남도,4411,부여군,임천면,소계,2398,1757,628,1050,26,2,17,1,0,0,4,2,4,2,1736,21,641
4400,충청남도,4411,부여군,,관내사전투표,963,963,364,550,16,2,6,1,0,0,4,1,3,2,949,14,0
4400,충청남도,4411,부여군,,임천면제1투,900,521,173,327,6,0,8,0,0,0,0,1,1,0,516,5,379
4400,충청남도,4411,부여군,,임천면제2투,535,273,91,173,4,0,3,0,0,0,0,0,0,0,271,2,262
4400,충청남도,4411,부여군,장암면,소계,2349,1687,567,1054,26,0,15,1,0,0,1,3,3,3,1673,14,662
4400,충청남도,4411,부여군,,관내사전투표,712,712,274,427,4,0,1,0,0,0,0,0,2,1,709,3,0
4400,충청남도,4411,부여군,,장암면제1투,363,206,66,133,4,0,3,0,0,0,0,0,0,0,206,0,157
4400,충청남도,4411,부여군,,장암면제2투,603,344,99,222,8,0,7,0,0,0,0,1,0,2,339,5,259
4400,충청남도,4411,부여군,,장암면제3투,671,425,128,272,10,0,4,1,0,0,1,2,1,0,419,6,246
4400,충청남도,4411,부여군,세도면,소계,2701,2040,818,1129,35,2,22,1,0,1,3,4,4,4,2023,17,661
4400,충청남도,4411,부여군,,관내사전투표,965,965,421,506,16,1,4,0,0,0,2,3,1,2,956,9,0
4400,충청남도,4411,부여군,,세도면제1투,850,510,183,300,9,1,9,0,0,1,0,0,3,0,506,4,340
4400,충청남도,4411,부여군,,세도면제2투,886,565,214,323,10,0,9,1,0,0,1,1,0,2,561,4,321
4400,충청남도,4411,부여군,석성면,소계,2406,1790,687,1029,30,1,18,1,0,1,5,3,2,1,1778,12,616
4400,충청남도,4411,부여군,,관내사전투표,873,873,368,479,10,1,6,0,0,1,2,0,0,0,867,6,0
4400,충청남도,4411,부여군,,석성면제1투,862,486,171,287,10,0,11,0,0,0,3,2,1,0,485,1,376
4400,충청남도,4411,부여군,,석성면제2투,671,431,148,263,10,0,1,1,0,0,0,1,1,1,426,5,240
4400,충청남도,4411,부여군,초촌면,소계,1765,1291,450,767,35,0,11,1,0,0,2,8,1,4,1279,12,474
4400,충청남도,4411,부여군,,관내사전투표,587,587,204,358,14,0,3,0,0,0,2,2,0,1,584,3,0
4400,충청남도,4411,부여군,,초촌면제1투,683,397,132,231,12,0,7,1,0,0,0,6,0,2,391,6,286
4400,충청남도,4411,부여군,,초촌면제2투,495,307,114,178,9,0,1,0,0,0,0,0,1,1,304,3,188
4400,충청남도,4411,부여군,잘못 투입·구분된 투표지,,0,0,0,0,0,0,0,0,0,0,0,0,0,0,0,0,0
4400,충청남도,4412,서천군,합계,,45997,35136,15443,18168,688,19,263,14,8,13,26,74,47,48,34811,325,10861
4400,충청남도,4412,서천군,거소·선상투표,,214,191,75,98,3,0,0,0,0,0,1,0,0,0,177,14,23
4400,충청남도,4412,서천군,관외사전투표,,3292,3291,1637,1491,76,0,35,3,0,2,1,6,0,4,3255,36,1
4400,충청남도,4412,서천군,재외투표,,158,112,71,36,2,0,0,0,0,0,0,0,0,0,109,3,46
4400,충청남도,4412,서천군,장항읍,소계,9099,6606,3147,3197,122,3,49,2,1,2,2,9,5,6,6545,61,2493
4400,충청남도,4412,서천군,,관내사전투표,3202,3202,1618,1472,56,2,22,2,0,2,2,8,3,3,3190,12,0
4400,충청남도,4412,서천군,,장항읍제1투,1308,682,293,354,15,0,11,0,0,0,0,0,0,0,673,9,626
4400,충청남도,4412,서천군,,장항읍제2투,1583,913,436,431,20,1,8,0,1,0,0,0,2,2,901,12,670
4400,충청남도,4412,서천군,,장항읍제3투,1778,1072,472,564,12,0,3,0,0,0,0,0,0,1,1052,20,706
4400,충청남도,4412,서천군,,장항읍제4투,1228,737,328,376,19,0,5,0,0,0,0,1,0,0,729,8,491
4400,충청남도,4412,서천군,서천읍,소계,10742,8172,3610,4215,185,3,59,1,2,2,10,10,7,13,8117,55,2570
4400,충청남도,4412,서천군,,관내사전투표,4255,4255,2000,2087,105,1,22,1,1,1,2,6,2,9,4237,18,0
4400,충청남도,4412,서천군,,서천읍제1투,1296,771,266,471,18,0,5,0,1,0,2,0,3,0,766,5,525
4400,충청남도,4412,서천군,,서천읍제2투,933,521,205,288,14,0,9,0,0,0,2,0,0,2,520,1,412
4400,충청남도,4412,서천군,,서천읍제3투,986,568,216,332,7,0,6,0,0,1,0,0,0,1,563,5,418
4400,충청남도,4412,서천군,,서천읍제4투,1173,734,313,399,9,1,4,0,0,0,0,0,0,0,726,8,439
4400,충청남도,4412,서천군,,서천읍제5투,2099,1323,610,638,32,1,13,0,0,0,4,4,2,1,1305,18,776
4400,충청남도,4412,서천군,마서면,소계,3946,2787,1199,1483,45,2,17,0,0,0,0,9,3,5,2763,24,1159
4400,충청남도,4412,서천군,,관내사전투표,1105,1105,530,533,19,2,7,0,0,0,0,3,2,2,1098,7,0
4400,충청남도,4412,서천군,,마서면제1투,838,470,202,245,10,0,4,0,0,0,0,2,1,1,465,5,368
4400,충청남도,4412,서천군,,마서면제2투,1014,642,236,386,8,0,3,0,0,0,0,1,0,2,636,6,372
4400,충청남도,4412,서천군,,마서면제3투,989,570,231,319,8,0,3,0,0,0,0,3,0,0,564,6,419
4400,충청남도,4412,서천군,화양면,소계,1888,1438,589,782,24,1,19,1,1,0,1,4,5,2,1429,9,450
4400,충청남도,4412,서천군,,관내사전투표,708,708,327,354,10,1,9,0,0,0,0,1,3,0,705,3,0
4400,충청남도,4412,서천군,,화양면제1투,663,385,139,227,7,0,6,0,0,0,0,1,1,1,382,3,278
4400,충청남도,4412,서천군,,화양면제2투,517,345,123,201,7,0,4,1,1,0,1,2,1,1,342,3,172
4400,충청남도,4412,서천군,기산면,소계,1382,1019,415,558,18,0,6,1,1,0,1,2,4,2,1008,11,363
4400,충청남도,4412,서천군,,관내사전투표,579,578,254,300,9,0,1,1,1,0,1,0,1,2,570,8,1
4400,충청남도,4412,서천군,,기산면투표소,803,441,161,258,9,0,5,0,0,0,0,2,3,0,438,3,362
4400,충청남도,4412,서천군,한산면,소계,2200,1710,742,892,29,1,11,0,0,1,1,6,4,3,1690,20,490
4400,충청남도,4412,서천군,,관내사전투표,1016,1016,443,534,15,0,5,0,0,1,0,2,2,1,1003,13,0
4400,충청남도,4412,서천군,,한산면투표소,1184,694,299,358,14,1,6,0,0,0,1,4,2,2,687,7,490
4400,충청남도,4412,서천군,마산면,소계,1242,914,378,493,16,0,7,1,0,1,1,9,1,2,909,5,328
4400,충청남도,4412,서천군,,관내사전투표,492,492,205,269,8,0,1,0,0,1,0,5,0,1,490,2,0
4400,충청남도,4412,서천군,,마산면투표소,750,422,173,224,8,0,6,1,0,0,1,4,1,1,419,3,328
4400,충청남도,4412,서천군,시초면,소계,1045,793,284,468,17,1,6,0,0,1,0,1,2,1,781,12,252
4400,충청남도,4412,서천군,,관내사전투표,435,435,166,245,8,1,4,0,0,0,0,0,1,1,426,9,0
4400,충청남도,4412,서천군,,시초면투표소,610,358,118,223,9,0,2,0,0,1,0,1,1,0,355,3,252
4400,충청남도,4412,서천군,문산면,소계,1124,864,317,513,13,0,7,0,0,0,1,5,2,0,858,6,260
4400,충청남도,4412,서천군,,관내사전투표,518,518,191,310,7,0,0,0,0,0,0,5,2,0,515,3,0
4400,충청남도,4412,서천군,,문산면투표소,606,346,126,203,6,0,7,0,0,0,1,0,0,0,343,3,260
4400,충청남도,4412,서천군,판교면,소계,1827,1443,476,908,20,3,7,0,2,1,3,3,3,1,1427,16,384
4400,충청남도,4412,서천군,,관내사전투표,898,898,330,536,13,2,3,0,2,1,2,2,2,0,893,5,0
4400,충청남도,4412,서천군,,판교면투표소,929,545,146,372,7,1,4,0,0,0,1,1,1,1,534,11,384
4400,충청남도,4412,서천군,종천면,소계,1776,1318,537,719,23,0,11,0,1,1,0,1,4,4,1301,17,458
4400,충청남도,4412,서천군,,관내사전투표,661,661,304,330,11,0,4,0,1,0,0,0,3,3,656,5,0
4400,충청남도,4412,서천군,,종천면제1투,506,277,103,156,8,0,3,0,0,1,0,0,1,1,273,4,229
4400,충청남도,4412,서천군,,종천면제2투,609,380,130,233,4,0,4,0,0,0,0,1,0,0,372,8,229
4400,충청남도,4412,서천군,비인면,소계,2575,1907,818,994,47,3,11,2,0,2,3,5,2,2,1889,18,668
4400,충청남도,4412,서천군,,관내사전투표,1075,1075,495,541,23,2,1,1,0,1,0,3,1,2,1070,5,0
4400,충청남도,4412,서천군,,비인면제1투,927,525,189,306,15,1,3,1,0,0,1,1,0,0,517,8,402
4400,충청남도,4412,서천군,,비인면제2투,573,307,134,147,9,0,7,0,0,1,2,1,1,0,302,5,266
4400,충청남도,4412,서천군,서면,소계,3487,2570,1147,1321,48,2,18,3,0,0,1,4,5,3,2552,18,917
4400,충청남도,4412,서천군,,관내사전투표,1200,1200,577,582,20,1,7,3,0,0,0,2,2,1,1195,5,0
4400,충청남도,4412,서천군,,서면제1투,867,506,203,280,11,1,3,0,0,0,1,2,0,0,501,5,361
4400,충청남도,4412,서천군,,서면제2투,1420,864,367,459,17,0,8,0,0,0,0,0,3,2,856,8,556
4400,충청남도,4412,서천군,잘못 투입·구분된 투표지,,0,1,1,0,0,0,0,0,0,0,0,0,0,0,1,0,-1
4400,충청남도,4413,홍성군,합계,,84379,62416,25860,33581,1536,28,611,28,6,9,38,65,60,49,61871,545,21963
4400,충청남도,4413,홍성군,거소·선상투표,,226,211,76,104,1,0,8,0,1,0,0,0,1,0,191,20,15
4400,충청남도,4413,홍성군,관외사전투표,,6570,6570,2942,3195,226,6,97,2,0,1,1,15,2,7,6494,76,0
4400,충청남도,4413,홍성군,재외투표,,219,153,93,37,8,0,1,0,0,0,1,0,0,0,140,13,66
4400,충청남도,4413,홍성군,홍성읍,소계,29056,19835,8160,10791,470,10,188,3,0,2,15,12,10,11,19672,163,9221
4400,충청남도,4413,홍성군,,관내사전투표,7915,7915,3591,4034,176,4,53,0,0,0,2,3,3,3,7869,46,0
4400,충청남도,4413,홍성군,,홍성읍제1투,1856,1160,358,743,33,0,13,0,0,0,1,0,2,1,1151,9,696
4400,충청남도,4413,홍성군,,홍성읍제2투,2167,1340,516,770,28,2,15,0,0,0,1,1,0,0,1333,7,827
4400,충청남도,4413,홍성군,,홍성읍제3투,3180,1684,732,864,46,1,17,0,0,0,1,1,3,2,1667,17,1496
4400,충청남도,4413,홍성군,,홍성읍제4투,1805,1021,354,619,25,0,15,0,0,0,0,0,1,1,1015,6,784
4400,충청남도,4413,홍성군,,홍성읍제5투,2818,1482,564,859,24,0,14,1,0,0,1,0,0,0,1463,19,1336
4400,충청남도,4413,홍성군,,홍성읍제6투,2549,1493,462,960,26,0,18,2,0,0,2,2,0,0,1472,21,1056
4400,충청남도,4413,홍성군,,홍성읍제7투,2781,1546,598,862,45,2,14,0,0,0,3,1,0,1,1526,20,1235
4400,충청남도,4413,홍성군,,홍성읍제8투,3985,2194,985,1080,67,1,29,0,0,2,4,4,1,3,2176,18,1791
4400,충청남도,4413,홍성군,광천읍,소계,7402,5343,1738,3409,64,2,61,6,0,3,5,1,8,5,5302,41,2059
4400,충청남도,4413,홍성군,,관내사전투표,2791,2791,951,1758,28,2,20,3,0,2,2,1,6,2,2775,16,0
4400,충청남도,4413,홍성군,,광천읍제1투,1318,715,226,468,5,0,10,0,0,0,2,0,2,0,713,2,603
4400,충청남도,4413,홍성군,,광천읍제2투,1680,937,311,584,11,0,15,1,0,0,0,0,0,1,923,14,743
4400,충청남도,4413,홍성군,,광천읍제3투,1613,900,250,599,20,0,16,2,0,1,1,0,0,2,891,9,713
4400,충청남도,4413,홍성군,금마면,소계,3251,2434,927,1396,47,0,24,2,0,0,1,0,4,4,2405,29,817
4400,충청남도,4413,홍성군,,관내사전투표,1084,1084,470,568,23,0,12,1,0,0,0,0,2,0,1076,8,0
4400,충청남도,4413,홍성군,,금마면제1투,603,394,133,237,8,0,5,0,0,0,1,0,0,1,385,9,209
4400,충청남도,4413,홍성군,,금마면제2투,615,360,114,229,8,0,2,1,0,0,0,0,2,0,356,4,255
4400,충청남도,4413,홍성군,,금마면제3투,949,596,210,362,8,0,5,0,0,0,0,0,0,3,588,8,353
4400,충청남도,4413,홍성군,홍동면,소계,3071,2358,1050,1184,72,1,17,11,0,0,2,3,2,1,2343,15,713
4400,충청남도,4413,홍성군,,관내사전투표,1001,1001,566,388,34,0,6,1,0,0,0,2,0,0,997,4,0
4400,충청남도,4413,홍성군,,홍동면제1투,739,451,198,225,13,0,4,7,0,0,0,0,1,1,449,2,288
4400,충청남도,4413,홍성군,,홍동면제2투,548,353,135,195,13,0,1,3,0,0,0,1,0,0,348,5,195
4400,충청남도,4413,홍성군,,홍동면제3투,783,553,151,376,12,1,6,0,0,0,2,0,1,0,549,4,230
4400,충청남도,4413,홍성군,장곡면,소계,2512,1831,589,1154,37,0,22,2,0,0,1,1,5,2,1813,18,681
4400,충청남도,4413,홍성군,,관내사전투표,702,702,282,392,15,0,4,1,0,0,0,1,0,2,697,5,0
4400,충청남도,4413,홍성군,,장곡면제1투,876,541,146,362,13,0,13,0,0,0,1,0,3,0,538,3,335
4400,충청남도,4413,홍성군,,장곡면제2투,370,229,68,154,3,0,0,0,0,0,0,0,1,0,226,3,141
4400,충청남도,4413,홍성군,,장곡면제3투,564,359,93,246,6,0,5,1,0,0,0,0,1,0,352,7,205
4400,충청남도,4413,홍성군,은하면,소계,2035,1476,451,962,28,0,12,0,0,0,0,1,4,0,1458,18,559
4400,충청남도,4413,홍성군,,관내사전투표,702,702,243,438,13,0,2,0,0,0,0,0,0,0,696,6,0
4400,충청남도,4413,홍성군,,은하면제1투,910,504,153,325,6,0,7,0,0,0,0,1,3,0,495,9,406
4400,충청남도,4413,홍성군,,은하면제2투,423,270,55,199,9,0,3,0,0,0,0,0,1,0,267,3,153
4400,충청남도,4413,홍성군,결성면,소계,1868,1417,381,970,29,1,9,0,1,0,4,3,5,2,1405,12,451
4400,충청남도,4413,홍성군,,관내사전투표,639,639,199,414,16,1,3,0,0,0,0,0,1,2,636,3,0
4400,충청남도,4413,홍성군,,결성면제1투,463,307,64,229,6,0,1,0,1,0,1,1,2,0,305,2,156
4400,충청남도,4413,홍성군,,결성면제2투,341,192,49,131,3,0,3,0,0,0,3,2,1,0,192,0,149
4400,충청남도,4413,홍성군,,결성면제3투,425,279,69,196,4,0,2,0,0,0,0,0,1,0,272,7,146
4400,충청남도,4413,홍성군,서부면,소계,2848,2105,672,1340,36,3,24,0,1,0,1,4,2,4,2087,18,743
4400,충청남도,4413,홍성군,,관내사전투표,1061,1061,340,681,18,2,6,0,0,0,1,3,0,0,1051,10,0
4400,충청남도,4413,홍성군,,서부면제1투,837,473,160,286,13,0,8,0,1,0,0,1,1,2,472,1,364
4400,충청남도,4413,홍성군,,서부면제2투,950,571,172,373,5,1,10,0,0,0,0,0,1,2,564,7,379
4400,충청남도,4413,홍성군,갈산면,소계,3269,2474,775,1610,33,1,13,0,1,0,1,8,4,3,2449,25,795
4400,충청남도,4413,홍성군,,관내사전투표,1297,1297,445,807,22,0,5,0,0,0,1,3,2,2,1287,10,0
4400,충청남도,4413,홍성군,,갈산면제1투,1201,685,182,477,4,0,6,0,0,0,0,5,1,1,676,9,516
4400,충청남도,4413,홍성군,,갈산면제2투,316,219,49,162,3,1,2,0,1,0,0,0,0,0,218,1,97
4400,충청남도,4413,홍성군,,갈산면제3투,455,273,99,164,4,0,0,0,0,0,0,0,1,0,268,5,182
4400,충청남도,4413,홍성군,구항면,소계,3577,2706,1144,1446,51,1,24,1,0,0,1,7,5,1,2681,25,871
4400,충청남도,4413,홍성군,,관내사전투표,1518,1518,734,732,26,1,9,1,0,0,1,5,1,0,1510,8,0
4400,충청남도,4413,홍성군,,구항면제1투,1085,633,218,384,11,0,5,0,0,0,0,1,2,1,622,11,452
4400,충청남도,4413,홍성군,,구항면제2투,974,555,192,330,14,0,10,0,0,0,0,1,2,0,549,6,419
4400,충청남도,4413,홍성군,홍북읍,소계,18475,13503,6862,5983,434,3,111,1,2,3,5,10,8,9,13431,72,4972
4400,충청남도,4413,홍성군,,관내사전투표,5494,5494,3147,2145,151,2,23,0,0,1,0,3,3,3,5478,16,0
4400,충청남도,4413,홍성군,,홍북읍제1투,1164,749,237,474,16,0,10,1,1,0,0,1,0,2,742,7,415
4400,충청남도,4413,홍성군,,홍북읍제2투,761,463,167,280,9,0,3,0,0,0,1,1,1,1,463,0,298
4400,충청남도,4413,홍성군,,홍북읍제3투,685,466,149,296,12,0,2,0,0,1,0,0,2,0,462,4,219
4400,충청남도,4413,홍성군,,홍북읍제4투,2337,1292,621,585,61,0,12,0,0,1,0,0,1,0,1281,11,1045
4400,충청남도,4413,홍성군,,홍북읍제5투,2070,1343,648,610,55,0,14,0,0,0,2,1,0,2,1332,11,727
4400,충청남도,4413,홍성군,,홍북읍제6투,2064,1319,672,581,42,1,15,0,1,0,1,1,0,0,1314,5,745
4400,충청남도,4413,홍성군,,홍북읍제7투,3900,2377,1221,1012,88,0,32,0,0,0,1,3,1,1,2359,18,1523
4400,충청남도,4413,홍성군,잘못 투입·구분된 투표지,,0,0,0,0,0,0,0,0,0,0,0,0,0,0,0,0,0
4400,충청남도,4414,청양군,합계,,27754,21588,7688,12932,416,23,223,7,6,3,12,33,23,21,21387,201,6166
4400,충청남도,4414,청양군,거소·선상투표,,65,59,14,35,4,0,0,0,0,0,1,0,0,0,54,5,6
4400,충청남도,4414,청양군,관외사전투표,,2643,2643,1132,1380,72,1,26,1,0,0,2,3,0,3,2620,23,0
4400,충청남도,4414,청양군,재외투표,,69,54,31,19,1,0,0,0,0,0,0,0,0,0,51,3,15
4400,충청남도,4414,청양군,청양읍,소계,7936,6019,2147,3611,114,5,65,3,0,1,1,13,5,3,5968,51,1917
4400,충청남도,4414,청양군,,관내사전투표,3257,3257,1213,1907,61,1,30,2,0,1,1,10,2,1,3229,28,0
4400,충청남도,4414,청양군,,청양읍제1투,976,580,165,388,13,0,8,0,0,0,0,1,0,1,576,4,396
4400,충청남도,4414,청양군,,청양읍제2투,1720,1007,392,568,23,1,14,0,0,0,0,0,2,0,1000,7,713
4400,충청남도,4414,청양군,,청양읍제3투,1018,566,177,364,10,1,5,0,0,0,0,2,1,0,560,6,452
4400,충청남도,4414,청양군,,청양읍제4투,965,609,200,384,7,2,8,1,0,0,0,0,0,1,603,6,356
4400,충청남도,4414,청양군,운곡면,소계,1786,1353,364,936,25,4,13,1,1,0,0,1,2,0,1347,6,433
4400,충청남도,4414,청양군,,관내사전투표,792,792,240,522,15,4,5,1,0,0,0,0,1,0,788,4,0
4400,충청남도,4414,청양군,,운곡면투표소,994,561,124,414,10,0,8,0,1,0,0,1,1,0,559,2,433
4400,충청남도,4414,청양군,대치면,소계,1863,1432,457,906,34,2,13,1,0,0,0,1,2,0,1416,16,431
4400,충청남도,4414,청양군,,관내사전투표,668,668,252,391,13,2,5,1,0,0,0,0,1,0,665,3,0
4400,충청남도,4414,청양군,,대치면제1투,590,357,93,243,13,0,3,0,0,0,0,0,1,0,353,4,233
4400,충청남도,4414,청양군,,대치면제2투,605,407,112,272,8,0,5,0,0,0,0,1,0,0,398,9,198
4400,충청남도,4414,청양군,정산면,소계,2964,2211,812,1302,43,4,21,0,2,0,1,4,6,1,2196,15,753
4400,충청남도,4414,청양군,,관내사전투표,1185,1185,480,654,23,3,11,0,2,0,0,1,4,0,1178,7,0
4400,충청남도,4414,청양군,,정산면제1투,997,595,195,378,11,1,6,0,0,0,1,2,0,1,595,0,402
4400,충청남도,4414,청양군,,정산면제2투,782,431,137,270,9,0,4,0,0,0,0,1,2,0,423,8,351
4400,충청남도,4414,청양군,목면,소계,1170,876,320,515,11,0,17,1,0,1,0,1,0,0,866,10,294
4400,충청남도,4414,청양군,,관내사전투표,377,377,162,205,6,0,2,0,0,1,0,0,0,0,376,1,0
4400,충청남도,4414,청양군,,목면제1투,401,237,68,147,3,0,12,1,0,0,0,0,0,0,231,6,164
4400,충청남도,4414,청양군,,목면제2투,392,262,90,163,2,0,3,0,0,0,0,1,0,0,259,3,130
4400,충청남도,4414,청양군,청남면,소계,1575,1160,354,767,13,2,8,0,0,0,1,2,2,1,1150,10,415
4400,충청남도,4414,청양군,,관내사전투표,552,550,176,359,6,1,0,0,0,0,0,1,0,1,544,6,2
4400,충청남도,4414,청양군,,청남면투표소,1023,610,178,408,7,1,8,0,0,0,1,1,2,0,606,4,413
4400,충청남도,4414,청양군,장평면,소계,1892,1431,509,869,25,1,9,0,0,0,2,2,1,6,1424,7,461
4400,충청남도,4414,청양군,,관내사전투표,574,574,202,355,11,0,2,0,0,0,0,0,1,2,573,1,0
4400,충청남도,4414,청양군,,장평면제1투,567,346,129,207,5,0,3,0,0,0,1,0,0,0,345,1,221
4400,충청남도,4414,청양군,,장평면제2투,328,230,67,153,4,1,2,0,0,0,0,0,0,3,230,0,98
4400,충청남도,4414,청양군,,장평면제3투,423,281,111,154,5,0,2,0,0,0,1,2,0,1,276,5,142
4400,충청남도,4414,청양군,남양면,소계,2268,1640,582,966,29,2,23,0,1,0,2,2,1,5,1613,27,628
4400,충청남도,4414,청양군,,관내사전투표,787,787,308,447,14,2,4,0,1,0,0,0,1,1,778,9,0
4400,충청남도,4414,청양군,,남양면제1투,1022,551,167,347,10,0,12,0,0,0,2,1,0,1,540,11,471
4400,충청남도,4414,청양군,,남양면제2투,459,302,107,172,5,0,7,0,0,0,0,1,0,3,295,7,157
4400,충청남도,4414,청양군,화성면,소계,1828,1397,475,852,31,1,16,0,1,1,2,2,2,0,1383,14,431
4400,충청남도,4414,청양군,,관내사전투표,614,614,228,354,20,0,5,0,1,1,0,1,1,0,611,3,0
4400,충청남도,4414,청양군,,화성면제1투,635,426,134,270,7,1,4,0,0,0,1,1,0,0,418,8,209
4400,충청남도,4414,청양군,,화성면제2투,579,357,113,228,4,0,7,0,0,0,1,0,1,0,354,3,222
4400,충청남도,4414,청양군,비봉면,소계,1695,1313,491,774,14,1,12,0,1,0,0,2,2,2,1299,14,382
4400,충청남도,4414,청양군,,관내사전투표,575,575,237,324,6,1,4,0,0,0,0,0,1,1,574,1,0
4400,충청남도,4414,청양군,,비봉면제1투,671,434,144,269,3,0,5,0,1,0,0,2,1,1,426,8,237
4400,충청남도,4414,청양군,,비봉면제2투,449,304,110,181,5,0,3,0,0,0,0,0,0,0,299,5,145
4400,충청남도,4414,청양군,잘못 투입·구분된 투표지,,0,0,0,0,0,0,0,0,0,0,0,0,0,0,0,0,0
4400,충청남도,4415,예산군,합계,,69064,51349,16904,32098,1034,29,537,15,9,10,47,90,44,33,50850,499,17715
4400,충청남도,4415,예산군,거소·선상투표,,141,133,41,73,5,0,3,0,0,0,0,0,0,0,122,11,8
4400,충청남도,4415,예산군,관외사전투표,,5676,5675,2417,2955,137,6,75,3,2,1,4,8,4,5,5617,58,1
4400,충청남도,4415,예산군,재외투표,,216,165,92,46,9,0,1,0,0,1,0,1,0,0,150,15,51
4400,충청남도,4415,예산군,예산읍,소계,25250,17851,5995,11098,364,12,172,6,1,4,20,21,7,4,17704,147,7399
4400,충청남도,4415,예산군,,관내사전투표,6183,6182,2431,3529,118,4,52,2,0,0,4,7,2,0,6149,33,1
4400,충청남도,4415,예산군,,예산읍제1투,1781,1024,250,727,18,1,13,0,0,0,0,1,1,0,1011,13,757
4400,충청남도,4415,예산군,,예산읍제2투,1064,689,177,485,12,0,7,0,0,0,3,0,0,0,684,5,375
4400,충청남도,4415,예산군,,예산읍제3투,2107,1372,457,848,28,0,15,0,0,2,0,2,2,0,1354,18,735
4400,충청남도,4415,예산군,,예산읍제4투,1879,1100,305,747,22,0,13,1,0,0,1,1,1,1,1092,8,779
4400,충청남도,4415,예산군,,예산읍제5투,1576,941,287,626,15,0,6,0,0,0,1,0,0,1,936,5,635
4400,충청남도,4415,예산군,,예산읍제6투,1837,1075,374,646,26,1,12,1,1,0,2,0,0,0,1063,12,762
4400,충청남도,4415,예산군,,예산읍제7투,2268,1338,464,810,37,2,11,0,0,0,4,1,0,0,1329,9,930
4400,충청남도,4415,예산군,,예산읍제8투,2338,1460,510,874,46,0,8,0,0,2,3,2,0,0,1445,15,878
4400,충청남도,4415,예산군,,예산읍제9투,1593,1025,257,733,13,1,9,0,0,0,1,0,1,1,1016,9,568
4400,충청남도,4415,예산군,,예산읍제10투,2624,1645,483,1073,29,3,26,2,0,0,1,7,0,1,1625,20,979
4400,충청남도,4415,예산군,삽교읍,소계,7512,5137,1647,3242,103,1,65,2,1,0,5,4,6,6,5082,55,2375
4400,충청남도,4415,예산군,,관내사전투표,2062,2062,663,1327,36,0,12,0,0,0,5,1,1,1,2046,16,0
4400,충청남도,4415,예산군,,삽교읍제1투,1345,737,191,515,14,0,11,0,0,0,0,1,0,0,732,5,608
4400,충청남도,4415,예산군,,삽교읍제2투,2220,1235,473,674,39,1,25,2,1,0,0,2,1,1,1219,16,985
4400,충청남도,4415,예산군,,삽교읍제3투,1206,709,225,450,8,0,8,0,0,0,0,0,2,4,697,12,497
4400,충청남도,4415,예산군,,삽교읍제4투,679,394,95,276,6,0,9,0,0,0,0,0,2,0,388,6,285
4400,충청남도,4415,예산군,대술면,소계,2228,1662,521,1065,34,1,19,0,0,0,0,1,4,2,1647,15,566
4400,충청남도,4415,예산군,,관내사전투표,872,872,288,557,12,1,8,0,0,0,0,1,0,1,868,4,0
4400,충청남도,4415,예산군,,대술면투표소,1356,790,233,508,22,0,11,0,0,0,0,0,4,1,779,11,566
4400,충청남도,4415,예산군,신양면,소계,2665,2015,532,1414,27,2,14,0,0,0,0,7,4,2,2002,13,650
4400,충청남도,4415,예산군,,관내사전투표,1101,1101,318,755,11,2,4,0,0,0,0,3,1,1,1095,6,0
4400,충청남도,4415,예산군,,신양면투표소,1564,914,214,659,16,0,10,0,0,0,0,4,3,1,907,7,650
4400,충청남도,4415,예산군,광시면,소계,2657,1931,490,1347,35,0,14,0,1,2,1,3,6,3,1902,29,726
4400,충청남도,4415,예산군,,관내사전투표,915,915,249,621,17,0,3,0,1,1,1,1,3,1,898,17,0
4400,충청남도,4415,예산군,,광시면투표소,1742,1016,241,726,18,0,11,0,0,1,0,2,3,2,1004,12,726
4400,충청남도,4415,예산군,대흥면,소계,1454,1084,269,764,23,2,8,1,0,0,1,1,2,0,1071,13,370
4400,충청남도,4415,예산군,,관내사전투표,363,363,123,224,7,0,4,0,0,0,0,0,0,0,358,5,0
4400,충청남도,4415,예산군,,대흥면제1투,462,272,54,208,4,0,2,0,0,0,0,1,0,0,269,3,190
4400,충청남도,4415,예산군,,대흥면제2투,629,449,92,332,12,2,2,1,0,0,1,0,2,0,444,5,180
4400,충청남도,4415,예산군,응봉면,소계,2264,1682,505,1090,33,0,30,0,0,0,3,3,1,1,1666,16,582
4400,충청남도,4415,예산군,,관내사전투표,862,862,306,514,25,0,9,0,0,0,1,0,0,1,856,6,0
4400,충청남도,4415,예산군,,응봉면제1투,895,497,129,339,4,0,17,0,0,0,1,2,1,0,493,4,398
4400,충청남도,4415,예산군,,응봉면제2투,507,323,70,237,4,0,4,0,0,0,1,1,0,0,317,6,184
4400,충청남도,4415,예산군,덕산면,소계,5772,4197,1375,2649,77,0,44,1,1,1,3,7,3,2,4163,34,1575
4400,충청남도,4415,예산군,,관내사전투표,2017,2017,735,1210,36,0,19,1,0,1,0,2,2,1,2007,10,0
4400,충청남도,4415,예산군,,덕산면제1투,1901,1022,316,658,19,0,12,0,1,0,0,3,0,0,1009,13,879
4400,충청남도,4415,예산군,,덕산면제2투,993,602,161,418,5,0,9,0,0,0,1,2,0,0,596,6,391
4400,충청남도,4415,예산군,,덕산면제3투,861,556,163,363,17,0,4,0,0,0,2,0,1,1,551,5,305
4400,충청남도,4415,예산군,봉산면,소계,1943,1410,382,953,26,1,14,0,1,0,1,9,1,3,1391,19,533
4400,충청남도,4415,예산군,,관내사전투표,628,628,192,404,17,0,4,0,0,0,0,4,0,2,623,5,0
4400,충청남도,4415,예산군,,봉산면투표소,1315,782,190,549,9,1,10,0,1,0,1,5,1,1,768,14,533
4400,충청남도,4415,예산군,고덕면,소계,3888,2840,915,1819,47,2,14,0,1,1,4,11,3,2,2819,21,1048
4400,충청남도,4415,예산군,,관내사전투표,1166,1166,398,726,25,0,6,0,1,1,0,2,0,0,1159,7,0
4400,충청남도,4415,예산군,,고덕면제1투,1609,942,290,614,14,1,8,0,0,0,2,5,1,1,936,6,667
4400,충청남도,4415,예산군,,고덕면제2투,586,386,114,254,7,1,0,0,0,0,0,4,1,1,382,4,200
4400,충청남도,4415,예산군,,고덕면제3투,527,346,113,225,1,0,0,0,0,0,2,0,1,0,342,4,181
4400,충청남도,4415,예산군,신암면,소계,3520,2697,876,1689,57,0,32,1,1,0,2,6,2,2,2668,29,823
4400,충청남도,4415,예산군,,관내사전투표,1574,1574,563,945,34,0,13,1,1,0,0,2,2,1,1562,12,0
4400,충청남도,4415,예산군,,신암면제1투,1356,739,192,491,20,0,19,0,0,0,1,2,0,1,726,13,617
4400,충청남도,4415,예산군,,신암면제2투,590,384,121,253,3,0,0,0,0,0,1,2,0,0,380,4,206
4400,충청남도,4415,예산군,오가면,소계,3878,2869,847,1893,57,2,32,1,0,0,3,8,1,1,2845,24,1009
4400,충청남도,4415,예산군,,관내사전투표,1530,1530,504,958,38,2,15,1,0,0,1,3,0,0,1522,8,0
4400,충청남도,4415,예산군,,오가면제1투,1358,755,196,527,10,0,11,0,0,0,1,1,1,1,748,7,603
4400,충청남도,4415,예산군,,오가면제2투,990,584,147,408,9,0,6,0,0,0,1,4,0,0,575,9,406
4400,충청남도,4415,예산군,잘못 투입·구분된 투표지,,0,1,0,1,0,0,0,0,0,0,0,0,0,0,1,0,-14500,전라북도,4501,전주시완산구,합계,,285828,231447,188693,35152,3907,98,1371,53,21,31,50,112,45,97,229630,1817,54381
4500,전라북도,4501,전주시완산구,거소·선상투표,,960,882,559,154,17,4,21,1,2,3,2,4,2,4,773,109,78
4500,전라북도,4501,전주시완산구,관외사전투표,,31475,31466,24720,5458,623,23,279,11,2,8,5,18,6,22,31175,291,9
4500,전라북도,4501,전주시완산구,재외투표,,1008,756,575,100,27,0,3,1,0,0,0,0,0,0,706,50,252
4500,전라북도,4501,전주시완산구,중앙동,소계,6636,5287,4161,967,82,2,23,0,1,1,5,0,1,2,5245,42,1349
4500,전라북도,4501,전주시완산구,,관내사전투표,3224,3224,2632,525,46,1,6,0,0,0,0,0,0,2,3212,12,0
4500,전라북도,4501,전주시완산구,,중앙동제1투,1128,675,532,111,11,0,9,0,0,0,4,0,0,0,667,8,453
4500,전라북도,4501,전주시완산구,,중앙동제2투,1495,916,617,261,14,1,7,0,1,1,1,0,1,0,904,12,579
4500,전라북도,4501,전주시완산구,,중앙동제3투,789,472,380,70,11,0,1,0,0,0,0,0,0,0,462,10,317
4500,전라북도,4501,전주시완산구,풍남동,소계,3994,3143,2576,473,51,2,16,1,0,1,1,2,1,2,3126,17,851
4500,전라북도,4501,전주시완산구,,관내사전투표,1939,1939,1619,261,36,0,9,1,0,1,0,1,1,0,1929,10,0
4500,전라북도,4501,전주시완산구,,풍남동제1투,980,558,429,111,11,1,0,0,0,0,0,1,0,0,553,5,422
4500,전라북도,4501,전주시완산구,,풍남동제2투,1075,646,528,101,4,1,7,0,0,0,1,0,0,2,644,2,429
4500,전라북도,4501,전주시완산구,노송동,소계,8941,6729,5595,943,108,4,26,1,0,2,0,1,4,5,6689,40,2212
4500,전라북도,4501,전주시완산구,,관내사전투표,3246,3245,2789,377,52,1,8,0,0,0,0,0,2,1,3230,15,1
4500,전라북도,4501,전주시완산구,,노송동제1투,1390,835,667,144,17,1,1,0,0,0,0,0,0,0,830,5,555
4500,전라북도,4501,전주시완산구,,노송동제2투,685,386,310,72,4,0,0,0,0,0,0,0,0,0,386,0,299
4500,전라북도,4501,전주시완산구,,노송동제3투,1558,1022,826,162,16,1,8,0,0,0,0,0,1,0,1014,8,536
4500,전라북도,4501,전주시완산구,,노송동제4투,1133,693,554,109,15,1,7,1,0,0,0,1,0,0,688,5,440
4500,전라북도,4501,전주시완산구,,노송동제5투,929,548,449,79,4,0,2,0,0,2,0,0,1,4,541,7,381
4500,전라북도,4501,전주시완산구,완산동,소계,4760,3705,3076,517,48,1,16,3,0,0,3,0,0,3,3667,38,1055
4500,전라북도,4501,전주시완산구,,관내사전투표,2079,2079,1773,253,27,1,4,1,0,0,2,0,0,0,2061,18,0
4500,전라북도,4501,전주시완산구,,완산동제1투,1376,873,723,123,9,0,4,0,0,0,0,0,0,3,862,11,503
4500,전라북도,4501,전주시완산구,,완산동제2투,1305,753,580,141,12,0,8,2,0,0,1,0,0,0,744,9,552
4500,전라북도,4501,전주시완산구,동서학동,소계,5265,4151,3480,553,62,2,19,0,0,0,1,3,1,1,4122,29,1114
4500,전라북도,4501,전주시완산구,,관내사전투표,2500,2500,2159,280,37,0,11,0,0,0,0,0,0,0,2487,13,0
4500,전라북도,4501,전주시완산구,,동서학동제1투,1178,685,549,116,8,1,5,0,0,0,0,0,1,0,680,5,493
4500,전라북도,4501,전주시완산구,,동서학동제2투,549,306,242,51,4,1,1,0,0,0,1,3,0,0,303,3,243
4500,전라북도,4501,전주시완산구,,동서학동제3투,1038,660,530,106,13,0,2,0,0,0,0,0,0,1,652,8,378
4500,전라북도,4501,전주시완산구,서서학동,소계,7236,5661,4796,700,80,0,33,0,1,0,2,3,2,7,5624,37,1575
4500,전라북도,4501,전주시완산구,,관내사전투표,3432,3432,3011,351,39,0,12,0,0,0,2,2,1,1,3419,13,0
4500,전라북도,4501,전주시완산구,,서서학동제1투,1142,657,508,113,15,0,7,0,0,0,0,1,0,6,650,7,485
4500,전라북도,4501,전주시완산구,,서서학동제2투,1468,845,700,113,10,0,8,0,1,0,0,0,0,0,832,13,623
4500,전라북도,4501,전주시완산구,,서서학동제3투,1194,727,577,123,16,0,6,0,0,0,0,0,1,0,723,4,467
4500,전라북도,4501,전주시완산구,중화산1동,소계,11603,9309,7534,1497,160,2,43,1,0,1,4,3,4,4,9253,56,2294
4500,전라북도,4501,전주시완산구,,관내사전투표,5495,5495,4608,749,81,1,25,0,0,0,2,2,3,0,5471,24,0
4500,전라북도,4501,전주시완산구,,중화산1동제1투,2161,1277,998,231,27,0,8,0,0,0,0,1,1,2,1268,9,884
4500,전라북도,4501,전주시완산구,,중화산1동제2투,2122,1346,1038,265,22,1,2,1,0,1,0,0,0,1,1331,15,776
4500,전라북도,4501,전주시완산구,,중화산1동제3투,1825,1191,890,252,30,0,8,0,0,0,2,0,0,1,1183,8,634
4500,전라북도,4501,전주시완산구,중화산2동,소계,14016,10644,8590,1715,183,2,72,3,1,1,1,7,0,2,10577,67,3372
4500,전라북도,4501,전주시완산구,,관내사전투표,5680,5680,4774,775,83,1,19,2,1,0,0,3,0,1,5659,21,0
4500,전라북도,4501,전주시완산구,,중화산2동제1투,2017,1376,980,348,23,0,5,0,0,1,0,2,0,1,1360,16,641
4500,전라북도,4501,전주시완산구,,중화산2동제2투,2414,1225,947,207,26,1,26,1,0,0,1,1,0,0,1210,15,1189
4500,전라북도,4501,전주시완산구,,중화산2동제3투,2293,1351,1063,232,36,0,11,0,0,0,0,1,0,0,1343,8,942
4500,전라북도,4501,전주시완산구,,중화산2동제4투,1612,1012,826,153,15,0,11,0,0,0,0,0,0,0,1005,7,600
4500,전라북도,4501,전주시완산구,평화1동,소계,11143,8550,7196,1073,123,4,42,4,0,1,2,9,3,11,8468,82,2593
4500,전라북도,4501,전주시완산구,,관내사전투표,5218,5217,4514,566,69,1,12,4,0,0,0,4,1,7,5178,39,1
4500,전라북도,4501,전주시완산구,,평화1동제1투,2002,1102,895,159,17,1,11,0,0,0,1,1,1,2,1088,14,900
4500,전라북도,4501,전주시완산구,,평화1동제2투,1848,917,716,162,9,2,8,0,0,0,0,3,0,2,902,15,931
4500,전라북도,4501,전주시완산구,,평화1동제3투,2075,1314,1071,186,28,0,11,0,0,1,1,1,1,0,1300,14,761
4500,전라북도,4501,전주시완산구,평화2동,소계,31449,24888,20976,3214,362,12,149,1,7,2,3,7,5,3,24741,147,6561
4500,전라북도,4501,전주시완산구,,관내사전투표,10509,10508,9147,1170,120,4,32,1,0,1,1,0,2,1,10479,29,1
4500,전라북도,4501,전주시완산구,,평화2동제1투,1703,1041,810,197,15,0,8,0,0,0,0,0,1,0,1031,10,662
4500,전라북도,4501,전주시완산구,,평화2동제2투,2361,1486,1189,236,26,3,19,0,1,0,1,0,0,1,1476,10,875
4500,전라북도,4501,전주시완산구,,평화2동제3투,1399,776,637,105,9,0,11,0,1,0,0,1,1,0,765,11,623
4500,전라북도,4501,전주시완산구,,평화2동제4투,2590,1921,1638,231,24,1,14,0,2,0,0,0,0,0,1910,11,669
4500,전라북도,4501,전주시완산구,,평화2동제5투,960,640,545,74,6,0,7,0,0,0,0,1,0,0,633,7,320
4500,전라북도,4501,전주시완산구,,평화2동제6투,2480,1804,1464,270,40,0,13,0,0,1,0,1,0,1,1790,14,676
4500,전라북도,4501,전주시완산구,,평화2동제7투,1888,1299,1039,210,22,2,11,0,1,0,0,1,0,0,1286,13,589
4500,전라북도,4501,전주시완산구,,평화2동제8투,2918,2024,1681,268,40,2,15,0,1,0,0,0,0,0,2007,17,894
4500,전라북도,4501,전주시완산구,,평화2동제9투,2850,2084,1742,274,38,0,11,0,1,0,1,2,0,0,2069,15,766
4500,전라북도,4501,전주시완산구,,평화2동제10투,1791,1305,1084,179,22,0,8,0,0,0,0,1,1,0,1295,10,486
4500,전라북도,4501,전주시완산구,서신동,소계,28743,22621,18436,3468,401,7,115,6,0,0,4,16,6,6,22465,156,6122
4500,전라북도,4501,전주시완산구,,관내사전투표,8618,8618,7336,1072,121,4,34,2,0,0,2,4,3,4,8582,36,0
4500,전라북도,4501,전주시완산구,,서신동제1투,1637,1087,865,180,22,0,8,1,0,0,0,0,0,0,1076,11,550
4500,전라북도,4501,전주시완산구,,서신동제2투,1813,1031,823,164,17,1,12,0,0,0,0,2,1,0,1020,11,782
4500,전라북도,4501,전주시완산구,,서신동제3투,1165,799,585,191,11,0,4,0,0,0,0,1,0,0,792,7,366
4500,전라북도,4501,전주시완산구,,서신동제4투,2718,2036,1566,408,36,0,9,0,0,0,0,2,0,1,2022,14,682
4500,전라북도,4501,전주시완산구,,서신동제5투,1758,1126,923,163,24,0,8,1,0,0,0,1,0,0,1120,6,632
4500,전라북도,4501,전주시완산구,,서신동제6투,1428,1055,860,155,16,0,6,0,0,0,0,1,0,1,1039,16,373
4500,전라북도,4501,전주시완산구,,서신동제7투,1595,1124,933,141,32,0,8,0,0,0,1,1,0,0,1116,8,471
4500,전라북도,4501,전주시완산구,,서신동제8투,2447,1853,1452,331,36,1,12,0,0,0,1,1,2,0,1836,17,594
4500,전라북도,4501,전주시완산구,,서신동제9투,2288,1758,1431,258,41,0,8,1,0,0,0,1,0,0,1740,18,530
4500,전라북도,4501,전주시완산구,,서신동제10투,3276,2134,1662,405,45,1,6,1,0,0,0,2,0,0,2122,12,1142
4500,전라북도,4501,전주시완산구,삼천1동,소계,8664,6940,5747,981,106,1,46,2,0,3,0,3,0,3,6892,48,1724
4500,전라북도,4501,전주시완산구,,관내사전투표,3763,3763,3215,458,49,0,18,2,0,0,0,2,0,2,3746,17,0
4500,전라북도,4501,전주시완산구,,삼천1동제1투,1211,685,534,116,20,1,5,0,0,2,0,0,0,1,679,6,526
4500,전라북도,4501,전주시완산구,,삼천1동제2투,2462,1769,1432,290,26,0,7,0,0,0,0,1,0,0,1756,13,693
4500,전라북도,4501,전주시완산구,,삼천1동제3투,1228,723,566,117,11,0,16,0,0,1,0,0,0,0,711,12,505
4500,전라북도,4501,전주시완산구,삼천2동,소계,11008,8531,7122,1154,112,4,56,2,0,3,3,8,0,6,8470,61,2477
4500,전라북도,4501,전주시완산구,,관내사전투표,4681,4680,4057,523,59,0,15,0,0,1,1,2,0,3,4661,19,1
4500,전라북도,4501,전주시완산구,,삼천2동제1투,1497,775,641,117,3,0,7,1,0,1,0,1,0,0,771,4,722
4500,전라북도,4501,전주시완산구,,삼천2동제2투,1168,713,577,108,8,1,9,0,0,0,0,3,0,0,706,7,455
4500,전라북도,4501,전주시완산구,,삼천2동제3투,1940,1350,1036,257,23,3,11,0,0,1,0,1,0,1,1333,17,590
4500,전라북도,4501,전주시완산구,,삼천2동제4투,1722,1013,811,149,19,0,14,1,0,0,2,1,0,2,999,14,709
4500,전라북도,4501,전주시완산구,삼천3동,소계,17125,14110,11979,1729,229,3,66,3,2,1,3,4,2,7,14028,82,3015
4500,전라북도,4501,전주시완산구,,관내사전투표,7650,7650,6699,787,110,0,22,1,1,1,0,1,1,3,7626,24,0
4500,전라북도,4501,전주시완산구,,삼천3동제1투,1526,1000,790,160,20,0,11,0,0,0,0,1,1,0,983,17,526
4500,전라북도,4501,전주시완산구,,삼천3동제2투,789,474,388,69,9,1,3,0,0,0,0,0,0,1,471,3,315
4500,전라북도,4501,전주시완산구,,삼천3동제3투,1650,1114,930,148,18,0,7,0,0,0,0,1,0,0,1104,10,536
4500,전라북도,4501,전주시완산구,,삼천3동제4투,1734,1257,1044,172,19,1,5,0,1,0,2,0,0,0,1244,13,477
4500,전라북도,4501,전주시완산구,,삼천3동제5투,2020,1320,1064,209,20,1,10,2,0,0,0,1,0,2,1309,11,700
4500,전라북도,4501,전주시완산구,,삼천3동제6투,1756,1295,1064,184,33,0,8,0,0,0,1,0,0,1,1291,4,461
4500,전라북도,4501,전주시완산구,효자1동,소계,8883,7016,5730,1099,102,2,25,0,0,1,0,4,0,3,6966,50,1867
4500,전라북도,4501,전주시완산구,,관내사전투표,3974,3974,3359,528,43,2,15,0,0,1,0,1,0,2,3951,23,0
4500,전라북도,4501,전주시완산구,,효자1동제1투,1845,1122,861,214,29,0,5,0,0,0,0,1,0,0,1110,12,723
4500,전라북도,4501,전주시완산구,,효자1동제2투,1653,967,766,179,9,0,4,0,0,0,0,1,0,1,960,7,686
4500,전라북도,4501,전주시완산구,,효자1동제3투,1411,953,744,178,21,0,1,0,0,0,0,1,0,0,945,8,458
4500,전라북도,4501,전주시완산구,효자2동,소계,8837,7107,5853,1025,113,3,48,2,2,0,1,1,1,0,7049,58,1730
4500,전라북도,4501,전주시완산구,,관내사전투표,4071,4071,3475,485,57,2,23,1,0,0,0,1,0,0,4044,27,0
4500,전라북도,4501,전주시완산구,,효자2동제1투,1897,1253,985,215,24,0,12,0,0,0,1,0,1,0,1238,15,644
4500,전라북도,4501,전주시완산구,,효자2동제2투,1154,737,581,129,10,0,7,0,1,0,0,0,0,0,728,9,417
4500,전라북도,4501,전주시완산구,,효자2동제3투,1715,1046,812,196,22,1,6,1,1,0,0,0,0,0,1039,7,669
4500,전라북도,4501,전주시완산구,효자3동,소계,12131,9987,8199,1504,164,4,56,2,1,0,1,2,0,2,9935,52,2144
4500,전라북도,4501,전주시완산구,,관내사전투표,5712,5712,4804,782,77,2,26,1,1,0,0,0,0,2,5695,17,0
4500,전라북도,4501,전주시완산구,,효자3동제1투,1254,780,585,165,15,0,9,0,0,0,0,0,0,0,774,6,474
4500,전라북도,4501,전주시완산구,,효자3동제2투,1965,1338,1069,221,35,0,7,0,0,0,0,1,0,0,1333,5,627
4500,전라북도,4501,전주시완산구,,효자3동제3투,1619,1060,838,187,16,1,8,0,0,0,0,0,0,0,1050,10,559
4500,전라북도,4501,전주시완산구,,효자3동제4투,1581,1097,903,149,21,1,6,1,0,0,1,1,0,0,1083,14,484
4500,전라북도,4501,전주시완산구,효자4동,소계,25505,20122,16185,3305,364,7,85,6,1,2,4,8,5,3,19975,147,5383
4500,전라북도,4501,전주시완산구,,관내사전투표,7667,7667,6489,1001,107,4,27,3,0,1,0,1,0,0,7633,34,0
4500,전라북도,4501,전주시완산구,,효자4동제1투,1410,988,735,223,21,0,4,0,0,0,0,0,0,0,983,5,422
4500,전라북도,4501,전주시완산구,,효자4동제2투,2640,1843,1335,448,33,2,5,0,0,0,0,2,0,0,1825,18,797
4500,전라북도,4501,전주시완산구,,효자4동제3투,1762,1224,962,222,25,1,3,0,0,1,0,1,1,0,1216,8,538
4500,전라북도,4501,전주시완산구,,효자4동제4투,1586,1022,842,141,22,0,5,0,0,0,0,0,0,1,1011,11,564
4500,전라북도,4501,전주시완산구,,효자4동제5투,1937,1253,990,212,24,0,6,1,0,0,0,1,0,0,1234,19,684
4500,전라북도,4501,전주시완산구,,효자4동제6투,579,299,201,72,13,0,2,1,0,0,0,0,2,1,292,7,280
4500,전라북도,4501,전주시완산구,,효자4동제7투,2742,1830,1460,295,39,0,15,0,0,0,0,0,1,1,1811,19,912
4500,전라북도,4501,전주시완산구,,효자4동제8투,2255,1724,1409,255,40,0,5,0,0,0,4,1,0,0,1714,10,531
4500,전라북도,4501,전주시완산구,,효자4동제9투,2927,2272,1762,436,40,0,13,1,1,0,0,2,1,0,2256,16,655
4500,전라북도,4501,전주시완산구,효자5동,소계,26446,19830,15599,3520,390,9,132,3,1,1,5,9,2,1,19672,158,6616
4500,전라북도,4501,전주시완산구,,관내사전투표,8740,8736,7078,1410,156,6,36,1,1,0,2,3,0,1,8694,42,4
4500,전라북도,4501,전주시완산구,,효자5동제1투,2484,1508,1131,315,41,0,11,0,0,0,0,0,0,0,1498,10,976
4500,전라북도,4501,전주시완산구,,효자5동제2투,2532,1408,1038,291,27,0,21,0,0,0,1,1,0,0,1379,29,1124
4500,전라북도,4501,전주시완산구,,효자5동제3투,1780,847,638,166,22,0,10,0,0,0,0,1,0,0,837,10,933
4500,전라북도,4501,전주시완산구,,효자5동제4투,3067,1731,1319,330,39,0,25,1,0,0,0,1,0,0,1715,16,1336
4500,전라북도,4501,전주시완산구,,효자5동제5투,2045,1472,1082,345,27,0,1,0,0,0,0,0,1,0,1456,16,573
4500,전라북도,4501,전주시완산구,,효자5동제6투,2890,2133,1739,315,44,2,16,1,0,1,0,1,1,0,2120,13,757
4500,전라북도,4501,전주시완산구,,효자5동제7투,2908,1995,1574,348,34,1,12,0,0,0,2,2,0,0,1973,22,913
4500,전라북도,4501,전주시완산구,잘못 투입·구분된 투표지,,0,12,9,3,0,0,0,0,0,0,0,0,0,0,12,0,-12
4500,전라북도,4502,전주시덕진구,합계,,265049,215995,175845,32731,4006,58,1370,48,10,27,40,139,33,97,214404,1591,49054
4500,전라북도,4502,전주시덕진구,거소·선상투표,,676,627,430,107,15,0,9,0,0,2,1,0,0,2,566,61,49
4500,전라북도,4502,전주시덕진구,관외사전투표,,30272,30269,23895,5146,663,13,266,8,1,1,5,22,2,11,30033,236,3
4500,전라북도,4502,전주시덕진구,재외투표,,741,562,429,69,20,0,2,0,0,0,2,0,0,0,522,40,179
4500,전라북도,4502,전주시덕진구,진북동,소계,11662,9138,7378,1478,154,4,50,7,1,2,0,1,2,6,9083,55,2524
4500,전라북도,4502,전주시덕진구,,관내사전투표,5118,5117,4237,748,75,2,22,7,0,1,0,1,1,4,5098,19,1
4500,전라북도,4502,전주시덕진구,,진북동제1투,1440,815,655,135,11,0,6,0,1,0,0,0,0,1,809,6,625
4500,전라북도,4502,전주시덕진구,,진북동제2투,1980,1143,863,226,29,2,10,0,0,0,0,0,1,0,1131,12,837
4500,전라북도,4502,전주시덕진구,,진북동제3투,1622,1078,883,155,22,0,8,0,0,0,0,0,0,1,1069,9,544
4500,전라북도,4502,전주시덕진구,,진북동제4투,1502,985,740,214,17,0,4,0,0,1,0,0,0,0,976,9,517
4500,전라북도,4502,전주시덕진구,인후1동,소계,13363,10645,8706,1621,179,3,55,4,1,0,0,3,1,2,10575,70,2718
4500,전라북도,4502,전주시덕진구,,관내사전투표,5603,5602,4727,770,68,1,9,2,0,0,0,1,1,2,5581,21,1
4500,전라북도,4502,전주시덕진구,,인후1동제1투,2077,1178,913,211,25,0,11,0,1,0,0,1,0,0,1162,16,899
4500,전라북도,4502,전주시덕진구,,인후1동제2투,1725,1121,895,178,30,1,11,0,0,0,0,0,0,0,1115,6,604
4500,전라북도,4502,전주시덕진구,,인후1동제3투,1927,1331,1055,224,25,1,12,1,0,0,0,1,0,0,1319,12,596
4500,전라북도,4502,전주시덕진구,,인후1동제4투,2031,1413,1116,238,31,0,12,1,0,0,0,0,0,0,1398,15,618
4500,전라북도,4502,전주시덕진구,인후2동,소계,9079,6858,5574,1061,113,2,45,0,0,1,1,3,1,3,6804,54,2221
4500,전라북도,4502,전주시덕진구,,관내사전투표,3507,3507,2963,468,41,0,13,0,0,0,0,3,1,2,3491,16,0
4500,전라북도,4502,전주시덕진구,,인후2동제1투,1318,833,649,143,17,0,11,0,0,1,0,0,0,0,821,12,485
4500,전라북도,4502,전주시덕진구,,인후2동제2투,949,488,378,86,8,1,5,0,0,0,1,0,0,0,479,9,461
4500,전라북도,4502,전주시덕진구,,인후2동제3투,1611,922,717,170,16,1,9,0,0,0,0,0,0,0,913,9,689
4500,전라북도,4502,전주시덕진구,,인후2동제4투,1694,1108,867,194,31,0,7,0,0,0,0,0,0,1,1100,8,586
4500,전라북도,4502,전주시덕진구,인후3동,소계,21858,16074,13517,2009,288,5,116,2,0,3,3,12,0,5,15960,114,5784
4500,전라북도,4502,전주시덕진구,,관내사전투표,7258,7258,6323,754,106,2,32,0,0,1,0,3,0,2,7223,35,0
4500,전라북도,4502,전주시덕진구,,인후3동제1투,2264,1103,864,184,32,0,8,0,0,1,0,0,0,0,1089,14,1161
4500,전라북도,4502,전주시덕진구,,인후3동제2투,1901,1156,969,139,17,1,12,2,0,0,0,1,0,1,1142,14,745
4500,전라북도,4502,전주시덕진구,,인후3동제3투,2081,1285,1051,171,34,0,13,0,0,0,0,2,0,0,1271,14,796
4500,전라북도,4502,전주시덕진구,,인후3동제4투,1793,1284,1017,210,32,0,12,0,0,0,0,2,0,1,1274,10,509
4500,전라북도,4502,전주시덕진구,,인후3동제5투,2350,1614,1342,210,29,2,17,0,0,0,0,1,0,0,1601,13,736
4500,전라북도,4502,전주시덕진구,,인후3동제6투,2235,1437,1208,192,23,0,5,0,0,0,0,0,0,1,1429,8,798
4500,전라북도,4502,전주시덕진구,,인후3동제7투,1976,937,743,149,15,0,17,0,0,1,3,3,0,0,931,6,1039
4500,전라북도,4502,전주시덕진구,덕진동,소계,14391,10793,8648,1768,201,1,61,3,0,0,2,7,1,5,10697,96,3598
4500,전라북도,4502,전주시덕진구,,관내사전투표,4444,4444,3692,630,66,0,23,1,0,0,0,5,0,3,4420,24,0
4500,전라북도,4502,전주시덕진구,,덕진동제1투,1457,730,533,157,22,0,5,0,0,0,1,0,1,0,719,11,727
4500,전라북도,4502,전주시덕진구,,덕진동제2투,1721,1041,744,239,27,1,11,0,0,0,0,1,0,1,1024,17,680
4500,전라북도,4502,전주시덕진구,,덕진동제3투,2030,1337,1052,234,21,0,6,0,0,0,1,1,0,1,1316,21,693
4500,전라북도,4502,전주시덕진구,,덕진동제4투,2244,1407,1104,243,41,0,6,0,0,0,0,0,0,0,1394,13,837
4500,전라북도,4502,전주시덕진구,,덕진동제5투,2495,1834,1523,265,24,0,10,2,0,0,0,0,0,0,1824,10,661
4500,전라북도,4502,전주시덕진구,금암1동,소계,7462,5807,4234,1286,134,3,48,1,1,3,1,4,2,5,5722,85,1655
4500,전라북도,4502,전주시덕진구,,관내사전투표,3519,3519,2589,769,86,2,28,0,0,2,0,3,0,2,3481,38,0
4500,전라북도,4502,전주시덕진구,,금암1동제1투,1888,1062,788,212,30,1,7,1,0,1,0,1,1,1,1043,19,826
4500,전라북도,4502,전주시덕진구,,금암1동제2투,2055,1226,857,305,18,0,13,0,1,0,1,0,1,2,1198,28,829
4500,전라북도,4502,전주시덕진구,금암2동,소계,8181,6459,5240,1030,88,2,36,1,1,0,1,7,4,4,6414,45,1722
4500,전라북도,4502,전주시덕진구,,관내사전투표,4000,3998,3336,554,57,2,20,1,1,0,0,3,2,3,3979,19,2
4500,전라북도,4502,전주시덕진구,,금암2동제1투,1385,761,604,137,8,0,6,0,0,0,0,1,0,0,756,5,624
4500,전라북도,4502,전주시덕진구,,금암2동제2투,1434,874,691,155,9,0,5,0,0,0,0,2,0,1,863,11,560
4500,전라북도,4502,전주시덕진구,,금암2동제3투,1362,826,609,184,14,0,5,0,0,0,1,1,2,0,816,10,536
4500,전라북도,4502,전주시덕진구,팔복동,소계,7056,5446,4639,639,78,2,41,2,1,0,1,1,1,3,5408,38,1610
4500,전라북도,4502,전주시덕진구,,관내사전투표,3365,3365,2937,345,44,2,17,0,0,0,0,1,1,2,3349,16,0
4500,전라북도,4502,전주시덕진구,,팔복동제1투,1269,629,506,94,13,0,9,0,0,0,0,0,0,0,622,7,640
4500,전라북도,4502,전주시덕진구,,팔복동제2투,1869,1108,928,136,18,0,11,0,1,0,1,0,0,1,1096,12,761
4500,전라북도,4502,전주시덕진구,,팔복동제3투,553,344,268,64,3,0,4,2,0,0,0,0,0,0,341,3,209
4500,전라북도,4502,전주시덕진구,우아1동,소계,9387,7195,5783,1182,128,3,40,0,1,3,3,6,0,2,7151,44,2192
4500,전라북도,4502,전주시덕진구,,관내사전투표,4113,4113,3435,573,67,2,18,0,0,0,2,2,0,1,4100,13,0
4500,전라북도,4502,전주시덕진구,,우아1동제1투,1652,858,638,187,14,0,9,0,0,1,0,2,0,0,851,7,794
4500,전라북도,4502,전주시덕진구,,우아1동제2투,2149,1499,1162,276,32,0,9,0,1,1,0,2,0,0,1483,16,650
4500,전라북도,4502,전주시덕진구,,우아1동제3투,1473,725,548,146,15,1,4,0,0,1,1,0,0,1,717,8,748
4500,전라북도,4502,전주시덕진구,우아2동,소계,12156,9057,7679,1117,133,1,63,3,0,1,3,5,2,3,9010,47,3099
4500,전라북도,4502,전주시덕진구,,관내사전투표,4889,4889,4246,533,65,1,16,2,0,0,0,2,2,1,4868,21,0
4500,전라북도,4502,전주시덕진구,,우아2동제1투,1568,1040,855,158,13,0,5,0,0,0,0,0,0,1,1032,8,528
4500,전라북도,4502,전주시덕진구,,우아2동제2투,2335,1233,1007,172,28,0,15,1,0,1,0,2,0,1,1227,6,1102
4500,전라북도,4502,전주시덕진구,,우아2동제3투,490,340,283,41,10,0,2,0,0,0,2,0,0,0,338,2,150
4500,전라북도,4502,전주시덕진구,,우아2동제4투,2874,1555,1288,213,17,0,25,0,0,0,1,1,0,0,1545,10,1319
4500,전라북도,4502,전주시덕진구,호성동,소계,15500,12890,10769,1715,223,5,68,2,0,2,0,8,2,6,12800,90,2610
4500,전라북도,4502,전주시덕진구,,관내사전투표,6802,6802,5866,761,103,2,23,1,0,1,0,4,2,2,6765,37,0
4500,전라북도,4502,전주시덕진구,,호성동제1투,695,476,393,60,8,0,8,1,0,0,0,0,0,1,471,5,219
4500,전라북도,4502,전주시덕진구,,호성동제2투,3038,2127,1768,276,49,2,14,0,0,0,0,1,0,0,2110,17,911
4500,전라북도,4502,전주시덕진구,,호성동제3투,2759,1939,1607,258,37,1,16,0,0,1,0,3,0,1,1924,15,820
4500,전라북도,4502,전주시덕진구,,호성동제4투,2206,1546,1135,360,26,0,7,0,0,0,0,0,0,2,1530,16,660
4500,전라북도,4502,전주시덕진구,송천1동,소계,37453,30030,24344,4613,629,4,157,6,1,6,5,32,8,11,29816,214,7423
4500,전라북도,4502,전주시덕진구,,관내사전투표,10392,10392,8756,1348,196,1,34,1,1,1,0,11,1,4,10354,38,0
4500,전라북도,4502,전주시덕진구,,송천1동제1투,1963,1334,1056,222,27,1,14,0,0,0,1,0,0,0,1321,13,629
4500,전라북도,4502,전주시덕진구,,송천1동제2투,1893,1324,1088,188,29,0,4,0,0,0,0,0,0,1,1310,14,569
4500,전라북도,4502,전주시덕진구,,송천1동제3투,2264,1477,1181,220,31,0,12,3,0,2,1,3,1,1,1455,22,787
4500,전라북도,4502,전주시덕진구,,송천1동제4투,2196,1611,1271,270,38,0,9,0,0,0,0,4,0,2,1594,17,585
4500,전라북도,4502,전주시덕진구,,송천1동제5투,2100,1598,1294,236,40,1,13,0,0,0,0,1,1,0,1586,12,502
4500,전라북도,4502,전주시덕진구,,송천1동제6투,2504,1893,1512,295,48,0,16,1,0,1,0,3,3,0,1879,14,611
4500,전라북도,4502,전주시덕진구,,송천1동제7투,2264,1587,1276,269,23,1,9,0,0,0,0,2,0,0,1580,7,677
4500,전라북도,4502,전주시덕진구,,송천1동제8투,2564,2066,1670,319,47,0,7,0,0,1,0,2,2,0,2048,18,498
4500,전라북도,4502,전주시덕진구,,송천1동제9투,2282,1628,1290,268,46,0,7,1,0,1,0,0,0,1,1614,14,654
4500,전라북도,4502,전주시덕진구,,송천1동제10투,2318,1700,1301,352,28,0,8,0,0,0,1,1,0,0,1691,9,618
4500,전라북도,4502,전주시덕진구,,송천1동제11투,2132,1446,1109,279,30,0,12,0,0,0,1,5,0,1,1437,9,686
4500,전라북도,4502,전주시덕진구,,송천1동제12투,2581,1974,1540,347,46,0,12,0,0,0,1,0,0,1,1947,27,607
4500,전라북도,4502,전주시덕진구,송천2동,소계,22440,18754,15832,2387,289,4,102,2,0,1,7,11,3,11,18649,105,3686
4500,전라북도,4502,전주시덕진구,,관내사전투표,9901,9899,8607,1078,127,3,36,1,0,0,1,3,2,4,9862,37,2
4500,전라북도,4502,전주시덕진구,,송천2동제1투,1778,1154,960,146,23,0,8,0,0,0,2,1,0,1,1141,13,624
4500,전라북도,4502,전주시덕진구,,송천2동제2투,1854,1385,1161,184,21,0,9,1,0,0,0,0,0,0,1376,9,469
4500,전라북도,4502,전주시덕진구,,송천2동제3투,1482,1014,824,150,23,0,9,0,0,0,0,1,0,2,1009,5,468
4500,전라북도,4502,전주시덕진구,,송천2동제4투,1818,1252,1033,179,22,1,7,0,0,0,0,2,1,1,1246,6,566
4500,전라북도,4502,전주시덕진구,,송천2동제5투,2598,1904,1489,354,22,0,16,0,0,1,0,1,0,1,1884,20,694
4500,전라북도,4502,전주시덕진구,,송천2동제6투,717,504,445,39,7,0,6,0,0,0,1,0,0,0,498,6,213
4500,전라북도,4502,전주시덕진구,,송천2동제7투,2292,1642,1313,257,44,0,11,0,0,0,3,3,0,2,1633,9,650
4500,전라북도,4502,전주시덕진구,조촌동,소계,10058,7902,6643,999,138,1,56,4,0,1,1,5,1,5,7854,48,2156
4500,전라북도,4502,전주시덕진구,,관내사전투표,4647,4647,4053,482,67,0,23,2,0,1,0,1,1,2,4632,15,0
4500,전라북도,4502,전주시덕진구,,조촌동제1투,2063,1201,926,208,30,0,14,1,0,0,0,3,0,1,1183,18,862
4500,전라북도,4502,전주시덕진구,,조촌동제2투,2407,1426,1133,234,31,1,17,1,0,0,1,1,0,0,1419,7,981
4500,전라북도,4502,전주시덕진구,,조촌동제3투,941,628,531,75,10,0,2,0,0,0,0,0,0,2,620,8,313
4500,전라북도,4502,전주시덕진구,혁신동,소계,13867,12070,9513,2219,222,1,52,1,0,0,1,3,0,2,12014,56,1797
4500,전라북도,4502,전주시덕진구,,관내사전투표,7042,7038,5706,1151,116,1,34,1,0,0,0,1,0,1,7011,27,4
4500,전라북도,4502,전주시덕진구,,혁신동제1투,1998,1472,1117,305,34,0,7,0,0,0,0,1,0,0,1464,8,526
4500,전라북도,4502,전주시덕진구,,혁신동제2투,2104,1527,1158,327,24,0,6,0,0,0,1,0,0,0,1516,11,577
4500,전라북도,4502,전주시덕진구,,혁신동제3투,2723,2033,1532,436,48,0,5,0,0,0,0,1,0,1,2023,10,690
4500,전라북도,4502,전주시덕진구,여의동,소계,19447,15408,12584,2283,311,4,103,2,2,1,3,9,3,11,15316,92,4039
4500,전라북도,4502,전주시덕진구,,관내사전투표,5947,5947,5165,622,91,2,33,1,2,0,0,4,1,5,5926,21,0
4500,전라북도,4502,전주시덕진구,,여의동제1투,1795,1021,808,162,26,1,11,0,0,0,0,0,0,0,1008,13,774
4500,전라북도,4502,전주시덕진구,,여의동제2투,1632,1013,802,160,29,0,8,0,0,0,0,1,0,1,1001,12,619
4500,전라북도,4502,전주시덕진구,,여의동제3투,2259,1410,1158,196,22,1,13,0,0,0,1,0,2,3,1396,14,849
4500,전라북도,4502,전주시덕진구,,여의동제4투,988,732,612,96,12,0,7,0,0,0,0,0,0,1,728,4,256
4500,전라북도,4502,전주시덕진구,,여의동제5투,849,670,547,99,17,0,4,0,0,0,0,0,0,0,667,3,179
4500,전라북도,4502,전주시덕진구,,여의동제6투,2422,1825,1357,402,46,0,8,1,0,1,1,0,0,1,1817,8,597
4500,전라북도,4502,전주시덕진구,,여의동제7투,1652,1323,1024,245,29,0,12,0,0,0,1,1,0,0,1312,11,329
4500,전라북도,4502,전주시덕진구,,여의동제8투,1903,1467,1111,301,39,0,7,0,0,0,0,3,0,0,1461,6,436
4500,전라북도,4502,전주시덕진구,잘못 투입·구분된 투표지,,0,11,8,2,0,0,0,0,0,0,0,0,0,0,10,1,-11
4500,전라북도,4503,군산시,합계,,225149,177339,144395,27400,2613,80,1241,44,13,17,40,129,37,130,176139,1200,47810
4500,전라북도,4503,군산시,거소·선상투표,,766,709,461,135,14,2,10,1,0,0,2,1,1,1,628,81,57
4500,전라북도,4503,군산시,관외사전투표,,15268,15266,11072,3468,343,19,186,7,2,0,4,15,1,11,15128,138,2
4500,전라북도,4503,군산시,재외투표,,638,470,358,70,14,1,2,0,0,0,0,1,0,0,446,24,168
4500,전라북도,4503,군산시,옥구읍,소계,3314,2755,2327,360,32,1,12,3,0,0,1,3,1,4,2744,11,559
4500,전라북도,4503,군산시,,관내사전투표,2170,2169,1850,267,24,1,9,3,0,0,0,3,1,3,2161,8,1
4500,전라북도,4503,군산시,,옥구읍투표소,1144,586,477,93,8,0,3,0,0,0,1,0,0,1,583,3,558
4500,전라북도,4503,군산시,옥산면,소계,4333,3608,3012,501,44,2,23,0,0,0,0,3,1,4,3590,18,725
4500,전라북도,4503,군산시,,관내사전투표,2560,2560,2197,308,29,1,13,0,0,0,0,1,0,3,2552,8,0
4500,전라북도,4503,군산시,,옥산면투표소,1773,1048,815,193,15,1,10,0,0,0,0,2,1,1,1038,10,725
4500,전라북도,4503,군산시,회현면,소계,2586,2120,1777,271,27,1,13,2,1,1,1,2,0,4,2100,20,466
4500,전라북도,4503,군산시,,관내사전투표,1496,1496,1279,167,19,1,6,2,1,0,1,2,0,3,1481,15,0
4500,전라북도,4503,군산시,,회현면투표소,1090,624,498,104,8,0,7,0,0,1,0,0,0,1,619,5,466
4500,전라북도,4503,군산시,임피면,소계,2332,1855,1575,226,16,2,16,2,0,1,0,1,0,2,1841,14,477
4500,전라북도,4503,군산시,,관내사전투표,1352,1352,1183,133,10,2,8,2,0,1,0,1,0,2,1342,10,0
4500,전라북도,4503,군산시,,임피면투표소,980,503,392,93,6,0,8,0,0,0,0,0,0,0,499,4,477
4500,전라북도,4503,군산시,서수면,소계,2210,1724,1414,255,21,1,8,1,0,0,0,0,2,5,1707,17,486
4500,전라북도,4503,군산시,,관내사전투표,1127,1127,948,157,9,0,3,1,0,0,0,0,1,2,1121,6,0
4500,전라북도,4503,군산시,,서수면투표소,1083,597,466,98,12,1,5,0,0,0,0,0,1,3,586,11,486
4500,전라북도,4503,군산시,대야면,소계,4392,3467,2924,447,47,0,22,2,1,0,0,2,2,3,3450,17,925
4500,전라북도,4503,군산시,,관내사전투표,2497,2497,2147,290,33,0,10,2,1,0,0,2,2,2,2489,8,0
4500,전라북도,4503,군산시,,대야면제1투,932,478,386,76,9,0,3,0,0,0,0,0,0,1,475,3,454
4500,전라북도,4503,군산시,,대야면제2투,963,492,391,81,5,0,9,0,0,0,0,0,0,0,486,6,471
4500,전라북도,4503,군산시,개정면,소계,2452,1967,1620,298,18,3,14,0,0,0,0,1,1,0,1955,12,485
4500,전라북도,4503,군산시,,관내사전투표,1286,1286,1086,172,11,1,8,0,0,0,0,0,1,0,1279,7,0
4500,전라북도,4503,군산시,,개정면투표소,1166,681,534,126,7,2,6,0,0,0,0,1,0,0,676,5,485
4500,전라북도,4503,군산시,성산면,소계,2758,2288,1887,338,27,1,12,2,0,0,0,3,1,4,2275,13,470
4500,전라북도,4503,군산시,,관내사전투표,1688,1685,1409,237,17,1,5,2,0,0,0,3,0,2,1676,9,3
4500,전라북도,4503,군산시,,성산면투표소,1070,603,478,101,10,0,7,0,0,0,0,0,1,2,599,4,467
4500,전라북도,4503,군산시,나포면,소계,1894,1490,1234,209,16,2,7,0,0,1,0,2,1,6,1478,12,404
4500,전라북도,4503,군산시,,관내사전투표,1027,1027,861,138,11,1,3,0,0,1,0,0,1,5,1021,6,0
4500,전라북도,4503,군산시,,나포면투표소,867,463,373,71,5,1,4,0,0,0,0,2,0,1,457,6,404
4500,전라북도,4503,군산시,옥도면,소계,2235,1575,1379,159,12,0,9,2,0,0,0,0,0,3,1564,11,660
4500,전라북도,4503,군산시,,관내사전투표,521,521,462,47,6,0,2,2,0,0,0,0,0,0,519,2,0
4500,전라북도,4503,군산시,,옥도면제1투,352,200,190,8,0,0,0,0,0,0,0,0,0,0,198,2,152
4500,전라북도,4503,군산시,,옥도면제2투,76,55,54,1,0,0,0,0,0,0,0,0,0,0,55,0,21
4500,전라북도,4503,군산시,,옥도면제3투,147,90,75,14,0,0,1,0,0,0,0,0,0,0,90,0,57
4500,전라북도,4503,군산시,,옥도면제4투,97,53,46,6,0,0,0,0,0,0,0,0,0,0,52,1,44
4500,전라북도,4503,군산시,,옥도면제5투,169,116,107,4,1,0,0,0,0,0,0,0,0,2,114,2,53
4500,전라북도,4503,군산시,,옥도면제6투,537,349,293,44,2,0,5,0,0,0,0,0,0,1,345,4,188
4500,전라북도,4503,군산시,,옥도면제7투,47,26,19,5,2,0,0,0,0,0,0,0,0,0,26,0,21
4500,전라북도,4503,군산시,,옥도면제8투,91,54,48,6,0,0,0,0,0,0,0,0,0,0,54,0,37
4500,전라북도,4503,군산시,,옥도면제9투,36,25,14,11,0,0,0,0,0,0,0,0,0,0,25,0,11
4500,전라북도,4503,군산시,,옥도면제10투,162,86,71,13,1,0,1,0,0,0,0,0,0,0,86,0,76
4500,전라북도,4503,군산시,옥서면,소계,2912,2381,1989,315,35,2,20,0,0,0,0,2,1,2,2366,15,531
4500,전라북도,4503,군산시,,관내사전투표,1693,1693,1453,198,22,1,9,0,0,0,0,2,0,1,1686,7,0
4500,전라북도,4503,군산시,,옥서면투표소,1219,688,536,117,13,1,11,0,0,0,0,0,1,1,680,8,531
4500,전라북도,4503,군산시,해신동,소계,2613,2167,1791,322,30,0,10,1,0,0,1,3,1,1,2160,7,446
4500,전라북도,4503,군산시,,관내사전투표,1617,1617,1368,210,26,0,2,1,0,0,0,3,1,1,1612,5,0
4500,전라북도,4503,군산시,,해신동투표소,996,550,423,112,4,0,8,0,0,0,1,0,0,0,548,2,446
4500,전라북도,4503,군산시,월명동,소계,4978,3900,3186,602,56,2,20,0,0,2,1,0,2,3,3874,26,1078
4500,전라북도,4503,군산시,,관내사전투표,2516,2516,2125,330,35,0,8,0,0,0,1,0,1,2,2502,14,0
4500,전라북도,4503,군산시,,월명동제1투,1210,637,460,151,8,0,9,0,0,2,0,0,1,1,632,5,573
4500,전라북도,4503,군산시,,월명동제2투,1252,747,601,121,13,2,3,0,0,0,0,0,0,0,740,7,505
4500,전라북도,4503,군산시,삼학동,소계,6050,5017,4187,732,38,4,30,0,0,0,1,1,0,3,4996,21,1033
4500,전라북도,4503,군산시,,관내사전투표,3586,3586,3053,481,21,3,14,0,0,0,1,1,0,2,3576,10,0
4500,전라북도,4503,군산시,,삼학동제1투,1038,602,453,127,8,1,6,0,0,0,0,0,0,0,595,7,436
4500,전라북도,4503,군산시,,삼학동제2투,1426,829,681,124,9,0,10,0,0,0,0,0,0,1,825,4,597
4500,전라북도,4503,군산시,신풍동,소계,6021,4622,3849,662,58,0,15,1,0,2,2,3,0,3,4595,27,1399
4500,전라북도,4503,군산시,,관내사전투표,2463,2463,2145,275,23,0,5,1,0,1,0,1,0,1,2452,11,0
4500,전라북도,4503,군산시,,신풍동제1투,1256,704,548,127,14,0,6,0,0,1,0,1,0,2,699,5,552
4500,전라북도,4503,군산시,,신풍동제2투,850,469,371,82,5,0,3,0,0,0,1,0,0,0,462,7,381
4500,전라북도,4503,군산시,,신풍동제3투,1452,986,785,178,16,0,1,0,0,0,1,1,0,0,982,4,466
4500,전라북도,4503,군산시,중앙동,소계,4336,3366,2776,503,46,1,12,0,1,0,0,2,0,3,3344,22,970
4500,전라북도,4503,군산시,,관내사전투표,2355,2355,2002,297,26,1,8,0,1,0,0,1,0,2,2338,17,0
4500,전라북도,4503,군산시,,중앙동투표소,1981,1011,774,206,20,0,4,0,0,0,0,1,0,1,1006,5,970
4500,전라북도,4503,군산시,흥남동,소계,10517,8219,6791,1205,118,0,38,2,1,0,2,7,5,2,8171,48,2298
4500,전라북도,4503,군산시,,관내사전투표,4779,4779,4079,612,50,0,15,2,0,0,0,3,2,2,4765,14,0
4500,전라북도,4503,군산시,,흥남동제1투,1747,912,706,167,20,0,7,0,0,0,1,3,0,0,904,8,835
4500,전라북도,4503,군산시,,흥남동제2투,1974,1227,981,203,22,0,4,0,0,0,1,1,2,0,1214,13,747
4500,전라북도,4503,군산시,,흥남동제3투,859,554,439,91,10,0,8,0,0,0,0,0,1,0,549,5,305
4500,전라북도,4503,군산시,,흥남동제4투,1158,747,586,132,16,0,4,0,1,0,0,0,0,0,739,8,411
4500,전라북도,4503,군산시,조촌동,소계,18575,14679,11930,2326,244,3,92,2,0,0,3,6,3,7,14616,63,3896
4500,전라북도,4503,군산시,,관내사전투표,7920,7920,6694,1057,101,0,38,1,0,0,0,3,1,3,7898,22,0
4500,전라북도,4503,군산시,,조촌동제1투,1844,972,729,205,18,0,10,0,0,0,0,1,1,1,965,7,872
4500,전라북도,4503,군산시,,조촌동제2투,2734,1608,1221,306,51,2,18,0,0,0,1,1,0,0,1600,8,1126
4500,전라북도,4503,군산시,,조촌동제3투,1182,703,548,136,11,1,3,1,0,0,1,0,0,1,702,1,479
4500,전라북도,4503,군산시,,조촌동제4투,2518,1707,1339,305,33,0,14,0,0,0,0,1,0,2,1694,13,811
4500,전라북도,4503,군산시,,조촌동제5투,2377,1769,1399,317,30,0,9,0,0,0,1,0,1,0,1757,12,608
4500,전라북도,4503,군산시,경암동,소계,6906,5408,4425,820,72,2,34,0,0,1,0,6,0,3,5363,45,1498
4500,전라북도,4503,군산시,,관내사전투표,3200,3200,2692,427,39,0,19,0,0,1,0,2,0,1,3181,19,0
4500,전라북도,4503,군산시,,경암동제1투,1117,585,440,123,10,1,3,0,0,0,0,1,0,1,579,6,532
4500,전라북도,4503,군산시,,경암동제2투,1750,1074,843,190,17,1,10,0,0,0,0,0,0,1,1062,12,676
4500,전라북도,4503,군산시,,경암동제3투,839,549,450,80,6,0,2,0,0,0,0,3,0,0,541,8,290
4500,전라북도,4503,군산시,구암동,소계,6646,5299,4346,757,99,1,43,0,0,1,0,5,3,5,5260,39,1347
4500,전라북도,4503,군산시,,관내사전투표,3161,3159,2641,424,51,0,20,0,0,0,0,3,0,3,3142,17,2
4500,전라북도,4503,군산시,,구암동제1투,2107,1196,959,174,31,1,16,0,0,0,0,0,1,1,1183,13,911
4500,전라북도,4503,군산시,,구암동제2투,1378,944,746,159,17,0,7,0,0,1,0,2,2,1,935,9,434
4500,전라북도,4503,군산시,개정동,소계,3174,2752,2326,356,38,0,10,0,0,0,1,0,0,2,2733,19,422
4500,전라북도,4503,군산시,,관내사전투표,2115,2115,1856,219,23,0,6,0,0,0,0,0,0,2,2106,9,0
4500,전라북도,4503,군산시,,개정동투표소,1059,637,470,137,15,0,4,0,0,0,1,0,0,0,627,10,422
4500,전라북도,4503,군산시,수송동,소계,34556,26434,21545,4087,441,5,153,6,1,3,4,18,3,6,26272,162,8122
4500,전라북도,4503,군산시,,관내사전투표,10337,10335,8695,1408,144,1,35,5,1,1,0,6,2,2,10300,35,2
4500,전라북도,4503,군산시,,수송동제1투,2143,1241,930,262,23,0,18,0,0,0,0,0,0,0,1233,8,902
4500,전라북도,4503,군산시,,수송동제2투,1748,1164,937,186,21,1,7,0,0,0,0,2,0,0,1154,10,584
4500,전라북도,4503,군산시,,수송동제3투,2026,1379,1107,230,17,0,10,0,0,0,0,1,0,2,1367,12,647
4500,전라북도,4503,군산시,,수송동제4투,1782,1122,890,190,21,0,4,0,0,1,0,2,1,0,1109,13,660
4500,전라북도,4503,군산시,,수송동제5투,2808,1609,1263,285,26,0,14,1,0,0,1,1,0,0,1591,18,1199
4500,전라북도,4503,군산시,,수송동제6투,2841,1969,1596,300,50,0,11,0,0,1,0,0,0,0,1958,11,872
4500,전라북도,4503,군산시,,수송동제7투,2511,1779,1386,333,35,1,10,0,0,0,1,0,0,0,1766,13,732
4500,전라북도,4503,군산시,,수송동제8투,2416,1664,1353,253,26,1,13,0,0,0,1,2,0,1,1650,14,752
4500,전라북도,4503,군산시,,수송동제9투,2854,1959,1608,287,29,0,17,0,0,0,1,3,0,1,1946,13,895
4500,전라북도,4503,군산시,,수송동제10투,1161,796,621,144,18,1,2,0,0,0,0,1,0,0,787,9,365
4500,전라북도,4503,군산시,,수송동제11투,1929,1417,1159,209,31,0,12,0,0,0,0,0,0,0,1411,6,512
4500,전라북도,4503,군산시,나운1동,소계,10129,7583,6216,1158,93,3,56,1,0,2,4,1,1,5,7540,43,2546
4500,전라북도,4503,군산시,,관내사전투표,4261,4261,3620,556,50,2,11,1,0,0,1,0,0,3,4244,17,0
4500,전라북도,4503,군산시,,나운1동제1투,1618,832,629,170,11,0,15,0,0,0,0,0,0,1,826,6,786
4500,전라북도,4503,군산시,,나운1동제2투,2312,1325,1055,225,16,1,13,0,0,1,1,0,1,1,1314,11,987
4500,전라북도,4503,군산시,,나운1동제3투,1185,759,602,129,12,0,8,0,0,1,0,1,0,0,753,6,426
4500,전라북도,4503,군산시,,나운1동제4투,753,406,310,78,4,0,9,0,0,0,2,0,0,0,403,3,347
4500,전라북도,4503,군산시,나운2동,소계,18671,14965,12291,2264,194,7,74,4,3,1,5,12,2,11,14868,97,3706
4500,전라북도,4503,군산시,,관내사전투표,7899,7898,6647,1097,86,4,23,2,1,0,1,9,1,3,7874,24,1
4500,전라북도,4503,군산시,,나운2동제1투,1700,1051,791,223,15,1,4,0,0,0,1,2,0,1,1038,13,649
4500,전라북도,4503,군산시,,나운2동제2투,1378,858,676,146,10,1,8,1,0,0,0,0,0,3,845,13,520
4500,전라북도,4503,군산시,,나운2동제3투,1799,1278,1027,206,14,1,16,0,0,0,1,0,0,0,1265,13,521
4500,전라북도,4503,군산시,,나운2동제4투,2285,1559,1282,223,26,0,11,1,0,0,0,1,0,1,1545,14,726
4500,전라북도,4503,군산시,,나운2동제5투,2080,1394,1137,213,24,0,8,0,0,0,2,0,0,1,1385,9,686
4500,전라북도,4503,군산시,,나운2동제6투,1530,927,731,156,19,0,4,0,2,1,0,0,1,2,916,11,603
4500,전라북도,4503,군산시,나운3동,소계,20496,14770,11959,2313,230,9,128,2,1,1,5,18,2,10,14678,92,5726
4500,전라북도,4503,군산시,,관내사전투표,4565,4565,3867,596,59,0,12,2,0,0,1,5,0,4,4546,19,0
4500,전라북도,4503,군산시,,나운3동제1투,2091,1281,1012,229,17,1,14,0,0,0,0,0,0,2,1275,6,810
4500,전라북도,4503,군산시,,나운3동제2투,1504,1062,850,173,21,0,9,0,0,0,0,2,0,0,1055,7,442
4500,전라북도,4503,군산시,,나운3동제3투,2107,1412,1166,193,28,2,15,0,0,0,1,1,0,1,1407,5,695
4500,전라북도,4503,군산시,,나운3동제4투,1818,1175,963,160,27,1,11,0,0,0,1,4,0,0,1167,8,643
4500,전라북도,4503,군산시,,나운3동제5투,1509,972,742,198,8,3,17,0,0,0,0,1,0,0,969,3,537
4500,전라북도,4503,군산시,,나운3동제6투,1873,932,762,145,6,1,9,0,0,0,1,1,0,1,926,6,941
4500,전라북도,4503,군산시,,나운3동제7투,1609,1020,799,162,25,1,13,0,0,0,0,1,0,2,1003,17,589
4500,전라북도,4503,군산시,,나운3동제8투,1377,942,717,174,22,0,15,0,1,0,1,3,0,0,933,9,435
4500,전라북도,4503,군산시,,나운3동제9투,2043,1409,1081,283,17,0,13,0,0,1,0,0,2,0,1397,12,634
4500,전라북도,4503,군산시,소룡동,소계,14216,10099,8363,1433,110,4,115,0,2,1,1,6,1,11,10047,52,4117
4500,전라북도,4503,군산시,,관내사전투표,5571,5571,4774,676,55,2,43,0,1,1,1,1,0,2,5556,15,0
4500,전라북도,4503,군산시,,소룡동제1투,1577,818,659,118,12,1,15,0,0,0,0,4,1,1,811,7,759
4500,전라북도,4503,군산시,,소룡동제2투,1046,613,487,106,6,0,3,0,0,0,0,0,0,3,605,8,433
4500,전라북도,4503,군산시,,소룡동제3투,1916,915,734,149,8,0,16,0,0,0,0,0,0,0,907,8,1001
4500,전라북도,4503,군산시,,소룡동제4투,2666,1450,1183,204,21,1,22,0,0,0,0,1,0,5,1437,13,1216
4500,전라북도,4503,군산시,,소룡동제5투,1440,732,526,180,8,0,16,0,1,0,0,0,0,0,731,1,708
4500,전라북도,4503,군산시,미성동,소계,9175,6378,5380,808,80,2,57,3,0,0,2,5,2,6,6345,33,2797
4500,전라북도,4503,군산시,,관내사전투표,3119,3118,2715,323,36,2,21,1,0,0,0,4,1,2,3105,13,1
4500,전라북도,4503,군산시,,미성동제1투,915,491,408,64,7,0,5,0,0,0,1,0,0,0,485,6,424
4500,전라북도,4503,군산시,,미성동제2투,1650,1001,821,151,12,0,9,1,0,0,1,0,0,1,996,5,649
4500,전라북도,4503,군산시,,미성동제3투,426,260,222,27,6,0,2,0,0,0,0,0,0,2,259,1,166
4500,전라북도,4503,군산시,,미성동제4투,2217,966,774,164,10,0,13,1,0,0,0,1,0,1,964,2,1251
4500,전라북도,4503,군산시,,미성동제5투,848,542,440,79,9,0,7,0,0,0,0,0,1,0,536,6,306
4500,전라북도,4503,군산시,잘못 투입·구분된 투표지,,0,6,5,0,0,0,0,0,0,0,0,0,0,0,5,1,-6
4500,전라북도,4505,익산시,합계,,239340,189310,154719,28076,3074,78,1335,45,24,32,46,153,47,153,187782,1528,50030
4500,전라북도,4505,익산시,거소·선상투표,,689,633,419,131,11,1,12,1,2,0,1,0,0,2,580,53,56
4500,전라북도,4505,익산시,관외사전투표,,17313,17312,12742,3729,357,15,230,8,5,2,1,14,5,13,17121,191,1
4500,전라북도,4505,익산시,재외투표,,721,533,408,71,16,1,1,0,0,0,1,1,0,0,499,34,188
4500,전라북도,4505,익산시,함열읍,소계,6008,4716,3983,615,59,2,25,0,0,1,0,6,1,4,4696,20,1292
4500,전라북도,4505,익산시,,관내사전투표,3118,3118,2686,370,33,0,13,0,0,0,0,4,1,1,3108,10,0
4500,전라북도,4505,익산시,,함열읍제1투,1602,827,659,139,11,1,7,0,0,0,0,1,0,2,820,7,775
4500,전라북도,4505,익산시,,함열읍제2투,1288,771,638,106,15,1,5,0,0,1,0,1,0,1,768,3,517
4500,전라북도,4505,익산시,오산면,소계,5707,4298,3671,518,49,0,23,0,1,0,2,0,3,0,4267,31,1409
4500,전라북도,4505,익산시,,관내사전투표,2023,2023,1766,221,17,0,5,0,1,0,1,0,2,0,2013,10,0
4500,전라북도,4505,익산시,,오산면제1투,1025,540,454,67,5,0,7,0,0,0,0,0,0,0,533,7,485
4500,전라북도,4505,익산시,,오산면제2투,2018,1335,1125,168,23,0,8,0,0,0,0,0,0,0,1324,11,683
4500,전라북도,4505,익산시,,오산면제3투,641,400,326,62,4,0,3,0,0,0,1,0,1,0,397,3,241
4500,전라북도,4505,익산시,황등면,소계,6403,5042,4268,597,64,1,22,2,0,3,0,4,5,12,4978,64,1361
4500,전라북도,4505,익산시,,관내사전투표,3342,3342,2912,324,34,1,7,1,0,2,0,2,4,10,3297,45,0
4500,전라북도,4505,익산시,,황등면제1투,1043,521,407,93,8,0,2,1,0,0,0,1,0,0,512,9,522
4500,전라북도,4505,익산시,,황등면제2투,1555,884,702,141,18,0,12,0,0,1,0,1,0,1,876,8,671
4500,전라북도,4505,익산시,,황등면제3투,463,295,247,39,4,0,1,0,0,0,0,0,1,1,293,2,168
4500,전라북도,4505,익산시,함라면,소계,1966,1544,1287,199,28,0,12,0,0,0,1,2,1,2,1532,12,422
4500,전라북도,4505,익산시,,관내사전투표,1118,1118,962,122,18,0,5,0,0,0,0,2,1,1,1111,7,0
4500,전라북도,4505,익산시,,함라면투표소,848,426,325,77,10,0,7,0,0,0,1,0,0,1,421,5,422
4500,전라북도,4505,익산시,웅포면,소계,1321,1090,929,140,9,0,3,0,0,0,1,1,0,2,1085,5,231
4500,전라북도,4505,익산시,,관내사전투표,720,720,621,84,8,0,1,0,0,0,1,1,0,1,717,3,0
4500,전라북도,4505,익산시,,웅포면투표소,601,370,308,56,1,0,2,0,0,0,0,0,0,1,368,2,231
4500,전라북도,4505,익산시,성당면,소계,1643,1235,1037,161,19,0,5,0,0,2,0,2,0,1,1227,8,408
4500,전라북도,4505,익산시,,관내사전투표,813,813,705,89,13,0,2,0,0,0,0,2,0,0,811,2,0
4500,전라북도,4505,익산시,,성당면투표소,830,422,332,72,6,0,3,0,0,2,0,0,0,1,416,6,408
4500,전라북도,4505,익산시,용안면,소계,2175,1685,1364,261,19,3,5,0,1,1,1,2,1,4,1662,23,490
4500,전라북도,4505,익산시,,관내사전투표,1112,1112,915,156,10,3,2,0,1,1,0,2,0,4,1094,18,0
4500,전라북도,4505,익산시,,용안면투표소,1063,573,449,105,9,0,3,0,0,0,1,0,1,0,568,5,490
4500,전라북도,4505,익산시,낭산면,소계,2530,1927,1561,292,35,1,13,0,0,0,0,4,0,4,1910,17,603
4500,전라북도,4505,익산시,,관내사전투표,1215,1215,1018,157,22,1,4,0,0,0,0,2,0,3,1207,8,0
4500,전라북도,4505,익산시,,낭산면투표소,1315,712,543,135,13,0,9,0,0,0,0,2,0,1,703,9,603
4500,전라북도,4505,익산시,망성면,소계,2472,1815,1356,400,26,2,17,0,0,1,0,1,1,2,1806,9,657
4500,전라북도,4505,익산시,,관내사전투표,1019,1019,815,180,9,0,8,0,0,0,0,1,0,2,1015,4,0
4500,전라북도,4505,익산시,,망성면투표소,1453,796,541,220,17,2,9,0,0,1,0,0,1,0,791,5,657
4500,전라북도,4505,익산시,여산면,소계,2849,2197,1735,377,35,0,19,2,1,0,3,1,0,2,2175,22,652
4500,전라북도,4505,익산시,,관내사전투표,1399,1399,1142,215,19,0,9,2,0,0,1,1,0,1,1390,9,0
4500,전라북도,4505,익산시,,여산면투표소,1450,798,593,162,16,0,10,0,1,0,2,0,0,1,785,13,652
4500,전라북도,4505,익산시,금마면,소계,4769,3754,2971,648,71,2,22,0,0,3,0,0,2,4,3723,31,1015
4500,전라북도,4505,익산시,,관내사전투표,2471,2470,2018,375,47,2,8,0,0,1,0,0,1,3,2455,15,1
4500,전라북도,4505,익산시,,금마면제1투,1486,805,597,176,14,0,11,0,0,0,0,0,0,0,798,7,681
4500,전라북도,4505,익산시,,금마면제2투,812,479,356,97,10,0,3,0,0,2,0,0,1,1,470,9,333
4500,전라북도,4505,익산시,왕궁면,소계,3403,2584,2154,359,24,2,12,0,0,0,4,1,0,3,2559,25,819
4500,전라북도,4505,익산시,,관내사전투표,1311,1311,1126,155,10,0,4,0,0,0,0,1,0,1,1297,14,0
4500,전라북도,4505,익산시,,왕궁면제1투,1020,539,444,79,7,0,4,0,0,0,1,0,0,0,535,4,481
4500,전라북도,4505,익산시,,왕궁면제2투,588,346,283,50,3,2,2,0,0,0,2,0,0,0,342,4,242
4500,전라북도,4505,익산시,,왕궁면제3투,484,388,301,75,4,0,2,0,0,0,1,0,0,2,385,3,96
4500,전라북도,4505,익산시,춘포면,소계,3446,2597,2220,283,30,1,20,0,2,0,1,1,2,3,2563,34,849
4500,전라북도,4505,익산시,,관내사전투표,1108,1107,954,115,11,1,5,0,2,0,0,0,1,1,1090,17,1
4500,전라북도,4505,익산시,,춘포면제1투,764,449,394,37,7,0,5,0,0,0,0,0,1,0,444,5,315
4500,전라북도,4505,익산시,,춘포면제2투,833,544,471,58,5,0,3,0,0,0,1,0,0,2,540,4,289
4500,전라북도,4505,익산시,,춘포면제3투,741,497,401,73,7,0,7,0,0,0,0,1,0,0,489,8,244
4500,전라북도,4505,익산시,삼기면,소계,2489,1955,1655,227,26,0,10,1,1,2,1,0,1,5,1929,26,534
4500,전라북도,4505,익산시,,관내사전투표,1360,1360,1172,133,18,0,7,1,1,0,1,0,1,4,1338,22,0
4500,전라북도,4505,익산시,,삼기면투표소,1129,595,483,94,8,0,3,0,0,2,0,0,0,1,591,4,534
4500,전라북도,4505,익산시,용동면,소계,1329,1036,825,181,12,0,5,0,0,0,0,3,1,2,1029,7,293
4500,전라북도,4505,익산시,,관내사전투표,618,618,509,100,3,0,2,0,0,0,0,0,1,2,617,1,0
4500,전라북도,4505,익산시,,용동면투표소,711,418,316,81,9,0,3,0,0,0,0,3,0,0,412,6,293
4500,전라북도,4505,익산시,중앙동,소계,3945,3217,2602,511,46,2,24,1,0,0,4,1,0,2,3193,24,728
4500,전라북도,4505,익산시,,관내사전투표,2336,2336,1957,319,35,1,8,0,0,0,2,1,0,1,2324,12,0
4500,전라북도,4505,익산시,,중앙동제1투,879,479,358,98,5,1,9,1,0,0,1,0,0,1,474,5,400
4500,전라북도,4505,익산시,,중앙동제2투,730,402,287,94,6,0,7,0,0,0,1,0,0,0,395,7,328
4500,전라북도,4505,익산시,평화동,소계,3830,3073,2609,379,30,0,26,0,0,0,0,6,0,3,3053,20,757
4500,전라북도,4505,익산시,,관내사전투표,1877,1876,1639,205,16,0,6,0,0,0,0,3,0,2,1871,5,1
4500,전라북도,4505,익산시,,평화동제1투,1075,641,518,88,10,0,10,0,0,0,0,3,0,1,630,11,434
4500,전라북도,4505,익산시,,평화동제2투,878,556,452,86,4,0,10,0,0,0,0,0,0,0,552,4,322
4500,전라북도,4505,익산시,인화동,소계,5902,4507,3745,621,70,1,29,0,0,2,3,4,1,0,4476,31,1395
4500,전라북도,4505,익산시,,관내사전투표,2833,2833,2441,321,40,0,14,0,0,2,1,3,1,0,2823,10,0
4500,전라북도,4505,익산시,,인화동제1투,1520,775,575,158,14,1,10,0,0,0,1,1,0,0,760,15,745
4500,전라북도,4505,익산시,,인화동제2투,1549,899,729,142,16,0,5,0,0,0,1,0,0,0,893,6,650
4500,전라북도,4505,익산시,동산동,소계,16569,12391,10583,1446,176,2,67,3,2,0,5,13,3,12,12312,79,4178
4500,전라북도,4505,익산시,,관내사전투표,6451,6451,5671,635,70,2,22,2,1,0,2,6,2,7,6420,31,0
4500,전라북도,4505,익산시,,동산동제1투,1480,888,716,143,14,0,7,0,0,0,1,0,0,0,881,7,592
4500,전라북도,4505,익산시,,동산동제2투,1332,753,599,123,15,0,7,0,1,0,0,2,0,1,748,5,579
4500,전라북도,4505,익산시,,동산동제3투,2361,1317,1084,180,25,0,10,1,0,0,0,2,0,1,1303,14,1044
4500,전라북도,4505,익산시,,동산동제4투,1646,1014,854,127,17,0,7,0,0,0,0,0,0,1,1006,8,632
4500,전라북도,4505,익산시,,동산동제5투,1556,856,719,105,17,0,5,0,0,0,0,1,0,1,848,8,700
4500,전라북도,4505,익산시,,동산동제6투,1743,1112,940,133,18,0,9,0,0,0,2,2,1,1,1106,6,631
4500,전라북도,4505,익산시,마동,소계,8771,6822,5644,954,97,5,48,4,1,0,2,6,3,8,6772,50,1949
4500,전라북도,4505,익산시,,관내사전투표,4290,4289,3641,525,53,4,27,4,1,0,2,2,3,5,4267,22,1
4500,전라북도,4505,익산시,,마동제1투,989,473,374,79,7,0,5,0,0,0,0,0,0,1,466,7,516
4500,전라북도,4505,익산시,,마동제2투,1505,857,663,157,16,1,7,0,0,0,0,0,0,2,846,11,648
4500,전라북도,4505,익산시,,마동제3투,1987,1203,966,193,21,0,9,0,0,0,0,4,0,0,1193,10,784
4500,전라북도,4505,익산시,남중동,소계,10139,7800,6369,1216,105,3,53,1,1,1,2,4,2,4,7761,39,2339
4500,전라북도,4505,익산시,,관내사전투표,4773,4773,4063,607,57,2,18,1,0,1,2,0,2,1,4754,19,0
4500,전라북도,4505,익산시,,남중동제1투,1194,585,449,114,10,0,8,0,0,0,0,0,0,1,582,3,609
4500,전라북도,4505,익산시,,남중동제2투,1465,866,641,187,17,0,8,0,0,0,0,3,0,0,856,10,599
4500,전라북도,4505,익산시,,남중동제3투,1312,715,554,135,12,1,7,0,1,0,0,1,0,1,712,3,597
4500,전라북도,4505,익산시,,남중동제4투,1395,861,662,173,9,0,12,0,0,0,0,0,0,1,857,4,534
4500,전라북도,4505,익산시,모현동,소계,26928,21059,17552,2934,310,3,127,3,1,2,0,7,2,7,20948,111,5869
4500,전라북도,4505,익산시,,관내사전투표,9378,9378,8051,1139,116,0,33,2,0,1,0,2,0,0,9344,34,0
4500,전라북도,4505,익산시,,모현동제1투,1708,927,744,139,15,0,17,0,0,0,0,1,0,2,918,9,781
4500,전라북도,4505,익산시,,모현동제2투,1434,907,714,168,11,2,6,0,0,0,0,0,0,0,901,6,527
4500,전라북도,4505,익산시,,모현동제3투,1881,1222,984,193,21,0,13,0,0,0,0,1,0,0,1212,10,659
4500,전라북도,4505,익산시,,모현동제4투,1212,721,581,112,15,0,3,0,0,0,0,1,0,1,713,8,491
4500,전라북도,4505,익산시,,모현동제5투,1932,1239,962,236,17,0,11,0,0,1,0,0,0,1,1228,11,693
4500,전라북도,4505,익산시,,모현동제6투,1957,1350,1130,182,25,1,8,0,0,0,0,1,0,0,1347,3,607
4500,전라북도,4505,익산시,,모현동제7투,1936,1228,1030,146,21,0,13,0,1,0,0,0,1,1,1213,15,708
4500,전라북도,4505,익산시,,모현동제8투,1921,1478,1201,235,23,0,10,0,0,0,0,0,1,1,1471,7,443
4500,전라북도,4505,익산시,,모현동제9투,1536,1060,857,170,20,0,8,1,0,0,0,0,0,1,1057,3,476
4500,전라북도,4505,익산시,,모현동제10투,2033,1549,1298,214,26,0,5,0,0,0,0,1,0,0,1544,5,484
4500,전라북도,4505,익산시,송학동,소계,8098,6734,5776,783,91,0,52,3,0,0,2,2,0,4,6713,21,1364
4500,전라북도,4505,익산시,,관내사전투표,4448,4447,3871,479,52,0,27,1,0,0,1,2,0,2,4435,12,1
4500,전라북도,4505,익산시,,송학동제1투,851,448,378,55,4,0,7,0,0,0,1,0,0,1,446,2,403
4500,전라북도,4505,익산시,,송학동제2투,1029,690,557,113,13,0,4,1,0,0,0,0,0,1,689,1,339
4500,전라북도,4505,익산시,,송학동제3투,1770,1149,970,136,22,0,14,1,0,0,0,0,0,0,1143,6,621
4500,전라북도,4505,익산시,신동,소계,11792,8600,6493,1721,182,2,84,2,0,1,1,9,3,6,8504,96,3192
4500,전라북도,4505,익산시,,관내사전투표,4587,4587,3567,833,93,1,37,2,0,1,1,5,1,1,4542,45,0
4500,전라북도,4505,익산시,,신동제1투,1980,1068,701,305,28,1,11,0,0,0,0,1,0,2,1049,19,912
4500,전라북도,4505,익산시,,신동제2투,1889,929,666,209,24,0,13,0,0,0,0,0,1,2,915,14,960
4500,전라북도,4505,익산시,,신동제3투,2045,1353,1040,254,27,0,17,0,0,0,0,0,1,0,1339,14,692
4500,전라북도,4505,익산시,,신동제4투,1291,663,519,120,10,0,6,0,0,0,0,3,0,1,659,4,628
4500,전라북도,4505,익산시,영등1동,소계,16493,12742,10370,1930,235,2,81,1,0,2,1,17,4,10,12653,89,3751
4500,전라북도,4505,익산시,,관내사전투표,6278,6278,5321,806,92,2,24,0,0,0,0,5,1,4,6255,23,0
4500,전라북도,4505,익산시,,영등1동제1투,1414,889,660,191,18,0,7,0,0,1,0,0,0,3,880,9,525
4500,전라북도,4505,익산시,,영등1동제2투,1397,820,663,124,17,0,9,0,0,0,1,1,0,0,815,5,577
4500,전라북도,4505,익산시,,영등1동제3투,1810,1120,874,185,28,0,12,1,0,0,0,3,1,1,1105,15,690
4500,전라북도,4505,익산시,,영등1동제4투,1374,882,691,149,23,0,5,0,0,0,0,6,1,0,875,7,492
4500,전라북도,4505,익산시,,영등1동제5투,1131,718,571,116,11,0,9,0,0,0,0,0,0,1,708,10,413
4500,전라북도,4505,익산시,,영등1동제6투,1420,886,692,158,16,0,7,0,0,0,0,2,1,0,876,10,534
4500,전라북도,4505,익산시,,영등1동제7투,1669,1149,898,201,30,0,8,0,0,1,0,0,0,1,1139,10,520
4500,전라북도,4505,익산시,영등2동,소계,12048,9916,8207,1370,197,6,60,2,0,1,1,11,1,6,9862,54,2132
4500,전라북도,4505,익산시,,관내사전투표,6433,6433,5454,799,108,3,31,2,0,0,0,7,1,2,6407,26,0
4500,전라북도,4505,익산시,,영등2동제1투,2132,1374,1111,202,35,1,13,0,0,1,0,0,0,2,1365,9,758
4500,전라북도,4505,익산시,,영등2동제2투,1468,879,650,183,23,1,9,0,0,0,0,3,0,0,869,10,589
4500,전라북도,4505,익산시,,영등2동제3투,2015,1230,992,186,31,1,7,0,0,0,1,1,0,2,1221,9,785
4500,전라북도,4505,익산시,어양동,소계,18626,14438,11822,2127,278,8,96,3,0,3,2,15,2,5,14361,77,4188
4500,전라북도,4505,익산시,,관내사전투표,7835,7837,6611,988,151,4,38,0,0,1,1,11,2,2,7809,28,-2
4500,전라북도,4505,익산시,,어양동제1투,1922,1059,869,151,19,0,11,0,0,0,0,1,0,2,1053,6,863
4500,전라북도,4505,익산시,,어양동제2투,1729,981,791,155,15,1,13,1,0,1,0,0,0,0,977,4,748
4500,전라북도,4505,익산시,,어양동제3투,1774,1072,780,258,22,0,7,1,0,0,0,1,0,0,1069,3,702
4500,전라북도,4505,익산시,,어양동제4투,2068,1274,969,251,29,1,9,0,0,0,0,0,0,1,1260,14,794
4500,전라북도,4505,익산시,,어양동제5투,1694,1145,960,144,22,1,6,1,0,0,0,1,0,0,1135,10,549
4500,전라북도,4505,익산시,,어양동제6투,1604,1070,842,180,20,1,12,0,0,1,1,1,0,0,1058,12,534
4500,전라북도,4505,익산시,팔봉동,소계,5928,4626,3790,602,75,2,37,6,5,1,4,4,2,8,4536,90,1302
4500,전라북도,4505,익산시,,관내사전투표,3106,3106,2592,346,55,1,22,5,4,0,1,1,2,4,3033,73,0
4500,전라북도,4505,익산시,,팔봉동제1투,2080,1110,879,178,15,1,13,1,1,1,2,3,0,3,1097,13,970
4500,전라북도,4505,익산시,,팔봉동제2투,742,410,319,78,5,0,2,0,0,0,1,0,0,1,406,4,332
4500,전라북도,4505,익산시,삼성동,소계,23038,17430,14570,2293,292,11,95,2,1,4,2,11,1,13,17295,135,5608
4500,전라북도,4505,익산시,,관내사전투표,8130,8130,7045,889,120,7,24,0,1,2,1,4,1,6,8100,30,0
4500,전라북도,4505,익산시,,삼성동제1투,2057,1323,1076,210,18,1,7,0,0,0,0,1,0,0,1313,10,734
4500,전라북도,4505,익산시,,삼성동제2투,1577,881,697,138,8,1,13,1,0,1,1,0,0,3,863,18,696
4500,전라북도,4505,익산시,,삼성동제3투,2045,1121,877,185,25,1,14,0,0,0,0,0,0,1,1103,18,924
4500,전라북도,4505,익산시,,삼성동제4투,2029,1328,1085,195,17,0,10,0,0,0,0,2,0,0,1309,19,701
4500,전라북도,4505,익산시,,삼성동제5투,2229,1394,1140,202,28,0,11,0,0,0,0,2,0,1,1384,10,835
4500,전라북도,4505,익산시,,삼성동제6투,1983,1312,1103,167,29,0,3,0,0,1,0,0,0,0,1303,9,671
4500,전라북도,4505,익산시,,삼성동제7투,714,484,402,64,10,1,1,1,0,0,0,0,0,1,480,4,230
4500,전라북도,4505,익산시,,삼성동제8투,2274,1457,1145,243,37,0,12,0,0,0,0,2,0,1,1440,17,817
4500,전라북도,4505,익산시,잘못 투입·구분된 투표지,,0,2,2,0,0,0,0,0,0,0,0,0,0,0,2,0,-2
4500,전라북도,4507,정읍시,합계,,93594,75092,63487,9085,1040,33,476,24,16,17,21,71,41,134,74445,647,18502
4500,전라북도,4507,정읍시,거소·선상투표,,461,431,301,53,10,0,14,0,3,2,1,1,1,4,390,41,30
4500,전라북도,4507,정읍시,관외사전투표,,7556,7555,5775,1449,143,3,104,1,4,1,1,7,3,2,7493,62,1
4500,전라북도,4507,정읍시,재외투표,,246,198,153,27,11,0,0,0,0,0,0,0,0,0,191,7,48
4500,전라북도,4507,정읍시,신태인읍,소계,4706,3679,3153,399,51,2,16,2,1,2,0,2,5,10,3643,36,1027
4500,전라북도,4507,정읍시,,관내사전투표,2235,2235,1965,208,27,1,4,0,0,1,0,2,1,5,2214,21,0
4500,전라북도,4507,정읍시,,신태인읍제1투,1016,583,490,69,11,0,6,1,0,0,0,0,0,1,578,5,433
4500,전라북도,4507,정읍시,,신태인읍제2투,782,434,359,57,6,1,3,0,1,0,0,0,1,2,430,4,348
4500,전라북도,4507,정읍시,,신태인읍제3투,673,427,339,65,7,0,3,1,0,1,0,0,3,2,421,6,246
4500,전라북도,4507,정읍시,북면,소계,3925,3141,2748,303,32,2,13,2,0,0,1,2,2,4,3109,32,784
4500,전라북도,4507,정읍시,,관내사전투표,2123,2123,1894,175,18,2,8,0,0,0,0,2,1,3,2103,20,0
4500,전라북도,4507,정읍시,,북면제1투,985,556,462,76,6,0,4,1,0,0,1,0,1,1,552,4,429
4500,전라북도,4507,정읍시,,북면제2투,817,462,392,52,8,0,1,1,0,0,0,0,0,0,454,8,355
4500,전라북도,4507,정읍시,입암면,소계,2473,1934,1668,197,27,1,7,0,0,2,2,1,2,8,1915,19,539
4500,전라북도,4507,정읍시,,관내사전투표,1189,1189,1015,125,21,1,4,0,0,2,2,0,2,8,1180,9,0
4500,전라북도,4507,정읍시,,입암면제1투,585,304,260,36,1,0,2,0,0,0,0,0,0,0,299,5,281
4500,전라북도,4507,정읍시,,입암면제2투,699,441,393,36,5,0,1,0,0,0,0,1,0,0,436,5,258
4500,전라북도,4507,정읍시,소성면,소계,1730,1364,1179,135,20,0,5,1,0,0,2,4,1,7,1354,10,366
4500,전라북도,4507,정읍시,,관내사전투표,910,909,805,75,12,0,0,1,0,0,0,3,1,5,902,7,1
4500,전라북도,4507,정읍시,,소성면투표소,820,455,374,60,8,0,5,0,0,0,2,1,0,2,452,3,365
4500,전라북도,4507,정읍시,고부면,소계,2289,1760,1512,195,16,1,4,1,0,0,0,6,2,5,1742,18,529
4500,전라북도,4507,정읍시,,관내사전투표,1126,1126,987,111,8,1,2,1,0,0,0,3,1,1,1115,11,0
4500,전라북도,4507,정읍시,,고부면투표소,1163,634,525,84,8,0,2,0,0,0,0,3,1,4,627,7,529
4500,전라북도,4507,정읍시,영원면,소계,1452,1203,1014,145,16,0,6,3,0,0,0,8,0,4,1196,7,249
4500,전라북도,4507,정읍시,,관내사전투표,839,839,734,77,11,0,3,2,0,0,0,5,0,3,835,4,0
4500,전라북도,4507,정읍시,,영원면투표소,613,364,280,68,5,0,3,1,0,0,0,3,0,1,361,3,249
4500,전라북도,4507,정읍시,덕천면,소계,1587,1300,1144,125,14,0,3,0,1,0,0,4,0,2,1293,7,287
4500,전라북도,4507,정읍시,,관내사전투표,792,791,700,74,7,0,2,0,0,0,0,2,0,1,786,5,1
4500,전라북도,4507,정읍시,,덕천면제1투,397,238,201,28,5,0,1,0,0,0,0,1,0,0,236,2,159
4500,전라북도,4507,정읍시,,덕천면제2투,398,271,243,23,2,0,0,0,1,0,0,1,0,1,271,0,127
4500,전라북도,4507,정읍시,이평면,소계,1714,1361,1165,143,22,0,5,0,0,0,1,0,2,5,1343,18,353
4500,전라북도,4507,정읍시,,관내사전투표,883,883,773,74,13,0,2,0,0,0,1,0,2,4,869,14,0
4500,전라북도,4507,정읍시,,이평면제1투,490,254,213,34,3,0,2,0,0,0,0,0,0,1,253,1,236
4500,전라북도,4507,정읍시,,이평면제2투,341,224,179,35,6,0,1,0,0,0,0,0,0,0,221,3,117
4500,전라북도,4507,정읍시,정우면,소계,1913,1442,1192,199,21,2,6,0,0,0,1,3,2,5,1431,11,471
4500,전라북도,4507,정읍시,,관내사전투표,900,900,754,119,13,2,2,0,0,0,0,1,0,2,893,7,0
4500,전라북도,4507,정읍시,,정우면투표소,1013,542,438,80,8,0,4,0,0,0,1,2,2,3,538,4,471
4500,전라북도,4507,정읍시,태인면,소계,2927,2301,1995,242,22,0,11,0,0,1,0,1,1,3,2276,25,626
4500,전라북도,4507,정읍시,,관내사전투표,1485,1485,1320,129,10,0,7,0,0,0,0,1,1,2,1470,15,0
4500,전라북도,4507,정읍시,,태인면제1투,795,450,367,66,6,0,4,0,0,1,0,0,0,0,444,6,345
4500,전라북도,4507,정읍시,,태인면제2투,647,366,308,47,6,0,0,0,0,0,0,0,0,1,362,4,281
4500,전라북도,4507,정읍시,감곡면,소계,2163,1559,1284,204,19,4,11,0,0,1,1,3,2,6,1535,24,604
4500,전라북도,4507,정읍시,,관내사전투표,999,999,856,96,13,3,3,0,0,0,0,2,2,6,981,18,0
4500,전라북도,4507,정읍시,,감곡면투표소,1164,560,428,108,6,1,8,0,0,1,1,1,0,0,554,6,604
4500,전라북도,4507,정읍시,옹동면,소계,1307,1017,869,107,11,1,5,0,1,1,0,2,0,8,1005,12,290
4500,전라북도,4507,정읍시,,관내사전투표,701,701,616,62,6,1,1,0,0,1,0,2,0,6,695,6,0
4500,전라북도,4507,정읍시,,옹동면투표소,606,316,253,45,5,0,4,0,1,0,0,0,0,2,310,6,290
4500,전라북도,4507,정읍시,칠보면,소계,1955,1587,1391,154,21,1,5,2,0,0,0,1,1,3,1579,8,368
4500,전라북도,4507,정읍시,,관내사전투표,1036,1036,931,86,11,0,1,2,0,0,0,1,0,1,1033,3,0
4500,전라북도,4507,정읍시,,칠보면제1투,633,338,287,37,6,1,4,0,0,0,0,0,1,0,336,2,295
4500,전라북도,4507,정읍시,,칠보면제2투,286,213,173,31,4,0,0,0,0,0,0,0,0,2,210,3,73
4500,전라북도,4507,정읍시,산내면,소계,1015,814,699,96,6,0,1,0,0,0,0,0,1,6,809,5,201
4500,전라북도,4507,정읍시,,관내사전투표,582,582,511,58,4,0,0,0,0,0,0,0,1,4,578,4,0
4500,전라북도,4507,정읍시,,산내면투표소,433,232,188,38,2,0,1,0,0,0,0,0,0,2,231,1,201
4500,전라북도,4507,정읍시,산외면,소계,1731,1373,1165,158,11,0,13,0,0,0,0,0,3,14,1364,9,358
4500,전라북도,4507,정읍시,,관내사전투표,985,985,852,103,9,0,4,0,0,0,0,0,1,10,979,6,0
4500,전라북도,4507,정읍시,,산외면투표소,746,388,313,55,2,0,9,0,0,0,0,0,2,4,385,3,358
4500,전라북도,4507,정읍시,수성동,소계,13425,10174,8694,1148,141,4,87,4,1,2,4,10,3,4,10102,72,3251
4500,전라북도,4507,정읍시,,관내사전투표,6034,6034,5318,559,72,1,45,2,1,1,1,6,2,1,6009,25,0
4500,전라북도,4507,정읍시,,수성동제1투,900,480,390,68,9,0,5,0,0,0,2,1,0,0,475,5,420
4500,전라북도,4507,정읍시,,수성동제2투,1134,761,626,112,6,0,6,2,0,0,1,1,0,0,754,7,373
4500,전라북도,4507,정읍시,,수성동제3투,1022,555,469,65,6,0,3,0,0,0,0,1,0,1,545,10,467
4500,전라북도,4507,정읍시,,수성동제4투,1993,1051,841,173,14,2,9,0,0,1,0,0,1,0,1041,10,942
4500,전라북도,4507,정읍시,,수성동제5투,2342,1293,1050,171,34,1,19,0,0,0,0,1,0,2,1278,15,1049
4500,전라북도,4507,정읍시,장명동,소계,2644,2059,1761,237,26,2,12,0,0,1,1,0,0,1,2041,18,585
4500,전라북도,4507,정읍시,,관내사전투표,1354,1354,1190,135,16,1,5,0,0,1,1,0,0,0,1349,5,0
4500,전라북도,4507,정읍시,,장명동투표소,1290,705,571,102,10,1,7,0,0,0,0,0,0,1,692,13,585
4500,전라북도,4507,정읍시,내장상동,소계,14853,11810,10126,1338,173,4,56,3,1,2,3,7,6,9,11728,82,3043
4500,전라북도,4507,정읍시,,관내사전투표,6744,6744,5927,658,88,2,23,2,0,2,0,5,4,2,6713,31,0
4500,전라북도,4507,정읍시,,내장상동제1투,1924,1207,1006,153,18,1,13,0,1,0,2,1,0,1,1196,11,717
4500,전라북도,4507,정읍시,,내장상동제2투,1338,842,701,116,12,0,4,1,0,0,0,0,1,0,835,7,496
4500,전라북도,4507,정읍시,,내장상동제3투,1116,750,605,114,17,0,2,0,0,0,0,0,0,2,740,10,366
4500,전라북도,4507,정읍시,,내장상동제4투,1227,730,608,98,8,0,8,0,0,0,0,0,1,0,723,7,497
4500,전라북도,4507,정읍시,,내장상동제5투,890,573,485,62,12,1,2,0,0,0,0,1,0,3,566,7,317
4500,전라북도,4507,정읍시,,내장상동제6투,1614,964,794,137,18,0,4,0,0,0,1,0,0,1,955,9,650
4500,전라북도,4507,정읍시,시기동,소계,3142,2614,2193,341,37,1,11,2,1,0,1,1,2,3,2593,21,528
4500,전라북도,4507,정읍시,,관내사전투표,1720,1720,1483,190,27,0,4,1,0,0,0,1,1,1,1708,12,0
4500,전라북도,4507,정읍시,,시기동제1투,805,475,375,85,6,1,2,0,0,0,0,0,1,1,471,4,330
4500,전라북도,4507,정읍시,,시기동제2투,617,419,335,66,4,0,5,1,1,0,1,0,0,1,414,5,198
4500,전라북도,4507,정읍시,초산동,소계,6747,5325,4554,618,81,4,28,0,1,1,1,2,0,4,5294,31,1422
4500,전라북도,4507,정읍시,,관내사전투표,3060,3060,2702,286,40,3,11,0,1,1,0,0,0,3,3047,13,0
4500,전라북도,4507,정읍시,,초산동제1투,842,469,393,66,3,0,4,0,0,0,1,1,0,1,469,0,373
4500,전라북도,4507,정읍시,,초산동제2투,1288,770,620,116,16,1,6,0,0,0,0,0,0,0,759,11,518
4500,전라북도,4507,정읍시,,초산동제3투,1557,1026,839,150,22,0,7,0,0,0,0,1,0,0,1019,7,531
4500,전라북도,4507,정읍시,연지동,소계,5565,4571,3872,579,56,0,29,0,0,0,0,0,2,3,4541,30,994
4500,전라북도,4507,정읍시,,관내사전투표,3100,3100,2697,351,29,0,8,0,0,0,0,0,1,2,3088,12,0
4500,전라북도,4507,정읍시,,연지동제1투,1185,665,526,103,9,0,15,0,0,0,0,0,1,0,654,11,520
4500,전라북도,4507,정읍시,,연지동제2투,1280,806,649,125,18,0,6,0,0,0,0,0,0,1,799,7,474
4500,전라북도,4507,정읍시,농소동,소계,2960,2215,1898,248,34,0,8,1,1,1,1,3,0,2,2197,18,745
4500,전라북도,4507,정읍시,,관내사전투표,1144,1144,989,123,16,0,2,0,1,0,1,2,0,2,1136,8,0
4500,전라북도,4507,정읍시,,농소동제1투,720,396,338,45,9,0,1,0,0,0,0,0,0,0,393,3,324
4500,전라북도,4507,정읍시,,농소동제2투,1096,675,571,80,9,0,5,1,0,1,0,1,0,0,668,7,421
4500,전라북도,4507,정읍시,상교동,소계,3108,2304,1982,244,19,1,16,2,1,0,0,3,0,12,2280,24,804
4500,전라북도,4507,정읍시,,관내사전투표,1434,1434,1245,153,8,1,9,1,1,0,0,0,0,6,1424,10,0
4500,전라북도,4507,정읍시,,상교동제1투,1000,518,439,56,5,0,3,0,0,0,0,2,0,6,511,7,482
4500,전라북도,4507,정읍시,,상교동제2투,674,352,298,35,6,0,4,1,0,0,0,1,0,0,345,7,322
4500,전라북도,4507,정읍시,잘못 투입·구분된 투표지,,0,1,0,1,0,0,0,0,0,0,0,0,0,0,1,0,-1
4500,전라북도,4508,남원시,합계,,69190,56509,47470,7163,731,40,366,39,13,9,18,47,35,128,56059,450,12681
4500,전라북도,4508,남원시,거소·선상투표,,297,273,170,60,4,1,7,0,2,1,0,0,1,2,248,25,24
4500,전라북도,4508,남원시,관외사전투표,,5712,5709,4302,1164,105,8,63,5,2,0,1,4,1,7,5662,47,3
4500,전라북도,4508,남원시,재외투표,,189,130,107,15,1,0,0,0,0,0,0,0,0,0,123,7,59
4500,전라북도,4508,남원시,운봉읍,소계,3189,2569,2205,276,33,0,12,2,0,2,2,1,1,10,2544,25,620
4500,전라북도,4508,남원시,,관내사전투표,1716,1716,1521,150,16,0,4,2,0,1,2,1,1,8,1706,10,0
4500,전라북도,4508,남원시,,운봉읍제1투,702,392,317,51,8,0,4,0,0,1,0,0,0,2,383,9,310
4500,전라북도,4508,남원시,,운봉읍제2투,771,461,367,75,9,0,4,0,0,0,0,0,0,0,455,6,310
4500,전라북도,4508,남원시,주천면,소계,2102,1692,1432,215,17,3,6,1,0,0,0,1,3,5,1683,9,410
4500,전라북도,4508,남원시,,관내사전투표,1113,1113,965,127,9,1,3,0,0,0,0,1,1,1,1108,5,0
4500,전라북도,4508,남원시,,주천면제1투,810,458,380,65,6,1,2,1,0,0,0,0,0,1,456,2,352
4500,전라북도,4508,남원시,,주천면제2투,179,121,87,23,2,1,1,0,0,0,0,0,2,3,119,2,58
4500,전라북도,4508,남원시,수지면,소계,913,728,615,90,7,1,3,0,0,0,0,0,1,2,719,9,185
4500,전라북도,4508,남원시,,관내사전투표,472,472,401,58,3,1,0,0,0,0,0,0,1,2,466,6,0
4500,전라북도,4508,남원시,,수지면투표소,441,256,214,32,4,0,3,0,0,0,0,0,0,0,253,3,185
4500,전라북도,4508,남원시,송동면,소계,1625,1291,1120,129,14,0,9,2,0,0,2,0,1,3,1280,11,334
4500,전라북도,4508,남원시,,관내사전투표,837,837,742,72,10,0,5,0,0,0,1,0,1,1,832,5,0
4500,전라북도,4508,남원시,,송동면투표소,788,454,378,57,4,0,4,2,0,0,1,0,0,2,448,6,334
4500,전라북도,4508,남원시,주생면,소계,1521,1252,1040,161,23,2,4,0,1,1,0,3,1,6,1242,10,269
4500,전라북도,4508,남원시,,관내사전투표,799,799,677,92,13,2,2,0,1,0,0,2,1,5,795,4,0
4500,전라북도,4508,남원시,,주생면투표소,722,453,363,69,10,0,2,0,0,1,0,1,0,1,447,6,269
4500,전라북도,4508,남원시,금지면,소계,1963,1623,1389,179,19,3,7,0,0,0,0,1,1,10,1609,14,340
4500,전라북도,4508,남원시,,관내사전투표,1026,1026,889,115,7,2,3,0,0,0,0,0,1,3,1020,6,0
4500,전라북도,4508,남원시,,금지면투표소,937,597,500,64,12,1,4,0,0,0,0,1,0,7,589,8,340
4500,전라북도,4508,남원시,대강면,소계,1341,1051,880,125,11,5,8,2,1,1,0,0,1,6,1040,11,290
4500,전라북도,4508,남원시,,관내사전투표,611,611,531,57,7,3,2,1,0,0,0,0,1,3,605,6,0
4500,전라북도,4508,남원시,,대강면투표소,730,440,349,68,4,2,6,1,1,1,0,0,0,3,435,5,290
4500,전라북도,4508,남원시,대산면,소계,1404,1111,906,123,22,5,7,1,1,1,2,5,2,5,1080,31,293
4500,전라북도,4508,남원시,,관내사전투표,816,816,657,94,17,5,4,1,1,1,1,4,2,4,791,25,0
4500,전라북도,4508,남원시,,대산면투표소,588,295,249,29,5,0,3,0,0,0,1,1,0,1,289,6,293
4500,전라북도,4508,남원시,사매면,소계,1270,984,837,104,13,0,8,0,0,0,0,1,3,6,972,12,286
4500,전라북도,4508,남원시,,관내사전투표,662,662,561,71,9,0,4,0,0,0,0,1,2,4,652,10,0
4500,전라북도,4508,남원시,,사매면투표소,608,322,276,33,4,0,4,0,0,0,0,0,1,2,320,2,286
4500,전라북도,4508,남원시,덕과면,소계,715,589,492,74,7,2,3,1,0,0,1,0,0,6,586,3,126
4500,전라북도,4508,남원시,,관내사전투표,400,400,346,38,4,2,2,1,0,0,1,0,0,4,398,2,0
4500,전라북도,4508,남원시,,덕과면투표소,315,189,146,36,3,0,1,0,0,0,0,0,0,2,188,1,126
4500,전라북도,4508,남원시,보절면,소계,1223,986,828,117,9,0,7,1,1,0,1,2,1,5,972,14,237
4500,전라북도,4508,남원시,,관내사전투표,706,706,600,85,3,0,4,1,1,0,1,0,0,3,698,8,0
4500,전라북도,4508,남원시,,보절면투표소,517,280,228,32,6,0,3,0,0,0,0,2,1,2,274,6,237
4500,전라북도,4508,남원시,산동면,소계,1436,1164,997,115,11,0,11,5,0,0,0,2,1,11,1153,11,272
4500,전라북도,4508,남원시,,관내사전투표,829,829,723,72,7,0,6,3,0,0,0,1,0,9,821,8,0
4500,전라북도,4508,남원시,,산동면투표소,607,335,274,43,4,0,5,2,0,0,0,1,1,2,332,3,272
4500,전라북도,4508,남원시,이백면,소계,1838,1494,1293,148,22,0,12,0,0,1,2,0,1,2,1481,13,344
4500,전라북도,4508,남원시,,관내사전투표,1037,1037,911,97,13,0,7,0,0,0,1,0,0,0,1029,8,0
4500,전라북도,4508,남원시,,이백면투표소,801,457,382,51,9,0,5,0,0,1,1,0,1,2,452,5,344
4500,전라북도,4508,남원시,인월면,소계,2338,1923,1611,257,22,2,12,0,0,0,0,2,4,5,1915,8,415
4500,전라북도,4508,남원시,,관내사전투표,1252,1252,1076,148,12,2,4,0,0,0,0,2,1,2,1247,5,0
4500,전라북도,4508,남원시,,인월면투표소,1086,671,535,109,10,0,8,0,0,0,0,0,3,3,668,3,415
4500,전라북도,4508,남원시,아영면,소계,1554,1265,1072,143,19,1,12,0,0,0,1,0,2,8,1258,7,289
4500,전라북도,4508,남원시,,관내사전투표,827,827,717,79,16,1,5,0,0,0,0,0,0,3,821,6,0
4500,전라북도,4508,남원시,,아영면투표소,727,438,355,64,3,0,7,0,0,0,1,0,2,5,437,1,289
4500,전라북도,4508,남원시,산내면,소계,1618,1349,1122,160,35,1,5,7,0,0,0,6,1,4,1341,8,269
4500,전라북도,4508,남원시,,관내사전투표,849,849,720,94,18,1,1,3,0,0,0,6,1,1,845,4,0
4500,전라북도,4508,남원시,,산내면투표소,769,500,402,66,17,0,4,4,0,0,0,0,0,3,496,4,269
4500,전라북도,4508,남원시,동충동,소계,3039,2487,2089,327,35,1,13,2,1,0,0,2,0,2,2472,15,552
4500,전라북도,4508,남원시,,관내사전투표,1827,1827,1558,224,20,1,7,2,1,0,0,1,0,2,1816,11,0
4500,전라북도,4508,남원시,,동충동투표소,1212,660,531,103,15,0,6,0,0,0,0,1,0,0,656,4,552
4500,전라북도,4508,남원시,죽항동,소계,2942,2312,1936,323,26,0,14,1,0,0,1,1,1,1,2304,8,630
4500,전라북도,4508,남원시,,관내사전투표,1732,1732,1487,211,16,0,10,1,0,0,0,1,1,0,1727,5,0
4500,전라북도,4508,남원시,,죽항동투표소,1210,580,449,112,10,0,4,0,0,0,1,0,0,1,577,3,630
4500,전라북도,4508,남원시,노암동,소계,4553,3635,3117,425,33,2,15,2,0,1,0,1,0,12,3608,27,918
4500,전라북도,4508,남원시,,관내사전투표,2234,2234,1948,230,21,1,8,2,0,0,0,0,0,8,2218,16,0
4500,전라북도,4508,남원시,,노암동제1투,560,321,268,41,0,0,4,0,0,0,0,0,0,2,315,6,239
4500,전라북도,4508,남원시,,노암동제2투,1759,1080,901,154,12,1,3,0,0,1,0,1,0,2,1075,5,679
4500,전라북도,4508,남원시,금동,소계,5421,4365,3788,486,38,1,25,1,1,0,0,1,2,2,4345,20,1056
4500,전라북도,4508,남원시,,관내사전투표,2806,2805,2479,280,19,0,12,1,1,0,0,1,1,1,2795,10,1
4500,전라북도,4508,남원시,,금동제1투,951,548,451,80,6,1,6,0,0,0,0,0,0,0,544,4,403
4500,전라북도,4508,남원시,,금동제2투,1664,1012,858,126,13,0,7,0,0,0,0,0,1,1,1006,6,652
4500,전라북도,4508,남원시,왕정동,소계,3505,2777,2357,345,23,0,17,2,0,0,2,1,1,4,2752,25,728
4500,전라북도,4508,남원시,,관내사전투표,1870,1870,1615,213,15,0,9,2,0,0,0,0,0,2,1856,14,0
4500,전라북도,4508,남원시,,왕정동제1투,848,464,392,57,4,0,2,0,0,0,2,0,1,0,458,6,384
4500,전라북도,4508,남원시,,왕정동제2투,787,443,350,75,4,0,6,0,0,0,0,1,0,2,438,5,344
4500,전라북도,4508,남원시,향교동,소계,6070,4728,3970,603,62,0,43,2,2,1,2,7,3,2,4697,31,1342
4500,전라북도,4508,남원시,,관내사전투표,3355,3355,2846,408,41,0,29,2,1,1,2,4,2,1,3337,18,0
4500,전라북도,4508,남원시,,향교동제1투,1554,762,630,97,15,0,10,0,0,0,0,2,1,1,756,6,792
4500,전라북도,4508,남원시,,향교동제2투,561,314,261,41,5,0,2,0,1,0,0,0,0,0,310,4,247
4500,전라북도,4508,남원시,,향교동제3투,600,297,233,57,1,0,2,0,0,0,0,1,0,0,294,3,303
4500,전라북도,4508,남원시,도통동,소계,11412,9021,7794,999,120,2,43,2,1,0,1,6,2,2,8972,49,2391
4500,전라북도,4508,남원시,,관내사전투표,5635,5635,4984,534,70,2,17,2,0,0,0,2,2,2,5615,20,0
4500,전라북도,4508,남원시,,도통동제1투,1220,718,582,108,13,0,6,0,0,0,0,1,0,0,710,8,502
4500,전라북도,4508,남원시,,도통동제2투,1089,631,509,109,4,0,2,0,1,0,1,0,0,0,626,5,458
4500,전라북도,4508,남원시,,도통동제3투,2022,1209,1026,149,17,0,9,0,0,0,0,0,0,0,1201,8,813
4500,전라북도,4508,남원시,,도통동제4투,1446,828,693,99,16,0,9,0,0,0,0,3,0,0,820,8,618
4500,전라북도,4508,남원시,잘못 투입·구분된 투표지,,0,1,1,0,0,0,0,0,0,0,0,0,0,0,1,0,-1
4500,전라북도,4509,김제시,합계,,72285,58026,48952,7164,750,38,398,15,5,13,13,33,26,96,57503,523,14259
4500,전라북도,4509,김제시,거소·선상투표,,481,448,317,57,5,0,7,3,1,1,2,1,2,2,398,50,33
4500,전라북도,4509,김제시,관외사전투표,,6937,6937,5504,1165,125,13,58,2,0,0,0,4,2,2,6875,62,0
4500,전라북도,4509,김제시,재외투표,,215,151,101,34,2,0,1,0,0,0,0,0,0,0,138,13,64
4500,전라북도,4509,김제시,만경읍,소계,2307,1872,1563,261,23,0,7,1,0,1,0,0,3,3,1862,10,435
4500,전라북도,4509,김제시,,관내사전투표,1187,1187,1010,157,13,0,3,0,0,0,0,0,0,1,1184,3,0
4500,전라북도,4509,김제시,,만경읍제1투,543,350,278,55,6,0,1,0,0,0,0,0,3,2,345,5,193
4500,전라북도,4509,김제시,,만경읍제2투,577,335,275,49,4,0,3,1,0,1,0,0,0,0,333,2,242
4500,전라북도,4509,김제시,죽산면,소계,2001,1539,1315,176,13,2,6,0,0,0,0,0,1,6,1519,20,462
4500,전라북도,4509,김제시,,관내사전투표,1061,1061,927,108,9,1,2,0,0,0,0,0,0,6,1053,8,0
4500,전라북도,4509,김제시,,죽산면투표소,940,478,388,68,4,1,4,0,0,0,0,0,1,0,466,12,462
4500,전라북도,4509,김제시,백산면,소계,2106,1681,1425,201,15,2,12,0,0,0,0,1,1,7,1664,17,425
4500,전라북도,4509,김제시,,관내사전투표,993,993,864,100,10,1,4,0,0,0,0,1,0,4,984,9,0
4500,전라북도,4509,김제시,,백산면제1투,608,341,278,51,4,0,6,0,0,0,0,0,0,1,340,1,267
4500,전라북도,4509,김제시,,백산면제2투,505,347,283,50,1,1,2,0,0,0,0,0,1,2,340,7,158
4500,전라북도,4509,김제시,용지면,소계,2730,2088,1790,234,21,0,14,1,0,0,1,2,2,7,2072,16,642
4500,전라북도,4509,김제시,,관내사전투표,1393,1393,1223,139,10,0,3,1,0,0,1,1,0,5,1383,10,0
4500,전라북도,4509,김제시,,용지면투표소,1337,695,567,95,11,0,11,0,0,0,0,1,2,2,689,6,642
4500,전라북도,4509,김제시,백구면,소계,2980,2305,1970,276,20,0,15,1,0,1,1,1,2,5,2292,13,675
4500,전라북도,4509,김제시,,관내사전투표,1441,1441,1262,155,9,0,4,1,0,1,1,0,0,2,1435,6,0
4500,전라북도,4509,김제시,,백구면제1투,812,463,370,77,5,0,6,0,0,0,0,0,2,1,461,2,349
4500,전라북도,4509,김제시,,백구면제2투,727,401,338,44,6,0,5,0,0,0,0,1,0,2,396,5,326
4500,전라북도,4509,김제시,부량면,소계,1075,859,742,91,12,0,3,1,0,0,0,0,0,0,849,10,216
4500,전라북도,4509,김제시,,관내사전투표,565,565,499,52,7,0,1,1,0,0,0,0,0,0,560,5,0
4500,전라북도,4509,김제시,,부량면투표소,510,294,243,39,5,0,2,0,0,0,0,0,0,0,289,5,216
4500,전라북도,4509,김제시,공덕면,소계,2050,1641,1410,183,17,2,11,0,1,2,0,1,1,3,1631,10,409
4500,전라북도,4509,김제시,,관내사전투표,1078,1078,950,105,8,1,7,0,0,0,0,0,1,1,1073,5,0
4500,전라북도,4509,김제시,,공덕면투표소,972,563,460,78,9,1,4,0,1,2,0,1,0,2,558,5,409
4500,전라북도,4509,김제시,청하면,소계,1429,1148,987,125,14,0,12,1,0,0,0,1,0,1,1141,7,281
4500,전라북도,4509,김제시,,관내사전투표,755,755,673,61,10,0,4,1,0,0,0,0,0,1,750,5,0
4500,전라북도,4509,김제시,,청하면투표소,674,393,314,64,4,0,8,0,0,0,0,1,0,0,391,2,281
4500,전라북도,4509,김제시,성덕면,소계,1372,1038,870,142,13,1,3,0,0,0,0,0,0,1,1030,8,334
4500,전라북도,4509,김제시,,관내사전투표,640,640,552,71,10,1,2,0,0,0,0,0,0,1,637,3,0
4500,전라북도,4509,김제시,,성덕면투표소,732,398,318,71,3,0,1,0,0,0,0,0,0,0,393,5,334
4500,전라북도,4509,김제시,진봉면,소계,1947,1454,1259,140,14,0,15,0,0,0,1,2,0,3,1434,20,493
4500,전라북도,4509,김제시,,관내사전투표,812,812,722,68,7,0,4,0,0,0,0,1,0,2,804,8,0
4500,전라북도,4509,김제시,,진봉면제1투,710,354,282,46,5,0,10,0,0,0,1,1,0,1,346,8,356
4500,전라북도,4509,김제시,,진봉면제2투,425,288,255,26,2,0,1,0,0,0,0,0,0,0,284,4,137
4500,전라북도,4509,김제시,금구면,소계,3877,3005,2591,321,43,1,12,0,0,1,1,2,3,10,2985,20,872
4500,전라북도,4509,김제시,,관내사전투표,1781,1781,1567,167,22,1,6,0,0,0,1,0,2,4,1770,11,0
4500,전라북도,4509,김제시,,금구면제1투,1040,577,472,80,15,0,4,0,0,0,0,1,1,3,576,1,463
4500,전라북도,4509,김제시,,금구면제2투,572,347,296,41,3,0,1,0,0,0,0,1,0,2,344,3,225
4500,전라북도,4509,김제시,,금구면제3투,484,300,256,33,3,0,1,0,0,1,0,0,0,1,295,5,184
4500,전라북도,4509,김제시,봉남면,소계,1828,1414,1199,157,16,1,9,2,1,0,1,3,0,11,1400,14,414
4500,전라북도,4509,김제시,,관내사전투표,866,866,747,92,7,1,5,2,0,0,0,2,0,5,861,5,0
4500,전라북도,4509,김제시,,봉남면투표소,962,548,452,65,9,0,4,0,1,0,1,1,0,6,539,9,414
4500,전라북도,4509,김제시,황산면,소계,1700,1358,1180,133,13,1,5,0,0,3,2,1,2,1,1341,17,342
4500,전라북도,4509,김제시,,관내사전투표,897,897,793,81,6,1,4,0,0,0,0,1,1,0,887,10,0
4500,전라북도,4509,김제시,,황산면투표소,803,461,387,52,7,0,1,0,0,3,2,0,1,1,454,7,342
4500,전라북도,4509,김제시,금산면,소계,3738,2933,2504,342,37,2,20,0,1,0,0,0,1,5,2912,21,805
4500,전라북도,4509,김제시,,관내사전투표,1832,1832,1605,185,19,0,7,0,0,0,0,0,0,3,1819,13,0
4500,전라북도,4509,김제시,,금산면제1투,1048,600,483,95,8,0,9,0,1,0,0,0,1,0,597,3,448
4500,전라북도,4509,김제시,,금산면제2투,858,501,416,62,10,2,4,0,0,0,0,0,0,2,496,5,357
4500,전라북도,4509,김제시,광활면,소계,1116,899,790,81,8,0,5,0,0,0,0,0,0,4,888,11,217
4500,전라북도,4509,김제시,,관내사전투표,508,508,461,36,4,0,1,0,0,0,0,0,0,1,503,5,0
4500,전라북도,4509,김제시,,광활면투표소,608,391,329,45,4,0,4,0,0,0,0,0,0,3,385,6,217
4500,전라북도,4509,김제시,요촌동,소계,8713,6822,5745,889,84,1,41,2,0,0,2,4,1,7,6776,46,1891
4500,전라북도,4509,김제시,,관내사전투표,4102,4102,3551,458,47,0,20,0,0,0,1,1,1,5,4084,18,0
4500,전라북도,4509,김제시,,요촌동제1투,1749,946,765,147,14,0,10,1,0,0,0,2,0,0,939,7,803
4500,전라북도,4509,김제시,,요촌동제2투,1238,774,614,130,11,0,6,0,0,0,1,1,0,0,763,11,464
4500,전라북도,4509,김제시,,요촌동제3투,1132,659,533,107,7,0,3,0,0,0,0,0,0,2,652,7,473
4500,전라북도,4509,김제시,,요촌동제4투,492,341,282,47,5,1,2,1,0,0,0,0,0,0,338,3,151
4500,전라북도,4509,김제시,신풍동,소계,9330,7155,6074,851,103,6,64,0,0,0,0,2,2,7,7109,46,2175
4500,전라북도,4509,김제시,,관내사전투표,4069,4069,3525,441,50,2,27,0,0,0,0,0,0,5,4050,19,0
4500,전라북도,4509,김제시,,신풍동제1투,1076,603,484,98,11,1,4,0,0,0,0,0,0,0,598,5,473
4500,전라북도,4509,김제시,,신풍동제2투,1056,618,505,82,11,0,11,0,0,0,0,1,0,2,612,6,438
4500,전라북도,4509,김제시,,신풍동제3투,1406,810,677,101,10,2,10,0,0,0,0,1,1,0,802,8,596
4500,전라북도,4509,김제시,,신풍동제4투,981,589,484,79,18,0,8,0,0,0,0,0,0,0,589,0,392
4500,전라북도,4509,김제시,,신풍동제5투,742,466,399,50,3,1,4,0,0,0,0,0,1,0,458,8,276
4500,전라북도,4509,김제시,검산동,소계,8930,6977,5933,810,107,5,51,1,0,1,1,6,3,6,6924,53,1953
4500,전라북도,4509,김제시,,관내사전투표,4198,4198,3649,429,66,1,22,1,0,1,0,5,0,5,4179,19,0
4500,전라북도,4509,김제시,,검산동제1투,2504,1434,1159,217,23,3,16,0,0,0,1,0,0,1,1420,14,1070
4500,전라북도,4509,김제시,,검산동제2투,1034,620,516,77,7,0,4,0,0,0,0,1,2,0,607,13,414
4500,전라북도,4509,김제시,,검산동제3투,1194,725,609,87,11,1,9,0,0,0,0,0,1,0,718,7,469
4500,전라북도,4509,김제시,교월동,소계,5423,4301,3682,495,45,1,27,0,1,3,1,2,0,5,4262,39,1122
4500,전라북도,4509,김제시,,관내사전투표,2615,2615,2293,264,23,1,14,0,0,0,1,1,0,2,2599,16,0
4500,전라북도,4509,김제시,,교월동제1투,918,550,468,56,9,0,8,0,0,2,0,0,0,1,544,6,368
4500,전라북도,4509,김제시,,교월동제2투,838,504,405,79,4,0,4,0,1,1,0,0,0,1,495,9,334
4500,전라북도,4509,김제시,,교월동제3투,1052,632,516,96,9,0,1,0,0,0,0,1,0,1,624,8,420
4500,전라북도,4509,김제시,잘못 투입·구분된 투표지,,0,1,1,0,0,0,0,0,0,0,0,0,0,0,1,0,-1
4500,전라북도,4510,완주군,합계,,78117,63481,52862,8443,1063,24,412,24,7,9,18,52,16,79,63009,472,14636
4500,전라북도,4510,완주군,거소·선상투표,,292,278,197,38,7,0,5,1,1,0,0,0,0,1,250,28,14
4500,전라북도,4510,완주군,관외사전투표,,11085,11083,8885,1807,208,2,86,1,0,1,1,12,1,4,11008,75,2
4500,전라북도,4510,완주군,재외투표,,257,211,151,30,6,0,1,0,0,0,0,0,0,0,188,23,46
4500,전라북도,4510,완주군,삼례읍,소계,11285,8666,7367,1027,127,2,54,4,1,4,1,4,1,8,8600,66,2619
4500,전라북도,4510,완주군,,관내사전투표,4798,4798,4171,515,55,1,20,2,0,2,0,1,1,5,4773,25,0
4500,전라북도,4510,완주군,,삼례읍제1투,1811,1018,834,141,18,0,13,1,0,0,0,0,0,2,1009,9,793
4500,전라북도,4510,완주군,,삼례읍제2투,1522,944,775,128,25,0,6,1,0,0,1,1,0,0,937,7,578
4500,전라북도,4510,완주군,,삼례읍제3투,1587,933,776,116,13,1,8,0,0,1,0,1,0,1,917,16,654
4500,전라북도,4510,완주군,,삼례읍제4투,1567,973,811,127,16,0,7,0,1,1,0,1,0,0,964,9,594
4500,전라북도,4510,완주군,봉동읍,소계,18038,14010,11769,1754,254,8,114,9,2,0,2,7,3,8,13930,80,4028
4500,전라북도,4510,완주군,,관내사전투표,7079,7079,6122,759,97,3,51,3,1,0,1,4,2,4,7047,32,0
4500,전라북도,4510,완주군,,봉동읍제1투,1762,973,799,139,15,1,10,1,0,0,0,0,0,0,965,8,789
4500,전라북도,4510,완주군,,봉동읍제2투,2354,1428,1184,185,29,0,14,0,0,0,0,0,0,1,1413,15,926
4500,전라북도,4510,완주군,,봉동읍제3투,979,619,538,54,13,1,6,1,1,0,0,0,0,0,614,5,360
4500,전라북도,4510,완주군,,봉동읍제4투,1047,612,465,121,14,0,6,0,0,0,0,0,0,2,608,4,435
4500,전라북도,4510,완주군,,봉동읍제5투,2301,1662,1347,240,46,2,15,2,0,0,1,2,1,0,1656,6,639
4500,전라북도,4510,완주군,,봉동읍제6투,2516,1637,1314,256,40,1,12,2,0,0,0,1,0,1,1627,10,879
4500,전라북도,4510,완주군,용진읍,소계,5400,4177,3523,544,60,1,20,1,0,1,3,5,0,6,4164,13,1223
4500,전라북도,4510,완주군,,관내사전투표,1938,1938,1690,205,28,1,5,0,0,0,2,3,0,2,1936,2,0
4500,전라북도,4510,완주군,,용진읍제1투,697,460,386,61,5,0,3,1,0,1,1,1,0,1,460,0,237
4500,전라북도,4510,완주군,,용진읍제2투,865,620,517,92,3,0,5,0,0,0,0,0,0,1,618,2,245
4500,전라북도,4510,완주군,,용진읍제3투,797,533,439,82,6,0,3,0,0,0,0,0,0,1,531,2,264
4500,전라북도,4510,완주군,,용진읍제4투,1103,626,491,104,18,0,4,0,0,0,0,1,0,1,619,7,477
4500,전라북도,4510,완주군,상관면,소계,3214,2495,2099,312,42,2,15,1,0,0,1,4,1,3,2480,15,719
4500,전라북도,4510,완주군,,관내사전투표,1542,1542,1322,176,23,1,8,1,0,0,0,2,1,1,1535,7,0
4500,전라북도,4510,완주군,,상관면제1투,1284,713,567,115,16,1,4,0,0,0,1,1,0,2,707,6,571
4500,전라북도,4510,완주군,,상관면제2투,388,240,210,21,3,0,3,0,0,0,0,1,0,0,238,2,148
4500,전라북도,4510,완주군,이서면,소계,8762,6835,5648,942,140,3,37,0,0,0,3,8,1,7,6789,46,1927
4500,전라북도,4510,완주군,,관내사전투표,3209,3209,2774,367,38,2,11,0,0,0,0,4,0,2,3198,11,0
4500,전라북도,4510,완주군,,이서면제1투,1208,679,545,104,13,0,5,0,0,0,0,1,0,2,670,9,529
4500,전라북도,4510,완주군,,이서면제2투,1966,1309,1037,198,38,0,14,0,0,0,2,2,1,2,1294,15,657
4500,전라북도,4510,완주군,,이서면제3투,2379,1638,1292,273,51,1,7,0,0,0,1,1,0,1,1627,11,741
4500,전라북도,4510,완주군,소양면,소계,4748,3714,3199,409,40,2,22,1,1,1,2,2,2,8,3689,25,1034
4500,전라북도,4510,완주군,,관내사전투표,2252,2252,1992,210,18,1,9,1,0,1,1,1,2,2,2238,14,0
4500,전라북도,4510,완주군,,소양면제1투,597,338,276,48,6,0,4,0,0,0,0,0,0,2,336,2,259
4500,전라북도,4510,완주군,,소양면제2투,625,390,327,44,6,0,4,0,0,0,1,0,0,3,385,5,235
4500,전라북도,4510,완주군,,소양면제3투,590,313,256,44,5,1,4,0,0,0,0,1,0,0,311,2,277
4500,전라북도,4510,완주군,,소양면제4투,684,421,348,63,5,0,1,0,1,0,0,0,0,1,419,2,263
4500,전라북도,4510,완주군,구이면,소계,4449,3547,2978,469,44,0,16,1,0,0,0,2,1,10,3521,26,902
4500,전라북도,4510,완주군,,관내사전투표,2018,2018,1748,224,23,0,6,1,0,0,0,1,0,4,2007,11,0
4500,전라북도,4510,완주군,,구이면제1투,954,565,417,133,6,0,3,0,0,0,0,0,0,1,560,5,389
4500,전라북도,4510,완주군,,구이면제2투,808,538,468,52,10,0,2,0,0,0,0,1,1,1,535,3,270
4500,전라북도,4510,완주군,,구이면제3투,669,426,345,60,5,0,5,0,0,0,0,0,0,4,419,7,243
4500,전라북도,4510,완주군,고산면,소계,3906,3174,2749,312,49,2,13,2,0,0,3,3,1,7,3141,33,732
4500,전라북도,4510,완주군,,관내사전투표,2235,2235,1999,177,29,0,3,1,0,0,1,2,0,6,2218,17,0
4500,전라북도,4510,완주군,,고산면제1투,1143,608,481,85,16,2,7,0,0,0,1,1,1,0,594,14,535
4500,전라북도,4510,완주군,,고산면제2투,528,331,269,50,4,0,3,1,0,0,1,0,0,1,329,2,197
4500,전라북도,4510,완주군,비봉면,소계,1612,1323,1129,147,20,0,5,0,1,0,0,2,0,3,1307,16,289
4500,전라북도,4510,완주군,,관내사전투표,838,838,727,82,10,0,2,0,1,0,0,1,0,2,825,13,0
4500,전라북도,4510,완주군,,비봉면제1투,518,316,263,42,6,0,2,0,0,0,0,1,0,0,314,2,202
4500,전라북도,4510,완주군,,비봉면제2투,256,169,139,23,4,0,1,0,0,0,0,0,0,1,168,1,87
4500,전라북도,4510,완주군,운주면,소계,1522,1189,875,262,23,1,8,1,1,1,1,2,0,2,1177,12,333
4500,전라북도,4510,완주군,,관내사전투표,752,752,574,147,13,1,2,1,1,1,1,2,0,2,745,7,0
4500,전라북도,4510,완주군,,운주면투표소,770,437,301,115,10,0,6,0,0,0,0,0,0,0,432,5,333
4500,전라북도,4510,완주군,화산면,소계,1972,1503,1252,200,19,1,11,2,0,0,0,1,2,8,1496,7,469
4500,전라북도,4510,완주군,,관내사전투표,937,937,811,105,9,1,3,0,0,0,0,0,1,5,935,2,0
4500,전라북도,4510,완주군,,화산면투표소,1035,566,441,95,10,0,8,2,0,0,0,1,1,3,561,5,469
4500,전라북도,4510,완주군,동상면,소계,673,496,412,66,10,0,0,0,0,0,1,0,2,2,493,3,177
4500,전라북도,4510,완주군,,관내사전투표,318,318,270,43,4,0,0,0,0,0,0,0,0,0,317,1,0
4500,전라북도,4510,완주군,,동상면투표소,355,178,142,23,6,0,0,0,0,0,1,0,2,2,176,2,177
4500,전라북도,4510,완주군,경천면,소계,902,780,629,124,14,0,5,0,0,1,0,0,1,2,776,4,122
4500,전라북도,4510,완주군,,관내사전투표,587,587,490,88,6,0,1,0,0,0,0,0,1,0,586,1,0
4500,전라북도,4510,완주군,,경천면투표소,315,193,139,36,8,0,4,0,0,1,0,0,0,2,190,3,122
4500,전라북도,4510,완주군,잘못 투입·구분된 투표지,,0,0,0,0,0,0,0,0,0,0,0,0,0,0,0,0,0
4500,전라북도,4511,진안군,합계,,22568,18855,15637,2572,264,9,93,10,2,6,7,13,20,47,18680,175,3713
4500,전라북도,4511,진안군,거소·선상투표,,66,65,48,8,0,0,1,0,0,0,0,0,0,0,57,8,1
4500,전라북도,4511,진안군,관외사전투표,,3539,3539,2854,548,73,0,15,1,1,0,0,4,2,0,3498,41,0
4500,전라북도,4511,진안군,재외투표,,74,51,43,8,0,0,0,0,0,0,0,0,0,0,51,0,23
4500,전라북도,4511,진안군,진안읍,소계,7577,5955,4959,809,74,3,37,4,0,0,1,1,3,13,5904,51,1622
4500,전라북도,4511,진안군,,관내사전투표,3888,3888,3323,463,44,1,13,3,0,0,0,1,2,6,3856,32,0
4500,전라북도,4511,진안군,,진안읍제1투,1018,535,402,108,12,0,3,0,0,0,0,0,1,3,529,6,483
4500,전라북도,4511,진안군,,진안읍제2투,1410,880,696,143,14,0,16,1,0,0,1,0,0,1,872,8,530
4500,전라북도,4511,진안군,,진안읍제3투,1261,652,538,95,4,2,5,0,0,0,0,0,0,3,647,5,609
4500,전라북도,4511,진안군,용담면,소계,700,579,442,120,9,0,3,0,0,1,0,0,3,0,578,1,121
4500,전라북도,4511,진안군,,관내사전투표,376,376,307,61,6,0,0,0,0,0,0,0,1,0,375,1,0
4500,전라북도,4511,진안군,,용담면투표소,324,203,135,59,3,0,3,0,0,1,0,0,2,0,203,0,121
4500,전라북도,4511,진안군,안천면,소계,852,724,560,136,10,1,9,1,0,0,0,0,0,3,720,4,128
4500,전라북도,4511,진안군,,관내사전투표,449,449,361,72,6,0,7,1,0,0,0,0,0,0,447,2,0
4500,전라북도,4511,진안군,,안천면투표소,403,275,199,64,4,1,2,0,0,0,0,0,0,3,273,2,128
4500,전라북도,4511,진안군,동향면,소계,1053,904,790,81,11,1,4,1,0,0,0,1,0,2,891,13,149
4500,전라북도,4511,진안군,,관내사전투표,582,582,524,43,6,0,2,1,0,0,0,0,0,0,576,6,0
4500,전라북도,4511,진안군,,동향면투표소,471,322,266,38,5,1,2,0,0,0,0,1,0,2,315,7,149
4500,전라북도,4511,진안군,상전면,소계,613,509,436,58,5,0,2,0,0,0,0,0,3,1,505,4,104
4500,전라북도,4511,진안군,,관내사전투표,354,354,305,37,3,0,2,0,0,0,0,0,2,1,350,4,0
4500,전라북도,4511,진안군,,상전면투표소,259,155,131,21,2,0,0,0,0,0,0,0,1,0,155,0,104
4500,전라북도,4511,진안군,백운면,소계,1438,1152,988,125,10,1,6,0,1,1,0,1,2,3,1138,14,286
4500,전라북도,4511,진안군,,관내사전투표,862,862,759,73,7,0,5,0,1,1,0,1,1,2,850,12,0
4500,전라북도,4511,진안군,,백운면투표소,576,290,229,52,3,1,1,0,0,0,0,0,1,1,288,2,286
4500,전라북도,4511,진안군,성수면,소계,1244,999,853,104,11,2,3,1,0,0,1,3,4,9,991,8,245
4500,전라북도,4511,진안군,,관내사전투표,635,635,559,53,5,1,2,1,0,0,0,2,3,4,630,5,0
4500,전라북도,4511,진안군,,성수면투표소,609,364,294,51,6,1,1,0,0,0,1,1,1,5,361,3,245
4500,전라북도,4511,진안군,마령면,소계,1406,1134,976,126,15,0,2,0,0,1,0,1,1,3,1125,9,272
4500,전라북도,4511,진안군,,관내사전투표,674,674,599,61,7,0,0,0,0,1,0,0,1,2,671,3,0
4500,전라북도,4511,진안군,,마령면투표소,732,460,377,65,8,0,2,0,0,0,0,1,0,1,454,6,272
4500,전라북도,4511,진안군,부귀면,소계,1982,1587,1379,172,15,0,5,0,0,2,3,1,0,4,1581,6,395
4500,전라북도,4511,진안군,,관내사전투표,1028,1028,906,108,6,0,3,0,0,0,0,0,0,2,1025,3,0
4500,전라북도,4511,진안군,,부귀면투표소,954,559,473,64,9,0,2,0,0,2,3,1,0,2,556,3,395
4500,전라북도,4511,진안군,정천면,소계,798,655,559,74,10,0,1,0,0,0,0,0,1,4,649,6,143
4500,전라북도,4511,진안군,,관내사전투표,409,409,351,50,4,0,0,0,0,0,0,0,1,1,407,2,0
4500,전라북도,4511,진안군,,정천면투표소,389,246,208,24,6,0,1,0,0,0,0,0,0,3,242,4,143
4500,전라북도,4511,진안군,주천면,소계,1226,1002,750,203,21,1,5,2,0,1,2,1,1,5,992,10,224
4500,전라북도,4511,진안군,,관내사전투표,667,667,524,115,12,1,3,0,0,1,0,1,1,4,662,5,0
4500,전라북도,4511,진안군,,주천면투표소,559,335,226,88,9,0,2,2,0,0,2,0,0,1,330,5,224
4500,전라북도,4511,진안군,잘못 투입·구분된 투표지,,0,0,0,0,0,0,0,0,0,0,0,0,0,0,0,0,0
4500,전라북도,4512,무주군,합계,,21244,17429,13292,3426,313,14,135,7,3,3,5,14,13,43,17268,161,3815
4500,전라북도,4512,무주군,거소·선상투표,,125,118,80,20,3,0,2,0,0,0,0,0,0,0,105,13,7
4500,전라북도,4512,무주군,관외사전투표,,2085,2085,1456,533,44,2,25,0,0,0,1,3,2,2,2068,17,0
4500,전라북도,4512,무주군,재외투표,,78,56,42,12,0,0,0,0,0,0,0,1,0,0,55,1,22
4500,전라북도,4512,무주군,무주읍,소계,7392,5959,4599,1122,127,4,45,2,0,0,1,3,3,8,5914,45,1433
4500,전라북도,4512,무주군,,관내사전투표,3840,3840,3051,635,90,4,23,2,0,0,1,2,3,5,3816,24,0
4500,전라북도,4512,무주군,,무주읍제1투,1272,802,601,179,9,0,4,0,0,0,0,1,0,2,796,6,470
4500,전라북도,4512,무주군,,무주읍제2투,1374,783,571,177,19,0,7,0,0,0,0,0,0,0,774,9,591
4500,전라북도,4512,무주군,,무주읍제3투,906,534,376,131,9,0,11,0,0,0,0,0,0,1,528,6,372
4500,전라북도,4512,무주군,무풍면,소계,1833,1480,1056,365,28,0,9,1,0,0,0,1,3,7,1470,10,353
4500,전라북도,4512,무주군,,관내사전투표,872,872,646,197,11,0,5,0,0,0,0,0,3,3,865,7,0
4500,전라북도,4512,무주군,,무풍면제1투,816,489,322,142,15,0,2,1,0,0,0,1,0,3,486,3,327
4500,전라북도,4512,무주군,,무풍면제2투,145,119,88,26,2,0,2,0,0,0,0,0,0,1,119,0,26
4500,전라북도,4512,무주군,설천면,소계,3030,2431,1841,487,40,3,18,1,0,2,2,1,1,6,2402,29,599
4500,전라북도,4512,무주군,,관내사전투표,1363,1363,1035,280,18,3,9,1,0,1,0,0,0,1,1348,15,0
4500,전라북도,4512,무주군,,설천면제1투,922,550,408,111,10,0,3,0,0,1,1,1,1,3,539,11,372
4500,전라북도,4512,무주군,,설천면제2투,745,518,398,96,12,0,6,0,0,0,1,0,0,2,515,3,227
4500,전라북도,4512,무주군,적상면,소계,2145,1684,1280,344,21,1,12,1,2,0,0,1,0,6,1668,16,461
4500,전라북도,4512,무주군,,관내사전투표,840,840,661,157,7,1,5,0,2,0,0,1,0,2,836,4,0
4500,전라북도,4512,무주군,,적상면제1투,546,333,224,99,3,0,3,0,0,0,0,0,0,0,329,4,213
4500,전라북도,4512,무주군,,적상면제2투,267,185,141,35,3,0,1,1,0,0,0,0,0,0,181,4,82
4500,전라북도,4512,무주군,,적상면제3투,492,326,254,53,8,0,3,0,0,0,0,0,0,4,322,4,166
4500,전라북도,4512,무주군,안성면,소계,3414,2704,2244,366,39,4,20,2,0,0,1,4,1,7,2688,16,710
4500,전라북도,4512,무주군,,관내사전투표,1844,1844,1567,225,22,4,11,1,0,0,1,1,1,5,1838,6,0
4500,전라북도,4512,무주군,,안성면제1투,751,431,340,76,5,0,5,0,0,0,0,1,0,0,427,4,320
4500,전라북도,4512,무주군,,안성면제2투,819,429,337,65,12,0,4,1,0,0,0,2,0,2,423,6,390
4500,전라북도,4512,무주군,부남면,소계,1142,912,694,177,11,0,4,0,1,1,0,0,3,7,898,14,230
4500,전라북도,4512,무주군,,관내사전투표,632,632,496,115,7,0,1,0,0,1,0,0,1,3,624,8,0
4500,전라북도,4512,무주군,,부남면투표소,510,280,198,62,4,0,3,0,1,0,0,0,2,4,274,6,230
4500,전라북도,4512,무주군,잘못 투입·구분된 투표지,,0,0,0,0,0,0,0,0,0,0,0,0,0,0,0,0,0
4500,전라북도,4513,장수군,합계,,19371,16230,13564,2063,222,13,114,9,4,3,3,14,8,61,16078,152,3141
4500,전라북도,4513,장수군,거소·선상투표,,78,72,50,8,3,0,1,0,0,0,0,0,0,0,62,10,6
4500,전라북도,4513,장수군,관외사전투표,,2280,2280,1822,370,39,2,26,1,2,0,1,2,0,1,2266,14,0
4500,전라북도,4513,장수군,재외투표,,81,58,40,14,2,0,0,0,0,0,0,0,0,0,56,2,23
4500,전라북도,4513,장수군,장수읍,소계,5506,4542,3804,588,56,2,27,4,0,1,1,4,4,11,4502,40,964
4500,전라북도,4513,장수군,,관내사전투표,2789,2789,2403,299,38,1,10,4,0,1,1,1,3,6,2767,22,0
4500,전라북도,4513,장수군,,장수읍제1투,745,463,367,79,8,0,7,0,0,0,0,0,0,1,462,1,282
4500,전라북도,4513,장수군,,장수읍제2투,738,481,388,77,3,1,3,0,0,0,0,2,1,2,477,4,257
4500,전라북도,4513,장수군,,장수읍제3투,1234,809,646,133,7,0,7,0,0,0,0,1,0,2,796,13,425
4500,전라북도,4513,장수군,산서면,소계,1596,1344,1174,128,10,2,3,0,0,0,1,0,0,10,1328,16,252
4500,전라북도,4513,장수군,,관내사전투표,953,953,850,79,7,2,2,0,0,0,0,0,0,5,945,8,0
4500,전라북도,4513,장수군,,산서면투표소,643,391,324,49,3,0,1,0,0,0,1,0,0,5,383,8,252
4500,전라북도,4513,장수군,번암면,소계,1849,1484,1244,180,20,1,6,0,1,1,0,1,1,14,1469,15,365
4500,전라북도,4513,장수군,,관내사전투표,1056,1056,895,123,14,1,4,0,1,1,0,0,1,7,1047,9,0
4500,전라북도,4513,장수군,,번암면투표소,793,428,349,57,6,0,2,0,0,0,0,1,0,7,422,6,365
4500,전라북도,4513,장수군,장계면,소계,3447,2796,2347,347,37,3,26,3,0,1,0,2,0,7,2773,23,651
4500,전라북도,4513,장수군,,관내사전투표,1887,1887,1621,208,22,2,11,2,0,1,0,1,0,6,1874,13,0
4500,전라북도,4513,장수군,,장계면제1투,843,465,366,74,8,1,7,1,0,0,0,0,0,1,458,7,378
4500,전라북도,4513,장수군,,장계면제2투,717,444,360,65,7,0,8,0,0,0,0,1,0,0,441,3,273
4500,전라북도,4513,장수군,천천면,소계,1662,1303,1083,171,18,1,8,0,1,0,0,3,1,6,1292,11,359
4500,전라북도,4513,장수군,,관내사전투표,840,840,739,76,10,1,3,0,1,0,0,1,1,4,836,4,0
4500,전라북도,4513,장수군,,천천면투표소,822,463,344,95,8,0,5,0,0,0,0,2,0,2,456,7,359
4500,전라북도,4513,장수군,계남면,소계,1632,1332,1140,135,21,1,8,1,0,0,0,1,2,8,1317,15,300
4500,전라북도,4513,장수군,,관내사전투표,920,919,806,85,13,0,2,1,0,0,0,0,2,3,912,7,1
4500,전라북도,4513,장수군,,계남면투표소,712,413,334,50,8,1,6,0,0,0,0,1,0,5,405,8,299
4500,전라북도,4513,장수군,계북면,소계,1240,1019,860,122,16,1,9,0,0,0,0,1,0,4,1013,6,221
4500,전라북도,4513,장수군,,관내사전투표,680,680,591,69,8,1,4,0,0,0,0,0,0,4,677,3,0
4500,전라북도,4513,장수군,,계북면투표소,560,339,269,53,8,0,5,0,0,0,0,1,0,0,336,3,221
4500,전라북도,4513,장수군,잘못 투입·구분된 투표지,,0,0,0,0,0,0,0,0,0,0,0,0,0,0,0,0,0
4500,전라북도,4514,임실군,합계,,24186,20057,16930,2416,253,16,123,9,1,6,4,13,20,89,19880,177,4129
4500,전라북도,4514,임실군,거소·선상투표,,114,108,85,9,3,0,3,0,0,0,0,1,0,0,101,7,6
4500,전라북도,4514,임실군,관외사전투표,,3480,3479,2825,542,49,2,22,3,0,0,1,5,2,5,3456,23,1
4500,전라북도,4514,임실군,재외투표,,90,69,44,20,1,0,0,0,0,0,0,0,0,0,65,4,21
4500,전라북도,4514,임실군,임실읍,소계,5458,4382,3614,605,73,2,29,1,1,2,1,1,3,10,4342,40,1076
4500,전라북도,4514,임실군,,관내사전투표,2872,2872,2428,349,46,2,19,1,0,1,1,1,0,4,2852,20,0
4500,전라북도,4514,임실군,,임실읍제1투,1009,534,399,114,11,0,2,0,1,1,0,0,1,0,529,5,475
4500,전라북도,4514,임실군,,임실읍제2투,849,505,406,81,6,0,3,0,0,0,0,0,2,1,499,6,344
4500,전라북도,4514,임실군,,임실읍제3투,728,471,381,61,10,0,5,0,0,0,0,0,0,5,462,9,257
4500,전라북도,4514,임실군,청웅면,소계,1066,864,741,93,11,0,6,0,0,0,0,0,1,4,856,8,202
4500,전라북도,4514,임실군,,관내사전투표,601,601,528,54,9,0,3,0,0,0,0,0,0,3,597,4,0
4500,전라북도,4514,임실군,,청웅면투표소,465,263,213,39,2,0,3,0,0,0,0,0,1,1,259,4,202
4500,전라북도,4514,임실군,운암면,소계,1013,774,654,95,4,1,5,0,0,1,0,0,0,8,768,6,239
4500,전라북도,4514,임실군,,관내사전투표,268,268,235,27,1,1,0,0,0,0,0,0,0,1,265,3,0
4500,전라북도,4514,임실군,,운암면제1투,187,122,103,14,1,0,2,0,0,1,0,0,0,1,122,0,65
4500,전라북도,4514,임실군,,운암면제2투,202,144,126,13,1,0,0,0,0,0,0,0,0,2,142,2,58
4500,전라북도,4514,임실군,,운암면제3투,356,240,190,41,1,0,3,0,0,0,0,0,0,4,239,1,116
4500,전라북도,4514,임실군,신평면,소계,1002,781,648,96,10,2,5,1,0,0,0,0,1,7,770,11,221
4500,전라북도,4514,임실군,,관내사전투표,546,546,469,57,5,2,2,0,0,0,0,0,0,5,540,6,0
4500,전라북도,4514,임실군,,신평면투표소,456,235,179,39,5,0,3,1,0,0,0,0,1,2,230,5,221
4500,전라북도,4514,임실군,성수면,소계,1216,980,846,108,9,1,6,0,0,0,0,0,0,8,978,2,236
4500,전라북도,4514,임실군,,관내사전투표,584,584,521,51,4,1,3,0,0,0,0,0,0,4,584,0,0
4500,전라북도,4514,임실군,,성수면제1투,400,219,170,40,4,0,3,0,0,0,0,0,0,2,219,0,181
4500,전라북도,4514,임실군,,성수면제2투,232,177,155,17,1,0,0,0,0,0,0,0,0,2,175,2,55
4500,전라북도,4514,임실군,오수면,소계,2978,2406,2096,229,25,3,13,0,0,2,0,1,4,11,2384,22,572
4500,전라북도,4514,임실군,,관내사전투표,1746,1746,1552,141,19,2,7,0,0,2,0,1,2,8,1734,12,0
4500,전라북도,4514,임실군,,오수면제1투,653,359,303,41,2,1,4,0,0,0,0,0,1,2,354,5,294
4500,전라북도,4514,임실군,,오수면제2투,579,301,241,47,4,0,2,0,0,0,0,0,1,1,296,5,278
4500,전라북도,4514,임실군,신덕면,소계,901,698,609,64,3,0,3,1,0,1,0,0,1,8,690,8,203
4500,전라북도,4514,임실군,,관내사전투표,410,410,369,31,0,0,1,1,0,0,0,0,0,5,407,3,0
4500,전라북도,4514,임실군,,신덕면투표소,491,288,240,33,3,0,2,0,0,1,0,0,1,3,283,5,203
4500,전라북도,4514,임실군,삼계면,소계,1077,822,708,80,13,0,5,0,0,0,1,0,2,4,813,9,255
4500,전라북도,4514,임실군,,관내사전투표,513,511,442,50,8,0,3,0,0,0,1,0,2,2,508,3,2
4500,전라북도,4514,임실군,,삼계면투표소,564,311,266,30,5,0,2,0,0,0,0,0,0,2,305,6,253
4500,전라북도,4514,임실군,관촌면,소계,2771,2297,1993,238,15,4,13,2,0,0,0,2,3,11,2281,16,474
4500,전라북도,4514,임실군,,관내사전투표,1617,1617,1428,149,8,3,8,2,0,0,0,1,2,9,1610,7,0
4500,전라북도,4514,임실군,,관촌면제1투,762,450,372,60,6,1,2,0,0,0,0,0,1,2,444,6,312
4500,전라북도,4514,임실군,,관촌면제2투,392,230,193,29,1,0,3,0,0,0,0,1,0,0,227,3,162
4500,전라북도,4514,임실군,강진면,소계,1284,1019,866,115,20,0,6,0,0,0,0,1,1,4,1013,6,265
4500,전라북도,4514,임실군,,관내사전투표,691,691,600,76,6,0,4,0,0,0,0,1,1,2,690,1,0
4500,전라북도,4514,임실군,,강진면투표소,593,328,266,39,14,0,2,0,0,0,0,0,0,2,323,5,265
4500,전라북도,4514,임실군,덕치면,소계,861,672,583,64,6,1,2,0,0,0,0,1,2,5,664,8,189
4500,전라북도,4514,임실군,,관내사전투표,359,359,315,32,1,1,2,0,0,0,0,0,0,3,354,5,0
4500,전라북도,4514,임실군,,덕치면제1투,272,156,131,18,4,0,0,0,0,0,0,0,1,1,155,1,116
4500,전라북도,4514,임실군,,덕치면제2투,230,157,137,14,1,0,0,0,0,0,0,1,1,1,155,2,73
4500,전라북도,4514,임실군,지사면,소계,875,704,616,58,11,0,5,1,0,0,1,1,0,4,697,7,171
4500,전라북도,4514,임실군,,관내사전투표,466,466,419,32,6,0,3,1,0,0,1,0,0,1,463,3,0
4500,전라북도,4514,임실군,,지사면투표소,409,238,197,26,5,0,2,0,0,0,0,1,0,3,234,4,171
4500,전라북도,4514,임실군,잘못 투입·구분된 투표지,,0,2,2,0,0,0,0,0,0,0,0,0,0,0,2,0,-2
4500,전라북도,4515,순창군,합계,,23847,19879,16980,2211,230,12,106,14,3,4,7,38,20,62,19687,192,3968
4500,전라북도,4515,순창군,거소·선상투표,,139,125,99,15,1,1,3,0,0,0,0,0,0,0,119,6,14
4500,전라북도,4515,순창군,관외사전투표,,3038,3037,2456,478,43,2,26,2,1,0,0,5,2,3,3018,19,1
4500,전라북도,4515,순창군,재외투표,,97,68,42,19,0,0,2,0,0,0,0,2,0,0,65,3,29
4500,전라북도,4515,순창군,순창읍,소계,7130,5729,4922,621,77,2,39,3,0,0,2,10,4,6,5686,43,1401
4500,전라북도,4515,순창군,,관내사전투표,3414,3414,2985,325,51,0,14,1,0,0,1,8,3,4,3392,22,0
4500,전라북도,4515,순창군,,순창읍제1투,1077,650,558,66,11,1,8,2,0,0,0,1,1,0,648,2,427
4500,전라북도,4515,순창군,,순창읍제2투,1357,859,711,119,5,0,8,0,0,0,1,1,0,1,846,13,498
4500,전라북도,4515,순창군,,순창읍제3투,1282,806,668,111,10,1,9,0,0,0,0,0,0,1,800,6,476
4500,전라북도,4515,순창군,인계면,소계,1203,971,844,97,10,3,2,0,0,2,0,1,1,5,965,6,232
4500,전라북도,4515,순창군,,관내사전투표,693,693,606,70,7,3,2,0,0,0,0,0,1,1,690,3,0
4500,전라북도,4515,순창군,,인계면투표소,510,278,238,27,3,0,0,0,0,2,0,1,0,4,275,3,232
4500,전라북도,4515,순창군,동계면,소계,1533,1243,1058,132,17,0,3,3,0,0,1,0,3,6,1223,20,290
4500,전라북도,4515,순창군,,관내사전투표,883,883,768,86,13,0,2,1,0,0,1,0,1,3,875,8,0
4500,전라북도,4515,순창군,,동계면제1투,406,237,190,31,4,0,0,1,0,0,0,0,1,1,228,9,169
4500,전라북도,4515,순창군,,동계면제2투,244,123,100,15,0,0,1,1,0,0,0,0,1,2,120,3,121
4500,전라북도,4515,순창군,적성면,소계,1028,832,718,90,8,0,3,0,0,0,0,2,1,1,823,9,196
4500,전라북도,4515,순창군,,관내사전투표,610,610,534,58,7,0,3,0,0,0,0,1,1,0,604,6,0
4500,전라북도,4515,순창군,,적성면투표소,418,222,184,32,1,0,0,0,0,0,0,1,0,1,219,3,196
4500,전라북도,4515,순창군,유등면,소계,888,710,643,48,6,0,3,0,0,0,1,1,2,3,707,3,178
4500,전라북도,4515,순창군,,관내사전투표,452,452,412,26,5,0,2,0,0,0,1,0,2,2,450,2,0
4500,전라북도,4515,순창군,,유등면투표소,436,258,231,22,1,0,1,0,0,0,0,1,0,1,257,1,178
4500,전라북도,4515,순창군,풍산면,소계,1269,989,851,96,15,0,3,0,0,0,0,5,0,7,977,12,280
4500,전라북도,4515,순창군,,관내사전투표,564,564,494,47,8,0,1,0,0,0,0,4,0,4,558,6,0
4500,전라북도,4515,순창군,,풍산면제1투,309,172,144,21,3,0,0,0,0,0,0,0,0,1,169,3,137
4500,전라북도,4515,순창군,,풍산면제2투,396,253,213,28,4,0,2,0,0,0,0,1,0,2,250,3,143
4500,전라북도,4515,순창군,금과면,소계,1375,1135,972,125,7,1,6,1,0,0,0,0,1,7,1120,15,240
4500,전라북도,4515,순창군,,관내사전투표,771,771,671,75,4,1,1,1,0,0,0,0,1,6,760,11,0
4500,전라북도,4515,순창군,,금과면투표소,604,364,301,50,3,0,5,0,0,0,0,0,0,1,360,4,240
4500,전라북도,4515,순창군,팔덕면,소계,1188,966,852,85,8,1,4,1,0,0,0,1,1,3,956,10,222
4500,전라북도,4515,순창군,,관내사전투표,649,649,588,41,7,1,1,1,0,0,0,0,1,3,643,6,0
4500,전라북도,4515,순창군,,팔덕면투표소,539,317,264,44,1,0,3,0,0,0,0,1,0,0,313,4,222
4500,전라북도,4515,순창군,복흥면,소계,1642,1373,1191,137,12,1,6,0,0,1,2,1,1,9,1361,12,269
4500,전라북도,4515,순창군,,관내사전투표,819,819,722,78,7,1,2,0,0,0,1,1,0,3,815,4,0
4500,전라북도,4515,순창군,,복흥면제1투,502,310,267,27,3,0,3,0,0,1,0,0,0,3,304,6,192
4500,전라북도,4515,순창군,,복흥면제2투,321,244,202,32,2,0,1,0,0,0,1,0,1,3,242,2,77
4500,전라북도,4515,순창군,쌍치면,소계,1512,1243,1074,133,11,1,2,2,0,0,1,3,0,3,1230,13,269
4500,전라북도,4515,순창군,,관내사전투표,799,799,697,83,4,1,1,1,0,0,1,1,0,3,792,7,0
4500,전라북도,4515,순창군,,쌍치면제1투,392,223,191,24,4,0,1,0,0,0,0,1,0,0,221,2,169
4500,전라북도,4515,순창군,,쌍치면제2투,321,221,186,26,3,0,0,1,0,0,0,1,0,0,217,4,100
4500,전라북도,4515,순창군,구림면,소계,1805,1458,1258,135,15,0,4,2,2,1,0,7,4,9,1437,21,347
4500,전라북도,4515,순창군,,관내사전투표,946,946,827,86,10,0,1,1,2,0,0,1,1,6,935,11,0
4500,전라북도,4515,순창군,,구림면제1투,564,317,267,28,4,0,2,1,0,1,0,2,3,2,310,7,247
4500,전라북도,4515,순창군,,구림면제2투,295,195,164,21,1,0,1,0,0,0,0,4,0,1,192,3,100
4500,전라북도,4515,순창군,잘못 투입·구분된 투표지,,0,0,0,0,0,0,0,0,0,0,0,0,0,0,0,0,0
4500,전라북도,4516,고창군,합계,,47655,38707,33000,4335,518,15,208,22,8,13,10,40,27,135,38331,376,8948
4500,전라북도,4516,고창군,거소·선상투표,,309,295,212,36,3,1,2,3,0,0,1,0,0,2,260,35,14
4500,전라북도,4516,고창군,관외사전투표,,4600,4600,3620,788,88,5,43,1,1,2,1,5,1,5,4560,40,0
4500,전라북도,4516,고창군,재외투표,,138,112,78,20,3,0,2,0,0,0,0,0,0,0,103,9,26
4500,전라북도,4516,고창군,고창읍,소계,14757,11511,9807,1377,171,1,56,4,2,4,2,7,1,9,11441,70,3246
4500,전라북도,4516,고창군,,관내사전투표,6420,6420,5578,693,85,1,26,2,0,2,2,2,0,5,6396,24,0
4500,전라북도,4516,고창군,,고창읍제1투,959,566,459,91,12,0,0,0,0,0,0,0,0,1,563,3,393
4500,전라북도,4516,고창군,,고창읍제2투,1190,734,611,101,14,0,2,0,1,0,0,0,0,1,730,4,456
4500,전라북도,4516,고창군,,고창읍제3투,1218,766,637,107,11,0,5,0,0,1,0,0,1,0,762,4,452
4500,전라북도,4516,고창군,,고창읍제4투,957,570,471,69,10,0,4,0,0,0,0,2,0,2,558,12,387
4500,전라북도,4516,고창군,,고창읍제5투,874,489,367,99,9,0,5,0,0,0,0,0,0,0,480,9,385
4500,전라북도,4516,고창군,,고창읍제6투,1235,796,671,100,12,0,3,1,1,0,0,1,0,0,789,7,439
4500,전라북도,4516,고창군,,고창읍제7투,1904,1170,1013,117,18,0,11,1,0,1,0,2,0,0,1163,7,734
4500,전라북도,4516,고창군,고수면,소계,2340,1924,1663,180,27,3,21,3,0,0,0,5,1,6,1909,15,416
4500,전라북도,4516,고창군,,관내사전투표,1383,1383,1216,120,17,2,12,3,0,0,0,2,1,4,1377,6,0
4500,전라북도,4516,고창군,,고수면투표소,957,541,447,60,10,1,9,0,0,0,0,3,0,2,532,9,416
4500,전라북도,4516,고창군,아산면,소계,2344,1933,1652,214,24,0,8,1,1,2,2,4,2,9,1919,14,411
4500,전라북도,4516,고창군,,관내사전투표,1264,1264,1105,128,11,0,2,1,1,1,1,2,2,4,1258,6,0
4500,전라북도,4516,고창군,,아산면제1투,669,385,324,45,7,0,3,0,0,1,0,0,0,1,381,4,284
4500,전라북도,4516,고창군,,아산면제2투,411,284,223,41,6,0,3,0,0,0,1,2,0,4,280,4,127
4500,전라북도,4516,고창군,무장면,소계,2258,1765,1531,169,22,0,13,1,0,1,1,1,3,10,1752,13,493
4500,전라북도,4516,고창군,,관내사전투표,1108,1108,979,93,14,0,8,1,0,0,0,0,2,4,1101,7,0
4500,전라북도,4516,고창군,,무장면투표소,1150,657,552,76,8,0,5,0,0,1,1,1,1,6,651,6,493
4500,전라북도,4516,고창군,공음면,소계,2058,1630,1434,133,16,1,5,2,0,0,2,2,1,9,1605,25,428
4500,전라북도,4516,고창군,,관내사전투표,1047,1046,932,77,7,1,1,2,0,0,2,2,0,6,1030,16,1
4500,전라북도,4516,고창군,,공음면제1투,556,301,265,24,7,0,0,0,0,0,0,0,0,2,298,3,255
4500,전라북도,4516,고창군,,공음면제2투,455,283,237,32,2,0,4,0,0,0,0,0,1,1,277,6,172
4500,전라북도,4516,고창군,상하면,소계,1956,1566,1400,110,15,0,6,2,0,2,0,2,3,12,1552,14,390
4500,전라북도,4516,고창군,,관내사전투표,997,997,900,60,12,0,2,2,0,1,0,1,1,8,987,10,0
4500,전라북도,4516,고창군,,상하면투표소,959,569,500,50,3,0,4,0,0,1,0,1,2,4,565,4,390
4500,전라북도,4516,고창군,해리면,소계,2330,1823,1559,201,20,0,4,1,0,0,0,1,6,14,1806,17,507
4500,전라북도,4516,고창군,,관내사전투표,1229,1229,1063,130,11,0,4,1,0,0,0,0,5,6,1220,9,0
4500,전라북도,4516,고창군,,해리면제1투,620,314,270,28,5,0,0,0,0,0,0,0,1,4,308,6,306
4500,전라북도,4516,고창군,,해리면제2투,481,280,226,43,4,0,0,0,0,0,0,1,0,4,278,2,201
4500,전라북도,4516,고창군,성송면,소계,1510,1203,1051,120,13,0,3,0,0,1,0,1,0,3,1192,11,307
4500,전라북도,4516,고창군,,관내사전투표,739,739,653,66,8,0,2,0,0,1,0,1,0,0,731,8,0
4500,전라북도,4516,고창군,,성송면제1투,414,254,217,29,4,0,1,0,0,0,0,0,0,1,252,2,160
4500,전라북도,4516,고창군,,성송면제2투,357,210,181,25,1,0,0,0,0,0,0,0,0,2,209,1,147
4500,전라북도,4516,고창군,대산면,소계,2733,2175,1932,155,27,0,14,0,1,0,0,0,2,15,2146,29,558
4500,전라북도,4516,고창군,,관내사전투표,1404,1404,1270,86,13,0,4,0,0,0,0,0,2,11,1386,18,0
4500,전라북도,4516,고창군,,대산면제1투,767,428,364,42,10,0,4,0,1,0,0,0,0,1,422,6,339
4500,전라북도,4516,고창군,,대산면제2투,562,343,298,27,4,0,6,0,0,0,0,0,0,3,338,5,219
4500,전라북도,4516,고창군,심원면,소계,2084,1681,1463,165,20,1,8,2,2,0,0,0,1,6,1668,13,403
4500,전라북도,4516,고창군,,관내사전투표,1100,1100,983,91,12,1,2,1,1,0,0,0,0,1,1092,8,0
4500,전라북도,4516,고창군,,심원면투표소,984,581,480,74,8,0,6,1,1,0,0,0,1,5,576,5,403
4500,전라북도,4516,고창군,흥덕면,소계,2668,2107,1795,241,26,0,10,0,0,0,1,1,0,11,2085,22,561
4500,전라북도,4516,고창군,,관내사전투표,1317,1317,1148,138,17,0,2,0,0,0,0,0,0,7,1312,5,0
4500,전라북도,4516,고창군,,흥덕면제1투,750,441,368,49,6,0,5,0,0,0,1,1,0,1,431,10,309
4500,전라북도,4516,고창군,,흥덕면제2투,601,349,279,54,3,0,3,0,0,0,0,0,0,3,342,7,252
4500,전라북도,4516,고창군,성내면,소계,1557,1212,1016,155,10,1,1,0,1,0,0,7,0,7,1198,14,345
4500,전라북도,4516,고창군,,관내사전투표,803,803,699,87,5,1,0,0,1,0,0,2,0,4,799,4,0
4500,전라북도,4516,고창군,,성내면투표소,754,409,317,68,5,0,1,0,0,0,0,5,0,3,399,10,345
4500,전라북도,4516,고창군,신림면,소계,1795,1423,1281,103,12,1,3,0,0,0,0,2,3,4,1409,14,372
4500,전라북도,4516,고창군,,관내사전투표,974,974,899,54,9,1,0,0,0,0,0,2,2,1,968,6,0
4500,전라북도,4516,고창군,,신림면투표소,821,449,382,49,3,0,3,0,0,0,0,0,1,3,441,8,372
4500,전라북도,4516,고창군,부안면,소계,2218,1747,1506,168,21,1,9,2,0,1,0,2,3,13,1726,21,471
4500,전라북도,4516,고창군,,관내사전투표,1095,1095,966,92,8,1,4,1,0,1,0,1,2,6,1082,13,0
4500,전라북도,4516,고창군,,부안면제1투,608,338,277,42,8,0,4,1,0,0,0,0,0,2,334,4,270
4500,전라북도,4516,고창군,,부안면제2투,515,314,263,34,5,0,1,0,0,0,0,1,1,5,310,4,201
4500,전라북도,4516,고창군,잘못 투입·구분된 투표지,,0,0,0,0,0,0,0,0,0,0,0,0,0,0,0,0,0
4500,전라북도,4517,부안군,합계,,45702,36856,31037,4572,467,14,227,14,5,9,17,28,21,113,36524,332,8846
4500,전라북도,4517,부안군,거소·선상투표,,156,138,94,20,2,0,2,0,1,0,0,2,1,0,122,16,18
4500,전라북도,4517,부안군,관외사전투표,,4748,4745,3742,822,82,1,48,0,0,0,0,1,1,4,4701,44,3
4500,전라북도,4517,부안군,재외투표,,136,92,71,13,1,0,1,0,0,0,0,0,0,0,86,6,44
4500,전라북도,4517,부안군,부안읍,소계,14652,11252,9530,1382,153,3,72,2,2,3,7,11,4,15,11184,68,3400
4500,전라북도,4517,부안군,,관내사전투표,6698,6698,5774,741,90,3,36,1,2,3,1,6,0,6,6663,35,0
4500,전라북도,4517,부안군,,부안읍제1투,568,292,235,49,3,0,4,0,0,0,1,0,0,0,292,0,276
4500,전라북도,4517,부안군,,부안읍제2투,642,369,289,68,3,0,6,0,0,0,2,0,1,0,369,0,273
4500,전라북도,4517,부안군,,부안읍제3투,1219,697,576,94,9,0,8,0,0,0,0,3,0,2,692,5,522
4500,전라북도,4517,부안군,,부안읍제4투,1015,518,425,75,4,0,4,1,0,0,2,0,0,2,513,5,497
4500,전라북도,4517,부안군,,부안읍제5투,2102,1284,1083,170,17,0,2,0,0,0,1,1,0,1,1275,9,818
4500,전라북도,4517,부안군,,부안읍제6투,1794,989,804,149,17,0,11,0,0,0,0,1,0,0,982,7,805
4500,전라북도,4517,부안군,,부안읍제7투,614,405,344,36,10,0,1,0,0,0,0,0,3,4,398,7,209
4500,전라북도,4517,부안군,주산면,소계,1653,1285,1087,149,14,1,5,2,0,1,1,1,5,6,1272,13,368
4500,전라북도,4517,부안군,,관내사전투표,797,797,682,95,6,1,1,1,0,1,1,0,2,3,793,4,0
4500,전라북도,4517,부안군,,주산면투표소,856,488,405,54,8,0,4,1,0,0,0,1,3,3,479,9,368
4500,전라북도,4517,부안군,동진면,소계,2271,1757,1484,207,21,1,7,2,0,0,2,0,2,15,1741,16,514
4500,전라북도,4517,부안군,,관내사전투표,1081,1081,923,124,12,1,3,2,0,0,1,0,1,8,1075,6,0
4500,전라북도,4517,부안군,,동진면제1투,482,245,203,26,4,0,3,0,0,0,1,0,0,2,239,6,237
4500,전라북도,4517,부안군,,동진면제2투,304,176,138,29,3,0,1,0,0,0,0,0,1,2,174,2,128
4500,전라북도,4517,부안군,,동진면제3투,404,255,220,28,2,0,0,0,0,0,0,0,0,3,253,2,149
4500,전라북도,4517,부안군,행안면,소계,2921,2509,2154,264,42,1,18,2,0,1,1,1,0,4,2488,21,412
4500,전라북도,4517,부안군,,관내사전투표,2001,2001,1756,177,33,1,15,2,0,0,1,1,0,1,1987,14,0
4500,전라북도,4517,부안군,,행안면투표소,920,508,398,87,9,0,3,0,0,1,0,0,0,3,501,7,412
4500,전라북도,4517,부안군,계화면,소계,2713,2131,1863,200,26,1,12,0,1,1,1,1,2,8,2116,15,582
4500,전라북도,4517,부안군,,관내사전투표,1175,1175,1050,92,17,1,6,0,1,0,1,0,0,0,1168,7,0
4500,전라북도,4517,부안군,,계화면제1투,790,418,338,61,5,0,4,0,0,0,0,1,2,2,413,5,372
4500,전라북도,4517,부안군,,계화면제2투,437,306,278,22,1,0,0,0,0,0,0,0,0,4,305,1,131
4500,전라북도,4517,부안군,,계화면제3투,311,232,197,25,3,0,2,0,0,1,0,0,0,2,230,2,79
4500,전라북도,4517,부안군,보안면,소계,1947,1523,1286,195,15,0,5,0,0,1,1,1,0,6,1510,13,424
4500,전라북도,4517,부안군,,관내사전투표,1043,1043,892,129,11,0,2,0,0,0,1,1,0,3,1039,4,0
4500,전라북도,4517,부안군,,보안면투표소,904,480,394,66,4,0,3,0,0,1,0,0,0,3,471,9,424
4500,전라북도,4517,부안군,변산면,소계,3521,2753,2324,349,27,2,13,0,0,0,0,2,1,9,2727,26,768
4500,전라북도,4517,부안군,,관내사전투표,1537,1537,1311,186,14,2,6,0,0,0,0,1,0,5,1525,12,0
4500,전라북도,4517,부안군,,변산면제1투,768,425,325,83,5,0,3,0,0,0,0,0,0,4,420,5,343
4500,전라북도,4517,부안군,,변산면제2투,1216,791,688,80,8,0,4,0,0,0,0,1,1,0,782,9,425
4500,전라북도,4517,부안군,진서면,소계,1899,1523,1305,168,9,0,6,0,1,0,1,3,1,10,1504,19,376
4500,전라북도,4517,부안군,,관내사전투표,1029,1029,894,102,7,0,4,0,1,0,1,3,1,4,1017,12,0
4500,전라북도,4517,부안군,,진서면투표소,870,494,411,66,2,0,2,0,0,0,0,0,0,6,487,7,376
4500,전라북도,4517,부안군,백산면,소계,2113,1667,1426,191,14,2,5,0,0,0,1,1,1,10,1651,16,446
4500,전라북도,4517,부안군,,관내사전투표,1161,1161,1001,131,9,2,4,0,0,0,0,1,1,5,1154,7,0
4500,전라북도,4517,부안군,,백산면투표소,952,506,425,60,5,0,1,0,0,0,1,0,0,5,497,9,446
4500,전라북도,4517,부안군,상서면,소계,1722,1339,1125,165,14,1,13,0,0,0,0,0,0,7,1325,14,383
4500,전라북도,4517,부안군,,관내사전투표,993,993,829,129,11,1,9,0,0,0,0,0,0,4,983,10,0
4500,전라북도,4517,부안군,,상서면투표소,729,346,296,36,3,0,4,0,0,0,0,0,0,3,342,4,383
4500,전라북도,4517,부안군,하서면,소계,2249,1768,1513,194,23,1,8,2,0,0,1,3,0,9,1754,14,481
4500,전라북도,4517,부안군,,관내사전투표,1247,1247,1081,125,17,1,5,2,0,0,0,2,0,5,1238,9,0
4500,전라북도,4517,부안군,,하서면투표소,1002,521,432,69,6,0,3,0,0,0,1,1,0,4,516,5,481
4500,전라북도,4517,부안군,줄포면,소계,2211,1757,1505,193,17,0,9,3,0,0,1,0,2,6,1736,21,454
4500,전라북도,4517,부안군,,관내사전투표,1209,1209,1053,124,7,0,3,2,0,0,0,0,2,5,1196,13,0
4500,전라북도,4517,부안군,,줄포면투표소,1002,548,452,69,10,0,6,1,0,0,1,0,0,1,540,8,454
4500,전라북도,4517,부안군,위도면,소계,790,616,527,60,7,0,3,1,0,2,0,1,1,4,606,10,174
4500,전라북도,4517,부안군,,관내사전투표,404,404,341,40,6,0,1,1,0,2,0,1,1,3,396,8,0
4500,전라북도,4517,부안군,,위도면제1투,278,128,103,19,1,0,2,0,0,0,0,0,0,1,126,2,150
4500,전라북도,4517,부안군,,위도면제2투,108,84,83,1,0,0,0,0,0,0,0,0,0,0,84,0,24
4500,전라북도,4517,부안군,잘못 투입·구분된 투표지,,0,1,1,0,0,0,0,0,0,0,0,0,0,0,1,0,-14600,전라남도,4601,목포시,합계,,183659,145187,125790,14936,2021,69,997,45,14,19,20,156,24,98,144189,998,38472
4600,전라남도,4601,목포시,거소·선상투표,,842,779,546,121,16,2,29,0,0,1,0,1,0,0,716,63,63
4600,전라남도,4601,목포시,관외사전투표,,14999,14996,11909,2365,287,10,202,11,3,2,1,29,4,14,14837,159,3
4600,전라남도,4601,목포시,재외투표,,469,347,256,53,6,0,1,0,0,0,0,0,0,0,316,31,122
4600,전라남도,4601,목포시,용당1동,소계,8488,6365,5609,571,83,5,38,1,0,0,2,10,1,7,6327,38,2123
4600,전라남도,4601,목포시,,관내사전투표,3981,3981,3599,291,40,2,13,0,0,0,2,7,1,3,3958,23,0
4600,전라남도,4601,목포시,,용당1동제1투,1245,691,579,82,11,0,9,0,0,0,0,1,0,2,684,7,554
4600,전라남도,4601,목포시,,용당1동제2투,977,447,381,47,10,0,5,0,0,0,0,0,0,1,444,3,530
4600,전라남도,4601,목포시,,용당1동제3투,1147,668,573,73,13,1,5,1,0,0,0,0,0,0,666,2,479
4600,전라남도,4601,목포시,,용당1동제4투,1138,578,477,78,9,2,6,0,0,0,0,2,0,1,575,3,560
4600,전라남도,4601,목포시,용당2동,소계,4608,3585,3158,341,35,1,21,0,0,1,1,3,2,1,3564,21,1023
4600,전라남도,4601,목포시,,관내사전투표,2523,2523,2255,210,21,1,14,0,0,0,1,3,1,1,2507,16,0
4600,전라남도,4601,목포시,,용당2동제1투,1226,616,515,82,11,0,2,0,0,1,0,0,1,0,612,4,610
4600,전라남도,4601,목포시,,용당2동제2투,859,446,388,49,3,0,5,0,0,0,0,0,0,0,445,1,413
4600,전라남도,4601,목포시,연동,소계,3902,2834,2510,255,27,3,8,1,1,0,1,2,0,6,2814,20,1068
4600,전라남도,4601,목포시,,관내사전투표,1843,1843,1661,144,15,2,3,1,0,0,0,2,0,4,1832,11,0
4600,전라남도,4601,목포시,,연동제1투,933,401,336,53,5,0,2,0,0,0,1,0,0,0,397,4,532
4600,전라남도,4601,목포시,,연동제2투,1126,590,513,58,7,1,3,0,1,0,0,0,0,2,585,5,536
4600,전라남도,4601,목포시,산정동,소계,6990,5510,4799,539,89,2,30,1,1,0,0,11,1,4,5477,33,1480
4600,전라남도,4601,목포시,,관내사전투표,3510,3510,3127,288,59,2,12,1,0,0,0,6,1,2,3498,12,0
4600,전라남도,4601,목포시,,산정동제1투,1716,884,720,128,13,0,7,0,1,0,0,2,0,1,872,12,832
4600,전라남도,4601,목포시,,산정동제2투,1764,1116,952,123,17,0,11,0,0,0,0,3,0,1,1107,9,648
4600,전라남도,4601,목포시,연산동,소계,6538,5015,4415,436,88,1,32,0,1,0,0,2,0,3,4978,37,1523
4600,전라남도,4601,목포시,,관내사전투표,2919,2919,2634,205,36,1,17,0,1,0,0,1,0,3,2898,21,0
4600,전라남도,4601,목포시,,연산동제1투,1617,1025,875,103,33,0,8,0,0,0,0,0,0,0,1019,6,592
4600,전라남도,4601,목포시,,연산동제2투,2002,1071,906,128,19,0,7,0,0,0,0,1,0,0,1061,10,931
4600,전라남도,4601,목포시,원산동,소계,9480,7109,6306,605,98,3,46,4,0,0,2,5,0,2,7071,38,2371
4600,전라남도,4601,목포시,,관내사전투표,4190,4190,3782,304,55,1,24,3,0,0,2,4,0,2,4177,13,0
4600,전라남도,4601,목포시,,원산동제1투,941,452,396,42,8,0,3,0,0,0,0,0,0,0,449,3,489
4600,전라남도,4601,목포시,,원산동제2투,1377,773,655,92,12,0,6,0,0,0,0,1,0,0,766,7,604
4600,전라남도,4601,목포시,,원산동제3투,1654,911,790,96,9,1,7,0,0,0,0,0,0,0,903,8,743
4600,전라남도,4601,목포시,,원산동제4투,1318,783,683,71,14,1,6,1,0,0,0,0,0,0,776,7,535
4600,전라남도,4601,목포시,대성동,소계,4139,3292,2885,324,40,1,15,0,0,0,1,8,1,2,3277,15,847
4600,전라남도,4601,목포시,,관내사전투표,2327,2327,2090,194,19,0,3,0,0,0,1,6,1,2,2316,11,0
4600,전라남도,4601,목포시,,대성동투표소,1812,965,795,130,21,1,12,0,0,0,0,2,0,0,961,4,847
4600,전라남도,4601,목포시,목원동,소계,6299,4592,3948,505,69,3,25,1,0,1,1,2,2,4,4561,31,1707
4600,전라남도,4601,목포시,,관내사전투표,2951,2951,2579,298,39,2,14,0,0,0,1,1,0,3,2937,14,0
4600,전라남도,4601,목포시,,목원동제1투,1094,613,529,63,10,0,3,0,0,0,0,1,0,0,606,7,481
4600,전라남도,4601,목포시,,목원동제2투,1154,518,421,75,8,0,5,1,0,0,0,0,2,1,513,5,636
4600,전라남도,4601,목포시,,목원동제3투,1100,510,419,69,12,1,3,0,0,1,0,0,0,0,505,5,590
4600,전라남도,4601,목포시,동명동,소계,4346,3270,2930,269,26,0,21,1,1,1,1,2,0,6,3258,12,1076
4600,전라남도,4601,목포시,,관내사전투표,2302,2302,2105,157,12,0,13,1,1,1,1,1,0,6,2298,4,0
4600,전라남도,4601,목포시,,동명동제1투,1184,595,503,77,7,0,4,0,0,0,0,0,0,0,591,4,589
4600,전라남도,4601,목포시,,동명동제2투,860,373,322,35,7,0,4,0,0,0,0,1,0,0,369,4,487
4600,전라남도,4601,목포시,삼학동,소계,5448,4461,4009,355,43,0,24,0,0,1,0,5,0,0,4437,24,987
4600,전라남도,4601,목포시,,관내사전투표,3235,3235,2965,217,31,0,6,0,0,1,0,4,0,0,3224,11,0
4600,전라남도,4601,목포시,,삼학동제1투,1244,668,559,90,5,0,4,0,0,0,0,1,0,0,659,9,576
4600,전라남도,4601,목포시,,삼학동제2투,969,558,485,48,7,0,14,0,0,0,0,0,0,0,554,4,411
4600,전라남도,4601,목포시,만호동,소계,2481,1774,1603,133,11,0,11,0,0,0,0,3,1,2,1764,10,707
4600,전라남도,4601,목포시,,관내사전투표,1314,1314,1193,98,6,0,6,0,0,0,0,3,1,1,1308,6,0
4600,전라남도,4601,목포시,,만호동투표소,1167,460,410,35,5,0,5,0,0,0,0,0,0,1,456,4,707
4600,전라남도,4601,목포시,유달동,소계,3826,2940,2609,252,27,1,10,3,1,1,2,0,3,8,2917,23,886
4600,전라남도,4601,목포시,,관내사전투표,2027,2027,1826,152,16,1,5,3,1,1,1,0,0,5,2011,16,0
4600,전라남도,4601,목포시,,유달동제1투,665,302,256,33,5,0,1,0,0,0,1,0,0,1,297,5,363
4600,전라남도,4601,목포시,,유달동제2투,712,339,300,30,5,0,1,0,0,0,0,0,1,1,338,1,373
4600,전라남도,4601,목포시,,유달동제3투,187,112,88,20,1,0,2,0,0,0,0,0,1,0,112,0,75
4600,전라남도,4601,목포시,,유달동제4투,111,77,63,13,0,0,1,0,0,0,0,0,0,0,77,0,34
4600,전라남도,4601,목포시,,유달동제5투,124,83,76,4,0,0,0,0,0,0,0,0,1,1,82,1,41
4600,전라남도,4601,목포시,죽교동,소계,2785,2093,1822,209,25,1,12,1,0,0,1,2,0,3,2076,17,692
4600,전라남도,4601,목포시,,관내사전투표,1423,1423,1273,118,16,1,4,0,0,0,0,2,0,2,1416,7,0
4600,전라남도,4601,목포시,,죽교동제1투,560,291,245,32,3,0,3,1,0,0,1,0,0,1,286,5,269
4600,전라남도,4601,목포시,,죽교동제2투,802,379,304,59,6,0,5,0,0,0,0,0,0,0,374,5,423
4600,전라남도,4601,목포시,북항동,소계,7380,5648,4955,544,68,0,39,0,1,0,2,4,0,5,5618,30,1732
4600,전라남도,4601,목포시,,관내사전투표,3432,3431,3083,287,33,0,11,0,0,0,1,2,0,2,3419,12,1
4600,전라남도,4601,목포시,,북항동제1투,2152,1240,1059,133,25,0,10,0,0,0,1,0,0,3,1231,9,912
4600,전라남도,4601,목포시,,북항동제2투,947,501,408,69,4,0,16,0,1,0,0,1,0,0,499,2,446
4600,전라남도,4601,목포시,,북항동제3투,849,476,405,55,6,0,2,0,0,0,0,1,0,0,469,7,373
4600,전라남도,4601,목포시,용해동,소계,12340,9507,8490,761,130,8,55,1,1,0,0,5,0,3,9454,53,2833
4600,전라남도,4601,목포시,,관내사전투표,5855,5855,5302,423,72,4,25,0,1,0,0,3,0,2,5832,23,0
4600,전라남도,4601,목포시,,용해동제1투,1475,769,637,103,8,1,11,0,0,0,0,0,0,0,760,9,706
4600,전라남도,4601,목포시,,용해동제2투,1546,870,766,71,19,0,9,0,0,0,0,0,0,0,865,5,676
4600,전라남도,4601,목포시,,용해동제3투,1772,936,813,93,14,1,3,1,0,0,0,1,0,0,926,10,836
4600,전라남도,4601,목포시,,용해동제4투,1692,1077,972,71,17,2,7,0,0,0,0,1,0,1,1071,6,615
4600,전라남도,4601,목포시,이로동,소계,7595,6063,5294,619,80,1,29,2,0,3,0,7,0,2,6037,26,1532
4600,전라남도,4601,목포시,,관내사전투표,3544,3544,3168,296,44,0,14,2,0,1,0,5,0,1,3531,13,0
4600,전라남도,4601,목포시,,이로동제1투,956,536,446,77,6,0,3,0,0,2,0,0,0,1,535,1,420
4600,전라남도,4601,목포시,,이로동제2투,1421,852,715,112,12,0,5,0,0,0,0,1,0,0,845,7,569
4600,전라남도,4601,목포시,,이로동제3투,1674,1131,965,134,18,1,7,0,0,0,0,1,0,0,1126,5,543
4600,전라남도,4601,목포시,상동,소계,13699,10291,9035,968,134,5,63,3,0,5,0,10,2,8,10233,58,3408
4600,전라남도,4601,목포시,,관내사전투표,5130,5130,4611,416,50,1,15,3,0,2,0,3,1,5,5107,23,0
4600,전라남도,4601,목포시,,상동제1투,1340,687,578,73,12,1,11,0,0,1,0,2,0,3,681,6,653
4600,전라남도,4601,목포시,,상동제2투,1144,487,400,60,7,3,8,0,0,0,0,1,1,0,480,7,657
4600,전라남도,4601,목포시,,상동제3투,1669,1160,1004,121,16,0,9,0,0,0,0,3,0,0,1153,7,509
4600,전라남도,4601,목포시,,상동제4투,2682,1747,1514,182,30,0,11,0,0,2,0,1,0,0,1740,7,935
4600,전라남도,4601,목포시,,상동제5투,1734,1080,928,116,19,0,9,0,0,0,0,0,0,0,1072,8,654
4600,전라남도,4601,목포시,하당동,소계,9628,7072,6144,702,88,5,62,3,1,0,2,10,0,3,7020,52,2556
4600,전라남도,4601,목포시,,관내사전투표,4327,4326,3856,359,45,3,24,1,1,0,0,7,0,2,4298,28,1
4600,전라남도,4601,목포시,,하당동제1투,1527,655,554,70,17,0,9,2,0,0,0,1,0,0,653,2,872
4600,전라남도,4601,목포시,,하당동제2투,2052,888,692,145,15,0,21,0,0,0,2,0,0,1,876,12,1164
4600,전라남도,4601,목포시,,하당동제3투,1722,1203,1042,128,11,2,8,0,0,0,0,2,0,0,1193,10,519
4600,전라남도,4601,목포시,신흥동,소계,11633,8906,7639,1005,117,4,67,3,0,2,0,8,2,5,8852,54,2727
4600,전라남도,4601,목포시,,관내사전투표,4680,4680,4103,472,50,1,30,2,0,2,0,2,1,2,4665,15,0
4600,전라남도,4601,목포시,,신흥동제1투,1922,1081,905,138,21,1,8,1,0,0,0,1,0,0,1075,6,841
4600,전라남도,4601,목포시,,신흥동제2투,1276,803,689,91,9,1,4,0,0,0,0,2,1,0,797,6,473
4600,전라남도,4601,목포시,,신흥동제3투,1693,1100,926,137,13,0,12,0,0,0,0,2,0,3,1093,7,593
4600,전라남도,4601,목포시,,신흥동제4투,2062,1242,1016,167,24,1,13,0,0,0,0,1,0,0,1222,20,820
4600,전라남도,4601,목포시,삼향동,소계,4540,3689,3205,367,53,2,26,2,1,0,1,3,1,4,3665,24,851
4600,전라남도,4601,목포시,,관내사전투표,2687,2685,2337,270,35,1,17,2,0,0,0,2,1,3,2668,17,2
4600,전라남도,4601,목포시,,삼향동제1투,890,479,428,36,6,1,2,0,1,0,1,1,0,1,477,2,411
4600,전라남도,4601,목포시,,삼향동제2투,963,525,440,61,12,0,7,0,0,0,0,0,0,0,520,5,438
4600,전라남도,4601,목포시,옥암동,소계,8979,7415,6493,728,112,3,37,1,2,1,0,3,1,2,7383,32,1564
4600,전라남도,4601,목포시,,관내사전투표,5049,5049,4497,445,64,3,15,1,2,1,0,1,1,2,5032,17,0
4600,전라남도,4601,목포시,,옥암동제1투,2279,1390,1181,156,29,0,13,0,0,0,0,1,0,0,1380,10,889
4600,전라남도,4601,목포시,,옥암동제2투,1651,976,815,127,19,0,9,0,0,0,0,1,0,0,971,5,675
4600,전라남도,4601,목포시,부흥동,소계,7728,6294,5532,590,78,3,31,2,0,0,0,11,2,0,6249,45,1434
4600,전라남도,4601,목포시,,관내사전투표,4432,4432,3955,370,46,2,19,2,0,0,0,6,2,0,4402,30,0
4600,전라남도,4601,목포시,,부흥동제1투,1087,543,452,64,14,0,5,0,0,0,0,3,0,0,538,5,544
4600,전라남도,4601,목포시,,부흥동제2투,716,379,333,33,3,0,4,0,0,0,0,1,0,0,374,5,337
4600,전라남도,4601,목포시,,부흥동제3투,1493,940,792,123,15,1,3,0,0,0,0,1,0,0,935,5,553
4600,전라남도,4601,목포시,부주동,소계,14497,11337,9686,1319,191,5,63,4,0,0,2,10,1,4,11285,52,3160
4600,전라남도,4601,목포시,,관내사전투표,6600,6599,5784,656,100,3,29,1,0,0,1,8,0,1,6583,16,1
4600,전라남도,4601,목포시,,부주동제1투,1234,769,662,86,12,0,5,0,0,0,0,0,0,0,765,4,465
4600,전라남도,4601,목포시,,부주동제2투,1751,944,775,121,24,0,11,1,0,0,1,1,0,1,935,9,807
4600,전라남도,4601,목포시,,부주동제3투,2398,1393,1176,172,19,1,10,0,0,0,0,0,1,2,1381,12,1005
4600,전라남도,4601,목포시,,부주동제4투,984,610,468,118,15,0,3,1,0,0,0,1,0,0,606,4,374
4600,전라남도,4601,목포시,,부주동제5투,1530,1022,821,166,21,1,5,1,0,0,0,0,0,0,1015,7,508
4600,전라남도,4601,목포시,잘못 투입·구분된 투표지,,0,3,3,0,0,0,0,0,0,0,0,0,0,0,3,0,-3
4600,전라남도,4602,여수시,합계,,237455,189617,162006,21986,2266,82,1369,52,24,35,36,183,43,230,188312,1305,47838
4600,전라남도,4602,여수시,거소·선상투표,,706,648,480,65,6,3,15,1,2,1,1,1,1,5,581,67,58
4600,전라남도,4602,여수시,관외사전투표,,15680,15676,11670,3181,344,12,219,11,3,2,1,18,3,14,15478,198,4
4600,전라남도,4602,여수시,재외투표,,600,418,319,55,15,0,2,0,0,0,1,1,0,0,393,25,182
4600,전라남도,4602,여수시,돌산읍,소계,9121,6374,5625,591,58,5,38,2,2,0,1,4,1,16,6343,31,2747
4600,전라남도,4602,여수시,,관내사전투표,2220,2220,2008,169,17,5,5,1,1,0,0,1,0,5,2212,8,0
4600,전라남도,4602,여수시,,돌산읍제1투,1014,474,410,50,2,0,4,0,0,0,0,0,1,1,468,6,540
4600,전라남도,4602,여수시,,돌산읍제2투,1133,748,645,81,11,0,4,0,0,0,0,0,0,1,742,6,385
4600,전라남도,4602,여수시,,돌산읍제3투,888,584,516,51,8,0,2,0,0,0,0,1,0,5,583,1,304
4600,전라남도,4602,여수시,,돌산읍제4투,874,530,478,39,2,0,3,1,0,0,1,1,0,4,529,1,344
4600,전라남도,4602,여수시,,돌산읍제5투,2992,1818,1568,201,18,0,20,0,1,0,0,1,0,0,1809,9,1174
4600,전라남도,4602,여수시,소라면,소계,15488,12163,10591,1216,133,6,80,6,1,2,3,15,2,17,12072,91,3325
4600,전라남도,4602,여수시,,관내사전투표,6031,6031,5403,484,60,6,24,5,0,0,2,10,2,7,6003,28,0
4600,전라남도,4602,여수시,,소라면제1투,880,500,421,50,7,0,9,0,0,0,0,0,0,3,490,10,380
4600,전라남도,4602,여수시,,소라면제2투,733,454,394,45,5,0,2,0,0,2,0,0,0,1,449,5,279
4600,전라남도,4602,여수시,,소라면제3투,863,554,495,41,6,0,3,0,0,0,0,1,0,2,548,6,309
4600,전라남도,4602,여수시,,소라면제4투,612,370,309,46,8,0,2,0,0,0,0,0,0,0,365,5,242
4600,전라남도,4602,여수시,,소라면제5투,3118,1975,1635,276,18,0,22,0,1,0,1,1,0,4,1958,17,1143
4600,전라남도,4602,여수시,,소라면제6투,3251,2279,1934,274,29,0,18,1,0,0,0,3,0,0,2259,20,972
4600,전라남도,4602,여수시,율촌면,소계,5092,3899,3453,321,39,3,19,1,0,1,0,4,2,17,3860,39,1193
4600,전라남도,4602,여수시,,관내사전투표,2314,2314,2105,148,20,2,8,1,0,1,0,0,0,9,2294,20,0
4600,전라남도,4602,여수시,,율촌면제1투,1497,762,651,83,12,0,6,0,0,0,0,2,0,1,755,7,735
4600,전라남도,4602,여수시,,율촌면제2투,560,335,272,45,4,1,2,0,0,0,0,1,2,2,329,6,225
4600,전라남도,4602,여수시,,율촌면제3투,559,361,313,34,2,0,0,0,0,0,0,1,0,5,355,6,198
4600,전라남도,4602,여수시,,율촌면제4투,162,127,112,11,1,0,3,0,0,0,0,0,0,0,127,0,35
4600,전라남도,4602,여수시,화양면,소계,5858,4555,4004,400,57,4,17,3,0,4,3,6,1,19,4518,37,1303
4600,전라남도,4602,여수시,,관내사전투표,2680,2676,2396,198,36,1,9,3,0,4,2,2,0,10,2661,15,4
4600,전라남도,4602,여수시,,화양면제1투,885,479,403,52,6,2,5,0,0,0,0,1,0,3,472,7,406
4600,전라남도,4602,여수시,,화양면제2투,679,402,349,37,4,0,1,0,0,0,0,2,1,2,396,6,277
4600,전라남도,4602,여수시,,화양면제3투,831,524,443,67,4,0,2,0,0,0,0,1,0,1,518,6,307
4600,전라남도,4602,여수시,,화양면제4투,783,474,413,46,7,1,0,0,0,0,1,0,0,3,471,3,309
4600,전라남도,4602,여수시,남면,소계,2054,1605,1402,135,21,1,6,1,1,3,2,0,2,15,1589,16,449
4600,전라남도,4602,여수시,,관내사전투표,713,713,631,62,7,0,3,0,0,2,0,0,2,1,708,5,0
4600,전라남도,4602,여수시,,남면제1투,426,189,151,24,4,0,3,1,0,0,0,0,0,4,187,2,237
4600,전라남도,4602,여수시,,남면제2투,123,104,95,6,2,0,0,0,1,0,0,0,0,0,104,0,19
4600,전라남도,4602,여수시,,남면제3투,178,135,123,5,2,0,0,0,0,0,2,0,0,1,133,2,43
4600,전라남도,4602,여수시,,남면제4투,89,74,67,4,2,0,0,0,0,1,0,0,0,0,74,0,15
4600,전라남도,4602,여수시,,남면제5투,217,153,135,14,1,0,0,0,0,0,0,0,0,3,153,0,64
4600,전라남도,4602,여수시,,남면제6투,308,237,200,20,3,1,0,0,0,0,0,0,0,6,230,7,71
4600,전라남도,4602,여수시,화정면,소계,1708,1344,1201,82,10,0,3,0,1,0,1,2,1,16,1317,27,364
4600,전라남도,4602,여수시,,관내사전투표,345,345,305,28,3,0,1,0,0,0,0,2,0,1,340,5,0
4600,전라남도,4602,여수시,,화정면제1투,119,80,69,7,2,0,0,0,0,0,0,0,1,1,80,0,39
4600,전라남도,4602,여수시,,화정면제2투,422,308,278,14,2,0,1,0,1,0,0,0,0,2,298,10,114
4600,전라남도,4602,여수시,,화정면제3투,150,77,67,6,0,0,1,0,0,0,0,0,0,2,76,1,73
4600,전라남도,4602,여수시,,화정면제4투,55,46,43,1,0,0,0,0,0,0,0,0,0,0,44,2,9
4600,전라남도,4602,여수시,,화정면제5투,207,167,147,9,1,0,0,0,0,0,0,0,0,6,163,4,40
4600,전라남도,4602,여수시,,화정면제6투,16,12,10,0,0,0,0,0,0,0,0,0,0,0,10,2,4
4600,전라남도,4602,여수시,,화정면제7투,77,62,53,6,0,0,0,0,0,0,0,0,0,3,62,0,15
4600,전라남도,4602,여수시,,화정면제8투,167,134,125,6,1,0,0,0,0,0,1,0,0,0,133,1,33
4600,전라남도,4602,여수시,,화정면제9투,58,42,38,2,1,0,0,0,0,0,0,0,0,0,41,1,16
4600,전라남도,4602,여수시,,화정면제10투,27,21,21,0,0,0,0,0,0,0,0,0,0,0,21,0,6
4600,전라남도,4602,여수시,,화정면제11투,32,24,21,1,0,0,0,0,0,0,0,0,0,1,23,1,8
4600,전라남도,4602,여수시,,화정면제12투,33,26,24,2,0,0,0,0,0,0,0,0,0,0,26,0,7
4600,전라남도,4602,여수시,삼산면,소계,1414,1076,900,140,10,0,6,0,0,1,0,2,1,5,1065,11,338
4600,전라남도,4602,여수시,,관내사전투표,460,460,394,57,3,0,3,0,0,0,0,1,0,0,458,2,0
4600,전라남도,4602,여수시,,삼산면제1투,272,118,98,16,1,0,1,0,0,0,0,0,0,1,117,1,154
4600,전라남도,4602,여수시,,삼산면제2투,281,201,169,20,4,0,0,0,0,0,0,1,1,0,195,6,80
4600,전라남도,4602,여수시,,삼산면제3투,255,186,157,24,1,0,1,0,0,0,0,0,0,3,186,0,69
4600,전라남도,4602,여수시,,삼산면제4투,146,111,82,23,1,0,1,0,0,1,0,0,0,1,109,2,35
4600,전라남도,4602,여수시,동문동,소계,4106,3173,2749,347,32,2,22,0,1,0,2,2,0,2,3159,14,933
4600,전라남도,4602,여수시,,관내사전투표,2000,2000,1768,195,18,2,10,0,1,0,0,2,0,0,1996,4,0
4600,전라남도,4602,여수시,,동문동제1투,1039,581,490,78,4,0,3,0,0,0,0,0,0,1,576,5,458
4600,전라남도,4602,여수시,,동문동제2투,571,306,242,46,6,0,7,0,0,0,2,0,0,1,304,2,265
4600,전라남도,4602,여수시,,동문동제3투,496,286,249,28,4,0,2,0,0,0,0,0,0,0,283,3,210
4600,전라남도,4602,여수시,한려동,소계,3069,2452,2130,260,15,1,25,0,0,0,1,1,2,1,2436,16,617
4600,전라남도,4602,여수시,,관내사전투표,1715,1715,1521,171,8,1,5,0,0,0,1,1,1,0,1709,6,0
4600,전라남도,4602,여수시,,한려동제1투,526,307,264,29,5,0,5,0,0,0,0,0,0,0,303,4,219
4600,전라남도,4602,여수시,,한려동제2투,828,430,345,60,2,0,15,0,0,0,0,0,1,1,424,6,398
4600,전라남도,4602,여수시,중앙동,소계,4562,3773,3305,377,39,3,22,3,0,0,1,1,0,4,3755,18,789
4600,전라남도,4602,여수시,,관내사전투표,2736,2735,2418,256,26,2,11,3,0,0,1,1,0,2,2720,15,1
4600,전라남도,4602,여수시,,중앙동제1투,977,577,491,65,10,1,8,0,0,0,0,0,0,0,575,2,400
4600,전라남도,4602,여수시,,중앙동제2투,849,461,396,56,3,0,3,0,0,0,0,0,0,2,460,1,388
4600,전라남도,4602,여수시,충무동,소계,3200,2274,2032,179,19,1,19,0,1,0,0,1,0,5,2257,17,926
4600,전라남도,4602,여수시,,관내사전투표,1304,1304,1183,99,7,0,5,0,0,0,0,1,0,2,1297,7,0
4600,전라남도,4602,여수시,,충무동제1투,823,402,347,41,2,1,7,0,1,0,0,0,0,1,400,2,421
4600,전라남도,4602,여수시,,충무동제2투,1073,568,502,39,10,0,7,0,0,0,0,0,0,2,560,8,505
4600,전라남도,4602,여수시,광림동,소계,5905,4668,4148,413,40,4,19,2,0,1,2,6,4,7,4646,22,1237
4600,전라남도,4602,여수시,,관내사전투표,2941,2941,2668,222,18,1,5,2,0,1,0,5,3,5,2930,11,0
4600,전라남도,4602,여수시,,광림동제1투,921,476,419,40,5,1,1,0,0,0,2,1,0,2,471,5,445
4600,전라남도,4602,여수시,,광림동제2투,679,407,360,38,2,1,4,0,0,0,0,0,0,0,405,2,272
4600,전라남도,4602,여수시,,광림동제3투,1364,844,701,113,15,1,9,0,0,0,0,0,1,0,840,4,520
4600,전라남도,4602,여수시,서강동,소계,3799,3043,2673,301,22,6,14,0,0,2,0,4,1,4,3027,16,756
4600,전라남도,4602,여수시,,관내사전투표,2087,2087,1876,164,15,3,9,0,0,1,0,4,1,2,2075,12,0
4600,전라남도,4602,여수시,,서강동제1투,701,348,288,54,2,1,1,0,0,0,0,0,0,0,346,2,353
4600,전라남도,4602,여수시,,서강동제2투,1011,608,509,83,5,2,4,0,0,1,0,0,0,2,606,2,403
4600,전라남도,4602,여수시,대교동,소계,5426,4264,3817,356,40,2,20,1,1,0,1,2,2,6,4248,16,1162
4600,전라남도,4602,여수시,,관내사전투표,2775,2775,2510,216,22,1,12,1,0,0,1,2,0,2,2767,8,0
4600,전라남도,4602,여수시,,대교동제1투,990,528,459,53,3,0,7,0,0,0,0,0,0,1,523,5,462
4600,전라남도,4602,여수시,,대교동제2투,890,477,418,46,10,1,0,0,0,0,0,0,0,0,475,2,413
4600,전라남도,4602,여수시,,대교동제3투,771,484,430,41,5,0,1,0,1,0,0,0,2,3,483,1,287
4600,전라남도,4602,여수시,국동,소계,9553,7454,6602,686,59,2,51,1,1,0,3,3,1,4,7413,41,2099
4600,전라남도,4602,여수시,,관내사전투표,4466,4466,4001,383,29,2,25,1,1,0,1,1,0,2,4446,20,0
4600,전라남도,4602,여수시,,국동제1투,834,458,396,49,3,0,3,0,0,0,1,0,0,0,452,6,376
4600,전라남도,4602,여수시,,국동제2투,1215,637,548,68,6,0,7,0,0,0,0,1,0,0,630,7,578
4600,전라남도,4602,여수시,,국동제3투,1527,930,803,101,15,0,6,0,0,0,1,0,1,0,927,3,597
4600,전라남도,4602,여수시,,국동제4투,1511,963,854,85,6,0,10,0,0,0,0,1,0,2,958,5,548
4600,전라남도,4602,여수시,월호동,소계,6043,5003,4339,542,51,1,45,1,0,0,2,3,1,0,4985,18,1040
4600,전라남도,4602,여수시,,관내사전투표,3330,3330,2918,343,31,1,25,0,0,0,0,3,1,0,3322,8,0
4600,전라남도,4602,여수시,,월호동제1투,1095,572,466,86,6,0,9,0,0,0,1,0,0,0,568,4,523
4600,전라남도,4602,여수시,,월호동제2투,1161,775,657,98,9,0,7,0,0,0,0,0,0,0,771,4,386
4600,전라남도,4602,여수시,,월호동제3투,384,274,249,14,5,0,3,1,0,0,1,0,0,0,273,1,110
4600,전라남도,4602,여수시,,월호동제4투,73,52,49,1,0,0,1,0,0,0,0,0,0,0,51,1,21
4600,전라남도,4602,여수시,여서동,소계,14437,11299,9745,1245,145,1,90,1,1,2,0,7,2,3,11242,57,3138
4600,전라남도,4602,여수시,,관내사전투표,5675,5673,5038,511,64,0,30,1,0,2,0,4,1,1,5652,21,2
4600,전라남도,4602,여수시,,여서동제1투,1523,749,623,99,14,0,7,0,0,0,0,1,0,0,744,5,774
4600,전라남도,4602,여수시,,여서동제2투,1295,864,713,122,11,0,13,0,0,0,0,1,0,0,860,4,431
4600,전라남도,4602,여수시,,여서동제3투,1532,1059,886,143,16,0,9,0,0,0,0,1,0,0,1055,4,473
4600,전라남도,4602,여수시,,여서동제4투,1586,1008,849,123,12,0,14,0,0,0,0,0,0,2,1000,8,578
4600,전라남도,4602,여수시,,여서동제5투,1436,1082,899,152,16,1,8,0,0,0,0,0,0,0,1076,6,354
4600,전라남도,4602,여수시,,여서동제6투,1390,864,737,95,12,0,9,0,1,0,0,0,1,0,855,9,526
4600,전라남도,4602,여수시,문수동,소계,16039,12253,10667,1312,118,3,69,1,1,3,2,12,3,5,12196,57,3786
4600,전라남도,4602,여수시,,관내사전투표,5946,5946,5272,581,44,1,22,0,0,2,0,4,1,1,5928,18,0
4600,전라남도,4602,여수시,,문수동제1투,749,521,469,41,4,0,2,0,0,0,0,0,0,1,517,4,228
4600,전라남도,4602,여수시,,문수동제2투,1430,918,798,91,16,0,9,0,0,0,0,1,0,1,916,2,512
4600,전라남도,4602,여수시,,문수동제3투,2280,1269,1046,190,15,0,8,0,1,0,0,2,0,0,1262,7,1011
4600,전라남도,4602,여수시,,문수동제4투,1762,1249,1081,138,15,2,7,0,0,0,0,3,0,0,1246,3,513
4600,전라남도,4602,여수시,,문수동제5투,1458,901,760,103,7,0,13,0,0,1,2,1,2,2,891,10,557
4600,전라남도,4602,여수시,,문수동제6투,2414,1449,1241,168,17,0,8,1,0,0,0,1,0,0,1436,13,965
4600,전라남도,4602,여수시,미평동,소계,10225,8127,6944,926,105,0,73,2,0,2,1,10,3,9,8075,52,2098
4600,전라남도,4602,여수시,,관내사전투표,5153,5153,4510,493,73,0,37,2,0,1,1,7,1,5,5130,23,0
4600,전라남도,4602,여수시,,미평동제1투,1632,871,671,164,15,0,7,0,0,1,0,1,1,0,860,11,761
4600,전라남도,4602,여수시,,미평동제2투,1273,720,610,81,4,0,10,0,0,0,0,1,1,4,711,9,553
4600,전라남도,4602,여수시,,미평동제3투,1184,729,618,88,7,0,9,0,0,0,0,1,0,0,723,6,455
4600,전라남도,4602,여수시,,미평동제4투,983,654,535,100,6,0,10,0,0,0,0,0,0,0,651,3,329
4600,전라남도,4602,여수시,둔덕동,소계,8231,6709,5827,689,88,1,57,1,0,3,0,6,0,4,6676,33,1522
4600,전라남도,4602,여수시,,관내사전투표,4353,4353,3890,366,45,1,32,0,0,3,0,2,0,3,4342,11,0
4600,전라남도,4602,여수시,,둔덕동제1투,898,456,372,60,13,0,8,0,0,0,0,2,0,0,455,1,442
4600,전라남도,4602,여수시,,둔덕동제2투,1705,1053,847,154,19,0,11,1,0,0,0,1,0,1,1034,19,652
4600,전라남도,4602,여수시,,둔덕동제3투,1275,847,718,109,11,0,6,0,0,0,0,1,0,0,845,2,428
4600,전라남도,4602,여수시,만덕동,소계,7716,6161,5212,801,72,1,34,1,1,0,1,3,0,6,6132,29,1555
4600,전라남도,4602,여수시,,관내사전투표,3467,3467,3021,389,30,0,13,1,0,0,1,1,0,3,3459,8,0
4600,전라남도,4602,여수시,,만덕동제1투,1762,1092,925,127,17,0,12,0,1,0,0,0,0,1,1083,9,670
4600,전라남도,4602,여수시,,만덕동제2투,1859,1186,896,250,20,1,8,0,0,0,0,1,0,0,1176,10,673
4600,전라남도,4602,여수시,,만덕동제3투,628,416,370,35,5,0,1,0,0,0,0,1,0,2,414,2,212
4600,전라남도,4602,여수시,쌍봉동,소계,25249,20264,17125,2603,237,8,125,2,3,3,1,20,3,8,20138,126,4985
4600,전라남도,4602,여수시,,관내사전투표,10433,10433,9071,1137,116,5,43,1,0,2,0,9,0,3,10387,46,0
4600,전라남도,4602,여수시,,쌍봉동제1투,1215,641,512,107,6,0,6,0,0,1,0,1,0,0,633,8,574
4600,전라남도,4602,여수시,,쌍봉동제2투,2024,1164,939,186,15,1,14,0,0,0,0,0,2,0,1157,7,860
4600,전라남도,4602,여수시,,쌍봉동제3투,1952,1243,1014,193,11,0,10,1,0,0,1,1,1,1,1233,10,709
4600,전라남도,4602,여수시,,쌍봉동제4투,1624,1175,954,187,16,1,7,0,0,0,0,1,0,1,1167,8,449
4600,전라남도,4602,여수시,,쌍봉동제5투,2063,1418,1178,196,15,0,10,0,1,0,0,1,0,2,1403,15,645
4600,전라남도,4602,여수시,,쌍봉동제6투,1469,980,818,135,11,0,10,0,1,0,0,1,0,0,976,4,489
4600,전라남도,4602,여수시,,쌍봉동제7투,2374,1663,1386,220,23,1,10,0,1,0,0,3,0,1,1645,18,711
4600,전라남도,4602,여수시,,쌍봉동제8투,2095,1547,1253,242,24,0,15,0,0,0,0,3,0,0,1537,10,548
4600,전라남도,4602,여수시,시전동,소계,25297,19923,16897,2537,227,7,123,6,3,3,1,13,4,10,19831,92,5374
4600,전라남도,4602,여수시,,관내사전투표,9097,9097,8016,920,77,4,43,2,2,1,0,4,2,4,9075,22,0
4600,전라남도,4602,여수시,,시전동제1투,985,585,488,72,11,0,10,0,0,0,0,0,0,1,582,3,400
4600,전라남도,4602,여수시,,시전동제2투,2061,1450,1219,193,18,0,6,1,1,0,0,1,0,0,1439,11,611
4600,전라남도,4602,여수시,,시전동제3투,1117,692,561,107,4,0,6,1,0,0,0,2,1,1,683,9,425
4600,전라남도,4602,여수시,,시전동제4투,1082,579,468,94,6,0,5,0,0,0,0,0,0,0,573,6,503
4600,전라남도,4602,여수시,,시전동제5투,1127,743,615,97,12,1,4,0,0,1,1,1,1,1,734,9,384
4600,전라남도,4602,여수시,,시전동제6투,1442,871,711,129,11,1,13,0,0,0,0,0,0,0,865,6,571
4600,전라남도,4602,여수시,,시전동제7투,2552,1706,1481,183,24,0,6,1,0,0,0,2,0,1,1698,8,846
4600,전라남도,4602,여수시,,시전동제8투,1478,1052,810,218,16,0,4,0,0,0,0,0,0,0,1048,4,426
4600,전라남도,4602,여수시,,시전동제9투,2749,2048,1632,368,30,0,6,1,0,0,0,0,0,1,2038,10,701
4600,전라남도,4602,여수시,,시전동제10투,1607,1100,896,156,18,1,20,0,0,1,0,3,0,1,1096,4,507
4600,전라남도,4602,여수시,여천동,소계,17708,13686,11643,1611,186,2,99,3,1,1,4,26,1,15,13592,94,4022
4600,전라남도,4602,여수시,,관내사전투표,7533,7533,6563,774,90,0,41,0,1,0,2,19,0,9,7499,34,0
4600,전라남도,4602,여수시,,여천동제1투,1148,719,591,94,19,0,7,2,0,0,0,1,0,2,716,3,429
4600,전라남도,4602,여수시,,여천동제2투,1950,1257,1040,180,15,0,11,0,0,0,0,2,0,0,1248,9,693
4600,전라남도,4602,여수시,,여천동제3투,2343,1210,1003,161,19,0,15,0,0,0,2,0,1,1,1202,8,1133
4600,전라남도,4602,여수시,,여천동제4투,2651,1567,1288,210,23,1,18,0,0,1,0,2,0,2,1545,22,1084
4600,전라남도,4602,여수시,,여천동제5투,2083,1400,1158,192,20,1,7,1,0,0,0,2,0,1,1382,18,683
4600,전라남도,4602,여수시,주삼동,소계,6066,4830,4257,430,59,0,42,1,0,1,0,6,0,6,4802,28,1236
4600,전라남도,4602,여수시,,관내사전투표,2726,2726,2457,209,25,0,14,1,0,1,0,5,0,3,2715,11,0
4600,전라남도,4602,여수시,,주삼동제1투,604,319,265,37,4,0,7,0,0,0,0,0,0,2,315,4,285
4600,전라남도,4602,여수시,,주삼동제2투,1075,710,614,71,8,0,10,0,0,0,0,1,0,0,704,6,365
4600,전라남도,4602,여수시,,주삼동제3투,1661,1075,921,113,22,0,11,0,0,0,0,0,0,1,1068,7,586
4600,전라남도,4602,여수시,삼일동,소계,2163,1749,1550,151,14,1,12,1,0,0,1,2,2,3,1737,12,414
4600,전라남도,4602,여수시,,관내사전투표,1289,1289,1169,90,8,1,6,1,0,0,0,2,2,3,1282,7,0
4600,전라남도,4602,여수시,,삼일동투표소,874,460,381,61,6,0,6,0,0,0,1,0,0,0,455,5,414
4600,전라남도,4602,여수시,묘도동,소계,940,753,698,34,5,2,3,0,0,0,0,2,0,4,748,5,187
4600,전라남도,4602,여수시,,관내사전투표,525,525,492,19,4,2,1,0,0,0,0,0,0,3,521,4,0
4600,전라남도,4602,여수시,,묘도동투표소,415,228,206,15,1,0,2,0,0,0,0,2,0,1,227,1,187
4600,전라남도,4602,여수시,잘못 투입·구분된 투표지,,0,1,1,0,0,0,0,0,0,0,0,0,0,0,1,0,-1
4600,전라남도,4604,순천시,합계,,235327,192412,162566,23709,2780,76,1205,60,21,50,28,295,46,132,190968,1444,42915
4600,전라남도,4604,순천시,거소·선상투표,,618,558,382,103,9,1,12,0,0,2,0,1,1,0,511,47,60
4600,전라남도,4604,순천시,관외사전투표,,21011,21007,16407,3657,435,6,222,7,4,6,3,34,5,7,20793,214,4
4600,전라남도,4604,순천시,재외투표,,643,463,341,74,13,0,0,0,0,0,0,0,0,0,428,35,180
4600,전라남도,4604,순천시,승주읍,소계,2559,2044,1796,181,21,1,7,2,1,1,1,6,1,6,2024,20,515
4600,전라남도,4604,순천시,,관내사전투표,1385,1385,1255,89,15,1,3,2,1,0,1,3,1,4,1375,10,0
4600,전라남도,4604,순천시,,승주읍제1투,893,466,384,62,4,0,4,0,0,1,0,2,0,2,459,7,427
4600,전라남도,4604,순천시,,승주읍제2투,281,193,157,30,2,0,0,0,0,0,0,1,0,0,190,3,88
4600,전라남도,4604,순천시,주암면,소계,2727,2164,1878,199,19,3,9,0,1,0,1,7,3,11,2131,33,563
4600,전라남도,4604,순천시,,관내사전투표,1232,1232,1090,102,9,3,2,0,1,0,0,4,1,5,1217,15,0
4600,전라남도,4604,순천시,,주암면제1투,732,519,454,45,3,0,0,0,0,0,1,2,0,3,508,11,213
4600,전라남도,4604,순천시,,주암면제2투,763,413,334,52,7,0,7,0,0,0,0,1,2,3,406,7,350
4600,전라남도,4604,순천시,송광면,소계,1268,982,857,91,17,0,1,0,0,1,1,0,1,3,972,10,286
4600,전라남도,4604,순천시,,관내사전투표,692,692,602,66,11,0,1,0,0,1,1,0,1,2,685,7,0
4600,전라남도,4604,순천시,,송광면투표소,576,290,255,25,6,0,0,0,0,0,0,0,0,1,287,3,286
4600,전라남도,4604,순천시,외서면,소계,741,592,527,46,8,0,0,0,1,2,0,0,0,3,587,5,149
4600,전라남도,4604,순천시,,관내사전투표,468,468,424,29,6,0,0,0,1,1,0,0,0,2,463,5,0
4600,전라남도,4604,순천시,,외서면투표소,273,124,103,17,2,0,0,0,0,1,0,0,0,1,124,0,149
4600,전라남도,4604,순천시,낙안면,소계,2822,2243,1973,199,29,5,7,2,0,0,0,0,3,8,2226,17,579
4600,전라남도,4604,순천시,,관내사전투표,1575,1575,1422,115,15,2,2,1,0,0,0,0,2,6,1565,10,0
4600,전라남도,4604,순천시,,낙안면제1투,746,374,307,51,5,2,4,0,0,0,0,0,0,2,371,3,372
4600,전라남도,4604,순천시,,낙안면제2투,501,294,244,33,9,1,1,1,0,0,0,0,1,0,290,4,207
4600,전라남도,4604,순천시,별량면,소계,4855,3785,3315,341,48,2,24,3,1,1,1,5,3,5,3749,36,1070
4600,전라남도,4604,순천시,,관내사전투표,2558,2558,2250,219,37,1,14,2,1,1,0,5,0,2,2532,26,0
4600,전라남도,4604,순천시,,별량면제1투,825,430,370,47,3,1,4,1,0,0,0,0,0,0,426,4,395
4600,전라남도,4604,순천시,,별량면제2투,804,364,315,39,4,0,1,0,0,0,1,0,2,0,362,2,440
4600,전라남도,4604,순천시,,별량면제3투,668,433,380,36,4,0,5,0,0,0,0,0,1,3,429,4,235
4600,전라남도,4604,순천시,상사면,소계,2831,2345,2056,228,21,1,9,3,0,0,0,2,0,6,2326,19,486
4600,전라남도,4604,순천시,,관내사전투표,1628,1628,1455,135,15,0,7,3,0,0,0,2,0,3,1620,8,0
4600,전라남도,4604,순천시,,상사면제1투,411,216,175,37,1,0,1,0,0,0,0,0,0,0,214,2,195
4600,전라남도,4604,순천시,,상사면제2투,792,501,426,56,5,1,1,0,0,0,0,0,0,3,492,9,291
4600,전라남도,4604,순천시,해룡면,소계,31432,24144,20438,3015,326,5,131,5,2,2,1,29,4,10,23968,176,7288
4600,전라남도,4604,순천시,,관내사전투표,6717,6716,5979,611,57,2,18,4,0,0,0,8,1,5,6685,31,1
4600,전라남도,4604,순천시,,해룡면제1투,1510,902,775,99,6,1,7,0,0,0,0,0,0,1,889,13,608
4600,전라남도,4604,순천시,,해룡면제2투,588,391,345,28,2,0,5,0,0,0,0,3,1,0,384,7,197
4600,전라남도,4604,순천시,,해룡면제3투,2261,1464,1248,170,16,0,12,0,0,0,0,3,0,0,1449,15,797
4600,전라남도,4604,순천시,,해룡면제4투,2278,1563,1316,188,20,0,15,0,0,0,0,2,0,1,1542,21,715
4600,전라남도,4604,순천시,,해룡면제5투,2227,1527,1263,201,35,0,13,0,0,0,0,2,0,1,1515,12,700
4600,전라남도,4604,순천시,,해룡면제6투,1879,1307,1110,169,16,0,4,0,0,0,0,1,0,0,1300,7,572
4600,전라남도,4604,순천시,,해룡면제7투,1898,1411,1206,162,21,0,8,0,1,1,0,1,1,0,1401,10,487
4600,전라남도,4604,순천시,,해룡면제8투,3026,2264,1840,344,49,0,10,1,0,1,0,1,0,0,2246,18,762
4600,전라남도,4604,순천시,,해룡면제9투,2808,1952,1629,267,24,2,10,0,1,0,0,3,0,1,1937,15,856
4600,전라남도,4604,순천시,,해룡면제10투,2463,1878,1555,278,23,0,7,0,0,0,1,2,0,1,1867,11,585
4600,전라남도,4604,순천시,,해룡면제11투,3777,2769,2172,498,57,0,22,0,0,0,0,3,1,0,2753,16,1008
4600,전라남도,4604,순천시,서면,소계,9968,7940,6794,888,111,11,58,3,2,4,4,8,4,5,7892,48,2028
4600,전라남도,4604,순천시,,관내사전투표,3907,3907,3391,390,50,9,20,3,2,2,1,4,4,3,3879,28,0
4600,전라남도,4604,순천시,,서면제1투,538,349,296,40,4,0,7,0,0,1,0,0,0,0,348,1,189
4600,전라남도,4604,순천시,,서면제2투,704,433,356,64,3,0,3,0,0,0,3,0,0,1,430,3,271
4600,전라남도,4604,순천시,,서면제3투,1770,1216,1034,139,22,1,11,0,0,0,0,2,0,0,1209,7,554
4600,전라남도,4604,순천시,,서면제4투,2387,1579,1323,202,29,1,15,0,0,0,0,1,0,0,1571,8,808
4600,전라남도,4604,순천시,,서면제5투,662,456,394,53,3,0,2,0,0,1,0,1,0,1,455,1,206
4600,전라남도,4604,순천시,황전면,소계,2690,2149,1845,209,16,0,8,0,0,2,1,37,0,4,2122,27,541
4600,전라남도,4604,순천시,,관내사전투표,1376,1376,1199,130,11,0,3,0,0,1,0,16,0,3,1363,13,0
4600,전라남도,4604,순천시,,황전면제1투,612,330,274,38,5,0,2,0,0,1,0,5,0,0,325,5,282
4600,전라남도,4604,순천시,,황전면제2투,702,443,372,41,0,0,3,0,0,0,1,16,0,1,434,9,259
4600,전라남도,4604,순천시,월등면,소계,1399,1143,1021,84,13,2,2,0,0,0,1,1,1,2,1127,16,256
4600,전라남도,4604,순천시,,관내사전투표,906,906,821,56,10,2,2,0,0,0,0,1,1,2,895,11,0
4600,전라남도,4604,순천시,,월등면투표소,493,237,200,28,3,0,0,0,0,0,1,0,0,0,232,5,256
4600,전라남도,4604,순천시,향동,소계,3311,2716,2309,326,33,1,13,2,2,1,0,3,0,8,2698,18,595
4600,전라남도,4604,순천시,,관내사전투표,2002,2002,1747,200,25,1,7,0,2,0,0,3,0,5,1990,12,0
4600,전라남도,4604,순천시,,향동투표소,1309,714,562,126,8,0,6,2,0,1,0,0,0,3,708,6,595
4600,전라남도,4604,순천시,매곡동,소계,5649,4625,3804,644,99,4,28,4,0,5,0,4,0,0,4592,33,1024
4600,전라남도,4604,순천시,,관내사전투표,3100,3100,2618,384,56,2,12,4,0,3,0,4,0,0,3083,17,0
4600,전라남도,4604,순천시,,매곡동제1투,851,492,378,92,8,2,5,0,0,0,0,0,0,0,485,7,359
4600,전라남도,4604,순천시,,매곡동제2투,1698,1033,808,168,35,0,11,0,0,2,0,0,0,0,1024,9,665
4600,전라남도,4604,순천시,삼산동,소계,19751,16083,13500,2066,258,9,104,8,0,5,0,16,0,4,15970,113,3668
4600,전라남도,4604,순천시,,관내사전투표,8756,8757,7551,999,117,3,34,5,0,1,0,7,0,1,8718,39,-1
4600,전라남도,4604,순천시,,삼산동제1투,895,492,367,86,12,2,9,0,0,1,0,2,0,1,480,12,403
4600,전라남도,4604,순천시,,삼산동제2투,1461,1034,836,156,16,0,10,2,0,1,0,1,0,0,1022,12,427
4600,전라남도,4604,순천시,,삼산동제3투,1027,627,512,85,14,0,5,0,0,0,0,1,0,0,617,10,400
4600,전라남도,4604,순천시,,삼산동제4투,2448,1545,1253,231,29,2,17,0,0,2,0,0,0,0,1534,11,903
4600,전라남도,4604,순천시,,삼산동제5투,1711,1174,974,158,19,1,8,1,0,0,0,2,0,1,1164,10,537
4600,전라남도,4604,순천시,,삼산동제6투,2145,1452,1170,226,29,1,17,0,0,0,0,1,0,1,1445,7,693
4600,전라남도,4604,순천시,,삼산동제7투,1308,1002,837,125,22,0,4,0,0,0,0,2,0,0,990,12,306
4600,전라남도,4604,순천시,조곡동,소계,5357,4360,3701,523,69,2,30,0,0,0,0,9,2,1,4337,23,997
4600,전라남도,4604,순천시,,관내사전투표,2548,2548,2235,250,35,1,14,0,0,0,0,3,1,1,2540,8,0
4600,전라남도,4604,순천시,,조곡동제1투,1532,1102,888,168,27,1,4,0,0,0,0,6,0,0,1094,8,430
4600,전라남도,4604,순천시,,조곡동제2투,448,245,202,37,3,0,1,0,0,0,0,0,0,0,243,2,203
4600,전라남도,4604,순천시,,조곡동제3투,829,465,376,68,4,0,11,0,0,0,0,0,1,0,460,5,364
4600,전라남도,4604,순천시,덕연동,소계,31719,25423,21878,2832,324,4,173,5,3,3,1,35,3,12,25273,150,6296
4600,전라남도,4604,순천시,,관내사전투표,11021,11022,9764,1026,112,1,54,1,1,0,0,9,1,6,10975,47,-1
4600,전라남도,4604,순천시,,덕연동제1투,1847,1225,976,201,17,0,18,0,1,0,0,1,0,1,1215,10,622
4600,전라남도,4604,순천시,,덕연동제2투,2024,1225,1023,147,20,1,19,0,0,0,0,0,0,1,1211,14,799
4600,전라남도,4604,순천시,,덕연동제3투,1795,1315,1115,170,13,0,7,0,0,0,0,2,0,0,1307,8,480
4600,전라남도,4604,순천시,,덕연동제4투,1645,1122,903,189,17,0,5,0,0,1,0,2,0,1,1118,4,523
4600,전라남도,4604,순천시,,덕연동제5투,1605,1177,992,149,19,1,6,0,0,1,0,1,1,0,1170,7,428
4600,전라남도,4604,순천시,,덕연동제6투,1615,1175,983,155,15,0,13,0,0,0,0,0,0,0,1166,9,440
4600,전라남도,4604,순천시,,덕연동제7투,1603,1036,893,111,12,0,6,0,0,0,0,2,0,0,1024,12,567
4600,전라남도,4604,순천시,,덕연동제8투,2138,1506,1289,157,25,0,13,0,1,1,0,5,0,1,1492,14,632
4600,전라남도,4604,순천시,,덕연동제9투,2130,1575,1342,167,30,1,15,2,0,0,0,2,1,0,1560,15,555
4600,전라남도,4604,순천시,,덕연동제10투,1969,1425,1213,162,29,0,10,0,0,0,1,5,0,0,1420,5,544
4600,전라남도,4604,순천시,,덕연동제11투,2327,1620,1385,198,15,0,7,2,0,0,0,6,0,2,1615,5,707
4600,전라남도,4604,순천시,풍덕동,소계,7928,6518,5731,661,56,1,26,3,1,0,1,3,0,4,6487,31,1410
4600,전라남도,4604,순천시,,관내사전투표,4243,4243,3784,387,35,1,8,2,1,0,1,3,0,4,4226,17,0
4600,전라남도,4604,순천시,,풍덕동제1투,809,418,345,59,5,0,5,0,0,0,0,0,0,0,414,4,391
4600,전라남도,4604,순천시,,풍덕동제2투,1190,734,650,75,3,0,3,0,0,0,0,0,0,0,731,3,456
4600,전라남도,4604,순천시,,풍덕동제3투,1686,1123,952,140,13,0,10,1,0,0,0,0,0,0,1116,7,563
4600,전라남도,4604,순천시,남제동,소계,7120,5444,4725,581,56,2,31,0,0,4,0,12,2,3,5416,28,1676
4600,전라남도,4604,순천시,,관내사전투표,3417,3416,3014,325,35,2,14,0,0,1,0,9,0,2,3402,14,1
4600,전라남도,4604,순천시,,남제동제1투,813,428,361,50,5,0,2,0,0,2,0,0,1,1,422,6,385
4600,전라남도,4604,순천시,,남제동제2투,959,537,445,75,8,0,6,0,0,0,0,2,0,0,536,1,422
4600,전라남도,4604,순천시,,남제동제3투,1931,1063,905,131,8,0,9,0,0,1,0,1,1,0,1056,7,868
4600,전라남도,4604,순천시,저전동,소계,2876,2417,2077,269,30,2,15,0,0,1,1,5,2,2,2404,13,459
4600,전라남도,4604,순천시,,관내사전투표,1862,1862,1620,196,21,1,9,0,0,1,1,2,2,2,1855,7,0
4600,전라남도,4604,순천시,,저전동투표소,1014,555,457,73,9,1,6,0,0,0,0,3,0,0,549,6,459
4600,전라남도,4604,순천시,장천동,소계,2679,2161,1828,268,38,1,8,0,0,1,1,1,0,0,2146,15,518
4600,전라남도,4604,순천시,,관내사전투표,1683,1683,1442,193,28,1,7,0,0,1,1,1,0,0,1674,9,0
4600,전라남도,4604,순천시,,장천동투표소,996,478,386,75,10,0,1,0,0,0,0,0,0,0,472,6,518
4600,전라남도,4604,순천시,중앙동,소계,3622,3043,2626,318,45,4,18,0,0,2,3,3,1,1,3021,22,579
4600,전라남도,4604,순천시,,관내사전투표,2361,2361,2085,216,27,3,9,0,0,0,3,2,0,0,2345,16,0
4600,전라남도,4604,순천시,,중앙동투표소,1261,682,541,102,18,1,9,0,0,2,0,1,1,1,676,6,579
4600,전라남도,4604,순천시,도사동,소계,12727,10149,8805,1070,135,0,52,4,0,2,1,14,2,6,10091,58,2578
4600,전라남도,4604,순천시,,관내사전투표,5284,5284,4723,466,51,0,14,1,0,1,0,7,1,3,5267,17,0
4600,전라남도,4604,순천시,,도사동제1투,1812,1010,833,141,16,0,8,1,0,1,1,1,0,0,1002,8,802
4600,전라남도,4604,순천시,,도사동제2투,993,572,496,54,5,0,7,0,0,0,0,0,0,1,563,9,421
4600,전라남도,4604,순천시,,도사동제3투,755,500,425,53,2,0,8,0,0,0,0,2,0,0,490,10,255
4600,전라남도,4604,순천시,,도사동제4투,1891,1380,1179,152,28,0,8,2,0,0,0,0,1,1,1371,9,511
4600,전라남도,4604,순천시,,도사동제5투,1992,1403,1149,204,33,0,7,0,0,0,0,4,0,1,1398,5,589
4600,전라남도,4604,순천시,왕조1동,소계,28936,22473,18569,3219,314,7,147,2,3,3,4,23,6,11,22308,165,6463
4600,전라남도,4604,순천시,,관내사전투표,10205,10205,8771,1198,117,3,55,1,2,2,2,7,2,4,10164,41,0
4600,전라남도,4604,순천시,,왕조1동제1투,1686,1150,903,204,17,0,7,1,0,0,1,2,0,4,1139,11,536
4600,전라남도,4604,순천시,,왕조1동제2투,1450,780,639,105,17,0,6,0,0,0,0,1,0,0,768,12,670
4600,전라남도,4604,순천시,,왕조1동제3투,1878,979,767,163,13,1,11,0,0,1,0,1,2,0,959,20,899
4600,전라남도,4604,순천시,,왕조1동제4투,1390,1019,842,147,11,0,6,0,0,0,0,2,0,0,1008,11,371
4600,전라남도,4604,순천시,,왕조1동제5투,1073,715,579,104,13,1,10,0,0,0,0,1,0,0,708,7,358
4600,전라남도,4604,순천시,,왕조1동제6투,1156,691,589,70,4,1,8,0,0,0,1,0,1,0,674,17,465
4600,전라남도,4604,순천시,,왕조1동제7투,2275,1310,1053,197,28,0,16,0,0,0,0,3,1,1,1299,11,965
4600,전라남도,4604,순천시,,왕조1동제8투,1796,1190,976,186,14,1,6,0,0,0,0,1,0,1,1185,5,606
4600,전라남도,4604,순천시,,왕조1동제9투,2759,2060,1698,287,44,0,11,0,1,0,0,5,0,1,2047,13,699
4600,전라남도,4604,순천시,,왕조1동제10투,1708,1217,902,289,11,0,5,0,0,0,0,0,0,0,1207,10,491
4600,전라남도,4604,순천시,,왕조1동제11투,1560,1157,850,269,25,0,6,0,0,0,0,0,0,0,1150,7,403
4600,전라남도,4604,순천시,왕조2동,소계,18088,15435,13380,1614,237,2,70,7,0,2,2,37,2,10,15363,72,2653
4600,전라남도,4604,순천시,,관내사전투표,10125,10125,8961,922,131,2,33,5,0,0,1,25,1,8,10089,36,0
4600,전라남도,4604,순천시,,왕조2동제1투,1664,1190,1016,138,19,0,7,0,0,0,0,2,0,0,1182,8,474
4600,전라남도,4604,순천시,,왕조2동제2투,1590,958,764,160,15,0,10,1,0,1,1,2,0,0,954,4,632
4600,전라남도,4604,순천시,,왕조2동제3투,1222,855,734,79,21,0,7,1,0,0,0,4,0,1,847,8,367
4600,전라남도,4604,순천시,,왕조2동제4투,1510,1001,827,145,14,0,6,0,0,1,0,0,0,1,994,7,509
4600,전라남도,4604,순천시,,왕조2동제5투,1977,1306,1078,170,37,0,7,0,0,0,0,4,1,0,1297,9,671
4600,전라남도,4604,순천시,잘못 투입·구분된 투표지,,0,6,3,3,0,0,0,0,0,0,0,0,0,0,6,0,-6
4600,전라남도,4606,나주시,합계,,99117,81076,68994,9512,1019,32,492,32,17,20,20,132,40,121,80431,645,18041
4600,전라남도,4606,나주시,거소·선상투표,,392,369,278,36,6,2,9,3,1,2,0,2,1,0,340,29,23
4600,전라남도,4606,나주시,관외사전투표,,11753,11752,9552,1816,191,3,79,2,1,0,1,16,5,6,11672,80,1
4600,전라남도,4606,나주시,재외투표,,302,207,140,45,4,0,1,0,0,0,0,0,0,1,191,16,95
4600,전라남도,4606,나주시,남평읍,소계,9043,7179,6351,653,67,0,35,1,0,1,1,5,2,12,7128,51,1864
4600,전라남도,4606,나주시,,관내사전투표,4592,4592,4132,361,38,0,19,1,0,0,1,2,1,9,4564,28,0
4600,전라남도,4606,나주시,,남평읍제1투,1249,724,618,78,9,0,5,0,0,0,0,0,0,1,711,13,525
4600,전라남도,4606,나주시,,남평읍제2투,2818,1598,1360,197,19,0,11,0,0,0,0,3,0,0,1590,8,1220
4600,전라남도,4606,나주시,,남평읍제3투,384,265,241,17,1,0,0,0,0,1,0,0,1,2,263,2,119
4600,전라남도,4606,나주시,세지면,소계,2308,1806,1640,128,15,2,1,0,0,1,0,1,1,4,1793,13,502
4600,전라남도,4606,나주시,,관내사전투표,1307,1307,1210,70,10,1,1,0,0,1,0,1,1,4,1299,8,0
4600,전라남도,4606,나주시,,세지면투표소,1001,499,430,58,5,1,0,0,0,0,0,0,0,0,494,5,502
4600,전라남도,4606,나주시,왕곡면,소계,2376,1944,1721,159,17,1,9,1,1,2,1,2,0,13,1927,17,432
4600,전라남도,4606,나주시,,관내사전투표,1254,1254,1122,94,10,0,3,0,1,1,1,1,0,12,1245,9,0
4600,전라남도,4606,나주시,,왕곡면제1투,472,250,217,20,4,0,5,0,0,1,0,0,0,0,247,3,222
4600,전라남도,4606,나주시,,왕곡면제2투,650,440,382,45,3,1,1,1,0,0,0,1,0,1,435,5,210
4600,전라남도,4606,나주시,반남면,소계,1160,933,838,71,3,0,2,1,1,1,0,0,1,5,923,10,227
4600,전라남도,4606,나주시,,관내사전투표,688,688,626,42,3,0,2,1,1,1,0,0,1,4,681,7,0
4600,전라남도,4606,나주시,,반남면투표소,472,245,212,29,0,0,0,0,0,0,0,0,0,1,242,3,227
4600,전라남도,4606,나주시,공산면,소계,1875,1550,1395,110,9,0,7,0,0,0,0,8,2,5,1536,14,325
4600,전라남도,4606,나주시,,관내사전투표,1112,1112,1018,68,3,0,6,0,0,0,0,7,1,3,1106,6,0
4600,전라남도,4606,나주시,,공산면투표소,763,438,377,42,6,0,1,0,0,0,0,1,1,2,430,8,325
4600,전라남도,4606,나주시,동강면,소계,1995,1578,1437,101,7,0,6,1,1,0,1,3,2,7,1566,12,417
4600,전라남도,4606,나주시,,관내사전투표,1151,1151,1068,57,3,0,4,1,1,0,1,3,1,4,1143,8,0
4600,전라남도,4606,나주시,,동강면투표소,844,427,369,44,4,0,2,0,0,0,0,0,1,3,423,4,417
4600,전라남도,4606,나주시,다시면,소계,3071,2540,2241,225,20,2,20,2,1,1,0,2,1,3,2518,22,531
4600,전라남도,4606,나주시,,관내사전투표,1820,1820,1645,135,9,1,9,2,1,0,0,0,1,3,1806,14,0
4600,전라남도,4606,나주시,,다시면투표소,1251,720,596,90,11,1,11,0,0,1,0,2,0,0,712,8,531
4600,전라남도,4606,나주시,문평면,소계,1457,1099,969,85,9,2,4,1,0,0,0,2,0,8,1080,19,358
4600,전라남도,4606,나주시,,관내사전투표,790,790,704,59,6,2,2,0,0,0,0,0,0,7,780,10,0
4600,전라남도,4606,나주시,,문평면투표소,667,309,265,26,3,0,2,1,0,0,0,2,0,1,300,9,358
4600,전라남도,4606,나주시,노안면,소계,3597,2813,2525,194,21,2,10,3,2,1,3,10,1,5,2777,36,784
4600,전라남도,4606,나주시,,관내사전투표,1722,1722,1579,102,7,0,5,3,2,0,2,8,0,1,1709,13,0
4600,전라남도,4606,나주시,,노안면제1투,420,227,187,26,3,1,2,0,0,1,1,1,0,1,223,4,193
4600,전라남도,4606,나주시,,노안면제2투,637,421,376,32,5,1,2,0,0,0,0,0,0,0,416,5,216
4600,전라남도,4606,나주시,,노안면제3투,818,443,383,34,6,0,1,0,0,0,0,1,1,3,429,14,375
4600,전라남도,4606,나주시,금천면,소계,3457,2710,2387,234,33,1,17,2,0,0,3,6,3,7,2693,17,747
4600,전라남도,4606,나주시,,관내사전투표,1800,1800,1605,141,17,1,12,2,0,0,1,6,1,4,1790,10,0
4600,전라남도,4606,나주시,,금천면제1투,571,268,217,39,4,0,3,0,0,0,0,0,1,1,265,3,303
4600,전라남도,4606,나주시,,금천면제2투,502,308,265,27,8,0,2,0,0,0,1,0,0,1,304,4,194
4600,전라남도,4606,나주시,,금천면제3투,584,334,300,27,4,0,0,0,0,0,1,0,1,1,334,0,250
4600,전라남도,4606,나주시,산포면,소계,3192,2675,2383,226,19,1,12,1,0,1,0,3,2,3,2651,24,517
4600,전라남도,4606,나주시,,관내사전투표,1847,1847,1654,155,14,0,5,0,0,1,0,2,0,2,1833,14,0
4600,전라남도,4606,나주시,,산포면제1투,737,391,340,37,4,0,4,0,0,0,0,1,1,0,387,4,346
4600,전라남도,4606,나주시,,산포면제2투,145,104,90,12,0,0,0,0,0,0,0,0,0,1,103,1,41
4600,전라남도,4606,나주시,,산포면제3투,463,333,299,22,1,1,3,1,0,0,0,0,1,0,328,5,130
4600,전라남도,4606,나주시,다도면,소계,1515,1108,957,101,10,4,2,0,0,1,3,5,1,9,1093,15,407
4600,전라남도,4606,나주시,,관내사전투표,819,819,702,76,8,4,2,0,0,1,3,4,1,7,808,11,0
4600,전라남도,4606,나주시,,다도면투표소,696,289,255,25,2,0,0,0,0,0,0,1,0,2,285,4,407
4600,전라남도,4606,나주시,봉황면,소계,3170,2493,2246,173,24,1,10,2,3,0,1,1,2,9,2472,21,677
4600,전라남도,4606,나주시,,관내사전투표,1710,1710,1565,99,13,1,4,1,0,0,1,0,1,8,1693,17,0
4600,전라남도,4606,나주시,,봉황면제1투,1009,547,473,58,4,0,5,0,3,0,0,1,0,0,544,3,462
4600,전라남도,4606,나주시,,봉황면제2투,451,236,208,16,7,0,1,1,0,0,0,0,1,1,235,1,215
4600,전라남도,4606,나주시,송월동,소계,5730,4402,3703,537,58,5,43,3,3,3,1,8,3,3,4370,32,1328
4600,전라남도,4606,나주시,,관내사전투표,2223,2223,1912,239,25,4,14,1,3,2,1,6,3,2,2212,11,0
4600,전라남도,4606,나주시,,송월동제1투,1232,718,576,111,13,0,8,0,0,1,0,2,0,1,712,6,514
4600,전라남도,4606,나주시,,송월동제2투,1076,660,547,85,11,0,9,2,0,0,0,0,0,0,654,6,416
4600,전라남도,4606,나주시,,송월동제3투,1199,801,668,102,9,1,12,0,0,0,0,0,0,0,792,9,398
4600,전라남도,4606,나주시,영강동,소계,2323,1785,1570,160,19,1,13,1,0,0,1,5,1,0,1771,14,538
4600,전라남도,4606,나주시,,관내사전투표,1363,1363,1219,108,13,0,8,0,0,0,1,3,0,0,1352,11,0
4600,전라남도,4606,나주시,,영강동투표소,960,422,351,52,6,1,5,1,0,0,0,2,1,0,419,3,538
4600,전라남도,4606,나주시,금남동,소계,4058,3135,2749,315,23,0,21,0,0,1,0,7,2,0,3118,17,923
4600,전라남도,4606,나주시,,관내사전투표,2074,2074,1840,200,14,0,11,0,0,1,0,2,1,0,2069,5,0
4600,전라남도,4606,나주시,,금남동제1투,746,440,371,55,4,0,5,0,0,0,0,2,0,0,437,3,306
4600,전라남도,4606,나주시,,금남동제2투,515,265,224,33,1,0,2,0,0,0,0,1,1,0,262,3,250
4600,전라남도,4606,나주시,,금남동제3투,723,356,314,27,4,0,3,0,0,0,0,2,0,0,350,6,367
4600,전라남도,4606,나주시,성북동,소계,7285,5952,5092,691,65,2,38,1,1,0,0,13,2,5,5910,42,1333
4600,전라남도,4606,나주시,,관내사전투표,3746,3745,3261,395,34,2,18,1,0,0,0,8,1,4,3724,21,1
4600,전라남도,4606,나주시,,성북동제1투,677,353,281,52,5,0,6,0,0,0,0,1,0,1,346,7,324
4600,전라남도,4606,나주시,,성북동제2투,824,476,387,72,7,0,5,0,0,0,0,0,0,0,471,5,348
4600,전라남도,4606,나주시,,성북동제3투,2038,1378,1163,172,19,0,9,0,1,0,0,4,1,0,1369,9,660
4600,전라남도,4606,나주시,영산동,소계,2444,1833,1619,162,15,2,10,1,0,1,1,0,1,6,1818,15,611
4600,전라남도,4606,나주시,,관내사전투표,1101,1101,991,93,2,2,0,1,0,0,0,0,1,5,1095,6,0
4600,전라남도,4606,나주시,,영산동제1투,488,253,227,16,2,0,4,0,0,1,0,0,0,0,250,3,235
4600,전라남도,4606,나주시,,영산동제2투,855,479,401,53,11,0,6,0,0,0,1,0,0,1,473,6,376
4600,전라남도,4606,나주시,이창동,소계,3354,2693,2343,251,32,0,28,3,0,0,0,3,4,7,2671,22,661
4600,전라남도,4606,나주시,,관내사전투표,2027,2027,1795,167,23,0,16,3,0,0,0,2,4,4,2014,13,0
4600,전라남도,4606,나주시,,이창동투표소,1327,666,548,84,9,0,12,0,0,0,0,1,0,3,657,9,661
4600,전라남도,4606,나주시,빛가람동,소계,23260,18519,14857,3039,352,1,115,3,2,4,3,30,3,3,18412,107,4741
4600,전라남도,4606,나주시,,관내사전투표,9631,9631,7935,1437,158,0,51,2,0,1,2,7,1,0,9594,37,0
4600,전라남도,4606,나주시,,빛가람동제1투,2281,1504,1043,388,43,0,4,0,0,0,0,3,0,0,1481,23,777
4600,전라남도,4606,나주시,,빛가람동제2투,2922,2000,1598,335,33,0,16,0,0,0,0,5,0,0,1987,13,922
4600,전라남도,4606,나주시,,빛가람동제3투,1802,1133,882,214,18,1,8,0,0,0,1,1,1,1,1127,6,669
4600,전라남도,4606,나주시,,빛가람동제4투,2836,1846,1531,248,39,0,9,1,0,1,0,6,1,0,1836,10,990
4600,전라남도,4606,나주시,,빛가람동제5투,1630,1051,816,185,26,0,5,0,0,0,0,6,0,1,1039,12,579
4600,전라남도,4606,나주시,,빛가람동제6투,2158,1354,1052,232,35,0,22,0,2,2,0,2,0,1,1348,6,804
4600,전라남도,4606,나주시,잘못 투입·구분된 투표지,,0,1,1,0,0,0,0,0,0,0,0,0,0,0,1,0,-1
4600,전라남도,4607,광양시,합계,,126644,100876,81441,15843,1560,46,865,20,12,16,22,160,23,93,100101,775,25768
4600,전라남도,4607,광양시,거소·선상투표,,399,350,225,63,3,1,6,2,1,1,1,1,0,1,305,45,49
4600,전라남도,4607,광양시,관외사전투표,,11900,11899,8550,2738,238,13,156,3,4,2,4,17,3,6,11734,165,1
4600,전라남도,4607,광양시,재외투표,,317,239,165,42,12,0,1,0,0,0,0,2,0,0,222,17,78
4600,전라남도,4607,광양시,광양읍,소계,33400,25084,21576,2798,280,7,182,3,3,6,6,43,10,22,24936,148,8316
4600,전라남도,4607,광양시,,관내사전투표,8574,8574,7508,891,66,2,39,2,2,3,1,9,3,6,8532,42,0
4600,전라남도,4607,광양시,,광양읍제1투,1656,1068,922,117,11,0,10,0,0,0,0,3,1,0,1064,4,588
4600,전라남도,4607,광양시,,광양읍제2투,1953,1153,979,142,15,1,8,0,0,0,0,1,0,1,1147,6,800
4600,전라남도,4607,광양시,,광양읍제3투,571,419,351,55,3,0,6,0,0,0,0,0,0,1,416,3,152
4600,전라남도,4607,광양시,,광양읍제4투,2270,1485,1258,189,15,1,8,0,0,0,0,1,0,1,1473,12,785
4600,전라남도,4607,광양시,,광양읍제5투,432,307,275,25,0,0,0,0,0,1,0,1,0,1,303,4,125
4600,전라남도,4607,광양시,,광양읍제6투,449,316,278,20,3,0,3,0,0,0,1,4,2,3,314,2,133
4600,전라남도,4607,광양시,,광양읍제7투,690,481,443,32,0,0,1,0,0,0,0,0,0,1,477,4,209
4600,전라남도,4607,광양시,,광양읍제8투,2143,1219,995,176,25,0,12,0,0,2,0,1,0,1,1212,7,924
4600,전라남도,4607,광양시,,광양읍제9투,3823,2415,2064,262,40,3,27,0,0,0,1,4,2,1,2404,11,1408
4600,전라남도,4607,광양시,,광양읍제10투,1579,1049,888,119,18,0,14,0,1,0,0,4,0,1,1045,4,530
4600,전라남도,4607,광양시,,광양읍제11투,2388,1620,1312,244,25,0,11,0,0,0,2,4,2,3,1603,17,768
4600,전라남도,4607,광양시,,광양읍제12투,2927,1999,1728,214,17,0,20,0,0,0,1,4,0,1,1985,14,928
4600,전라남도,4607,광양시,,광양읍제13투,2590,1941,1702,176,27,0,18,0,0,0,0,5,0,0,1928,13,649
4600,전라남도,4607,광양시,,광양읍제14투,1355,1038,873,136,15,0,5,1,0,0,0,2,0,1,1033,5,317
4600,전라남도,4607,광양시,봉강면,소계,2952,2605,2261,266,24,2,13,1,1,1,0,1,0,8,2578,27,347
4600,전라남도,4607,광양시,,관내사전투표,1945,1945,1698,188,17,2,10,1,1,1,0,1,0,4,1923,22,0
4600,전라남도,4607,광양시,,봉강면제1투,381,257,224,26,1,0,2,0,0,0,0,0,0,2,255,2,124
4600,전라남도,4607,광양시,,봉강면제2투,626,403,339,52,6,0,1,0,0,0,0,0,0,2,400,3,223
4600,전라남도,4607,광양시,옥룡면,소계,3501,3038,2651,313,26,0,15,1,0,0,1,3,0,12,3022,16,463
4600,전라남도,4607,광양시,,관내사전투표,2190,2190,1947,202,17,0,11,1,0,0,1,1,0,6,2186,4,0
4600,전라남도,4607,광양시,,옥룡면제1투,720,461,373,69,8,0,3,0,0,0,0,1,0,2,456,5,259
4600,전라남도,4607,광양시,,옥룡면제2투,591,387,331,42,1,0,1,0,0,0,0,1,0,4,380,7,204
4600,전라남도,4607,광양시,옥곡면,소계,3600,2784,2363,342,35,1,13,1,0,0,0,2,1,8,2766,18,816
4600,전라남도,4607,광양시,,관내사전투표,1792,1792,1576,174,18,0,4,1,0,0,0,1,0,4,1778,14,0
4600,전라남도,4607,광양시,,옥곡면투표소,1808,992,787,168,17,1,9,0,0,0,0,1,1,4,988,4,816
4600,전라남도,4607,광양시,진상면,소계,2444,1947,1709,161,27,1,7,1,0,0,1,6,1,6,1920,27,497
4600,전라남도,4607,광양시,,관내사전투표,1159,1159,1030,90,18,1,4,0,0,0,0,2,1,2,1148,11,0
4600,전라남도,4607,광양시,,진상면제1투,791,469,399,50,5,0,1,1,0,0,1,2,0,1,460,9,322
4600,전라남도,4607,광양시,,진상면제2투,494,319,280,21,4,0,2,0,0,0,0,2,0,3,312,7,175
4600,전라남도,4607,광양시,진월면,소계,2371,1882,1602,205,23,1,15,2,0,0,0,1,0,10,1859,23,489
4600,전라남도,4607,광양시,,관내사전투표,1019,1019,879,106,15,0,3,0,0,0,0,1,0,3,1007,12,0
4600,전라남도,4607,광양시,,진월면제1투,586,322,273,34,2,0,4,2,0,0,0,0,0,3,318,4,264
4600,전라남도,4607,광양시,,진월면제2투,357,250,219,17,1,1,6,0,0,0,0,0,0,1,245,5,107
4600,전라남도,4607,광양시,,진월면제3투,409,291,231,48,5,0,2,0,0,0,0,0,0,3,289,2,118
4600,전라남도,4607,광양시,다압면,소계,1453,1138,918,170,20,2,10,0,0,0,1,2,0,1,1124,14,315
4600,전라남도,4607,광양시,,관내사전투표,566,566,479,67,10,1,4,0,0,0,0,1,0,1,563,3,0
4600,전라남도,4607,광양시,,다압면제1투,467,328,256,61,5,0,0,0,0,0,0,1,0,0,323,5,139
4600,전라남도,4607,광양시,,다압면제2투,420,244,183,42,5,1,6,0,0,0,1,0,0,0,238,6,176
4600,전라남도,4607,광양시,골약동,소계,3825,3291,2657,550,47,0,17,0,0,0,2,3,1,2,3279,12,534
4600,전라남도,4607,광양시,,관내사전투표,2224,2224,1846,327,32,0,8,0,0,0,0,2,1,2,2218,6,0
4600,전라남도,4607,광양시,,골약동제1투,395,265,233,27,1,0,2,0,0,0,0,0,0,0,263,2,130
4600,전라남도,4607,광양시,,골약동제2투,1206,802,578,196,14,0,7,0,0,0,2,1,0,0,798,4,404
4600,전라남도,4607,광양시,중마동,소계,39811,30086,24258,4765,517,9,274,3,1,3,5,57,5,7,29904,182,9725
4600,전라남도,4607,광양시,,관내사전투표,14697,14697,12167,2110,219,5,94,1,1,1,1,27,1,1,14628,69,0
4600,전라남도,4607,광양시,,중마동제1투,2218,1330,1003,265,31,0,15,1,0,0,0,3,0,1,1319,11,888
4600,전라남도,4607,광양시,,중마동제2투,2549,1352,1073,220,20,0,23,0,0,0,0,4,1,1,1342,10,1197
4600,전라남도,4607,광양시,,중마동제3투,2965,1806,1420,321,33,0,15,0,0,0,0,4,0,2,1795,11,1159
4600,전라남도,4607,광양시,,중마동제4투,2867,1798,1401,312,41,1,22,0,0,1,1,5,0,0,1784,14,1069
4600,전라남도,4607,광양시,,중마동제5투,3288,1968,1551,334,37,0,26,0,0,1,0,4,0,0,1953,15,1320
4600,전라남도,4607,광양시,,중마동제6투,3014,1906,1473,334,36,0,37,0,0,0,1,3,3,0,1887,19,1108
4600,전라남도,4607,광양시,,중마동제7투,2765,1840,1485,292,42,1,8,0,0,0,0,2,0,0,1830,10,925
4600,전라남도,4607,광양시,,중마동제8투,2478,1687,1378,246,32,2,13,1,0,0,2,1,0,1,1676,11,791
4600,전라남도,4607,광양시,,중마동제9투,2970,1702,1307,331,26,0,21,0,0,0,0,4,0,1,1690,12,1268
4600,전라남도,4607,광양시,광영동,소계,10063,7637,6156,1213,115,5,89,2,1,1,0,13,1,5,7601,36,2426
4600,전라남도,4607,광양시,,관내사전투표,4596,4596,3830,642,52,5,35,2,0,0,0,9,1,4,4580,16,0
4600,전라남도,4607,광양시,,광영동제1투,1858,937,717,171,14,0,24,0,0,0,0,1,0,1,928,9,921
4600,전라남도,4607,광양시,,광영동제2투,1401,821,637,142,21,0,15,0,0,1,0,0,0,0,816,5,580
4600,전라남도,4607,광양시,,광영동제3투,2208,1283,972,258,28,0,15,0,1,0,0,3,0,0,1277,6,925
4600,전라남도,4607,광양시,태인동,소계,1812,1503,1307,147,20,1,13,0,0,0,0,4,0,3,1495,8,309
4600,전라남도,4607,광양시,,관내사전투표,1078,1078,939,107,13,1,9,0,0,0,0,3,0,2,1074,4,0
4600,전라남도,4607,광양시,,태인동투표소,734,425,368,40,7,0,4,0,0,0,0,1,0,1,421,4,309
4600,전라남도,4607,광양시,금호동,소계,8796,7393,5043,2070,173,3,54,1,1,2,1,5,1,2,7356,37,1403
4600,전라남도,4607,광양시,,관내사전투표,4395,4395,3182,1100,77,2,20,0,0,2,0,2,0,1,4386,9,0
4600,전라남도,4607,광양시,,금호동제1투,1045,723,467,210,25,0,9,0,1,0,1,1,0,0,714,9,322
4600,전라남도,4607,광양시,,금호동제2투,796,575,360,185,17,0,7,0,0,0,0,1,1,0,571,4,221
4600,전라남도,4607,광양시,,금호동제3투,886,583,339,213,17,0,6,0,0,0,0,1,0,0,576,7,303
4600,전라남도,4607,광양시,,금호동제4투,830,531,332,176,15,0,4,1,0,0,0,0,0,0,528,3,299
4600,전라남도,4607,광양시,,금호동제5투,844,586,363,186,22,1,8,0,0,0,0,0,0,1,581,5,258
4600,전라남도,4607,광양시,잘못 투입·구분된 투표지,,0,0,0,0,0,0,0,0,0,0,0,0,0,0,0,0,0
4600,전라남도,4608,담양군,합계,,41698,34632,30076,3435,396,20,204,15,5,9,14,46,25,97,34342,290,7066
4600,전라남도,4608,담양군,거소·선상투표,,139,133,85,23,4,0,6,0,0,0,0,0,0,0,118,15,6
4600,전라남도,4608,담양군,관외사전투표,,6257,6255,5139,884,102,3,62,4,1,0,0,6,4,8,6213,42,2
4600,전라남도,4608,담양군,재외투표,,152,101,75,15,2,0,0,0,0,0,1,0,0,0,93,8,51
4600,전라남도,4608,담양군,담양읍,소계,10621,8226,7171,831,92,2,50,0,1,4,2,6,3,13,8175,51,2395
4600,전라남도,4608,담양군,,관내사전투표,4464,4464,3983,390,44,1,14,0,1,3,1,4,1,6,4448,16,0
4600,전라남도,4608,담양군,,담양읍제1투,1542,920,778,103,12,1,9,0,0,1,0,0,1,4,909,11,622
4600,전라남도,4608,담양군,,담양읍제2투,735,447,403,32,4,0,4,0,0,0,0,0,0,0,443,4,288
4600,전라남도,4608,담양군,,담양읍제3투,1945,1206,993,170,23,0,8,0,0,0,1,0,1,2,1198,8,739
4600,전라남도,4608,담양군,,담양읍제4투,880,540,442,76,5,0,8,0,0,0,0,1,0,0,532,8,340
4600,전라남도,4608,담양군,,담양읍제5투,1055,649,572,60,4,0,7,0,0,0,0,1,0,1,645,4,406
4600,전라남도,4608,담양군,봉산면,소계,2173,1735,1555,139,12,1,7,2,1,1,1,2,1,3,1725,10,438
4600,전라남도,4608,담양군,,관내사전투표,1081,1080,986,74,6,0,5,2,0,0,1,1,0,1,1076,4,1
4600,전라남도,4608,담양군,,봉산면제1투,713,399,337,47,4,0,1,0,1,1,0,1,0,2,394,5,314
4600,전라남도,4608,담양군,,봉산면제2투,379,256,232,18,2,1,1,0,0,0,0,0,1,0,255,1,123
4600,전라남도,4608,담양군,고서면,소계,2444,1980,1759,159,12,0,7,0,0,1,0,6,0,19,1963,17,464
4600,전라남도,4608,담양군,,관내사전투표,1396,1396,1251,99,8,0,3,0,0,1,0,5,0,16,1383,13,0
4600,전라남도,4608,담양군,,고서면제1투,563,307,275,21,3,0,3,0,0,0,0,1,0,3,306,1,256
4600,전라남도,4608,담양군,,고서면제2투,485,277,233,39,1,0,1,0,0,0,0,0,0,0,274,3,208
4600,전라남도,4608,담양군,창평면,소계,2819,2293,2036,176,23,1,7,2,0,0,1,6,2,12,2266,27,526
4600,전라남도,4608,담양군,,관내사전투표,1663,1663,1505,99,17,1,5,2,0,0,0,3,2,10,1644,19,0
4600,전라남도,4608,담양군,,창평면제1투,817,454,375,60,4,0,2,0,0,0,1,3,0,2,447,7,363
4600,전라남도,4608,담양군,,창평면제2투,339,176,156,17,2,0,0,0,0,0,0,0,0,0,175,1,163
4600,전라남도,4608,담양군,대덕면,소계,1358,1055,918,106,14,1,2,0,0,0,2,0,0,3,1046,9,303
4600,전라남도,4608,담양군,,관내사전투표,661,661,584,63,6,1,0,0,0,0,1,0,0,2,657,4,0
4600,전라남도,4608,담양군,,대덕면제1투,536,296,243,38,7,0,2,0,0,0,1,0,0,1,292,4,240
4600,전라남도,4608,담양군,,대덕면제2투,161,98,91,5,1,0,0,0,0,0,0,0,0,0,97,1,63
4600,전라남도,4608,담양군,무정면,소계,2051,1580,1330,185,16,1,19,0,0,1,0,1,1,7,1561,19,471
4600,전라남도,4608,담양군,,관내사전투표,1020,1019,858,120,9,1,16,0,0,1,0,1,0,1,1007,12,1
4600,전라남도,4608,담양군,,무정면투표소,1031,561,472,65,7,0,3,0,0,0,0,0,1,6,554,7,470
4600,전라남도,4608,담양군,금성면,소계,2102,1671,1464,151,17,1,6,1,1,1,2,2,2,6,1654,17,431
4600,전라남도,4608,담양군,,관내사전투표,1191,1191,1044,104,12,1,4,1,1,1,2,1,2,5,1178,13,0
4600,전라남도,4608,담양군,,금성면투표소,911,480,420,47,5,0,2,0,0,0,0,1,0,1,476,4,431
4600,전라남도,4608,담양군,용면,소계,1592,1326,1179,113,8,0,4,0,0,0,0,6,2,2,1314,12,266
4600,전라남도,4608,담양군,,관내사전투표,843,843,764,62,8,0,1,0,0,0,0,4,2,0,841,2,0
4600,전라남도,4608,담양군,,용면제1투,566,356,303,39,0,0,3,0,0,0,0,1,0,2,348,8,210
4600,전라남도,4608,담양군,,용면제2투,183,127,112,12,0,0,0,0,0,0,0,1,0,0,125,2,56
4600,전라남도,4608,담양군,월산면,소계,2077,1708,1498,153,13,2,8,0,1,0,3,1,5,6,1690,18,369
4600,전라남도,4608,담양군,,관내사전투표,1227,1227,1100,85,8,2,6,0,1,0,2,1,4,4,1213,14,0
4600,전라남도,4608,담양군,,월산면투표소,850,481,398,68,5,0,2,0,0,0,1,0,1,2,477,4,369
4600,전라남도,4608,담양군,수북면,소계,3869,3281,2915,254,58,6,13,4,0,0,1,3,2,9,3265,16,588
4600,전라남도,4608,담양군,,관내사전투표,2298,2298,2068,162,40,4,5,4,0,0,0,0,0,7,2290,8,0
4600,전라남도,4608,담양군,,수북면제1투,1193,721,613,75,13,2,7,0,0,0,1,3,0,1,715,6,472
4600,전라남도,4608,담양군,,수북면제2투,378,262,234,17,5,0,1,0,0,0,0,0,2,1,260,2,116
4600,전라남도,4608,담양군,대전면,소계,3159,2562,2306,187,18,2,11,2,0,1,1,4,2,4,2538,24,597
4600,전라남도,4608,담양군,,관내사전투표,1575,1575,1449,84,11,2,5,1,0,0,0,2,2,3,1559,16,0
4600,전라남도,4608,담양군,,대전면제1투,1124,686,586,79,6,0,5,0,0,1,1,2,0,0,680,6,438
4600,전라남도,4608,담양군,,대전면제2투,460,301,271,24,1,0,1,1,0,0,0,0,0,1,299,2,159
4600,전라남도,4608,담양군,가사문학면,소계,885,723,644,59,5,0,1,0,0,0,0,3,1,5,718,5,162
4600,전라남도,4608,담양군,,관내사전투표,497,497,445,39,3,0,0,0,0,0,0,3,0,3,493,4,0
4600,전라남도,4608,담양군,,가사문학면제1투,197,114,97,12,2,0,1,0,0,0,0,0,1,0,113,1,83
4600,전라남도,4608,담양군,,가사문학면제2투,191,112,102,8,0,0,0,0,0,0,0,0,0,2,112,0,79
4600,전라남도,4608,담양군,잘못 투입·구분된 투표지,,0,3,2,0,0,0,1,0,0,0,0,0,0,0,3,0,-3
4600,전라남도,4609,장성군,합계,,38486,31666,27132,3566,386,18,189,6,7,4,5,26,19,69,31427,239,6820
4600,전라남도,4609,장성군,거소·선상투표,,145,135,109,10,0,0,1,0,0,0,1,0,0,0,121,14,10
4600,전라남도,4609,장성군,관외사전투표,,5540,5539,4525,830,90,3,44,0,0,1,0,7,6,1,5507,32,1
4600,전라남도,4609,장성군,재외투표,,110,69,61,4,1,0,2,0,0,0,0,0,0,0,68,1,41
4600,전라남도,4609,장성군,장성읍,소계,9957,7921,7001,707,92,4,41,1,1,2,2,3,0,19,7873,48,2036
4600,전라남도,4609,장성군,,관내사전투표,5390,5390,4856,420,48,1,21,1,0,1,2,3,0,13,5366,24,0
4600,전라남도,4609,장성군,,장성읍제1투,997,547,437,77,17,0,8,0,1,0,0,0,0,2,542,5,450
4600,전라남도,4609,장성군,,장성읍제2투,974,506,419,67,8,0,2,0,0,1,0,0,0,0,497,9,468
4600,전라남도,4609,장성군,,장성읍제3투,1412,766,655,89,9,3,5,0,0,0,0,0,0,1,762,4,646
4600,전라남도,4609,장성군,,장성읍제4투,1184,712,634,54,10,0,5,0,0,0,0,0,0,3,706,6,472
4600,전라남도,4609,장성군,진원면,소계,2472,2027,1783,192,24,0,10,2,0,0,0,1,0,3,2015,12,445
4600,전라남도,4609,장성군,,관내사전투표,1292,1292,1165,103,13,0,5,1,0,0,0,0,0,3,1290,2,0
4600,전라남도,4609,장성군,,진원면제1투,711,428,347,64,6,0,3,0,0,0,0,1,0,0,421,7,283
4600,전라남도,4609,장성군,,진원면제2투,469,307,271,25,5,0,2,1,0,0,0,0,0,0,304,3,162
4600,전라남도,4609,장성군,남면,소계,2820,2194,1944,183,27,1,16,0,0,0,0,2,0,7,2180,14,626
4600,전라남도,4609,장성군,,관내사전투표,1434,1434,1298,110,10,0,6,0,0,0,0,0,0,3,1427,7,0
4600,전라남도,4609,장성군,,남면제1투,668,330,275,38,6,0,6,0,0,0,0,1,0,2,328,2,338
4600,전라남도,4609,장성군,,남면제2투,718,430,371,35,11,1,4,0,0,0,0,1,0,2,425,5,288
4600,전라남도,4609,장성군,동화면,소계,1637,1350,1177,131,12,0,5,0,0,0,0,5,3,5,1338,12,287
4600,전라남도,4609,장성군,,관내사전투표,853,853,769,66,7,0,2,0,0,0,0,1,1,3,849,4,0
4600,전라남도,4609,장성군,,동화면제1투,508,305,248,43,1,0,3,0,0,0,0,4,0,0,299,6,203
4600,전라남도,4609,장성군,,동화면제2투,276,192,160,22,4,0,0,0,0,0,0,0,2,2,190,2,84
4600,전라남도,4609,장성군,삼서면,소계,2222,1733,1483,194,20,0,9,1,0,0,0,1,4,6,1718,15,489
4600,전라남도,4609,장성군,,관내사전투표,1236,1236,1056,144,9,0,5,1,0,0,0,1,3,3,1222,14,0
4600,전라남도,4609,장성군,,삼서면투표소,986,497,427,50,11,0,4,0,0,0,0,0,1,3,496,1,489
4600,전라남도,4609,장성군,삼계면,소계,4148,3255,2505,639,45,1,24,0,2,0,1,2,1,7,3227,28,893
4600,전라남도,4609,장성군,,관내사전투표,2263,2263,1793,397,28,1,20,0,1,0,1,2,0,4,2247,16,0
4600,전라남도,4609,장성군,,삼계면제1투,824,446,369,63,4,0,0,0,1,0,0,0,1,3,441,5,378
4600,전라남도,4609,장성군,,삼계면제2투,746,375,190,163,13,0,4,0,0,0,0,0,0,0,370,5,371
4600,전라남도,4609,장성군,,삼계면제3투,315,171,153,16,0,0,0,0,0,0,0,0,0,0,169,2,144
4600,전라남도,4609,장성군,황룡면,소계,3174,2452,2167,216,21,2,15,0,1,1,0,3,1,7,2434,18,722
4600,전라남도,4609,장성군,,관내사전투표,1591,1591,1413,132,14,0,9,0,1,0,0,2,1,5,1577,14,0
4600,전라남도,4609,장성군,,황룡면제1투,527,283,245,29,2,0,3,0,0,1,0,1,0,0,281,2,244
4600,전라남도,4609,장성군,,황룡면제2투,1056,578,509,55,5,2,3,0,0,0,0,0,0,2,576,2,478
4600,전라남도,4609,장성군,서삼면,소계,1146,937,811,104,10,1,1,1,0,0,0,1,0,2,931,6,209
4600,전라남도,4609,장성군,,관내사전투표,644,644,562,68,6,0,0,1,0,0,0,1,0,1,639,5,0
4600,전라남도,4609,장성군,,서삼면투표소,502,293,249,36,4,1,1,0,0,0,0,0,0,1,292,1,209
4600,전라남도,4609,장성군,북일면,소계,1140,932,828,79,10,2,6,0,0,0,0,0,0,2,927,5,208
4600,전라남도,4609,장성군,,관내사전투표,650,650,587,51,4,2,2,0,0,0,0,0,0,2,648,2,0
4600,전라남도,4609,장성군,,북일면투표소,490,282,241,28,6,0,4,0,0,0,0,0,0,0,279,3,208
4600,전라남도,4609,장성군,북이면,소계,2266,1808,1594,161,17,1,10,1,1,0,0,0,3,3,1791,17,458
4600,전라남도,4609,장성군,,관내사전투표,1372,1372,1236,100,12,1,6,1,1,0,0,0,1,3,1361,11,0
4600,전라남도,4609,장성군,,북이면제1투,406,203,169,25,4,0,2,0,0,0,0,0,1,0,201,2,203
4600,전라남도,4609,장성군,,북이면제2투,488,233,189,36,1,0,2,0,0,0,0,0,1,0,229,4,255
4600,전라남도,4609,장성군,북하면,소계,1709,1313,1143,116,17,3,5,0,2,0,1,1,1,7,1296,17,396
4600,전라남도,4609,장성군,,관내사전투표,1022,1022,909,71,12,3,1,0,2,0,1,1,1,7,1008,14,0
4600,전라남도,4609,장성군,,북하면투표소,687,291,234,45,5,0,4,0,0,0,0,0,0,0,288,3,396
4600,전라남도,4609,장성군,잘못 투입·구분된 투표지,,0,1,1,0,0,0,0,0,0,0,0,0,0,0,1,0,-1
4600,전라남도,4610,곡성군,합계,,25143,20717,17472,2380,305,22,132,14,5,8,8,35,20,84,20485,232,4426
4600,전라남도,4610,곡성군,거소·선상투표,,181,147,69,16,6,1,7,1,0,2,1,6,2,5,116,31,34
4600,전라남도,4610,곡성군,관외사전투표,,3238,3236,2612,495,69,4,21,3,1,1,1,5,0,0,3212,24,2
4600,전라남도,4610,곡성군,재외투표,,90,52,34,15,1,0,0,0,0,0,0,0,0,0,50,2,38
4600,전라남도,4610,곡성군,곡성읍,소계,6175,4960,4207,565,72,5,31,1,1,2,1,8,1,17,4911,49,1215
4600,전라남도,4610,곡성군,,관내사전투표,3267,3267,2803,349,47,5,15,0,1,2,0,5,1,9,3237,30,0
4600,전라남도,4610,곡성군,,곡성읍제1투,710,418,340,62,5,0,2,0,0,0,0,1,0,4,414,4,292
4600,전라남도,4610,곡성군,,곡성읍제2투,667,395,320,55,7,0,7,1,0,0,1,1,0,1,393,2,272
4600,전라남도,4610,곡성군,,곡성읍제3투,927,543,463,61,5,0,3,0,0,0,0,1,0,1,534,9,384
4600,전라남도,4610,곡성군,,곡성읍제4투,604,337,281,38,8,0,4,0,0,0,0,0,0,2,333,4,267
4600,전라남도,4610,곡성군,오곡면,소계,1479,1224,1023,152,21,1,8,0,0,0,0,3,2,4,1214,10,255
4600,전라남도,4610,곡성군,,관내사전투표,782,782,661,89,14,1,5,0,0,0,0,3,2,2,777,5,0
4600,전라남도,4610,곡성군,,오곡면투표소,697,442,362,63,7,0,3,0,0,0,0,0,0,2,437,5,255
4600,전라남도,4610,곡성군,삼기면,소계,1269,991,856,100,3,1,6,1,1,0,0,0,2,7,977,14,278
4600,전라남도,4610,곡성군,,관내사전투표,595,595,529,51,2,1,1,1,0,0,0,0,1,5,591,4,0
4600,전라남도,4610,곡성군,,삼기면투표소,674,396,327,49,1,0,5,0,1,0,0,0,1,2,386,10,278
4600,전라남도,4610,곡성군,석곡면,소계,2103,1721,1505,150,20,2,10,1,1,1,0,0,1,11,1702,19,382
4600,전라남도,4610,곡성군,,관내사전투표,1350,1350,1210,95,18,1,5,1,0,0,0,0,0,7,1337,13,0
4600,전라남도,4610,곡성군,,석곡면투표소,753,371,295,55,2,1,5,0,1,1,0,0,1,4,365,6,382
4600,전라남도,4610,곡성군,목사동면,소계,931,693,598,62,6,1,1,2,0,0,1,0,0,10,681,12,238
4600,전라남도,4610,곡성군,,관내사전투표,470,470,410,37,3,1,1,2,0,0,1,0,0,5,460,10,0
4600,전라남도,4610,곡성군,,목사동면투표소,461,223,188,25,3,0,0,0,0,0,0,0,0,5,221,2,238
4600,전라남도,4610,곡성군,죽곡면,소계,1366,1088,925,136,9,2,3,0,0,1,0,0,1,3,1080,8,278
4600,전라남도,4610,곡성군,,관내사전투표,770,770,654,98,6,0,3,0,0,1,0,0,1,2,765,5,0
4600,전라남도,4610,곡성군,,죽곡면투표소,596,318,271,38,3,2,0,0,0,0,0,0,0,1,315,3,278
4600,전라남도,4610,곡성군,고달면,소계,947,767,678,68,6,1,4,1,0,0,0,0,1,3,762,5,180
4600,전라남도,4610,곡성군,,관내사전투표,466,466,417,38,3,1,1,1,0,0,0,0,0,2,463,3,0
4600,전라남도,4610,곡성군,,고달면투표소,481,301,261,30,3,0,3,0,0,0,0,0,1,1,299,2,180
4600,전라남도,4610,곡성군,옥과면,소계,3359,2695,2291,296,48,2,21,0,0,1,1,1,3,6,2670,25,664
4600,전라남도,4610,곡성군,,관내사전투표,1875,1875,1618,192,30,2,10,0,0,1,1,1,2,4,1861,14,0
4600,전라남도,4610,곡성군,,옥과면제1투,960,505,410,65,12,0,9,0,0,0,0,0,1,1,498,7,455
4600,전라남도,4610,곡성군,,옥과면제2투,524,315,263,39,6,0,2,0,0,0,0,0,0,1,311,4,209
4600,전라남도,4610,곡성군,입면,소계,1738,1386,1193,127,21,0,10,2,0,0,1,6,2,7,1369,17,352
4600,전라남도,4610,곡성군,,관내사전투표,1003,1003,885,82,10,0,3,1,0,0,1,2,1,6,991,12,0
4600,전라남도,4610,곡성군,,입면투표소,735,383,308,45,11,0,7,1,0,0,0,4,1,1,378,5,352
4600,전라남도,4610,곡성군,겸면,소계,1250,982,825,104,17,1,7,2,0,0,2,6,3,4,971,11,268
4600,전라남도,4610,곡성군,,관내사전투표,605,605,526,50,10,1,2,0,0,0,1,4,2,4,600,5,0
4600,전라남도,4610,곡성군,,겸면투표소,645,377,299,54,7,0,5,2,0,0,1,2,1,0,371,6,268
4600,전라남도,4610,곡성군,오산면,소계,1017,775,656,94,6,1,3,0,1,0,0,0,2,7,770,5,242
4600,전라남도,4610,곡성군,,관내사전투표,504,504,434,62,1,1,0,0,0,0,0,0,1,2,501,3,0
4600,전라남도,4610,곡성군,,오산면투표소,513,271,222,32,5,0,3,0,1,0,0,0,1,5,269,2,242
4600,전라남도,4610,곡성군,잘못 투입·구분된 투표지,,0,0,0,0,0,0,0,0,0,0,0,0,0,0,0,0,0
4600,전라남도,4611,구례군,합계,,22770,19132,16137,2352,232,12,114,10,1,7,3,46,5,40,18959,173,3638
4600,전라남도,4611,구례군,거소·선상투표,,159,151,113,20,4,0,0,0,0,0,0,0,0,0,137,14,8
4600,전라남도,4611,구례군,관외사전투표,,2550,2549,1988,469,39,2,16,1,0,2,1,7,0,1,2526,23,1
4600,전라남도,4611,구례군,재외투표,,89,56,40,14,2,0,0,0,0,0,0,0,0,0,56,0,33
4600,전라남도,4611,구례군,구례읍,소계,7890,6451,5552,697,88,4,48,1,0,0,1,12,1,4,6408,43,1439
4600,전라남도,4611,구례군,,관내사전투표,3861,3861,3374,381,50,3,21,1,0,0,1,5,0,2,3838,23,0
4600,전라남도,4611,구례군,,구례읍제1투,563,382,325,43,7,0,2,0,0,0,0,0,1,0,378,4,181
4600,전라남도,4611,구례군,,구례읍제2투,911,601,519,65,7,0,6,0,0,0,0,0,0,0,597,4,310
4600,전라남도,4611,구례군,,구례읍제3투,889,540,448,77,6,0,5,0,0,0,0,2,0,0,538,2,349
4600,전라남도,4611,구례군,,구례읍제4투,662,424,363,47,6,0,5,0,0,0,0,0,0,0,421,3,238
4600,전라남도,4611,구례군,,구례읍제5투,1004,643,523,84,12,1,9,0,0,0,0,5,0,2,636,7,361
4600,전라남도,4611,구례군,문척면,소계,1240,1037,874,130,11,1,4,1,0,0,0,6,0,2,1029,8,203
4600,전라남도,4611,구례군,,관내사전투표,706,706,609,77,8,1,2,0,0,0,0,5,0,0,702,4,0
4600,전라남도,4611,구례군,,문척면투표소,534,331,265,53,3,0,2,1,0,0,0,1,0,2,327,4,203
4600,전라남도,4611,구례군,간전면,소계,1199,984,840,110,9,1,4,0,0,0,0,2,1,9,976,8,215
4600,전라남도,4611,구례군,,관내사전투표,601,601,519,66,6,1,1,0,0,0,0,1,0,2,596,5,0
4600,전라남도,4611,구례군,,간전면제1투,263,155,130,20,1,0,1,0,0,0,0,0,1,2,155,0,108
4600,전라남도,4611,구례군,,간전면제2투,164,111,100,6,0,0,0,0,0,0,0,0,0,3,109,2,53
4600,전라남도,4611,구례군,,간전면제3투,171,117,91,18,2,0,2,0,0,0,0,1,0,2,116,1,54
4600,전라남도,4611,구례군,토지면,소계,1941,1598,1351,192,14,1,7,2,1,0,0,2,1,8,1579,19,343
4600,전라남도,4611,구례군,,관내사전투표,979,979,840,107,7,1,4,2,1,0,0,1,1,4,968,11,0
4600,전라남도,4611,구례군,,토지면제1투,535,326,272,46,1,0,2,0,0,0,0,0,0,1,322,4,209
4600,전라남도,4611,구례군,,토지면제2투,200,128,103,13,3,0,1,0,0,0,0,1,0,3,124,4,72
4600,전라남도,4611,구례군,,토지면제3투,227,165,136,26,3,0,0,0,0,0,0,0,0,0,165,0,62
4600,전라남도,4611,구례군,마산면,소계,2256,1836,1550,202,27,2,14,3,0,2,0,6,0,2,1808,28,420
4600,전라남도,4611,구례군,,관내사전투표,1316,1316,1132,128,16,2,7,2,0,1,0,3,0,2,1293,23,0
4600,전라남도,4611,구례군,,마산면투표소,940,520,418,74,11,0,7,1,0,1,0,3,0,0,515,5,420
4600,전라남도,4611,구례군,광의면,소계,1812,1455,1262,151,15,1,7,1,0,0,1,3,0,4,1445,10,357
4600,전라남도,4611,구례군,,관내사전투표,899,899,793,84,7,1,3,0,0,0,1,0,0,3,892,7,0
4600,전라남도,4611,구례군,,광의면제1투,566,343,284,42,8,0,4,1,0,0,0,2,0,1,342,1,223
4600,전라남도,4611,구례군,,광의면제2투,347,213,185,25,0,0,0,0,0,0,0,1,0,0,211,2,134
4600,전라남도,4611,구례군,용방면,소계,1267,1071,920,115,10,0,5,1,0,2,0,5,0,2,1060,11,196
4600,전라남도,4611,구례군,,관내사전투표,695,695,630,48,5,0,5,0,0,0,0,1,0,1,690,5,0
4600,전라남도,4611,구례군,,용방면투표소,572,376,290,67,5,0,0,1,0,2,0,4,0,1,370,6,196
4600,전라남도,4611,구례군,산동면,소계,2367,1944,1647,252,13,0,9,0,0,1,0,3,2,8,1935,9,423
4600,전라남도,4611,구례군,,관내사전투표,1203,1203,1042,136,8,0,4,0,0,1,0,2,0,5,1198,5,0
4600,전라남도,4611,구례군,,산동면제1투,509,310,253,47,3,0,4,0,0,0,0,0,1,1,309,1,199
4600,전라남도,4611,구례군,,산동면제2투,414,260,212,46,1,0,0,0,0,0,0,1,0,0,260,0,154
4600,전라남도,4611,구례군,,산동면제3투,241,171,140,23,1,0,1,0,0,0,0,0,1,2,168,3,70
4600,전라남도,4611,구례군,잘못 투입·구분된 투표지,,0,0,0,0,0,0,0,0,0,0,0,0,0,0,0,0,0
4600,전라남도,4612,고흥군,합계,,57414,47171,40466,5120,507,34,263,27,11,12,9,60,31,151,46691,480,10243
4600,전라남도,4612,고흥군,거소·선상투표,,360,327,238,31,6,1,4,4,1,0,1,0,0,1,287,40,33
4600,전라남도,4612,고흥군,관외사전투표,,4927,4923,3912,808,92,4,44,1,0,0,0,12,2,4,4879,44,4
4600,전라남도,4612,고흥군,재외투표,,177,113,73,26,4,0,1,0,0,0,0,0,0,0,104,9,64
4600,전라남도,4612,고흥군,고흥읍,소계,9165,7352,6296,846,97,2,47,4,1,2,1,9,1,6,7312,40,1813
4600,전라남도,4612,고흥군,,관내사전투표,4603,4603,4002,470,65,0,28,3,1,2,0,6,1,3,4581,22,0
4600,전라남도,4612,고흥군,,고흥읍제1투,379,287,256,24,2,0,2,0,0,0,0,0,0,0,284,3,92
4600,전라남도,4612,고흥군,,고흥읍제2투,674,409,351,46,4,0,2,1,0,0,0,2,0,1,407,2,265
4600,전라남도,4612,고흥군,,고흥읍제3투,1168,701,579,101,7,0,8,0,0,0,1,0,0,0,696,5,467
4600,전라남도,4612,고흥군,,고흥읍제4투,1147,677,550,104,11,1,4,0,0,0,0,1,0,1,672,5,470
4600,전라남도,4612,고흥군,,고흥읍제5투,1194,675,558,101,8,1,3,0,0,0,0,0,0,1,672,3,519
4600,전라남도,4612,고흥군,도양읍,소계,8757,6942,5977,795,57,4,29,0,1,3,0,3,6,8,6883,59,1815
4600,전라남도,4612,고흥군,,관내사전투표,4150,4150,3715,355,33,3,14,0,0,0,0,2,1,5,4128,22,0
4600,전라남도,4612,고흥군,,도양읍제1투,1027,603,515,74,7,0,1,0,0,0,0,0,1,0,598,5,424
4600,전라남도,4612,고흥군,,도양읍제2투,814,417,350,47,7,0,2,0,1,1,0,1,1,1,411,6,397
4600,전라남도,4612,고흥군,,도양읍제3투,1561,904,799,82,5,0,9,0,0,1,0,0,0,0,896,8,657
4600,전라남도,4612,고흥군,,도양읍제4투,276,203,188,11,1,0,1,0,0,0,0,0,0,1,202,1,73
4600,전라남도,4612,고흥군,,도양읍제5투,270,180,159,14,1,0,2,0,0,0,0,0,0,0,176,4,90
4600,전라남도,4612,고흥군,,도양읍제6투,477,355,130,207,3,1,0,0,0,1,0,0,3,1,346,9,122
4600,전라남도,4612,고흥군,,도양읍제7투,182,130,121,5,0,0,0,0,0,0,0,0,0,0,126,4,52
4600,전라남도,4612,고흥군,풍양면,소계,2784,2281,2024,182,20,2,22,1,0,3,1,1,1,8,2265,16,503
4600,전라남도,4612,고흥군,,관내사전투표,1433,1433,1282,109,11,1,10,1,0,2,0,1,1,6,1424,9,0
4600,전라남도,4612,고흥군,,풍양면제1투,766,413,353,41,6,1,7,0,0,1,1,0,0,1,411,2,353
4600,전라남도,4612,고흥군,,풍양면제2투,585,435,389,32,3,0,5,0,0,0,0,0,0,1,430,5,150
4600,전라남도,4612,고흥군,도덕면,소계,2409,1927,1716,167,10,2,1,0,1,0,0,4,2,7,1910,17,482
4600,전라남도,4612,고흥군,,관내사전투표,1251,1251,1138,93,4,2,1,0,1,0,0,2,1,4,1246,5,0
4600,전라남도,4612,고흥군,,도덕면제1투,619,346,296,44,3,0,0,0,0,0,0,1,0,0,344,2,273
4600,전라남도,4612,고흥군,,도덕면제2투,539,330,282,30,3,0,0,0,0,0,0,1,1,3,320,10,209
4600,전라남도,4612,고흥군,금산면,소계,3635,2960,2613,257,28,0,17,1,1,0,2,2,1,14,2936,24,675
4600,전라남도,4612,고흥군,,관내사전투표,2234,2234,1982,190,15,0,9,1,1,0,1,2,1,14,2216,18,0
4600,전라남도,4612,고흥군,,금산면제1투,716,321,272,34,6,0,8,0,0,0,0,0,0,0,320,1,395
4600,전라남도,4612,고흥군,,금산면제2투,685,405,359,33,7,0,0,0,0,0,1,0,0,0,400,5,280
4600,전라남도,4612,고흥군,도화면,소계,3395,2714,2370,260,12,1,17,3,2,0,2,6,1,14,2688,26,681
4600,전라남도,4612,고흥군,,관내사전투표,1722,1722,1511,155,12,1,7,2,1,0,1,5,1,10,1706,16,0
4600,전라남도,4612,고흥군,,도화면제1투,305,212,191,19,0,0,0,0,0,0,0,0,0,2,212,0,93
4600,전라남도,4612,고흥군,,도화면제2투,1368,780,668,86,0,0,10,1,1,0,1,1,0,2,770,10,588
4600,전라남도,4612,고흥군,포두면,소계,4085,3253,2849,300,32,2,14,3,1,1,0,1,4,13,3220,33,832
4600,전라남도,4612,고흥군,,관내사전투표,1828,1828,1633,151,16,2,4,2,1,0,0,0,2,3,1814,14,0
4600,전라남도,4612,고흥군,,포두면제1투,371,270,232,24,4,0,1,0,0,0,0,1,1,4,267,3,101
4600,전라남도,4612,고흥군,,포두면제2투,403,280,247,20,2,0,5,0,0,0,0,0,0,1,275,5,123
4600,전라남도,4612,고흥군,,포두면제3투,817,427,356,55,4,0,2,1,0,1,0,0,0,2,421,6,390
4600,전라남도,4612,고흥군,,포두면제4투,666,448,381,50,6,0,2,0,0,0,0,0,1,3,443,5,218
4600,전라남도,4612,고흥군,봉래면,소계,1565,1234,1025,160,20,1,9,0,1,0,0,2,1,4,1223,11,331
4600,전라남도,4612,고흥군,,관내사전투표,889,889,763,100,13,1,4,0,1,0,0,1,1,2,886,3,0
4600,전라남도,4612,고흥군,,봉래면투표소,676,345,262,60,7,0,5,0,0,0,0,1,0,2,337,8,331
4600,전라남도,4612,고흥군,동일면,소계,1231,992,844,109,9,3,4,0,0,0,0,0,3,8,980,12,239
4600,전라남도,4612,고흥군,,관내사전투표,695,695,605,67,6,3,2,0,0,0,0,0,2,5,690,5,0
4600,전라남도,4612,고흥군,,동일면투표소,536,297,239,42,3,0,2,0,0,0,0,0,1,3,290,7,239
4600,전라남도,4612,고흥군,점암면,소계,2169,1773,1517,177,19,2,12,2,0,0,0,2,2,12,1745,28,396
4600,전라남도,4612,고흥군,,관내사전투표,1146,1146,997,94,14,2,6,1,0,0,0,1,0,8,1123,23,0
4600,전라남도,4612,고흥군,,점암면제1투,471,258,207,42,2,0,4,1,0,0,0,0,0,0,256,2,213
4600,전라남도,4612,고흥군,,점암면제2투,264,165,136,20,3,0,1,0,0,0,0,0,1,2,163,2,99
4600,전라남도,4612,고흥군,,점암면제3투,288,204,177,21,0,0,1,0,0,0,0,1,1,2,203,1,84
4600,전라남도,4612,고흥군,영남면,소계,1040,848,717,88,11,0,4,1,1,0,0,2,0,12,836,12,192
4600,전라남도,4612,고흥군,,관내사전투표,430,430,358,53,5,0,1,1,0,0,0,0,0,8,426,4,0
4600,전라남도,4612,고흥군,,영남면제1투,323,259,229,16,4,0,3,0,0,0,0,1,0,3,256,3,64
4600,전라남도,4612,고흥군,,영남면제2투,287,159,130,19,2,0,0,0,1,0,0,1,0,1,154,5,128
4600,전라남도,4612,고흥군,과역면,소계,3024,2517,2187,247,24,2,9,3,1,0,0,1,0,8,2482,35,507
4600,전라남도,4612,고흥군,,관내사전투표,1777,1777,1568,158,12,2,6,3,1,0,0,1,0,5,1756,21,0
4600,전라남도,4612,고흥군,,과역면제1투,790,458,380,60,8,0,1,0,0,0,0,0,0,2,451,7,332
4600,전라남도,4612,고흥군,,과역면제2투,457,282,239,29,4,0,2,0,0,0,0,0,0,1,275,7,175
4600,전라남도,4612,고흥군,남양면,소계,1794,1434,1224,135,12,3,9,0,0,1,2,8,1,12,1407,27,360
4600,전라남도,4612,고흥군,,관내사전투표,818,818,699,77,7,2,3,0,0,0,2,3,1,9,803,15,0
4600,전라남도,4612,고흥군,,남양면제1투,555,326,280,30,2,1,4,0,0,0,0,4,0,0,321,5,229
4600,전라남도,4612,고흥군,,남양면제2투,421,290,245,28,3,0,2,0,0,1,0,1,0,3,283,7,131
4600,전라남도,4612,고흥군,동강면,소계,2685,2164,1878,213,23,2,11,3,0,1,0,5,2,6,2144,20,521
4600,전라남도,4612,고흥군,,관내사전투표,1482,1482,1310,128,14,2,5,3,0,1,0,3,1,4,1471,11,0
4600,전라남도,4612,고흥군,,동강면제1투,587,321,266,40,6,0,3,0,0,0,0,2,0,0,317,4,266
4600,전라남도,4612,고흥군,,동강면제2투,616,361,302,45,3,0,3,0,0,0,0,0,1,2,356,5,255
4600,전라남도,4612,고흥군,대서면,소계,1762,1422,1260,114,19,1,3,0,0,0,0,2,2,7,1408,14,340
4600,전라남도,4612,고흥군,,관내사전투표,929,929,829,74,12,0,1,0,0,0,0,1,1,3,921,8,0
4600,전라남도,4612,고흥군,,대서면제1투,481,275,243,19,3,1,2,0,0,0,0,0,0,3,271,4,206
4600,전라남도,4612,고흥군,,대서면제2투,352,218,188,21,4,0,0,0,0,0,0,1,1,1,216,2,134
4600,전라남도,4612,고흥군,두원면,소계,2450,1995,1746,205,12,2,6,1,0,1,0,0,2,7,1982,13,455
4600,전라남도,4612,고흥군,,관내사전투표,1297,1297,1145,128,9,1,3,1,0,1,0,0,0,5,1293,4,0
4600,전라남도,4612,고흥군,,두원면제1투,596,326,267,53,1,0,2,0,0,0,0,0,0,1,324,2,270
4600,전라남도,4612,고흥군,,두원면제2투,557,372,334,24,2,1,1,0,0,0,0,0,2,1,365,7,185
4600,전라남도,4612,고흥군,잘못 투입·구분된 투표지,,0,0,0,0,0,0,0,0,0,0,0,0,0,0,0,0,0
4600,전라남도,4613,보성군,합계,,35850,29323,25214,3102,322,21,179,12,3,12,8,70,14,73,29030,293,6527
4600,전라남도,4613,보성군,거소·선상투표,,198,184,137,18,3,3,1,0,0,0,0,2,1,1,166,18,14
4600,전라남도,4613,보성군,관외사전투표,,4047,4047,3307,606,62,2,31,1,0,1,0,9,0,2,4021,26,0
4600,전라남도,4613,보성군,재외투표,,151,97,70,19,0,0,0,0,0,0,0,0,0,1,90,7,54
4600,전라남도,4613,보성군,보성읍,소계,6819,5500,4715,597,61,1,46,5,1,2,1,13,5,5,5452,48,1319
4600,전라남도,4613,보성군,,관내사전투표,3450,3450,3007,337,38,1,27,4,0,1,1,7,3,1,3427,23,0
4600,전라남도,4613,보성군,,보성읍제1투,556,308,262,37,5,0,1,0,0,0,0,1,0,0,306,2,248
4600,전라남도,4613,보성군,,보성읍제2투,529,314,247,49,5,0,4,0,0,0,0,0,2,0,307,7,215
4600,전라남도,4613,보성군,,보성읍제3투,911,579,492,71,4,0,9,1,0,0,0,0,0,0,577,2,332
4600,전라남도,4613,보성군,,보성읍제4투,230,133,113,15,2,0,0,0,0,0,0,0,0,2,132,1,97
4600,전라남도,4613,보성군,,보성읍제5투,752,477,394,60,4,0,4,0,0,1,0,4,0,2,469,8,275
4600,전라남도,4613,보성군,,보성읍제6투,391,239,200,28,3,0,1,0,1,0,0,1,0,0,234,5,152
4600,전라남도,4613,보성군,벌교읍,소계,9123,7157,6237,704,64,3,39,1,0,3,0,4,4,23,7082,75,1966
4600,전라남도,4613,보성군,,관내사전투표,3814,3814,3355,360,38,1,13,0,0,1,0,2,1,9,3780,34,0
4600,전라남도,4613,보성군,,벌교읍제1투,387,202,168,28,3,0,1,0,0,0,0,0,0,0,200,2,185
4600,전라남도,4613,보성군,,벌교읍제2투,549,342,309,26,2,0,2,0,0,0,0,1,0,0,340,2,207
4600,전라남도,4613,보성군,,벌교읍제3투,774,530,452,59,3,1,2,0,0,2,0,0,1,3,523,7,244
4600,전라남도,4613,보성군,,벌교읍제4투,602,367,320,34,2,0,4,0,0,0,0,0,0,2,362,5,235
4600,전라남도,4613,보성군,,벌교읍제5투,437,299,255,27,3,0,3,0,0,0,0,0,1,4,293,6,138
4600,전라남도,4613,보성군,,벌교읍제6투,429,259,221,32,0,0,1,0,0,0,0,0,1,2,257,2,170
4600,전라남도,4613,보성군,,벌교읍제7투,195,125,110,12,2,0,1,0,0,0,0,0,0,0,125,0,70
4600,전라남도,4613,보성군,,벌교읍제8투,1348,835,697,108,10,0,7,1,0,0,0,0,0,2,825,10,513
4600,전라남도,4613,보성군,,벌교읍제9투,387,252,225,16,1,1,3,0,0,0,0,0,0,1,247,5,135
4600,전라남도,4613,보성군,,벌교읍제10투,201,132,125,2,0,0,2,0,0,0,0,1,0,0,130,2,69
4600,전라남도,4613,보성군,노동면,소계,881,705,594,75,10,3,4,0,0,0,0,6,0,5,697,8,176
4600,전라남도,4613,보성군,,관내사전투표,542,542,455,59,9,1,4,0,0,0,0,6,0,3,537,5,0
4600,전라남도,4613,보성군,,노동면투표소,339,163,139,16,1,2,0,0,0,0,0,0,0,2,160,3,176
4600,전라남도,4613,보성군,미력면,소계,1121,891,782,76,12,1,2,0,0,0,0,3,0,1,877,14,230
4600,전라남도,4613,보성군,,관내사전투표,614,614,536,55,8,1,2,0,0,0,0,2,0,1,605,9,0
4600,전라남도,4613,보성군,,미력면투표소,507,277,246,21,4,0,0,0,0,0,0,1,0,0,272,5,230
4600,전라남도,4613,보성군,겸백면,소계,893,736,645,60,9,2,3,0,0,1,3,1,1,4,729,7,157
4600,전라남도,4613,보성군,,관내사전투표,523,523,464,40,3,2,0,0,0,1,2,1,1,4,518,5,0
4600,전라남도,4613,보성군,,겸백면투표소,370,213,181,20,6,0,3,0,0,0,1,0,0,0,211,2,157
4600,전라남도,4613,보성군,율어면,소계,906,716,625,69,7,1,6,1,0,0,0,0,1,1,711,5,190
4600,전라남도,4613,보성군,,관내사전투표,502,502,449,41,4,1,2,0,0,0,0,0,1,1,499,3,0
4600,전라남도,4613,보성군,,율어면투표소,404,214,176,28,3,0,4,1,0,0,0,0,0,0,212,2,190
4600,전라남도,4613,보성군,복내면,소계,1286,1052,915,99,14,3,6,1,1,2,0,2,0,4,1047,5,234
4600,전라남도,4613,보성군,,관내사전투표,737,737,662,50,8,1,3,1,1,1,0,2,0,4,733,4,0
4600,전라남도,4613,보성군,,복내면투표소,549,315,253,49,6,2,3,0,0,1,0,0,0,0,314,1,234
4600,전라남도,4613,보성군,문덕면,소계,693,564,492,54,4,0,3,0,0,0,1,6,0,0,560,4,129
4600,전라남도,4613,보성군,,관내사전투표,391,391,352,29,2,0,3,0,0,0,1,2,0,0,389,2,0
4600,전라남도,4613,보성군,,문덕면투표소,302,173,140,25,2,0,0,0,0,0,0,4,0,0,171,2,129
4600,전라남도,4613,보성군,조성면,소계,3072,2455,2159,213,30,0,12,0,1,2,2,4,0,10,2433,22,617
4600,전라남도,4613,보성군,,관내사전투표,1556,1556,1381,127,22,0,3,0,1,1,1,2,0,3,1541,15,0
4600,전라남도,4613,보성군,,조성면제1투,937,529,461,48,7,0,5,0,0,0,1,0,0,3,525,4,408
4600,전라남도,4613,보성군,,조성면제2투,579,370,317,38,1,0,4,0,0,1,0,2,0,4,367,3,209
4600,전라남도,4613,보성군,득량면,소계,3243,2516,2168,257,29,2,12,2,0,1,1,11,1,7,2491,25,727
4600,전라남도,4613,보성군,,관내사전투표,1502,1502,1324,130,17,2,8,0,0,0,0,6,1,3,1491,11,0
4600,전라남도,4613,보성군,,득량면제1투,503,266,212,36,5,0,2,1,0,0,0,3,0,3,262,4,237
4600,전라남도,4613,보성군,,득량면제2투,805,481,404,61,5,0,2,1,0,1,1,1,0,0,476,5,324
4600,전라남도,4613,보성군,,득량면제3투,433,267,228,30,2,0,0,0,0,0,0,1,0,1,262,5,166
4600,전라남도,4613,보성군,회천면,소계,2469,1924,1692,177,12,0,12,0,0,0,0,6,0,7,1906,18,545
4600,전라남도,4613,보성군,,관내사전투표,1070,1070,943,97,4,0,8,0,0,0,0,5,0,3,1060,10,0
4600,전라남도,4613,보성군,,회천면제1투,423,218,191,24,1,0,0,0,0,0,0,0,0,1,217,1,205
4600,전라남도,4613,보성군,,회천면제2투,475,317,273,29,5,0,3,0,0,0,0,1,0,1,312,5,158
4600,전라남도,4613,보성군,,회천면제3투,501,319,285,27,2,0,1,0,0,0,0,0,0,2,317,2,182
4600,전라남도,4613,보성군,웅치면,소계,948,779,676,78,5,0,2,1,0,0,0,3,1,2,768,11,169
4600,전라남도,4613,보성군,,관내사전투표,551,551,483,49,3,0,1,1,0,0,0,1,1,2,541,10,0
4600,전라남도,4613,보성군,,웅치면투표소,397,228,193,29,2,0,1,0,0,0,0,2,0,0,227,1,169
4600,전라남도,4613,보성군,잘못 투입·구분된 투표지,,0,0,0,0,0,0,0,0,0,0,0,0,0,0,0,0,0
4600,전라남도,4614,화순군,합계,,55122,45152,39327,4389,475,20,268,19,7,17,8,128,23,93,44774,378,9970
4600,전라남도,4614,화순군,거소·선상투표,,155,137,99,24,0,1,0,0,0,0,0,0,0,0,124,13,18
4600,전라남도,4614,화순군,관외사전투표,,7242,7241,6048,954,115,5,54,1,0,4,0,9,0,5,7195,46,1
4600,전라남도,4614,화순군,재외투표,,138,112,81,17,4,0,0,0,0,0,0,0,0,0,102,10,26
4600,전라남도,4614,화순군,화순읍,소계,28662,22461,19685,2134,239,6,133,5,2,2,0,67,6,14,22293,168,6201
4600,전라남도,4614,화순군,,관내사전투표,10450,10449,9408,829,85,2,38,2,1,0,0,32,2,6,10405,44,1
4600,전라남도,4614,화순군,,화순읍제1투,1205,875,759,89,13,0,4,1,0,0,0,1,0,1,868,7,330
4600,전라남도,4614,화순군,,화순읍제2투,1327,880,753,88,10,0,12,0,0,1,0,3,0,1,868,12,447
4600,전라남도,4614,화순군,,화순읍제3투,1710,1019,868,120,7,4,10,0,0,0,0,2,0,0,1011,8,691
4600,전라남도,4614,화순군,,화순읍제4투,1631,1004,844,113,16,0,18,0,0,0,0,0,1,1,993,11,627
4600,전라남도,4614,화순군,,화순읍제5투,874,606,510,71,8,0,7,0,0,0,0,1,1,0,598,8,268
4600,전라남도,4614,화순군,,화순읍제6투,629,379,329,38,3,0,4,1,0,0,0,0,0,1,376,3,250
4600,전라남도,4614,화순군,,화순읍제7투,448,315,279,24,2,0,1,0,0,0,0,2,0,2,310,5,133
4600,전라남도,4614,화순군,,화순읍제8투,2132,1442,1238,163,18,0,9,0,1,0,0,3,0,0,1432,10,690
4600,전라남도,4614,화순군,,화순읍제9투,1722,1154,992,119,13,0,9,0,0,0,0,7,0,0,1140,14,568
4600,전라남도,4614,화순군,,화순읍제10투,1535,875,734,102,15,0,7,0,0,0,0,4,1,0,863,12,660
4600,전라남도,4614,화순군,,화순읍제11투,2004,1348,1146,159,20,0,7,1,0,1,0,3,0,1,1338,10,656
4600,전라남도,4614,화순군,,화순읍제12투,929,621,537,62,9,0,0,0,0,0,0,2,1,0,611,10,308
4600,전라남도,4614,화순군,,화순읍제13투,2066,1494,1288,157,20,0,7,0,0,0,0,7,0,1,1480,14,572
4600,전라남도,4614,화순군,한천면,소계,995,788,689,73,7,0,4,0,0,1,0,1,0,7,782,6,207
4600,전라남도,4614,화순군,,관내사전투표,440,440,391,41,4,0,3,0,0,0,0,0,0,1,440,0,0
4600,전라남도,4614,화순군,,한천면제1투,317,160,131,21,2,0,0,0,0,0,0,0,0,4,158,2,157
4600,전라남도,4614,화순군,,한천면제2투,238,188,167,11,1,0,1,0,0,1,0,1,0,2,184,4,50
4600,전라남도,4614,화순군,춘양면,소계,1480,1152,1016,101,8,1,8,0,1,1,0,4,2,1,1143,9,328
4600,전라남도,4614,화순군,,관내사전투표,865,865,774,65,8,1,5,0,1,1,0,2,2,0,859,6,0
4600,전라남도,4614,화순군,,춘양면투표소,615,287,242,36,0,0,3,0,0,0,0,2,0,1,284,3,328
4600,전라남도,4614,화순군,청풍면,소계,769,621,543,50,5,1,2,0,0,2,0,2,4,4,613,8,148
4600,전라남도,4614,화순군,,관내사전투표,434,433,386,30,4,1,2,0,0,1,0,1,4,0,429,4,1
4600,전라남도,4614,화순군,,청풍면투표소,335,188,157,20,1,0,0,0,0,1,0,1,0,4,184,4,147
4600,전라남도,4614,화순군,이양면,소계,1535,1210,1083,74,8,1,5,1,0,0,2,2,2,6,1184,26,325
4600,전라남도,4614,화순군,,관내사전투표,954,954,865,53,5,0,3,1,0,0,1,2,1,6,937,17,0
4600,전라남도,4614,화순군,,이양면투표소,581,256,218,21,3,1,2,0,0,0,1,0,1,0,247,9,325
4600,전라남도,4614,화순군,능주면,소계,2805,2310,2050,194,17,1,19,2,1,1,0,5,1,1,2292,18,495
4600,전라남도,4614,화순군,,관내사전투표,1503,1503,1346,123,9,0,10,2,1,1,0,3,0,1,1496,7,0
4600,전라남도,4614,화순군,,능주면제1투,766,464,397,44,6,1,7,0,0,0,0,2,1,0,458,6,302
4600,전라남도,4614,화순군,,능주면제2투,536,343,307,27,2,0,2,0,0,0,0,0,0,0,338,5,193
4600,전라남도,4614,화순군,도곡면,소계,2354,1916,1711,151,17,0,8,2,1,0,0,12,1,7,1910,6,438
4600,전라남도,4614,화순군,,관내사전투표,1293,1293,1176,90,9,0,3,2,0,0,0,5,0,5,1290,3,0
4600,전라남도,4614,화순군,,도곡면제1투,498,273,240,21,2,0,4,0,1,0,0,4,0,0,272,1,225
4600,전라남도,4614,화순군,,도곡면제2투,563,350,295,40,6,0,1,0,0,0,0,3,1,2,348,2,213
4600,전라남도,4614,화순군,도암면,소계,1104,894,788,84,5,0,5,1,0,1,0,0,1,4,889,5,210
4600,전라남도,4614,화순군,,관내사전투표,669,669,597,59,3,0,2,1,0,0,0,0,1,2,665,4,0
4600,전라남도,4614,화순군,,도암면투표소,435,225,191,25,2,0,3,0,0,1,0,0,0,2,224,1,210
4600,전라남도,4614,화순군,이서면,소계,698,562,485,50,5,0,2,1,0,0,0,1,1,8,553,9,136
4600,전라남도,4614,화순군,,관내사전투표,391,391,341,31,3,0,2,1,0,0,0,0,1,6,385,6,0
4600,전라남도,4614,화순군,,이서면투표소,307,171,144,19,2,0,0,0,0,0,0,1,0,2,168,3,136
4600,전라남도,4614,화순군,동복면,소계,1327,1090,944,96,6,0,9,1,1,2,0,11,1,6,1077,13,237
4600,전라남도,4614,화순군,,관내사전투표,751,751,654,62,3,0,6,1,0,1,0,8,1,5,741,10,0
4600,전라남도,4614,화순군,,동복면투표소,576,339,290,34,3,0,3,0,1,1,0,3,0,1,336,3,237
4600,전라남도,4614,화순군,동면,소계,2925,2318,2019,221,18,1,10,1,1,3,3,8,1,10,2296,22,607
4600,전라남도,4614,화순군,,관내사전투표,1669,1669,1483,133,11,1,7,1,1,2,3,6,1,6,1655,14,0
4600,전라남도,4614,화순군,,동면제1투,809,386,310,59,6,0,2,0,0,1,0,1,0,1,380,6,423
4600,전라남도,4614,화순군,,동면제2투,447,263,226,29,1,0,1,0,0,0,0,1,0,3,261,2,184
4600,전라남도,4614,화순군,백아면,소계,1152,897,797,61,10,2,3,2,0,0,3,3,1,10,892,5,255
4600,전라남도,4614,화순군,,관내사전투표,661,661,593,38,9,2,1,2,0,0,3,2,1,6,657,4,0
4600,전라남도,4614,화순군,,백아면투표소,491,236,204,23,1,0,2,0,0,0,0,1,0,4,235,1,255
4600,전라남도,4614,화순군,사평면,소계,1781,1441,1287,105,11,1,6,2,0,0,0,3,2,10,1427,14,340
4600,전라남도,4614,화순군,,관내사전투표,1074,1074,962,81,7,1,4,1,0,0,0,3,0,6,1065,9,0
4600,전라남도,4614,화순군,,사평면투표소,707,367,325,24,4,0,2,1,0,0,0,0,2,4,362,5,340
4600,전라남도,4614,화순군,잘못 투입·구분된 투표지,,0,2,2,0,0,0,0,0,0,0,0,0,0,0,2,0,-2
4600,전라남도,4615,장흥군,합계,,32712,27048,23565,2555,301,14,159,11,8,6,7,88,14,91,26819,229,5664
4600,전라남도,4615,장흥군,거소·선상투표,,360,298,258,23,1,1,2,1,0,0,0,1,1,0,288,10,62
4600,전라남도,4615,장흥군,관외사전투표,,3387,3387,2758,491,69,1,36,0,0,0,1,8,0,0,3364,23,0
4600,전라남도,4615,장흥군,재외투표,,124,71,42,23,2,0,0,0,0,0,0,0,0,0,67,4,53
4600,전라남도,4615,장흥군,장흥읍,소계,10911,8691,7597,841,86,0,65,0,2,2,1,21,5,17,8637,54,2220
4600,전라남도,4615,장흥군,,관내사전투표,5389,5389,4795,475,43,0,32,0,1,1,1,11,0,5,5364,25,0
4600,전라남도,4615,장흥군,,장흥읍제1투,898,509,423,66,8,0,6,0,0,0,0,0,0,1,504,5,389
4600,전라남도,4615,장흥군,,장흥읍제2투,646,359,309,36,4,0,2,0,0,0,0,1,2,0,354,5,287
4600,전라남도,4615,장흥군,,장흥읍제3투,1501,915,789,92,13,0,11,0,0,0,0,3,1,4,913,2,586
4600,전라남도,4615,장흥군,,장흥읍제4투,1273,782,659,88,9,0,6,0,0,1,0,4,1,3,771,11,491
4600,전라남도,4615,장흥군,,장흥읍제5투,834,501,423,64,6,0,2,0,0,0,0,0,0,2,497,4,333
4600,전라남도,4615,장흥군,,장흥읍제6투,370,236,199,20,3,0,6,0,1,0,0,2,1,2,234,2,134
4600,전라남도,4615,장흥군,관산읍,소계,4002,3169,2890,211,16,1,4,2,2,0,0,9,2,8,3145,24,833
4600,전라남도,4615,장흥군,,관내사전투표,2020,2020,1855,131,8,0,1,2,2,0,0,4,1,3,2007,13,0
4600,전라남도,4615,장흥군,,관산읍제1투,741,369,325,31,7,0,0,0,0,0,0,2,1,0,366,3,372
4600,전라남도,4615,장흥군,,관산읍제2투,595,341,311,20,1,0,3,0,0,0,0,2,0,2,339,2,254
4600,전라남도,4615,장흥군,,관산읍제3투,646,439,399,29,0,1,0,0,0,0,0,1,0,3,433,6,207
4600,전라남도,4615,장흥군,대덕읍,소계,2759,2245,1945,207,34,2,15,1,1,0,0,2,2,13,2222,23,514
4600,전라남도,4615,장흥군,,관내사전투표,1478,1477,1298,122,21,2,10,0,0,0,0,1,2,8,1464,13,1
4600,전라남도,4615,장흥군,,대덕읍제1투,993,568,478,65,8,0,5,1,1,0,0,0,0,3,561,7,425
4600,전라남도,4615,장흥군,,대덕읍제2투,288,200,169,20,5,0,0,0,0,0,0,1,0,2,197,3,88
4600,전라남도,4615,장흥군,용산면,소계,1829,1511,1340,118,16,1,10,0,0,0,0,10,0,7,1502,9,318
4600,전라남도,4615,장흥군,,관내사전투표,1124,1124,1021,69,10,0,5,0,0,0,0,8,0,6,1119,5,0
4600,전라남도,4615,장흥군,,용산면투표소,705,387,319,49,6,1,5,0,0,0,0,2,0,1,383,4,318
4600,전라남도,4615,장흥군,안양면,소계,2346,1941,1735,143,20,2,3,3,1,0,2,5,2,6,1922,19,405
4600,전라남도,4615,장흥군,,관내사전투표,1279,1279,1151,86,14,0,2,3,1,0,2,1,1,5,1266,13,0
4600,전라남도,4615,장흥군,,안양면제1투,527,294,251,35,2,1,1,0,0,0,0,1,0,0,291,3,233
4600,전라남도,4615,장흥군,,안양면제2투,540,368,333,22,4,1,0,0,0,0,0,3,1,1,365,3,172
4600,전라남도,4615,장흥군,장동면,소계,979,801,687,83,7,0,6,0,0,0,0,4,0,4,791,10,178
4600,전라남도,4615,장흥군,,관내사전투표,561,561,499,42,4,0,2,0,0,0,0,3,0,3,553,8,0
4600,전라남도,4615,장흥군,,장동면투표소,418,240,188,41,3,0,4,0,0,0,0,1,0,1,238,2,178
4600,전라남도,4615,장흥군,장평면,소계,1670,1380,1210,100,7,1,6,2,2,1,0,16,1,17,1363,17,290
4600,전라남도,4615,장흥군,,관내사전투표,928,928,821,59,5,1,3,2,1,0,0,11,0,13,916,12,0
4600,전라남도,4615,장흥군,,장평면제1투,530,294,243,35,2,0,3,0,0,1,0,5,1,3,293,1,236
4600,전라남도,4615,장흥군,,장평면제2투,212,158,146,6,0,0,0,0,1,0,0,0,0,1,154,4,54
4600,전라남도,4615,장흥군,유치면,소계,790,617,504,73,14,3,8,1,0,0,2,6,0,3,614,3,173
4600,전라남도,4615,장흥군,,관내사전투표,431,431,363,51,9,0,4,1,0,0,0,1,0,0,429,2,0
4600,전라남도,4615,장흥군,,유치면투표소,359,186,141,22,5,3,4,0,0,0,2,5,0,3,185,1,173
4600,전라남도,4615,장흥군,부산면,소계,1322,1099,958,102,12,1,2,1,0,3,1,6,1,3,1090,9,223
4600,전라남도,4615,장흥군,,관내사전투표,861,860,760,75,7,1,2,0,0,1,0,5,1,1,853,7,1
4600,전라남도,4615,장흥군,,부산면투표소,461,239,198,27,5,0,0,1,0,2,1,1,0,2,237,2,222
4600,전라남도,4615,장흥군,회진면,소계,2233,1838,1641,140,17,1,2,0,0,0,0,0,0,13,1814,24,395
4600,전라남도,4615,장흥군,,관내사전투표,1373,1373,1236,92,14,1,1,0,0,0,0,0,0,9,1353,20,0
4600,전라남도,4615,장흥군,,회진면투표소,860,465,405,48,3,0,1,0,0,0,0,0,0,4,461,4,395
4600,전라남도,4615,장흥군,잘못 투입·구분된 투표지,,0,0,0,0,0,0,0,0,0,0,0,0,0,0,0,0,0
4600,전라남도,4616,강진군,합계,,30272,24960,21064,3010,298,24,141,15,5,10,6,43,17,53,24686,274,5312
4600,전라남도,4616,강진군,거소·선상투표,,182,154,114,19,3,1,0,3,0,1,0,0,0,1,142,12,28
4600,전라남도,4616,강진군,관외사전투표,,3188,3188,2502,546,63,4,32,1,1,1,0,6,1,2,3159,29,0
4600,전라남도,4616,강진군,재외투표,,114,79,56,17,1,0,1,0,0,0,0,0,0,0,75,4,35
4600,전라남도,4616,강진군,강진읍,소계,10325,8189,6972,971,87,3,39,2,1,2,3,11,6,16,8113,76,2136
4600,전라남도,4616,강진군,,관내사전투표,4956,4956,4251,566,52,2,23,2,0,1,1,6,3,6,4913,43,0
4600,전라남도,4616,강진군,,강진읍제1투,776,398,333,54,4,0,1,0,0,0,1,0,0,0,393,5,378
4600,전라남도,4616,강진군,,강진읍제2투,1135,688,589,81,8,0,1,0,0,0,0,1,2,2,684,4,447
4600,전라남도,4616,강진군,,강진읍제3투,945,570,454,91,7,0,5,0,0,1,1,1,0,2,562,8,375
4600,전라남도,4616,강진군,,강진읍제4투,541,332,284,35,5,0,2,0,0,0,0,0,0,4,330,2,209
4600,전라남도,4616,강진군,,강진읍제5투,560,356,307,27,4,1,5,0,1,0,0,0,0,2,347,9,204
4600,전라남도,4616,강진군,,강진읍제6투,1412,889,754,117,7,0,2,0,0,0,0,3,1,0,884,5,523
4600,전라남도,4616,강진군,군동면,소계,3153,2490,2097,303,33,3,19,2,0,0,1,5,2,5,2470,20,663
4600,전라남도,4616,강진군,,관내사전투표,1485,1484,1261,181,21,3,7,1,0,0,0,3,1,0,1478,6,1
4600,전라남도,4616,강진군,,군동면제1투,449,237,189,36,3,0,3,0,0,0,0,0,0,3,234,3,212
4600,전라남도,4616,강진군,,군동면제2투,880,562,473,69,7,0,3,0,0,0,0,1,1,2,556,6,318
4600,전라남도,4616,강진군,,군동면제3투,339,207,174,17,2,0,6,1,0,0,1,1,0,0,202,5,132
4600,전라남도,4616,강진군,칠량면,소계,1876,1563,1338,159,18,1,7,1,0,1,0,4,2,9,1540,23,313
4600,전라남도,4616,강진군,,관내사전투표,1124,1124,969,108,12,1,4,1,0,1,0,2,2,7,1107,17,0
4600,전라남도,4616,강진군,,칠량면투표소,752,439,369,51,6,0,3,0,0,0,0,2,0,2,433,6,313
4600,전라남도,4616,강진군,대구면,소계,952,767,668,81,5,2,1,0,0,0,0,1,1,0,759,8,185
4600,전라남도,4616,강진군,,관내사전투표,569,569,502,54,3,2,0,0,0,0,0,1,1,0,563,6,0
4600,전라남도,4616,강진군,,대구면투표소,383,198,166,27,2,0,1,0,0,0,0,0,0,0,196,2,185
4600,전라남도,4616,강진군,마량면,소계,1486,1212,1072,107,9,1,6,0,0,1,0,3,0,4,1203,9,274
4600,전라남도,4616,강진군,,관내사전투표,832,832,742,67,7,1,5,0,0,0,0,2,0,3,827,5,0
4600,전라남도,4616,강진군,,마량면투표소,654,380,330,40,2,0,1,0,0,1,0,1,0,1,376,4,274
4600,전라남도,4616,강진군,도암면,소계,1890,1529,1264,200,18,3,8,1,2,1,0,5,2,4,1508,21,361
4600,전라남도,4616,강진군,,관내사전투표,1100,1100,912,143,12,2,5,1,1,1,0,4,2,2,1085,15,0
4600,전라남도,4616,강진군,,도암면제1투,529,265,220,37,4,0,1,0,0,0,0,0,0,0,262,3,264
4600,전라남도,4616,강진군,,도암면제2투,261,164,132,20,2,1,2,0,1,0,0,1,0,2,161,3,97
4600,전라남도,4616,강진군,신전면,소계,1449,1198,1025,134,15,0,2,1,1,0,1,1,3,3,1186,12,251
4600,전라남도,4616,강진군,,관내사전투표,777,777,686,74,5,0,2,1,1,0,0,0,1,2,772,5,0
4600,전라남도,4616,강진군,,신전면제1투,408,244,189,38,10,0,0,0,0,0,0,0,2,1,240,4,164
4600,전라남도,4616,강진군,,신전면제2투,264,177,150,22,0,0,0,0,0,0,1,1,0,0,174,3,87
4600,전라남도,4616,강진군,성전면,소계,2290,1879,1603,201,27,3,12,2,0,2,0,4,0,3,1857,22,411
4600,전라남도,4616,강진군,,관내사전투표,1383,1383,1186,143,18,3,6,2,0,2,0,3,0,2,1365,18,0
4600,전라남도,4616,강진군,,성전면투표소,907,496,417,58,9,0,6,0,0,0,0,1,0,1,492,4,411
4600,전라남도,4616,강진군,작천면,소계,1494,1172,1013,125,7,1,5,1,0,0,1,2,0,3,1158,14,322
4600,전라남도,4616,강진군,,관내사전투표,852,852,746,89,5,0,1,1,0,0,0,1,0,1,844,8,0
4600,전라남도,4616,강진군,,작천면투표소,642,320,267,36,2,1,4,0,0,0,1,1,0,2,314,6,322
4600,전라남도,4616,강진군,병영면,소계,1390,1140,993,105,10,1,7,1,0,1,0,1,0,2,1121,19,250
4600,전라남도,4616,강진군,,관내사전투표,815,814,724,67,6,0,4,1,0,1,0,1,0,2,806,8,1
4600,전라남도,4616,강진군,,병영면투표소,575,326,269,38,4,1,3,0,0,0,0,0,0,0,315,11,249
4600,전라남도,4616,강진군,옴천면,소계,483,398,345,42,2,1,2,0,0,0,0,0,0,1,393,5,85
4600,전라남도,4616,강진군,,관내사전투표,282,282,243,30,2,1,2,0,0,0,0,0,0,1,279,3,0
4600,전라남도,4616,강진군,,옴천면투표소,201,116,102,12,0,0,0,0,0,0,0,0,0,0,114,2,85
4600,전라남도,4616,강진군,잘못 투입·구분된 투표지,,0,2,2,0,0,0,0,0,0,0,0,0,0,0,2,0,-2
4600,전라남도,4617,완도군,합계,,42767,35300,31062,3085,347,14,200,11,4,16,6,64,20,115,34944,356,7467
4600,전라남도,4617,완도군,거소·선상투표,,904,850,738,49,8,2,8,0,0,3,0,0,2,0,810,40,54
4600,전라남도,4617,완도군,관외사전투표,,3964,3963,3195,611,63,2,33,1,0,2,1,9,3,7,3927,36,1
4600,전라남도,4617,완도군,재외투표,,102,75,61,9,2,0,0,0,0,0,0,0,0,0,72,3,27
4600,전라남도,4617,완도군,완도읍,소계,13844,10697,9383,1012,123,4,60,0,1,4,1,25,2,11,10626,71,3147
4600,전라남도,4617,완도군,,관내사전투표,6324,6324,5660,528,64,1,27,0,0,0,1,11,1,1,6294,30,0
4600,전라남도,4617,완도군,,완도읍제1투,1770,917,774,105,15,1,9,0,1,0,0,5,0,1,911,6,853
4600,전라남도,4617,완도군,,완도읍제2투,1705,1025,893,96,10,1,10,0,0,1,0,4,0,1,1016,9,680
4600,전라남도,4617,완도군,,완도읍제3투,757,458,380,58,6,0,1,0,0,1,0,0,0,3,449,9,299
4600,전라남도,4617,완도군,,완도읍제4투,1741,1007,855,119,17,0,7,0,0,0,0,2,0,1,1001,6,734
4600,전라남도,4617,완도군,,완도읍제5투,822,531,441,71,4,1,4,0,0,0,0,2,1,1,525,6,291
4600,전라남도,4617,완도군,,완도읍제6투,725,435,380,35,7,0,2,0,0,2,0,1,0,3,430,5,290
4600,전라남도,4617,완도군,금일읍,소계,2705,2236,2069,123,11,0,6,0,0,1,1,2,0,9,2222,14,469
4600,전라남도,4617,완도군,,관내사전투표,1303,1303,1226,56,10,0,2,0,0,0,0,2,0,3,1299,4,0
4600,전라남도,4617,완도군,,금일읍제1투,287,166,147,14,0,0,1,0,0,0,0,0,0,0,162,4,121
4600,전라남도,4617,완도군,,금일읍제2투,490,340,303,30,0,0,2,0,0,1,0,0,0,1,337,3,150
4600,전라남도,4617,완도군,,금일읍제3투,625,427,393,23,1,0,1,0,0,0,1,0,0,5,424,3,198
4600,전라남도,4617,완도군,노화읍,소계,3886,3123,2828,201,19,1,12,5,1,1,0,6,5,13,3092,31,763
4600,전라남도,4617,완도군,,관내사전투표,1869,1869,1695,124,10,1,8,4,0,1,0,3,3,7,1856,13,0
4600,전라남도,4617,완도군,,노화읍제1투,970,530,462,44,7,0,4,0,1,0,0,1,1,2,522,8,440
4600,전라남도,4617,완도군,,노화읍제2투,561,356,325,19,2,0,0,0,0,0,0,1,1,4,352,4,205
4600,전라남도,4617,완도군,,노화읍제3투,486,368,346,14,0,0,0,1,0,0,0,1,0,0,362,6,118
4600,전라남도,4617,완도군,군외면,소계,2442,1964,1688,207,26,0,12,0,0,0,0,1,0,8,1942,22,478
4600,전라남도,4617,완도군,,관내사전투표,1319,1319,1139,142,13,0,7,0,0,0,0,1,0,5,1307,12,0
4600,전라남도,4617,완도군,,군외면제1투,589,305,258,33,7,0,3,0,0,0,0,0,0,0,301,4,284
4600,전라남도,4617,완도군,,군외면제2투,534,340,291,32,6,0,2,0,0,0,0,0,0,3,334,6,194
4600,전라남도,4617,완도군,신지면,소계,2763,2298,2074,159,15,0,16,0,1,1,0,3,1,8,2278,20,465
4600,전라남도,4617,완도군,,관내사전투표,1656,1656,1520,102,9,0,6,0,1,0,0,2,1,3,1644,12,0
4600,전라남도,4617,완도군,,신지면제1투,553,310,270,25,3,0,5,0,0,0,0,1,0,2,306,4,243
4600,전라남도,4617,완도군,,신지면제2투,554,332,284,32,3,0,5,0,0,1,0,0,0,3,328,4,222
4600,전라남도,4617,완도군,고금면,소계,3385,2845,2562,194,17,1,13,0,1,2,0,6,3,11,2810,35,540
4600,전라남도,4617,완도군,,관내사전투표,2027,2027,1851,120,11,1,6,0,1,0,0,6,2,9,2007,20,0
4600,전라남도,4617,완도군,,고금면제1투,746,417,363,39,3,0,5,0,0,1,0,0,1,0,412,5,329
4600,전라남도,4617,완도군,,고금면제2투,303,204,176,18,2,0,1,0,0,0,0,0,0,1,198,6,99
4600,전라남도,4617,완도군,,고금면제3투,309,197,172,17,1,0,1,0,0,1,0,0,0,1,193,4,112
4600,전라남도,4617,완도군,약산면,소계,1866,1549,1377,121,12,0,10,0,0,1,0,6,1,8,1536,13,317
4600,전라남도,4617,완도군,,관내사전투표,995,995,889,76,5,0,3,0,0,0,0,4,1,7,985,10,0
4600,전라남도,4617,완도군,,약산면제1투,519,307,271,24,5,0,2,0,0,0,0,2,0,0,304,3,212
4600,전라남도,4617,완도군,,약산면제2투,352,247,217,21,2,0,5,0,0,1,0,0,0,1,247,0,105
4600,전라남도,4617,완도군,청산면,소계,1746,1420,1223,132,9,3,9,3,0,0,2,2,2,14,1399,21,326
4600,전라남도,4617,완도군,,관내사전투표,927,927,801,85,6,2,6,2,0,0,1,0,1,10,914,13,0
4600,전라남도,4617,완도군,,청산면제1투,462,231,194,26,2,1,2,0,0,0,0,1,0,1,227,4,231
4600,전라남도,4617,완도군,,청산면제2투,228,162,139,16,1,0,1,0,0,0,0,1,0,0,158,4,66
4600,전라남도,4617,완도군,,청산면제3투,129,100,89,5,0,0,0,1,0,0,1,0,1,3,100,0,29
4600,전라남도,4617,완도군,소안면,소계,1860,1529,1389,89,14,0,7,0,0,0,1,1,1,13,1515,14,331
4600,전라남도,4617,완도군,,관내사전투표,1003,1003,919,52,10,0,5,0,0,0,0,0,1,4,991,12,0
4600,전라남도,4617,완도군,,소안면제1투,474,253,225,17,3,0,1,0,0,0,1,0,0,5,252,1,221
4600,전라남도,4617,완도군,,소안면제2투,383,273,245,20,1,0,1,0,0,0,0,1,0,4,272,1,110
4600,전라남도,4617,완도군,금당면,소계,744,630,570,41,4,0,3,0,0,0,0,0,0,3,621,9,114
4600,전라남도,4617,완도군,,관내사전투표,482,482,441,28,1,0,2,0,0,0,0,0,0,3,475,7,0
4600,전라남도,4617,완도군,,금당면투표소,262,148,129,13,3,0,1,0,0,0,0,0,0,0,146,2,114
4600,전라남도,4617,완도군,보길면,소계,1989,1668,1495,109,18,1,8,1,0,1,0,2,0,7,1642,26,321
4600,전라남도,4617,완도군,,관내사전투표,1092,1092,991,60,10,1,3,1,0,1,0,1,0,5,1073,19,0
4600,전라남도,4617,완도군,,보길면제1투,413,239,208,16,6,0,4,0,0,0,0,0,0,1,235,4,174
4600,전라남도,4617,완도군,,보길면제2투,484,337,296,33,2,0,1,0,0,0,0,1,0,1,334,3,147
4600,전라남도,4617,완도군,생일면,소계,567,453,410,28,6,0,3,1,0,0,0,1,0,3,452,1,114
4600,전라남도,4617,완도군,,관내사전투표,340,340,316,12,6,0,1,1,0,0,0,0,0,3,339,1,0
4600,전라남도,4617,완도군,,생일면투표소,227,113,94,16,0,0,2,0,0,0,0,1,0,0,113,0,114
4600,전라남도,4617,완도군,잘못 투입·구분된 투표지,,0,0,0,0,0,0,0,0,0,0,0,0,0,0,0,0,0
4600,전라남도,4618,해남군,합계,,59631,48441,42071,4690,510,33,288,28,5,9,15,96,27,126,47898,543,11190
4600,전라남도,4618,해남군,거소·선상투표,,561,508,378,37,13,5,4,2,1,2,2,2,0,4,450,58,53
4600,전라남도,4618,해남군,관외사전투표,,5737,5736,4642,855,95,5,61,4,1,0,1,15,3,5,5687,49,1
4600,전라남도,4618,해남군,재외투표,,132,79,59,13,2,0,0,0,0,0,0,0,0,0,74,5,53
4600,전라남도,4618,해남군,해남읍,소계,17152,13006,11408,1233,124,8,88,5,1,1,3,24,4,13,12912,94,4146
4600,전라남도,4618,해남군,,관내사전투표,7337,7337,6518,633,73,6,43,5,1,0,0,13,1,6,7299,38,0
4600,전라남도,4618,해남군,,해남읍제1투,836,488,423,51,5,0,4,0,0,0,1,0,0,0,484,4,348
4600,전라남도,4618,해남군,,해남읍제2투,701,428,364,55,3,0,2,0,0,0,0,0,0,0,424,4,273
4600,전라남도,4618,해남군,,해남읍제3투,1229,765,656,81,6,1,9,0,0,0,0,0,0,1,754,11,464
4600,전라남도,4618,해남군,,해남읍제4투,2212,1244,1072,130,15,0,11,0,0,1,1,1,3,3,1237,7,968
4600,전라남도,4618,해남군,,해남읍제5투,660,377,332,36,3,1,3,0,0,0,0,1,0,0,376,1,283
4600,전라남도,4618,해남군,,해남읍제6투,665,345,289,42,0,0,3,0,0,0,0,4,0,0,338,7,320
4600,전라남도,4618,해남군,,해남읍제7투,859,509,452,43,4,0,5,0,0,0,0,3,0,0,507,2,350
4600,전라남도,4618,해남군,,해남읍제8투,2042,1092,935,128,10,0,4,0,0,0,0,2,0,0,1079,13,950
4600,전라남도,4618,해남군,,해남읍제9투,611,421,367,34,5,0,4,0,0,0,1,0,0,3,414,7,190
4600,전라남도,4618,해남군,삼산면,소계,2651,2199,1915,212,22,0,12,2,0,0,0,7,0,5,2175,24,452
4600,전라남도,4618,해남군,,관내사전투표,1525,1525,1339,142,15,0,5,2,0,0,0,4,0,3,1510,15,0
4600,전라남도,4618,해남군,,삼산면제1투,650,382,325,40,4,0,4,0,0,0,0,3,0,0,376,6,268
4600,전라남도,4618,해남군,,삼산면제2투,476,292,251,30,3,0,3,0,0,0,0,0,0,2,289,3,184
4600,전라남도,4618,해남군,화산면,소계,2647,2117,1840,207,22,1,12,1,0,0,2,3,1,6,2095,22,530
4600,전라남도,4618,해남군,,관내사전투표,1383,1383,1220,123,14,1,4,1,0,0,2,1,1,3,1370,13,0
4600,전라남도,4618,해남군,,화산면제1투,437,211,171,31,1,0,2,0,0,0,0,2,0,1,208,3,226
4600,전라남도,4618,해남군,,화산면제2투,338,215,191,18,1,0,3,0,0,0,0,0,0,1,214,1,123
4600,전라남도,4618,해남군,,화산면제3투,489,308,258,35,6,0,3,0,0,0,0,0,0,1,303,5,181
4600,전라남도,4618,해남군,현산면,소계,2452,2016,1759,178,17,1,4,1,0,0,1,9,1,8,1979,37,436
4600,전라남도,4618,해남군,,관내사전투표,1287,1287,1130,112,13,0,3,0,0,0,0,7,1,7,1273,14,0
4600,전라남도,4618,해남군,,현산면제1투,321,172,146,20,0,0,0,0,0,0,0,0,0,0,166,6,149
4600,전라남도,4618,해남군,,현산면제2투,341,237,203,21,3,0,1,1,0,0,0,0,0,0,229,8,104
4600,전라남도,4618,해남군,,현산면제3투,503,320,280,25,1,1,0,0,0,0,1,2,0,1,311,9,183
4600,전라남도,4618,해남군,송지면,소계,4894,3890,3398,338,45,2,23,4,0,0,0,6,3,20,3839,51,1004
4600,전라남도,4618,해남군,,관내사전투표,2343,2343,2074,189,20,2,10,2,0,0,0,3,1,16,2317,26,0
4600,전라남도,4618,해남군,,송지면제1투,783,400,335,47,5,0,5,0,0,0,0,0,1,1,394,6,383
4600,전라남도,4618,해남군,,송지면제2투,538,337,279,35,3,0,1,2,0,0,0,2,1,3,326,11,201
4600,전라남도,4618,해남군,,송지면제3투,658,420,375,31,8,0,4,0,0,0,0,0,0,0,418,2,238
4600,전라남도,4618,해남군,,송지면제4투,572,390,335,36,9,0,3,0,0,0,0,1,0,0,384,6,182
4600,전라남도,4618,해남군,북평면,소계,2354,1980,1742,173,15,0,10,0,0,0,1,0,6,9,1956,24,374
4600,전라남도,4618,해남군,,관내사전투표,1388,1388,1211,134,6,0,6,0,0,0,1,0,5,7,1370,18,0
4600,전라남도,4618,해남군,,북평면제1투,547,297,265,18,6,0,4,0,0,0,0,0,1,1,295,2,250
4600,전라남도,4618,해남군,,북평면제2투,419,295,266,21,3,0,0,0,0,0,0,0,0,1,291,4,124
4600,전라남도,4618,해남군,북일면,소계,1708,1408,1260,93,18,3,6,0,0,1,0,1,0,6,1388,20,300
4600,전라남도,4618,해남군,,관내사전투표,955,955,863,62,15,3,3,0,0,1,0,1,0,2,950,5,0
4600,전라남도,4618,해남군,,북일면제1투,434,247,217,17,1,0,1,0,0,0,0,0,0,1,237,10,187
4600,전라남도,4618,해남군,,북일면제2투,319,206,180,14,2,0,2,0,0,0,0,0,0,3,201,5,113
4600,전라남도,4618,해남군,옥천면,소계,2894,2443,2118,245,27,0,8,1,0,0,0,9,5,5,2418,25,451
4600,전라남도,4618,해남군,,관내사전투표,1827,1827,1615,164,17,0,6,1,0,0,0,6,1,4,1814,13,0
4600,전라남도,4618,해남군,,옥천면제1투,588,319,273,32,6,0,2,0,0,0,0,2,0,0,315,4,269
4600,전라남도,4618,해남군,,옥천면제2투,479,297,230,49,4,0,0,0,0,0,0,1,4,1,289,8,182
4600,전라남도,4618,해남군,계곡면,소계,1727,1366,1204,115,15,0,4,1,1,0,0,1,0,2,1343,23,361
4600,전라남도,4618,해남군,,관내사전투표,924,923,828,64,10,0,2,1,1,0,0,1,0,2,909,14,1
4600,전라남도,4618,해남군,,계곡면제1투,401,196,170,18,1,0,1,0,0,0,0,0,0,0,190,6,205
4600,전라남도,4618,해남군,,계곡면제2투,402,247,206,33,4,0,1,0,0,0,0,0,0,0,244,3,155
4600,전라남도,4618,해남군,마산면,소계,2005,1639,1438,148,13,2,7,1,0,0,0,5,2,5,1621,18,366
4600,전라남도,4618,해남군,,관내사전투표,1122,1122,1011,77,6,2,3,0,0,0,0,2,1,4,1106,16,0
4600,전라남도,4618,해남군,,마산면제1투,450,260,204,45,4,0,2,0,0,0,0,2,0,1,258,2,190
4600,전라남도,4618,해남군,,마산면제2투,433,257,223,26,3,0,2,1,0,0,0,1,1,0,257,0,176
4600,전라남도,4618,해남군,황산면,소계,3909,3126,2780,255,30,3,12,1,0,2,2,5,0,12,3102,24,783
4600,전라남도,4618,해남군,,관내사전투표,2052,2052,1830,166,16,3,5,1,0,1,2,3,0,7,2034,18,0
4600,전라남도,4618,해남군,,황산면제1투,611,315,276,27,9,0,2,0,0,0,0,0,0,0,314,1,296
4600,전라남도,4618,해남군,,황산면제2투,471,289,257,24,2,0,2,0,0,1,0,1,0,2,289,0,182
4600,전라남도,4618,해남군,,황산면제3투,311,199,184,7,2,0,2,0,0,0,0,0,0,2,197,2,112
4600,전라남도,4618,해남군,,황산면제4투,464,271,233,31,1,0,1,0,0,0,0,1,0,1,268,3,193
4600,전라남도,4618,해남군,산이면,소계,2735,2162,1923,166,20,2,16,0,0,2,2,1,1,5,2138,24,573
4600,전라남도,4618,해남군,,관내사전투표,1551,1551,1396,106,15,2,9,0,0,1,1,0,1,5,1536,15,0
4600,전라남도,4618,해남군,,산이면제1투,378,166,139,17,2,0,3,0,0,1,0,1,0,0,163,3,212
4600,전라남도,4618,해남군,,산이면제2투,338,200,180,14,1,0,1,0,0,0,1,0,0,0,197,3,138
4600,전라남도,4618,해남군,,산이면제3투,468,245,208,29,2,0,3,0,0,0,0,0,0,0,242,3,223
4600,전라남도,4618,해남군,문내면,소계,3239,2574,2297,209,15,1,9,2,0,0,1,4,0,13,2551,23,665
4600,전라남도,4618,해남군,,관내사전투표,1700,1700,1553,110,7,1,5,2,0,0,1,1,0,7,1687,13,0
4600,전라남도,4618,해남군,,문내면제1투,741,406,349,47,3,0,1,0,0,0,0,1,0,2,403,3,335
4600,전라남도,4618,해남군,,문내면제2투,395,229,193,25,3,0,2,0,0,0,0,2,0,0,225,4,166
4600,전라남도,4618,해남군,,문내면제3투,403,239,202,27,2,0,1,0,0,0,0,0,0,4,236,3,164
4600,전라남도,4618,해남군,화원면,소계,2834,2192,1910,213,17,0,12,3,1,1,0,4,1,8,2170,22,642
4600,전라남도,4618,해남군,,관내사전투표,1566,1566,1385,139,14,0,5,1,1,1,0,1,1,5,1553,13,0
4600,전라남도,4618,해남군,,화원면제1투,554,243,196,35,2,0,5,1,0,0,0,0,0,0,239,4,311
4600,전라남도,4618,해남군,,화원면제2투,348,209,181,17,1,0,0,0,0,0,0,3,0,3,205,4,139
4600,전라남도,4618,해남군,,화원면제3투,366,174,148,22,0,0,2,1,0,0,0,0,0,0,173,1,192
4600,전라남도,4618,해남군,잘못 투입·구분된 투표지,,0,0,0,0,0,0,0,0,0,0,0,0,0,0,0,0,0
4600,전라남도,4619,진도군,합계,,26802,21744,18692,2313,219,17,141,15,1,8,15,32,8,69,21530,214,5058
4600,전라남도,4619,진도군,거소·선상투표,,239,205,175,13,1,0,3,0,0,0,1,0,0,0,193,12,34
4600,전라남도,4619,진도군,관외사전투표,,2732,2731,2184,443,38,0,31,2,0,0,0,2,1,2,2703,28,1
4600,전라남도,4619,진도군,재외투표,,98,59,41,13,5,0,0,0,0,0,0,0,0,0,59,0,39
4600,전라남도,4619,진도군,진도읍,소계,7872,6229,5372,685,61,1,39,0,0,0,5,4,1,8,6176,53,1643
4600,전라남도,4619,진도군,,관내사전투표,3918,3918,3428,405,34,1,17,0,0,0,0,4,1,1,3891,27,0
4600,전라남도,4619,진도군,,진도읍제1투,1734,980,829,121,7,0,7,0,0,0,2,0,0,2,968,12,754
4600,전라남도,4619,진도군,,진도읍제2투,1671,968,791,134,19,0,7,0,0,0,3,0,0,2,956,12,703
4600,전라남도,4619,진도군,,진도읍제3투,549,363,324,25,1,0,8,0,0,0,0,0,0,3,361,2,186
4600,전라남도,4619,진도군,군내면,소계,2691,2238,1925,217,38,3,10,4,0,0,1,10,1,11,2220,18,453
4600,전라남도,4619,진도군,,관내사전투표,1315,1315,1155,113,20,1,3,2,0,0,1,7,0,6,1308,7,0
4600,전라남도,4619,진도군,,군내면제1투,403,251,217,21,5,1,3,0,0,0,0,0,0,1,248,3,152
4600,전라남도,4619,진도군,,군내면제2투,534,351,279,54,7,1,1,0,0,0,0,1,0,2,345,6,183
4600,전라남도,4619,진도군,,군내면제3투,439,321,274,29,6,0,3,2,0,0,0,2,1,2,319,2,118
4600,전라남도,4619,진도군,고군면,소계,2828,2180,1929,199,11,2,10,1,0,1,2,3,0,5,2163,17,648
4600,전라남도,4619,진도군,,관내사전투표,1164,1164,1049,97,3,1,3,1,0,1,1,2,0,0,1158,6,0
4600,전라남도,4619,진도군,,고군면제1투,518,271,233,29,3,0,2,0,0,0,1,0,0,2,270,1,247
4600,전라남도,4619,진도군,,고군면제2투,562,357,298,39,5,1,3,0,0,0,0,1,0,2,349,8,205
4600,전라남도,4619,진도군,,고군면제3투,584,388,349,34,0,0,2,0,0,0,0,0,0,1,386,2,196
4600,전라남도,4619,진도군,의신면,소계,3006,2390,2078,222,15,1,15,1,0,3,0,5,2,20,2362,28,616
4600,전라남도,4619,진도군,,관내사전투표,1415,1415,1247,123,8,1,2,0,0,1,0,4,1,12,1399,16,0
4600,전라남도,4619,진도군,,의신면제1투,582,319,270,34,4,0,5,0,0,0,0,0,0,2,315,4,263
4600,전라남도,4619,진도군,,의신면제2투,359,240,207,22,0,0,2,1,0,2,0,0,0,2,236,4,119
4600,전라남도,4619,진도군,,의신면제3투,650,416,354,43,3,0,6,0,0,0,0,1,1,4,412,4,234
4600,전라남도,4619,진도군,임회면,소계,2859,2281,1985,214,26,6,14,1,0,3,1,5,0,7,2262,19,578
4600,전라남도,4619,진도군,,관내사전투표,1365,1365,1228,94,11,3,9,1,0,2,1,5,0,1,1355,10,0
4600,전라남도,4619,진도군,,임회면제1투,607,337,275,48,5,1,2,0,0,0,0,0,0,0,331,6,270
4600,전라남도,4619,진도군,,임회면제2투,445,308,260,37,2,1,2,0,0,1,0,0,0,4,307,1,137
4600,전라남도,4619,진도군,,임회면제3투,442,271,222,35,8,1,1,0,0,0,0,0,0,2,269,2,171
4600,전라남도,4619,진도군,지산면,소계,2542,2015,1767,183,14,1,14,1,0,1,2,0,3,6,1992,23,527
4600,전라남도,4619,진도군,,관내사전투표,1155,1155,1024,102,7,0,6,1,0,1,1,0,2,3,1147,8,0
4600,전라남도,4619,진도군,,지산면제1투,538,296,245,38,3,0,3,0,0,0,0,0,1,1,291,5,242
4600,전라남도,4619,진도군,,지산면제2투,482,318,283,27,1,0,1,0,0,0,1,0,0,1,314,4,164
4600,전라남도,4619,진도군,,지산면제3투,367,246,215,16,3,1,4,0,0,0,0,0,0,1,240,6,121
4600,전라남도,4619,진도군,조도면,소계,1935,1416,1236,124,10,3,5,5,1,0,3,3,0,10,1400,16,519
4600,전라남도,4619,진도군,,관내사전투표,661,661,563,66,9,2,2,3,1,0,2,1,0,3,652,9,0
4600,전라남도,4619,진도군,,조도면제1투,573,286,244,29,1,0,0,2,0,0,1,2,0,4,283,3,287
4600,전라남도,4619,진도군,,조도면제2투,88,52,47,4,0,0,0,0,0,0,0,0,0,0,51,1,36
4600,전라남도,4619,진도군,,조도면제3투,74,53,49,4,0,0,0,0,0,0,0,0,0,0,53,0,21
4600,전라남도,4619,진도군,,조도면제4투,160,120,106,8,0,1,3,0,0,0,0,0,0,1,119,1,40
4600,전라남도,4619,진도군,,조도면제5투,83,47,44,3,0,0,0,0,0,0,0,0,0,0,47,0,36
4600,전라남도,4619,진도군,,조도면제6투,121,67,58,7,0,0,0,0,0,0,0,0,0,1,66,1,54
4600,전라남도,4619,진도군,,조도면제7투,175,130,125,3,0,0,0,0,0,0,0,0,0,1,129,1,45
4600,전라남도,4619,진도군,잘못 투입·구분된 투표지,,0,0,0,0,0,0,0,0,0,0,0,0,0,0,0,0,0
4600,전라남도,4620,영암군,합계,,46507,37333,31909,4092,521,27,269,14,4,7,10,40,17,74,36984,349,9174
4600,전라남도,4620,영암군,거소·선상투표,,277,252,141,44,6,2,10,0,0,0,1,1,0,3,208,44,25
4600,전라남도,4620,영암군,관외사전투표,,6234,6233,5107,911,102,3,49,1,0,2,1,8,1,3,6188,45,1
4600,전라남도,4620,영암군,재외투표,,130,81,49,20,4,0,0,0,0,0,0,0,0,0,73,8,49
4600,전라남도,4620,영암군,영암읍,소계,5883,4644,4041,457,65,4,23,2,1,0,2,7,1,7,4610,34,1239
4600,전라남도,4620,영암군,,관내사전투표,3098,3098,2740,271,37,3,14,2,0,0,2,6,0,2,3077,21,0
4600,전라남도,4620,영암군,,영암읍제1투,1274,684,584,75,11,1,3,0,0,0,0,0,1,3,678,6,590
4600,전라남도,4620,영암군,,영암읍제2투,708,399,334,49,9,0,1,0,1,0,0,0,0,1,395,4,309
4600,전라남도,4620,영암군,,영암읍제3투,803,463,383,62,8,0,5,0,0,0,0,1,0,1,460,3,340
4600,전라남도,4620,영암군,삼호읍,소계,14684,10442,8902,1157,179,7,105,6,1,2,0,10,3,6,10378,64,4242
4600,전라남도,4620,영암군,,관내사전투표,4789,4789,4199,445,75,4,29,3,1,0,0,6,1,3,4766,23,0
4600,전라남도,4620,영암군,,삼호읍제1투,1728,956,802,118,20,0,8,0,0,2,0,0,0,0,950,6,772
4600,전라남도,4620,영암군,,삼호읍제2투,1502,746,615,90,19,0,16,0,0,0,0,0,0,0,740,6,756
4600,전라남도,4620,영암군,,삼호읍제3투,568,364,303,50,3,0,1,0,0,0,0,0,0,1,358,6,204
4600,전라남도,4620,영암군,,삼호읍제4투,2600,1492,1281,156,20,0,25,0,0,0,0,1,1,0,1484,8,1108
4600,전라남도,4620,영암군,,삼호읍제5투,722,415,330,63,7,1,6,1,0,0,0,0,1,1,410,5,307
4600,전라남도,4620,영암군,,삼호읍제6투,1395,786,640,112,14,0,12,1,0,0,0,0,0,1,780,6,609
4600,전라남도,4620,영암군,,삼호읍제7투,1380,894,732,123,21,2,8,1,0,0,0,3,0,0,890,4,486
4600,전라남도,4620,영암군,덕진면,소계,1622,1322,1165,117,18,0,5,0,0,1,0,1,1,2,1310,12,300
4600,전라남도,4620,영암군,,관내사전투표,927,927,828,75,10,0,4,0,0,0,0,0,1,0,918,9,0
4600,전라남도,4620,영암군,,덕진면제1투,320,144,123,15,4,0,0,0,0,0,0,0,0,1,143,1,176
4600,전라남도,4620,영암군,,덕진면제2투,375,251,214,27,4,0,1,0,0,1,0,1,0,1,249,2,124
4600,전라남도,4620,영암군,금정면,소계,1623,1298,1126,128,12,0,8,1,0,0,0,0,2,11,1288,10,325
4600,전라남도,4620,영암군,,관내사전투표,1011,1011,890,92,9,0,2,1,0,0,0,0,1,8,1003,8,0
4600,전라남도,4620,영암군,,금정면투표소,612,287,236,36,3,0,6,0,0,0,0,0,1,3,285,2,325
4600,전라남도,4620,영암군,신북면,소계,2929,2386,2137,187,17,2,11,0,0,0,1,2,1,5,2363,23,543
4600,전라남도,4620,영암군,,관내사전투표,1661,1661,1506,113,13,1,3,0,0,0,1,2,0,4,1643,18,0
4600,전라남도,4620,영암군,,신북면제1투,554,289,245,40,1,0,2,0,0,0,0,0,0,0,288,1,265
4600,전라남도,4620,영암군,,신북면제2투,357,197,171,20,2,1,2,0,0,0,0,0,1,0,197,0,160
4600,전라남도,4620,영암군,,신북면제3투,357,239,215,14,1,0,4,0,0,0,0,0,0,1,235,4,118
4600,전라남도,4620,영암군,시종면,소계,2830,2221,1965,188,16,1,5,2,0,0,2,3,2,8,2192,29,609
4600,전라남도,4620,영암군,,관내사전투표,1533,1533,1385,103,11,1,1,2,0,0,2,3,2,7,1517,16,0
4600,전라남도,4620,영암군,,시종면제1투,753,374,311,53,2,0,1,0,0,0,0,0,0,1,368,6,379
4600,전라남도,4620,영암군,,시종면제2투,544,314,269,32,3,0,3,0,0,0,0,0,0,0,307,7,230
4600,전라남도,4620,영암군,도포면,소계,1733,1368,1213,115,10,1,7,0,1,1,0,1,0,4,1353,15,365
4600,전라남도,4620,영암군,,관내사전투표,955,955,861,64,8,0,4,0,1,1,0,1,0,3,943,12,0
4600,전라남도,4620,영암군,,도포면제1투,389,200,176,20,1,1,2,0,0,0,0,0,0,0,200,0,189
4600,전라남도,4620,영암군,,도포면제2투,389,213,176,31,1,0,1,0,0,0,0,0,0,1,210,3,176
4600,전라남도,4620,영암군,군서면,소계,2531,2078,1793,218,24,3,15,0,1,0,0,2,1,4,2061,17,453
4600,전라남도,4620,영암군,,관내사전투표,1418,1418,1245,127,19,1,7,0,1,0,0,2,1,2,1405,13,0
4600,전라남도,4620,영암군,,군서면제1투,449,234,193,30,1,1,5,0,0,0,0,0,0,2,232,2,215
4600,전라남도,4620,영암군,,군서면제2투,664,426,355,61,4,1,3,0,0,0,0,0,0,0,424,2,238
4600,전라남도,4620,영암군,서호면,소계,1536,1231,1047,140,9,0,5,0,0,1,1,4,3,6,1216,15,305
4600,전라남도,4620,영암군,,관내사전투표,902,902,772,93,8,0,3,0,0,1,0,3,3,6,889,13,0
4600,전라남도,4620,영암군,,서호면투표소,634,329,275,47,1,0,2,0,0,0,1,1,0,0,327,2,305
4600,전라남도,4620,영암군,학산면,소계,2921,2509,2130,273,44,2,17,1,0,0,2,0,1,10,2480,29,412
4600,전라남도,4620,영암군,,관내사전투표,1954,1954,1681,195,34,1,12,1,0,0,1,0,1,8,1934,20,0
4600,전라남도,4620,영암군,,학산면제1투,447,234,193,30,3,1,2,0,0,0,0,0,0,1,230,4,213
4600,전라남도,4620,영암군,,학산면제2투,354,216,168,38,5,0,0,0,0,0,0,0,0,1,212,4,138
4600,전라남도,4620,영암군,,학산면제3투,166,105,88,10,2,0,3,0,0,0,1,0,0,0,104,1,61
4600,전라남도,4620,영암군,미암면,소계,1574,1267,1092,137,15,2,9,1,0,0,0,1,1,5,1263,4,307
4600,전라남도,4620,영암군,,관내사전투표,857,857,755,79,9,1,6,0,0,0,0,0,1,5,856,1,0
4600,전라남도,4620,영암군,,미암면투표소,717,410,337,58,6,1,3,1,0,0,0,1,0,0,407,3,307
4600,전라남도,4620,영암군,잘못 투입·구분된 투표지,,0,1,1,0,0,0,0,0,0,0,0,0,0,0,1,0,-1
4600,전라남도,4621,무안군,합계,,75012,61552,52983,6624,808,29,363,21,13,7,19,63,23,106,61059,493,13460
4600,전라남도,4621,무안군,거소·선상투표,,777,679,394,91,22,7,12,2,4,1,7,6,4,9,559,120,98
4600,전라남도,4621,무안군,관외사전투표,,12466,12459,10448,1642,183,5,92,1,3,0,2,9,3,7,12395,64,7
4600,전라남도,4621,무안군,재외투표,,186,131,103,19,2,0,0,0,0,0,0,0,0,0,124,7,55
4600,전라남도,4621,무안군,무안읍,소계,8836,7102,6257,647,72,0,52,1,0,3,0,9,3,8,7052,50,1734
4600,전라남도,4621,무안군,,관내사전투표,4994,4994,4431,442,52,0,31,1,0,2,0,7,1,3,4970,24,0
4600,전라남도,4621,무안군,,무안읍제1투,1238,622,539,62,7,0,4,0,0,0,0,1,1,0,614,8,616
4600,전라남도,4621,무안군,,무안읍제2투,1475,841,721,89,9,0,9,0,0,0,0,0,1,2,831,10,634
4600,전라남도,4621,무안군,,무안읍제3투,301,203,183,15,0,0,2,0,0,0,0,0,0,2,202,1,98
4600,전라남도,4621,무안군,,무안읍제4투,828,442,383,39,4,0,6,0,0,1,0,1,0,1,435,7,386
4600,전라남도,4621,무안군,일로읍,소계,9285,7351,6436,732,80,6,35,3,1,2,0,5,1,15,7316,35,1934
4600,전라남도,4621,무안군,,관내사전투표,3616,3616,3275,265,29,3,19,2,1,0,0,2,1,4,3601,15,0
4600,전라남도,4621,무안군,,일로읍제1투,387,232,209,18,0,0,2,0,0,0,0,0,0,1,230,2,155
4600,전라남도,4621,무안군,,일로읍제2투,343,223,190,25,3,0,1,0,0,0,0,0,0,3,222,1,120
4600,전라남도,4621,무안군,,일로읍제3투,763,411,365,33,3,3,4,1,0,0,0,2,0,0,411,0,352
4600,전라남도,4621,무안군,,일로읍제4투,238,158,147,9,0,0,0,0,0,0,0,0,0,2,158,0,80
4600,전라남도,4621,무안군,,일로읍제5투,516,315,284,22,3,0,1,0,0,0,0,0,0,4,314,1,201
4600,전라남도,4621,무안군,,일로읍제6투,327,181,153,23,0,0,2,0,0,2,0,0,0,1,181,0,146
4600,전라남도,4621,무안군,,일로읍제7투,1677,1216,1001,181,21,0,2,0,0,0,0,0,0,0,1205,11,461
4600,전라남도,4621,무안군,,일로읍제8투,1418,999,812,156,21,0,4,0,0,0,0,1,0,0,994,5,419
4600,전라남도,4621,무안군,삼향읍,소계,24585,18960,16239,2174,317,4,103,4,1,0,3,16,2,7,18870,90,5625
4600,전라남도,4621,무안군,,관내사전투표,9405,9404,8231,961,126,3,36,3,1,0,0,11,1,0,9373,31,1
4600,전라남도,4621,무안군,,삼향읍제1투,383,246,212,28,5,0,1,0,0,0,0,0,0,0,246,0,137
4600,전라남도,4621,무안군,,삼향읍제2투,655,415,359,41,7,0,5,0,0,0,1,0,0,0,413,2,240
4600,전라남도,4621,무안군,,삼향읍제3투,865,501,430,55,4,0,2,0,0,0,2,0,0,3,496,5,364
4600,전라남도,4621,무안군,,삼향읍제4투,567,353,310,29,10,0,0,0,0,0,0,0,0,2,351,2,214
4600,전라남도,4621,무안군,,삼향읍제5투,1654,968,811,123,22,0,6,0,0,0,0,0,0,0,962,6,686
4600,전라남도,4621,무안군,,삼향읍제6투,1994,1235,1039,158,21,0,10,0,0,0,0,0,0,1,1229,6,759
4600,전라남도,4621,무안군,,삼향읍제7투,2369,1388,1128,203,23,0,18,0,0,0,0,1,0,0,1373,15,981
4600,전라남도,4621,무안군,,삼향읍제8투,1765,1113,927,140,25,0,8,0,0,0,0,1,0,0,1101,12,652
4600,전라남도,4621,무안군,,삼향읍제9투,1864,1273,1084,138,34,1,7,1,0,0,0,1,1,1,1268,5,591
4600,전라남도,4621,무안군,,삼향읍제10투,1938,1289,1081,175,27,0,4,0,0,0,0,0,0,0,1287,2,649
4600,전라남도,4621,무안군,,삼향읍제11투,1126,775,627,123,13,0,6,0,0,0,0,2,0,0,771,4,351
4600,전라남도,4621,무안군,몽탄면,소계,2337,1848,1646,152,21,1,4,0,0,0,1,4,0,7,1836,12,489
4600,전라남도,4621,무안군,,관내사전투표,1171,1171,1063,82,10,1,2,0,0,0,0,4,0,2,1164,7,0
4600,전라남도,4621,무안군,,몽탄면제1투,396,216,180,30,1,0,1,0,0,0,0,0,0,1,213,3,180
4600,전라남도,4621,무안군,,몽탄면제2투,214,105,88,15,1,0,0,0,0,0,0,0,0,1,105,0,109
4600,전라남도,4621,무안군,,몽탄면제3투,242,122,110,8,3,0,1,0,0,0,0,0,0,0,122,0,120
4600,전라남도,4621,무안군,,몽탄면제4투,314,234,205,17,6,0,0,0,0,0,1,0,0,3,232,2,80
4600,전라남도,4621,무안군,청계면,소계,4921,3815,3361,351,27,0,14,5,0,0,2,3,2,16,3781,34,1106
4600,전라남도,4621,무안군,,관내사전투표,2144,2144,1897,201,16,0,5,2,0,0,1,1,2,7,2132,12,0
4600,전라남도,4621,무안군,,청계면제1투,399,272,248,15,1,0,2,1,0,0,0,1,0,0,268,4,127
4600,전라남도,4621,무안군,,청계면제2투,811,394,325,52,7,0,1,0,0,0,1,0,0,2,388,6,417
4600,전라남도,4621,무안군,,청계면제3투,547,348,304,35,0,0,2,0,0,0,0,0,0,2,343,5,199
4600,전라남도,4621,무안군,,청계면제4투,449,308,275,22,2,0,0,1,0,0,0,1,0,3,304,4,141
4600,전라남도,4621,무안군,,청계면제5투,571,349,312,26,1,0,4,1,0,0,0,0,0,2,346,3,222
4600,전라남도,4621,무안군,현경면,소계,3585,2800,2483,231,28,3,17,2,1,0,0,3,1,8,2777,23,785
4600,전라남도,4621,무안군,,관내사전투표,1541,1541,1405,100,15,2,10,1,0,0,0,1,0,1,1535,6,0
4600,전라남도,4621,무안군,,현경면제1투,222,156,136,13,2,0,1,0,0,0,0,0,0,1,153,3,66
4600,전라남도,4621,무안군,,현경면제2투,530,269,229,29,3,0,1,1,0,0,0,0,0,0,263,6,261
4600,전라남도,4621,무안군,,현경면제3투,427,251,212,29,1,0,3,0,0,0,0,1,1,2,249,2,176
4600,전라남도,4621,무안군,,현경면제4투,445,292,263,21,2,1,1,0,0,0,0,0,0,1,289,3,153
4600,전라남도,4621,무안군,,현경면제5투,420,291,238,39,5,0,1,0,1,0,0,1,0,3,288,3,129
4600,전라남도,4621,무안군,망운면,소계,1622,1327,1170,126,7,1,5,0,0,0,0,1,1,1,1312,15,295
4600,전라남도,4621,무안군,,관내사전투표,910,910,809,84,6,0,3,0,0,0,0,1,1,0,904,6,0
4600,전라남도,4621,무안군,,망운면제1투,442,236,196,28,1,1,2,0,0,0,0,0,0,0,228,8,206
4600,전라남도,4621,무안군,,망운면제2투,270,181,165,14,0,0,0,0,0,0,0,0,0,1,180,1,89
4600,전라남도,4621,무안군,해제면,소계,4142,3260,2859,287,28,1,19,3,3,0,4,2,4,20,3230,30,882
4600,전라남도,4621,무안군,,관내사전투표,2425,2425,2173,186,18,1,12,3,2,0,1,2,3,11,2412,13,0
4600,전라남도,4621,무안군,,해제면제1투,438,206,174,20,2,0,3,0,0,0,0,0,0,4,203,3,232
4600,전라남도,4621,무안군,,해제면제2투,536,234,197,28,3,0,1,0,1,0,1,0,0,0,231,3,302
4600,전라남도,4621,무안군,,해제면제3투,322,182,149,19,0,0,3,0,0,0,0,0,1,3,175,7,140
4600,전라남도,4621,무안군,,해제면제4투,421,213,166,34,5,0,0,0,0,0,2,0,0,2,209,4,208
4600,전라남도,4621,무안군,운남면,소계,2270,1819,1586,172,21,1,10,0,0,1,0,5,2,8,1806,13,451
4600,전라남도,4621,무안군,,관내사전투표,1303,1303,1160,102,14,1,8,0,0,1,0,2,1,8,1297,6,0
4600,전라남도,4621,무안군,,운남면제1투,272,146,118,21,3,0,0,0,0,0,0,0,1,0,143,3,126
4600,전라남도,4621,무안군,,운남면제2투,498,250,205,38,2,0,1,0,0,0,0,3,0,0,249,1,248
4600,전라남도,4621,무안군,,운남면제3투,197,120,103,11,2,0,1,0,0,0,0,0,0,0,117,3,77
4600,전라남도,4621,무안군,잘못 투입·구분된 투표지,,0,1,1,0,0,0,0,0,0,0,0,0,0,0,1,0,-1
4600,전라남도,4622,영광군,합계,,45280,36321,30855,4056,475,22,221,16,5,17,10,89,34,142,35942,379,8959
4600,전라남도,4622,영광군,거소·선상투표,,160,147,97,30,4,1,0,0,0,0,0,0,0,0,132,15,13
4600,전라남도,4622,영광군,관외사전투표,,5417,5416,4284,920,98,6,45,3,0,1,1,12,3,3,5376,40,1
4600,전라남도,4622,영광군,재외투표,,127,85,69,10,0,0,0,0,0,0,0,0,0,0,79,6,42
4600,전라남도,4622,영광군,영광읍,소계,15242,11478,9968,1146,152,7,65,4,0,6,2,13,6,18,11387,91,3764
4600,전라남도,4622,영광군,,관내사전투표,6453,6453,5678,600,81,5,29,1,0,0,1,9,1,7,6412,41,0
4600,전라남도,4622,영광군,,영광읍제1투,892,440,369,49,6,0,3,0,0,0,0,0,1,4,432,8,452
4600,전라남도,4622,영광군,,영광읍제2투,1538,973,829,102,17,1,10,1,0,1,0,1,2,1,965,8,565
4600,전라남도,4622,영광군,,영광읍제3투,1217,672,562,89,11,0,5,0,0,1,0,0,0,0,668,4,545
4600,전라남도,4622,영광군,,영광읍제4투,1357,687,584,77,11,0,3,0,0,2,0,0,0,1,678,9,670
4600,전라남도,4622,영광군,,영광읍제5투,649,420,361,36,8,1,4,1,0,0,1,0,0,5,417,3,229
4600,전라남도,4622,영광군,,영광읍제6투,247,187,171,7,2,0,1,0,0,1,0,0,2,0,184,3,60
4600,전라남도,4622,영광군,,영광읍제7투,317,208,180,21,2,0,2,0,0,0,0,2,0,0,207,1,109
4600,전라남도,4622,영광군,,영광읍제8투,1677,916,770,120,10,0,4,1,0,1,0,0,0,0,906,10,761
4600,전라남도,4622,영광군,,영광읍제9투,895,522,464,45,4,0,4,0,0,0,0,1,0,0,518,4,373
4600,전라남도,4622,영광군,백수읍,소계,3611,2817,2478,240,21,3,15,2,0,1,1,3,3,15,2782,35,794
4600,전라남도,4622,영광군,,관내사전투표,1539,1539,1370,123,10,2,6,2,0,0,0,1,1,7,1522,17,0
4600,전라남도,4622,영광군,,백수읍제1투,335,174,143,21,3,1,1,0,0,0,0,0,1,1,171,3,161
4600,전라남도,4622,영광군,,백수읍제2투,713,452,389,47,2,0,3,0,0,0,0,1,0,4,446,6,261
4600,전라남도,4622,영광군,,백수읍제3투,550,361,322,24,2,0,4,0,0,1,0,1,0,2,356,5,189
4600,전라남도,4622,영광군,,백수읍제4투,474,291,254,25,4,0,1,0,0,0,1,0,1,1,287,4,183
4600,전라남도,4622,영광군,홍농읍,소계,4639,3639,2806,647,77,0,29,1,0,3,1,19,1,12,3596,43,1000
4600,전라남도,4622,영광군,,관내사전투표,2277,2277,1792,370,53,0,10,1,0,2,1,14,0,7,2250,27,0
4600,전라남도,4622,영광군,,홍농읍제1투,534,261,208,32,6,0,7,0,0,0,0,2,0,1,256,5,273
4600,전라남도,4622,영광군,,홍농읍제2투,214,128,105,20,1,0,0,0,0,1,0,0,0,0,127,1,86
4600,전라남도,4622,영광군,,홍농읍제3투,285,186,158,17,2,0,1,0,0,0,0,0,1,3,182,4,99
4600,전라남도,4622,영광군,,홍농읍제4투,482,319,294,18,4,0,0,0,0,0,0,1,0,0,317,2,163
4600,전라남도,4622,영광군,,홍농읍제5투,847,468,249,190,11,0,11,0,0,0,0,2,0,1,464,4,379
4600,전라남도,4622,영광군,대마면,소계,1373,1084,917,97,13,2,6,0,0,0,1,17,2,10,1065,19,289
4600,전라남도,4622,영광군,,관내사전투표,701,701,610,53,5,1,4,0,0,0,1,12,2,4,692,9,0
4600,전라남도,4622,영광군,,대마면제1투,437,235,184,31,5,1,1,0,0,0,0,4,0,4,230,5,202
4600,전라남도,4622,영광군,,대마면제2투,235,148,123,13,3,0,1,0,0,0,0,1,0,2,143,5,87
4600,전라남도,4622,영광군,묘량면,소계,1408,1157,1023,95,10,1,6,0,0,0,0,5,2,8,1150,7,251
4600,전라남도,4622,영광군,,관내사전투표,696,696,626,48,5,1,3,0,0,0,0,4,2,4,693,3,0
4600,전라남도,4622,영광군,,묘량면제1투,384,241,201,30,2,0,2,0,0,0,0,1,0,3,239,2,143
4600,전라남도,4622,영광군,,묘량면제2투,328,220,196,17,3,0,1,0,0,0,0,0,0,1,218,2,108
4600,전라남도,4622,영광군,불갑면,소계,1154,959,856,72,10,0,5,1,1,1,0,1,0,4,951,8,195
4600,전라남도,4622,영광군,,관내사전투표,695,695,629,51,5,0,1,1,1,0,0,1,0,1,690,5,0
4600,전라남도,4622,영광군,,불갑면제1투,293,157,135,12,1,0,3,0,0,1,0,0,0,3,155,2,136
4600,전라남도,4622,영광군,,불갑면제2투,166,107,92,9,4,0,1,0,0,0,0,0,0,0,106,1,59
4600,전라남도,4622,영광군,군서면,소계,2274,1847,1607,169,25,0,8,2,3,1,1,4,2,12,1834,13,427
4600,전라남도,4622,영광군,,관내사전투표,1381,1381,1207,123,20,0,5,2,2,1,0,3,2,8,1373,8,0
4600,전라남도,4622,영광군,,군서면제1투,441,217,186,26,1,0,1,0,1,0,0,0,0,1,216,1,224
4600,전라남도,4622,영광군,,군서면제2투,452,249,214,20,4,0,2,0,0,0,1,1,0,3,245,4,203
4600,전라남도,4622,영광군,군남면,소계,2018,1582,1372,137,18,2,6,1,1,2,1,2,3,18,1563,19,436
4600,전라남도,4622,영광군,,관내사전투표,1053,1053,933,81,10,2,5,1,0,1,1,2,3,5,1044,9,0
4600,전라남도,4622,영광군,,군남면제1투,426,217,182,24,3,0,0,0,0,1,0,0,0,5,215,2,209
4600,전라남도,4622,영광군,,군남면제2투,237,152,123,19,1,0,0,0,0,0,0,0,0,4,147,5,85
4600,전라남도,4622,영광군,,군남면제3투,302,160,134,13,4,0,1,0,1,0,0,0,0,4,157,3,142
4600,전라남도,4622,영광군,염산면,소계,3260,2560,2263,197,17,0,14,1,0,2,0,3,6,21,2524,36,700
4600,전라남도,4622,영광군,,관내사전투표,1679,1679,1511,112,13,0,7,1,0,2,0,1,4,10,1661,18,0
4600,전라남도,4622,영광군,,염산면제1투,561,266,224,34,2,0,2,0,0,0,0,0,0,2,264,2,295
4600,전라남도,4622,영광군,,염산면제2투,416,263,228,16,1,0,0,0,0,0,0,1,1,6,253,10,153
4600,전라남도,4622,영광군,,염산면제3투,331,204,176,19,1,0,3,0,0,0,0,1,1,0,201,3,127
4600,전라남도,4622,영광군,,염산면제4투,273,148,124,16,0,0,2,0,0,0,0,0,0,3,145,3,125
4600,전라남도,4622,영광군,법성면,소계,4277,3318,2903,286,29,0,22,1,0,0,1,10,5,19,3276,42,959
4600,전라남도,4622,영광군,,관내사전투표,2122,2122,1887,165,18,0,6,0,0,0,1,9,2,10,2098,24,0
4600,전라남도,4622,영광군,,법성면제1투,898,452,379,53,4,0,9,0,0,0,0,0,2,2,449,3,446
4600,전라남도,4622,영광군,,법성면제2투,259,147,125,13,2,0,2,0,0,0,0,1,0,0,143,4,112
4600,전라남도,4622,영광군,,법성면제3투,237,125,105,13,0,0,1,0,0,0,0,0,0,2,121,4,112
4600,전라남도,4622,영광군,,법성면제4투,486,286,251,20,4,0,1,0,0,0,0,0,1,3,280,6,200
4600,전라남도,4622,영광군,,법성면제5투,275,186,156,22,1,0,3,1,0,0,0,0,0,2,185,1,89
4600,전라남도,4622,영광군,낙월면,소계,320,232,212,10,1,0,0,0,0,0,1,0,1,2,227,5,88
4600,전라남도,4622,영광군,,관내사전투표,56,56,50,3,0,0,0,0,0,0,1,0,0,1,55,1,0
4600,전라남도,4622,영광군,,낙월면제1투,82,36,33,1,0,0,0,0,0,0,0,0,0,0,34,2,46
4600,전라남도,4622,영광군,,낙월면제2투,70,52,51,0,0,0,0,0,0,0,0,0,0,1,52,0,18
4600,전라남도,4622,영광군,,낙월면제3투,112,88,78,6,1,0,0,0,0,0,0,0,1,0,86,2,24
4600,전라남도,4622,영광군,잘못 투입·구분된 투표지,,0,0,0,0,0,0,0,0,0,0,0,0,0,0,0,0,0
4600,전라남도,4623,함평군,합계,,28435,23295,20467,2052,259,16,118,12,2,9,9,37,17,91,23089,206,5140
4600,전라남도,4623,함평군,거소·선상투표,,153,149,115,19,3,0,0,0,1,1,1,0,0,0,140,9,4
4600,전라남도,4623,함평군,관외사전투표,,3924,3922,3291,520,51,4,25,1,0,0,1,5,0,1,3899,23,2
4600,전라남도,4623,함평군,재외투표,,114,86,54,20,1,0,3,0,0,0,0,0,0,0,78,8,28
4600,전라남도,4623,함평군,함평읍,소계,6557,5223,4595,439,71,3,29,4,1,1,1,4,5,16,5169,54,1334
4600,전라남도,4623,함평군,,관내사전투표,3332,3332,2942,264,49,3,19,4,1,1,1,2,3,4,3293,39,0
4600,전라남도,4623,함평군,,함평읍제1투,616,393,347,37,1,0,3,0,0,0,0,1,0,2,391,2,223
4600,전라남도,4623,함평군,,함평읍제2투,622,335,289,34,2,0,2,0,0,0,0,0,0,4,331,4,287
4600,전라남도,4623,함평군,,함평읍제3투,322,193,169,14,3,0,2,0,0,0,0,1,0,1,190,3,129
4600,전라남도,4623,함평군,,함평읍제4투,1080,596,526,58,6,0,2,0,0,0,0,0,0,1,593,3,484
4600,전라남도,4623,함평군,,함평읍제5투,585,374,322,32,10,0,1,0,0,0,0,0,2,4,371,3,211
4600,전라남도,4623,함평군,손불면,소계,2596,2021,1802,150,20,2,10,2,0,2,0,4,1,13,2006,15,575
4600,전라남도,4623,함평군,,관내사전투표,1308,1308,1181,89,11,2,4,2,0,1,0,3,0,8,1301,7,0
4600,전라남도,4623,함평군,,손불면제1투,811,437,379,40,3,0,2,0,0,1,0,1,0,4,430,7,374
4600,전라남도,4623,함평군,,손불면제2투,477,276,242,21,6,0,4,0,0,0,0,0,1,1,275,1,201
4600,전라남도,4623,함평군,신광면,소계,1373,1128,1006,79,8,1,2,1,0,1,0,3,3,13,1117,11,245
4600,전라남도,4623,함평군,,관내사전투표,743,743,671,47,5,1,0,1,0,1,0,1,1,7,735,8,0
4600,전라남도,4623,함평군,,신광면제1투,436,255,224,21,0,0,2,0,0,0,0,2,2,3,254,1,181
4600,전라남도,4623,함평군,,신광면제2투,194,130,111,11,3,0,0,0,0,0,0,0,0,3,128,2,64
4600,전라남도,4623,함평군,학교면,소계,2801,2180,1944,160,24,1,7,0,0,2,1,5,1,12,2157,23,621
4600,전라남도,4623,함평군,,관내사전투표,1370,1370,1250,87,12,1,1,0,0,0,1,1,1,5,1359,11,0
4600,전라남도,4623,함평군,,학교면제1투,356,193,170,13,3,0,0,0,0,2,0,0,0,1,189,4,163
4600,전라남도,4623,함평군,,학교면제2투,289,200,175,15,0,0,1,0,0,0,0,1,0,3,195,5,89
4600,전라남도,4623,함평군,,학교면제3투,160,110,95,8,2,0,3,0,0,0,0,0,0,1,109,1,50
4600,전라남도,4623,함평군,,학교면제4투,626,307,254,37,7,0,2,0,0,0,0,3,0,2,305,2,319
4600,전라남도,4623,함평군,엄다면,소계,1435,1140,1012,87,11,1,7,1,0,0,4,2,0,6,1131,9,295
4600,전라남도,4623,함평군,,관내사전투표,742,742,680,46,5,1,0,1,0,0,0,0,0,4,737,5,0
4600,전라남도,4623,함평군,,엄다면투표소,693,398,332,41,6,0,7,0,0,0,4,2,0,2,394,4,295
4600,전라남도,4623,함평군,대동면,소계,2423,1887,1646,190,16,0,10,0,0,0,0,1,2,11,1876,11,536
4600,전라남도,4623,함평군,,관내사전투표,1066,1066,957,90,6,0,6,0,0,0,0,0,1,3,1063,3,0
4600,전라남도,4623,함평군,,대동면제1투,821,475,393,66,3,0,3,0,0,0,0,0,1,4,470,5,346
4600,전라남도,4623,함평군,,대동면제2투,536,346,296,34,7,0,1,0,0,0,0,1,0,4,343,3,190
4600,전라남도,4623,함평군,나산면,소계,2133,1667,1480,130,18,1,8,2,0,0,0,3,2,7,1651,16,466
4600,전라남도,4623,함평군,,관내사전투표,1090,1090,981,77,9,0,3,2,0,0,0,2,1,5,1080,10,0
4600,전라남도,4623,함평군,,나산면제1투,777,416,359,43,3,1,4,0,0,0,0,1,0,1,412,4,361
4600,전라남도,4623,함평군,,나산면제2투,266,161,140,10,6,0,1,0,0,0,0,0,1,1,159,2,105
4600,전라남도,4623,함평군,해보면,소계,2132,1685,1509,118,23,3,5,1,0,2,1,3,0,7,1672,13,447
4600,전라남도,4623,함평군,,관내사전투표,1104,1104,1005,68,9,3,4,0,0,1,0,2,0,4,1096,8,0
4600,전라남도,4623,함평군,,해보면제1투,431,224,191,22,8,0,0,0,0,0,1,0,0,0,222,2,207
4600,전라남도,4623,함평군,,해보면제2투,597,357,313,28,6,0,1,1,0,1,0,1,0,3,354,3,240
4600,전라남도,4623,함평군,월야면,소계,2794,2207,2013,140,13,0,12,0,0,0,0,7,3,5,2193,14,587
4600,전라남도,4623,함평군,,관내사전투표,1373,1373,1258,81,10,0,6,0,0,0,0,6,2,0,1363,10,0
4600,전라남도,4623,함평군,,월야면제1투,607,313,285,22,1,0,2,0,0,0,0,0,0,1,311,2,294
4600,전라남도,4623,함평군,,월야면제2투,256,166,152,8,0,0,1,0,0,0,0,1,0,2,164,2,90
4600,전라남도,4623,함평군,,월야면제3투,558,355,318,29,2,0,3,0,0,0,0,0,1,2,355,0,203
4600,전라남도,4623,함평군,잘못 투입·구분된 투표지,,0,0,0,0,0,0,0,0,0,0,0,0,0,0,0,0,0
4600,전라남도,4624,신안군,합계,,35175,29213,25583,2742,272,24,145,18,5,6,18,28,17,98,28956,257,5962
4600,전라남도,4624,신안군,거소·선상투표,,218,209,172,18,7,0,0,0,0,0,0,0,0,0,197,12,9
4600,전라남도,4624,신안군,관외사전투표,,7050,7043,6047,822,89,4,33,2,2,0,1,8,1,6,7015,28,7
4600,전라남도,4624,신안군,재외투표,,83,50,42,2,0,0,1,0,0,0,0,0,0,0,45,5,33
4600,전라남도,4624,신안군,지도읍,소계,3464,2754,2454,228,14,0,8,1,0,2,4,1,1,11,2724,30,710
4600,전라남도,4624,신안군,,관내사전투표,1862,1862,1684,137,9,0,4,1,0,2,2,1,0,4,1844,18,0
4600,전라남도,4624,신안군,,지도읍제1투,770,378,324,41,2,0,3,0,0,0,1,0,0,2,373,5,392
4600,전라남도,4624,신안군,,지도읍제2투,67,44,39,4,0,0,1,0,0,0,0,0,0,0,44,0,23
4600,전라남도,4624,신안군,,지도읍제3투,301,164,146,12,0,0,0,0,0,0,0,0,1,1,160,4,137
4600,전라남도,4624,신안군,,지도읍제4투,308,181,149,25,2,0,0,0,0,0,1,0,0,2,179,2,127
4600,전라남도,4624,신안군,,지도읍제5투,156,125,112,9,1,0,0,0,0,0,0,0,0,2,124,1,31
4600,전라남도,4624,신안군,증도면,소계,1370,1115,991,85,13,1,5,2,0,0,1,0,0,4,1102,13,255
4600,전라남도,4624,신안군,,관내사전투표,675,675,604,46,8,0,3,1,0,0,0,0,0,3,665,10,0
4600,전라남도,4624,신안군,,증도면제1투,220,103,89,11,2,0,0,0,0,0,1,0,0,0,103,0,117
4600,전라남도,4624,신안군,,증도면제2투,267,177,152,18,1,1,2,1,0,0,0,0,0,1,176,1,90
4600,전라남도,4624,신안군,,증도면제3투,208,160,146,10,2,0,0,0,0,0,0,0,0,0,158,2,48
4600,전라남도,4624,신안군,임자면,소계,2280,1758,1555,159,9,1,9,0,1,0,1,0,1,10,1746,12,522
4600,전라남도,4624,신안군,,관내사전투표,1194,1194,1061,107,6,1,4,0,1,0,0,0,0,6,1186,8,0
4600,전라남도,4624,신안군,,임자면제1투,678,335,275,47,3,0,4,0,0,0,1,0,0,3,333,2,343
4600,전라남도,4624,신안군,,임자면제2투,154,79,78,0,0,0,1,0,0,0,0,0,0,0,79,0,75
4600,전라남도,4624,신안군,,임자면제3투,66,42,42,0,0,0,0,0,0,0,0,0,0,0,42,0,24
4600,전라남도,4624,신안군,,임자면제4투,188,108,99,5,0,0,0,0,0,0,0,0,1,1,106,2,80
4600,전라남도,4624,신안군,자은면,소계,1743,1380,1219,116,13,0,7,3,0,0,0,2,0,7,1367,13,363
4600,전라남도,4624,신안군,,관내사전투표,906,906,802,73,11,0,3,3,0,0,0,2,0,5,899,7,0
4600,전라남도,4624,신안군,,자은면제1투,541,258,227,24,1,0,2,0,0,0,0,0,0,2,256,2,283
4600,전라남도,4624,신안군,,자은면제2투,296,216,190,19,1,0,2,0,0,0,0,0,0,0,212,4,80
4600,전라남도,4624,신안군,비금면,소계,2504,1978,1728,177,21,4,11,0,0,1,0,4,2,3,1951,27,526
4600,전라남도,4624,신안군,,관내사전투표,1321,1321,1179,101,13,4,3,0,0,1,0,1,2,2,1306,15,0
4600,전라남도,4624,신안군,,비금면제1투,507,259,219,28,3,0,2,0,0,0,0,0,0,1,253,6,248
4600,전라남도,4624,신안군,,비금면제2투,283,166,138,23,2,0,1,0,0,0,0,0,0,0,164,2,117
4600,전라남도,4624,신안군,,비금면제3투,311,169,143,14,2,0,5,0,0,0,0,2,0,0,166,3,142
4600,전라남도,4624,신안군,,비금면제4투,82,63,49,11,1,0,0,0,0,0,0,1,0,0,62,1,19
4600,전라남도,4624,신안군,도초면,소계,1867,1478,1309,126,13,2,7,1,0,0,0,2,0,7,1467,11,389
4600,전라남도,4624,신안군,,관내사전투표,996,996,886,79,9,2,4,1,0,0,0,0,0,6,987,9,0
4600,전라남도,4624,신안군,,도초면제1투,482,241,205,30,3,0,1,0,0,0,0,1,0,0,240,1,241
4600,전라남도,4624,신안군,,도초면제2투,268,156,146,7,1,0,2,0,0,0,0,0,0,0,156,0,112
4600,전라남도,4624,신안군,,도초면제3투,121,85,72,10,0,0,0,0,0,0,0,1,0,1,84,1,36
4600,전라남도,4624,신안군,흑산면,소계,2146,1522,1336,126,13,1,13,1,0,0,3,5,1,9,1508,14,624
4600,전라남도,4624,신안군,,관내사전투표,675,675,600,54,6,0,4,0,0,0,1,1,0,1,667,8,0
4600,전라남도,4624,신안군,,흑산면제1투,444,171,146,22,1,0,0,1,0,0,0,0,0,1,171,0,273
4600,전라남도,4624,신안군,,흑산면제2투,100,62,52,5,1,0,0,0,0,0,0,0,0,2,60,2,38
4600,전라남도,4624,신안군,,흑산면제3투,141,84,80,1,0,0,1,0,0,0,0,2,0,0,84,0,57
4600,전라남도,4624,신안군,,흑산면제4투,116,83,71,6,1,0,1,0,0,0,1,0,1,1,82,1,33
4600,전라남도,4624,신안군,,흑산면제5투,248,181,168,9,1,1,1,0,0,0,0,0,0,1,181,0,67
4600,전라남도,4624,신안군,,흑산면제6투,80,44,40,1,0,0,1,0,0,0,0,1,0,1,44,0,36
4600,전라남도,4624,신안군,,흑산면제7투,270,178,145,22,2,0,5,0,0,0,1,0,0,2,177,1,92
4600,전라남도,4624,신안군,,흑산면제8투,26,16,11,3,0,0,0,0,0,0,0,0,0,0,14,2,10
4600,전라남도,4624,신안군,,흑산면제9투,46,28,23,3,1,0,0,0,0,0,0,1,0,0,28,0,18
4600,전라남도,4624,신안군,하의면,소계,1158,904,791,77,11,2,7,0,0,0,0,1,1,6,896,8,254
4600,전라남도,4624,신안군,,관내사전투표,698,698,623,48,9,1,4,0,0,0,0,1,1,4,691,7,0
4600,전라남도,4624,신안군,,하의면제1투,219,100,79,15,2,1,2,0,0,0,0,0,0,0,99,1,119
4600,전라남도,4624,신안군,,하의면제2투,193,67,55,10,0,0,1,0,0,0,0,0,0,1,67,0,126
4600,전라남도,4624,신안군,,하의면제3투,48,39,34,4,0,0,0,0,0,0,0,0,0,1,39,0,9
4600,전라남도,4624,신안군,신의면,소계,1011,797,699,65,8,0,9,2,0,1,3,0,1,3,791,6,214
4600,전라남도,4624,신안군,,관내사전투표,665,665,583,55,6,0,7,2,0,1,3,0,1,2,660,5,0
4600,전라남도,4624,신안군,,신의면투표소,346,132,116,10,2,0,2,0,0,0,0,0,0,1,131,1,214
4600,전라남도,4624,신안군,장산면,소계,1076,877,761,82,12,3,3,2,1,1,2,0,2,4,873,4,199
4600,전라남도,4624,신안군,,관내사전투표,615,615,540,57,7,2,2,1,0,1,1,0,1,2,614,1,0
4600,전라남도,4624,신안군,,장산면제1투,273,162,133,16,4,1,1,1,1,0,1,0,0,2,160,2,111
4600,전라남도,4624,신안군,,장산면제2투,188,100,88,9,1,0,0,0,0,0,0,0,1,0,99,1,88
4600,전라남도,4624,신안군,안좌면,소계,2170,1683,1435,191,8,4,4,0,0,0,1,0,2,11,1656,27,487
4600,전라남도,4624,신안군,,관내사전투표,1260,1260,1098,123,4,4,3,0,0,0,1,0,0,8,1241,19,0
4600,전라남도,4624,신안군,,안좌면제1투,385,139,110,21,2,0,1,0,0,0,0,0,1,1,136,3,246
4600,전라남도,4624,신안군,,안좌면제2투,119,84,68,11,1,0,0,0,0,0,0,0,1,1,82,2,35
4600,전라남도,4624,신안군,,안좌면제3투,244,125,102,21,0,0,0,0,0,0,0,0,0,1,124,1,119
4600,전라남도,4624,신안군,,안좌면제4투,162,75,57,15,1,0,0,0,0,0,0,0,0,0,73,2,87
4600,전라남도,4624,신안군,팔금면,소계,790,659,571,64,4,0,6,2,1,0,0,1,1,3,653,6,131
4600,전라남도,4624,신안군,,관내사전투표,522,522,457,47,2,0,4,2,1,0,0,1,1,3,518,4,0
4600,전라남도,4624,신안군,,팔금면투표소,268,137,114,17,2,0,2,0,0,0,0,0,0,0,135,2,131
4600,전라남도,4624,신안군,암태면,소계,1513,1231,1096,94,10,0,7,1,0,0,1,1,1,4,1215,16,282
4600,전라남도,4624,신안군,,관내사전투표,916,916,814,73,6,0,5,1,0,0,1,1,0,4,905,11,0
4600,전라남도,4624,신안군,,암태면제1투,336,139,119,13,3,0,1,0,0,0,0,0,0,0,136,3,197
4600,전라남도,4624,신안군,,암태면제2투,161,99,91,5,1,0,0,0,0,0,0,0,1,0,98,1,62
4600,전라남도,4624,신안군,,암태면제3투,100,77,72,3,0,0,1,0,0,0,0,0,0,0,76,1,23
4600,전라남도,4624,신안군,압해읍,소계,4732,3772,3374,310,27,2,15,1,0,1,1,3,3,10,3747,25,960
4600,전라남도,4624,신안군,,관내사전투표,2321,2321,2098,171,18,1,8,1,0,1,1,0,2,5,2306,15,0
4600,전라남도,4624,신안군,,압해읍제1투,554,264,231,24,5,0,1,0,0,0,0,0,0,1,262,2,290
4600,전라남도,4624,신안군,,압해읍제2투,385,231,210,18,1,0,0,0,0,0,0,0,0,0,229,2,154
4600,전라남도,4624,신안군,,압해읍제3투,549,326,267,50,2,0,3,0,0,0,0,1,0,1,324,2,223
4600,전라남도,4624,신안군,,압해읍제4투,633,406,359,38,1,1,2,0,0,0,0,1,1,0,403,3,227
4600,전라남도,4624,신안군,,압해읍제5투,132,103,94,7,0,0,0,0,0,0,0,1,0,1,103,0,29
4600,전라남도,4624,신안군,,압해읍제6투,158,121,115,2,0,0,1,0,0,0,0,0,0,2,120,1,37
4600,전라남도,4624,신안군,잘못 투입·구분된 투표지,,0,3,3,0,0,0,0,0,0,0,0,0,0,0,3,0,-34700,경상북도,4701,포항시북구,합계,,232070,183046,45053,130458,3911,73,1539,54,30,57,182,128,73,48,181606,1440,49024
4700,경상북도,4701,포항시북구,거소·선상투표,,602,549,95,379,5,3,11,2,0,0,1,0,0,3,499,50,53
4700,경상북도,4701,포항시북구,관외사전투표,,20577,20575,5886,13576,570,13,250,8,6,4,14,22,6,10,20365,210,2
4700,경상북도,4701,포항시북구,재외투표,,789,569,263,214,22,0,0,0,0,0,0,0,0,0,499,70,220
4700,경상북도,4701,포항시북구,흥해읍,소계,30218,22685,5336,16385,494,7,216,9,5,9,25,20,7,2,22515,170,7533
4700,경상북도,4701,포항시북구,,관내사전투표,7905,7903,1819,5825,143,4,55,3,1,3,3,5,1,0,7862,41,2
4700,경상북도,4701,포항시북구,,흥해읍제1투,1306,772,148,599,11,0,8,0,0,2,0,1,0,0,769,3,534
4700,경상북도,4701,포항시북구,,흥해읍제2투,1179,774,154,584,11,0,10,0,0,0,4,1,0,0,764,10,405
4700,경상북도,4701,포항시북구,,흥해읍제3투,1025,752,105,619,7,0,3,0,0,1,1,2,1,0,739,13,273
4700,경상북도,4701,포항시북구,,흥해읍제4투,1165,734,90,607,10,0,5,1,0,1,3,0,1,0,718,16,431
4700,경상북도,4701,포항시북구,,흥해읍제5투,952,581,127,419,18,0,10,0,0,0,0,0,0,0,574,7,371
4700,경상북도,4701,포항시북구,,흥해읍제6투,942,536,86,434,5,0,5,1,0,0,2,1,0,0,534,2,406
4700,경상북도,4701,포항시북구,,흥해읍제7투,1304,889,153,699,12,0,9,2,0,0,1,0,0,1,877,12,415
4700,경상북도,4701,포항시북구,,흥해읍제8투,652,403,47,344,4,0,2,0,0,1,0,1,1,0,400,3,249
4700,경상북도,4701,포항시북구,,흥해읍제9투,2366,1543,367,1099,41,0,15,0,0,1,2,3,1,1,1530,13,823
4700,경상북도,4701,포항시북구,,흥해읍제10투,1760,1172,277,838,24,0,16,1,2,0,1,2,0,0,1161,11,588
4700,경상북도,4701,포항시북구,,흥해읍제11투,1654,1070,192,827,19,1,23,0,1,0,0,0,1,0,1064,6,584
4700,경상북도,4701,포항시북구,,흥해읍제12투,2272,1587,440,1071,49,0,14,1,1,0,3,1,1,0,1581,6,685
4700,경상북도,4701,포항시북구,,흥해읍제13투,2700,1855,592,1165,63,1,15,0,0,0,4,3,0,0,1843,12,845
4700,경상북도,4701,포항시북구,,흥해읍제14투,3036,2114,739,1255,77,1,26,0,0,0,1,0,0,0,2099,15,922
4700,경상북도,4701,포항시북구,신광면,소계,2790,2267,347,1851,26,2,12,1,1,0,4,3,4,0,2251,16,523
4700,경상북도,4701,포항시북구,,관내사전투표,1399,1399,232,1131,15,2,3,1,1,0,3,1,2,0,1391,8,0
4700,경상북도,4701,포항시북구,,신광면제1투,576,327,46,266,7,0,2,0,0,0,1,1,1,0,324,3,249
4700,경상북도,4701,포항시북구,,신광면제2투,348,221,29,181,2,0,4,0,0,0,0,0,1,0,217,4,127
4700,경상북도,4701,포항시북구,,신광면제3투,467,320,40,273,2,0,3,0,0,0,0,1,0,0,319,1,147
4700,경상북도,4701,포항시북구,청하면,소계,4526,3611,609,2849,57,8,24,4,2,0,4,2,6,2,3567,44,915
4700,경상북도,4701,포항시북구,,관내사전투표,2280,2280,422,1762,32,7,11,4,0,0,2,2,5,2,2249,31,0
4700,경상북도,4701,포항시북구,,청하면제1투,1146,628,110,487,14,0,9,0,2,0,0,0,0,0,622,6,518
4700,경상북도,4701,포항시북구,,청하면제2투,785,496,57,421,8,1,2,0,0,0,1,0,1,0,491,5,289
4700,경상북도,4701,포항시북구,,청하면제3투,315,207,20,179,3,0,2,0,0,0,1,0,0,0,205,2,108
4700,경상북도,4701,포항시북구,송라면,소계,2267,1859,261,1530,20,2,9,3,1,3,0,3,7,1,1840,19,408
4700,경상북도,4701,포항시북구,,관내사전투표,1309,1309,182,1073,18,2,7,2,1,1,0,2,6,1,1295,14,0
4700,경상북도,4701,포항시북구,,송라면투표소,958,550,79,457,2,0,2,1,0,2,0,1,1,0,545,5,408
4700,경상북도,4701,포항시북구,기계면,소계,4670,3789,554,3115,37,2,32,3,0,1,8,6,3,1,3762,27,881
4700,경상북도,4701,포항시북구,,관내사전투표,2398,2398,323,2003,28,2,14,1,0,1,4,3,1,0,2380,18,0
4700,경상북도,4701,포항시북구,,기계면제1투,1383,813,142,640,4,0,14,2,0,0,2,2,1,1,808,5,570
4700,경상북도,4701,포항시북구,,기계면제2투,482,288,53,228,0,0,2,0,0,0,2,0,1,0,286,2,194
4700,경상북도,4701,포항시북구,,기계면제3투,407,290,36,244,5,0,2,0,0,0,0,1,0,0,288,2,117
4700,경상북도,4701,포항시북구,죽장면,소계,2334,1896,216,1617,18,2,10,2,0,1,1,5,2,3,1877,19,438
4700,경상북도,4701,포항시북구,,관내사전투표,1168,1168,126,1014,9,1,4,0,0,0,1,3,2,2,1162,6,0
4700,경상북도,4701,포항시북구,,죽장면제1투,770,418,47,347,4,0,5,2,0,1,0,1,0,1,408,10,352
4700,경상북도,4701,포항시북구,,죽장면제2투,396,310,43,256,5,1,1,0,0,0,0,1,0,0,307,3,86
4700,경상북도,4701,포항시북구,기북면,소계,1238,1044,160,843,18,2,3,1,0,2,2,0,4,0,1035,9,194
4700,경상북도,4701,포항시북구,,관내사전투표,800,800,117,655,11,1,2,0,0,2,1,0,2,0,791,9,0
4700,경상북도,4701,포항시북구,,기북면투표소,438,244,43,188,7,1,1,1,0,0,1,0,2,0,244,0,194
4700,경상북도,4701,포항시북구,중앙동,소계,13349,9845,2010,7461,196,2,58,2,0,3,14,8,4,2,9760,85,3504
4700,경상북도,4701,포항시북구,,관내사전투표,4333,4333,998,3195,90,1,19,2,0,0,3,2,0,1,4311,22,0
4700,경상북도,4701,포항시북구,,중앙동제1투,1051,534,78,443,4,0,4,0,0,1,1,0,0,0,531,3,517
4700,경상북도,4701,포항시북구,,중앙동제2투,619,350,47,285,5,0,8,0,0,0,0,0,0,1,346,4,269
4700,경상북도,4701,포항시북구,,중앙동제3투,1038,618,112,474,13,1,6,0,0,0,4,0,0,0,610,8,420
4700,경상북도,4701,포항시북구,,중앙동제4투,2022,1250,258,928,34,0,12,0,0,1,0,3,0,0,1236,14,772
4700,경상북도,4701,포항시북구,,중앙동제5투,1631,1013,178,796,15,0,3,0,0,1,4,2,2,0,1001,12,618
4700,경상북도,4701,포항시북구,,중앙동제6투,979,519,94,402,6,0,4,0,0,0,1,1,1,0,509,10,460
4700,경상북도,4701,포항시북구,,중앙동제7투,1676,1228,245,938,29,0,2,0,0,0,1,0,1,0,1216,12,448
4700,경상북도,4701,포항시북구,양학동,소계,13083,10259,2641,7216,242,3,78,1,3,2,8,13,3,1,10211,48,2824
4700,경상북도,4701,포항시북구,,관내사전투표,5017,5017,1343,3519,106,0,26,0,0,0,3,4,2,1,5004,13,0
4700,경상북도,4701,포항시북구,,양학동제1투,1742,1159,234,863,30,1,10,1,1,1,0,4,1,0,1146,13,583
4700,경상북도,4701,포항시북구,,양학동제2투,2063,1253,329,863,31,0,17,0,1,1,2,1,0,0,1245,8,810
4700,경상북도,4701,포항시북구,,양학동제3투,2391,1482,413,991,50,1,11,0,1,0,1,3,0,0,1471,11,909
4700,경상북도,4701,포항시북구,,양학동제4투,1870,1348,322,980,25,1,14,0,0,0,2,1,0,0,1345,3,522
4700,경상북도,4701,포항시북구,죽도동,소계,17037,12136,2249,9445,191,4,127,2,1,2,24,5,2,1,12053,83,4901
4700,경상북도,4701,포항시북구,,관내사전투표,5017,5017,942,3957,63,3,24,2,0,0,4,0,1,0,4996,21,0
4700,경상북도,4701,포항시북구,,죽도동제1투,1696,1073,150,884,14,1,13,0,0,0,3,1,0,0,1066,7,623
4700,경상북도,4701,포항시북구,,죽도동제2투,3071,1553,287,1188,30,0,26,0,0,0,3,0,0,1,1535,18,1518
4700,경상북도,4701,포항시북구,,죽도동제3투,2366,1427,255,1094,35,0,22,0,0,1,4,2,0,0,1413,14,939
4700,경상북도,4701,포항시북구,,죽도동제4투,2028,1317,252,1008,18,0,23,0,1,0,5,2,0,0,1309,8,711
4700,경상북도,4701,포항시북구,,죽도동제5투,2859,1749,363,1314,31,0,19,0,0,1,5,0,1,0,1734,15,1110
4700,경상북도,4701,포항시북구,용흥동,소계,17064,13197,2937,9836,215,1,81,4,2,2,13,6,5,5,13107,90,3867
4700,경상북도,4701,포항시북구,,관내사전투표,5068,5068,1196,3770,59,1,12,3,0,0,2,3,2,1,5049,19,0
4700,경상북도,4701,포항시북구,,용흥동제1투,1860,1353,218,1094,21,0,8,1,0,0,5,0,1,0,1348,5,507
4700,경상북도,4701,포항시북구,,용흥동제2투,1479,875,182,637,25,0,16,0,0,1,1,1,0,0,863,12,604
4700,경상북도,4701,포항시북구,,용흥동제3투,1476,932,195,710,8,0,7,0,0,0,2,0,0,0,922,10,544
4700,경상북도,4701,포항시북구,,용흥동제4투,1623,1201,269,898,15,0,9,0,0,0,1,1,1,2,1196,5,422
4700,경상북도,4701,포항시북구,,용흥동제5투,2025,1484,366,1054,36,0,11,0,0,0,0,1,0,1,1469,15,541
4700,경상북도,4701,포항시북구,,용흥동제6투,1699,1137,285,793,30,0,10,0,2,1,1,0,0,0,1122,15,562
4700,경상북도,4701,포항시북구,,용흥동제7투,1834,1147,226,880,21,0,8,0,0,0,1,0,1,1,1138,9,687
4700,경상북도,4701,포항시북구,우창동,소계,24596,18885,4988,13076,473,7,165,5,3,8,18,11,5,5,18764,121,5711
4700,경상북도,4701,포항시북구,,관내사전투표,7275,7275,2111,4935,157,6,29,4,0,2,1,6,1,2,7254,21,0
4700,경상북도,4701,포항시북구,,우창동제1투,1876,1235,265,917,32,0,9,0,0,1,1,0,0,0,1225,10,641
4700,경상북도,4701,포항시북구,,우창동제2투,1685,1140,213,860,28,0,19,0,0,3,4,1,0,1,1129,11,545
4700,경상북도,4701,포항시북구,,우창동제3투,2119,1429,423,936,43,0,13,0,0,0,5,0,0,1,1421,8,690
4700,경상북도,4701,포항시북구,,우창동제4투,1416,941,203,692,25,0,14,0,0,0,1,0,1,0,936,5,475
4700,경상북도,4701,포항시북구,,우창동제5투,1294,881,180,670,9,0,9,0,0,1,2,0,1,0,872,9,413
4700,경상북도,4701,포항시북구,,우창동제6투,1585,1037,189,805,15,0,9,0,1,0,1,0,1,0,1021,16,548
4700,경상북도,4701,포항시북구,,우창동제7투,2104,1373,316,981,36,0,27,0,0,0,0,1,0,0,1361,12,731
4700,경상북도,4701,포항시북구,,우창동제8투,2454,1648,490,1063,61,1,16,0,1,0,0,3,0,0,1635,13,806
4700,경상북도,4701,포항시북구,,우창동제9투,2788,1926,598,1217,67,0,20,1,1,1,3,0,1,1,1910,16,862
4700,경상북도,4701,포항시북구,두호동,소계,19898,16278,3768,11924,331,3,123,0,3,6,9,3,3,2,16175,103,3620
4700,경상북도,4701,포항시북구,,관내사전투표,7660,7660,1844,5615,118,3,42,0,1,0,1,1,2,1,7628,32,0
4700,경상북도,4701,포항시북구,,두호동제1투,905,493,98,377,7,0,4,0,0,0,1,0,1,0,488,5,412
4700,경상북도,4701,포항시북구,,두호동제2투,1458,858,165,653,18,0,11,0,2,0,1,1,0,0,851,7,600
4700,경상북도,4701,포항시북구,,두호동제3투,2056,1510,314,1127,42,0,10,0,0,2,1,1,0,0,1497,13,546
4700,경상북도,4701,포항시북구,,두호동제4투,2526,1963,456,1412,50,0,28,0,0,2,2,0,0,0,1950,13,563
4700,경상북도,4701,포항시북구,,두호동제5투,3003,2129,470,1560,53,0,20,0,0,2,2,0,0,0,2107,22,874
4700,경상북도,4701,포항시북구,,두호동제6투,2290,1665,421,1180,43,0,8,0,0,0,1,0,0,1,1654,11,625
4700,경상북도,4701,포항시북구,장량동,소계,49032,37056,10962,24640,850,11,276,6,2,9,27,19,10,8,36820,236,11976
4700,경상북도,4701,포항시북구,,관내사전투표,11842,11840,3835,7642,230,5,64,2,1,0,5,4,5,5,11798,42,2
4700,경상북도,4701,포항시북구,,장량동제1투,1511,986,236,719,18,0,8,0,0,0,0,1,0,0,982,4,525
4700,경상북도,4701,포항시북구,,장량동제2투,1762,1146,252,853,24,0,9,0,0,0,2,2,0,0,1142,4,616
4700,경상북도,4701,포항시북구,,장량동제3투,1571,1156,327,775,32,1,10,0,0,1,0,1,0,0,1147,9,415
4700,경상북도,4701,포항시북구,,장량동제4투,2417,1712,433,1200,40,0,25,0,0,2,1,0,0,0,1701,11,705
4700,경상북도,4701,포항시북구,,장량동제5투,2729,1601,434,1094,35,0,18,2,0,0,2,1,0,0,1586,15,1128
4700,경상북도,4701,포항시북구,,장량동제6투,2586,1974,507,1402,40,0,5,0,0,2,0,1,1,1,1959,15,612
4700,경상북도,4701,포항시북구,,장량동제7투,3477,1874,485,1296,44,3,24,1,0,0,2,2,2,1,1860,14,1603
4700,경상북도,4701,포항시북구,,장량동제8투,2659,1860,602,1155,53,0,20,0,0,1,2,1,0,0,1834,26,799
4700,경상북도,4701,포항시북구,,장량동제9투,2772,1734,506,1137,56,0,15,0,0,0,2,2,0,0,1718,16,1038
4700,경상북도,4701,포항시북구,,장량동제10투,2656,2026,630,1323,56,0,7,0,1,1,2,1,0,0,2021,5,630
4700,경상북도,4701,포항시북구,,장량동제11투,3033,1883,558,1236,46,0,23,0,0,0,2,2,2,0,1869,14,1150
4700,경상북도,4701,포항시북구,,장량동제12투,3408,2472,785,1594,62,0,8,0,0,0,2,0,0,1,2452,20,936
4700,경상북도,4701,포항시북구,,장량동제13투,1834,1297,385,863,25,1,12,1,0,1,0,0,0,0,1288,9,537
4700,경상북도,4701,포항시북구,,장량동제14투,2618,1836,522,1224,49,1,15,0,0,0,2,0,0,0,1813,23,782
4700,경상북도,4701,포항시북구,,장량동제15투,2157,1659,465,1127,40,0,13,0,0,1,3,1,0,0,1650,9,498
4700,경상북도,4701,포항시북구,환여동,소계,8000,6542,1769,4499,146,1,64,1,1,5,10,2,2,2,6502,40,1458
4700,경상북도,4701,포항시북구,,관내사전투표,3463,3463,949,2390,74,1,24,1,1,1,3,0,1,2,3447,16,0
4700,경상북도,4701,포항시북구,,환여동제1투,533,348,63,263,6,0,11,0,0,0,1,0,1,0,345,3,185
4700,경상북도,4701,포항시북구,,환여동제2투,890,550,89,442,7,0,4,0,0,1,1,1,0,0,545,5,340
4700,경상북도,4701,포항시북구,,환여동제3투,2305,1618,510,1027,47,0,17,0,0,3,4,1,0,0,1609,9,687
4700,경상북도,4701,포항시북구,,환여동제4투,809,563,158,377,12,0,8,0,0,0,1,0,0,0,556,7,246
4700,경상북도,4701,포항시북구,잘못 투입·구분된 투표지,,0,4,2,2,0,0,0,0,0,0,0,0,0,0,4,0,-4
4700,경상북도,4702,포항시남구,합계,,197466,152184,38517,106712,3250,72,1690,32,19,44,121,140,81,62,150740,1444,45282
4700,경상북도,4702,포항시남구,거소·선상투표,,365,337,61,219,5,3,10,0,0,0,0,0,1,1,300,37,28
4700,경상북도,4702,포항시남구,관외사전투표,,15615,15612,4354,10398,378,13,234,6,3,5,10,18,11,11,15441,171,3
4700,경상북도,4702,포항시남구,재외투표,,541,363,198,111,15,0,2,0,0,0,0,0,0,0,326,37,178
4700,경상북도,4702,포항시남구,구룡포읍,소계,6697,4959,642,4155,50,7,25,0,2,2,6,5,8,7,4909,50,1738
4700,경상북도,4702,포항시남구,,관내사전투표,2618,2618,340,2193,31,4,15,0,0,0,3,3,6,1,2596,22,0
4700,경상북도,4702,포항시남구,,구룡포읍제1투,1861,1105,141,930,8,2,3,0,1,1,0,1,1,2,1090,15,756
4700,경상북도,4702,포항시남구,,구룡포읍제2투,909,546,78,452,4,1,3,0,0,0,2,0,0,3,543,3,363
4700,경상북도,4702,포항시남구,,구룡포읍제3투,398,229,28,190,2,0,2,0,0,0,1,1,1,1,226,3,169
4700,경상북도,4702,포항시남구,,구룡포읍제4투,911,461,55,390,5,0,2,0,1,1,0,0,0,0,454,7,450
4700,경상북도,4702,포항시남구,연일읍,소계,22206,16888,4429,11725,402,12,143,3,2,3,12,10,12,7,16760,128,5318
4700,경상북도,4702,포항시남구,,관내사전투표,6186,6185,1645,4328,120,4,41,2,0,0,5,6,3,2,6156,29,1
4700,경상북도,4702,포항시남구,,연일읍제1투,1391,776,174,561,13,4,14,0,0,1,1,0,3,0,771,5,615
4700,경상북도,4702,포항시남구,,연일읍제2투,2035,1284,306,918,31,2,14,0,0,0,0,0,1,0,1272,12,751
4700,경상북도,4702,포항시남구,,연일읍제3투,1289,775,172,568,17,0,13,0,0,0,0,0,1,0,771,4,514
4700,경상북도,4702,포항시남구,,연일읍제4투,2640,1695,443,1159,47,1,19,0,0,2,4,2,1,1,1679,16,945
4700,경상북도,4702,포항시남구,,연일읍제5투,2224,1520,438,1014,48,0,10,0,0,0,2,1,0,0,1513,7,704
4700,경상북도,4702,포항시남구,,연일읍제6투,2550,1889,531,1268,53,0,14,0,2,0,0,0,1,2,1871,18,661
4700,경상북도,4702,포항시남구,,연일읍제7투,2565,1862,578,1179,60,1,13,0,0,0,0,1,0,0,1832,30,703
4700,경상북도,4702,포항시남구,,연일읍제8투,493,340,51,276,5,0,3,1,0,0,0,0,2,0,338,2,153
4700,경상북도,4702,포항시남구,,연일읍제9투,833,562,91,454,8,0,2,0,0,0,0,0,0,2,557,5,271
4700,경상북도,4702,포항시남구,오천읍,소계,42071,29354,8722,19025,738,8,493,5,2,6,15,34,19,6,29073,281,12717
4700,경상북도,4702,포항시남구,,관내사전투표,11606,11606,3667,7399,278,3,146,0,2,2,3,11,4,3,11518,88,0
4700,경상북도,4702,포항시남구,,오천읍제1투,2632,1354,398,870,47,0,18,0,0,0,1,0,1,1,1336,18,1278
4700,경상북도,4702,포항시남구,,오천읍제2투,1693,991,209,712,26,0,22,0,0,0,1,6,1,0,977,14,702
4700,경상북도,4702,포항시남구,,오천읍제3투,910,599,119,451,8,2,10,1,0,0,0,0,1,1,593,6,311
4700,경상북도,4702,포항시남구,,오천읍제4투,937,560,115,410,14,3,12,0,0,0,0,1,0,0,555,5,377
4700,경상북도,4702,포항시남구,,오천읍제5투,1686,992,220,729,18,0,11,0,0,0,1,2,3,0,984,8,694
4700,경상북도,4702,포항시남구,,오천읍제6투,974,623,134,450,13,0,11,2,0,0,0,2,0,0,612,11,351
4700,경상북도,4702,포항시남구,,오천읍제7투,1778,1175,233,873,22,0,23,1,0,0,1,1,3,0,1157,18,603
4700,경상북도,4702,포항시남구,,오천읍제8투,2426,1622,461,1063,50,0,25,0,0,0,6,4,1,1,1611,11,804
4700,경상북도,4702,포항시남구,,오천읍제9투,2198,1164,381,715,30,0,21,0,0,0,0,2,0,0,1149,15,1034
4700,경상북도,4702,포항시남구,,오천읍제10투,2873,1851,693,1044,66,0,28,1,0,1,0,0,1,0,1834,17,1022
4700,경상북도,4702,포항시남구,,오천읍제11투,1875,967,310,586,38,0,18,0,0,1,1,3,0,0,957,10,908
4700,경상북도,4702,포항시남구,,오천읍제12투,1759,904,227,626,14,0,29,0,0,1,0,1,1,0,899,5,855
4700,경상북도,4702,포항시남구,,오천읍제13투,1009,640,135,469,12,0,13,0,0,0,1,1,2,0,633,7,369
4700,경상북도,4702,포항시남구,,오천읍제14투,2755,1591,516,982,32,0,39,0,0,1,0,0,0,0,1570,21,1164
4700,경상북도,4702,포항시남구,,오천읍제15투,2751,1827,626,1101,54,0,25,0,0,0,0,0,1,0,1807,20,924
4700,경상북도,4702,포항시남구,,오천읍제16투,2209,888,278,545,16,0,42,0,0,0,0,0,0,0,881,7,1321
4700,경상북도,4702,포항시남구,대송면,소계,3356,2701,491,2109,39,0,28,0,0,2,0,3,4,1,2677,24,655
4700,경상북도,4702,포항시남구,,관내사전투표,1546,1546,306,1194,23,0,10,0,0,1,0,0,2,0,1536,10,0
4700,경상북도,4702,포항시남구,,대송면제1투,664,426,66,337,3,0,7,0,0,1,0,1,1,0,416,10,238
4700,경상북도,4702,포항시남구,,대송면제2투,655,404,57,327,8,0,7,0,0,0,0,1,1,1,402,2,251
4700,경상북도,4702,포항시남구,,대송면제3투,491,325,62,251,5,0,4,0,0,0,0,1,0,0,323,2,166
4700,경상북도,4702,포항시남구,동해면,소계,8237,6269,1358,4570,116,4,104,3,3,4,5,7,3,5,6182,87,1968
4700,경상북도,4702,포항시남구,,관내사전투표,3555,3555,749,2629,63,2,50,3,1,2,3,5,1,4,3512,43,0
4700,경상북도,4702,포항시남구,,동해면제1투,1339,789,195,548,11,0,19,0,1,1,1,0,1,0,777,12,550
4700,경상북도,4702,포항시남구,,동해면제2투,284,184,24,156,0,0,1,0,0,0,0,1,0,0,182,2,100
4700,경상북도,4702,포항시남구,,동해면제3투,506,326,75,235,3,0,9,0,0,0,0,0,0,0,322,4,180
4700,경상북도,4702,포항시남구,,동해면제4투,1223,629,120,466,20,2,8,0,0,0,1,1,0,1,619,10,594
4700,경상북도,4702,포항시남구,,동해면제5투,1330,786,195,536,19,0,17,0,1,1,0,0,1,0,770,16,544
4700,경상북도,4702,포항시남구,장기면,소계,3549,2683,325,2197,44,1,28,2,0,0,7,0,6,6,2616,67,866
4700,경상북도,4702,포항시남구,,관내사전투표,1496,1496,200,1211,23,1,12,1,0,0,2,0,2,2,1454,42,0
4700,경상북도,4702,포항시남구,,장기면제1투,608,290,28,240,4,0,5,0,0,0,1,0,1,0,279,11,318
4700,경상북도,4702,포항시남구,,장기면제2투,837,507,57,426,5,0,6,1,0,0,4,0,1,1,501,6,330
4700,경상북도,4702,포항시남구,,장기면제3투,608,390,40,320,12,0,5,0,0,0,0,0,2,3,382,8,218
4700,경상북도,4702,포항시남구,호미곶면,소계,1709,1325,187,1092,14,2,6,0,0,0,1,2,2,1,1307,18,384
4700,경상북도,4702,포항시남구,,관내사전투표,953,953,139,783,7,2,5,0,0,0,0,2,1,1,940,13,0
4700,경상북도,4702,포항시남구,,호미곶면투표소,756,372,48,309,7,0,1,0,0,0,1,0,1,0,367,5,384
4700,경상북도,4702,포항시남구,상대동,소계,20259,14549,2872,11134,250,8,129,1,1,4,13,15,3,4,14434,115,5710
4700,경상북도,4702,포항시남구,,관내사전투표,5963,5963,1260,4520,86,3,40,1,0,0,2,8,1,2,5923,40,0
4700,경상북도,4702,포항시남구,,상대동제1투,1840,1112,225,839,20,1,12,0,0,0,2,4,1,0,1104,8,728
4700,경상북도,4702,포항시남구,,상대동제2투,2007,1120,210,866,19,2,9,0,0,2,1,0,0,0,1109,11,887
4700,경상북도,4702,포항시남구,,상대동제3투,1626,1025,179,800,19,0,11,0,0,2,1,1,0,1,1014,11,601
4700,경상북도,4702,포항시남구,,상대동제4투,1621,907,173,685,28,1,11,0,0,0,1,0,0,0,899,8,714
4700,경상북도,4702,포항시남구,,상대동제5투,1606,866,180,649,18,0,10,0,0,0,1,0,0,0,858,8,740
4700,경상북도,4702,포항시남구,,상대동제6투,1678,1020,191,786,18,0,16,0,1,0,1,0,1,0,1014,6,658
4700,경상북도,4702,포항시남구,,상대동제7투,1596,1040,187,824,16,0,4,0,0,0,1,0,0,1,1033,7,556
4700,경상북도,4702,포항시남구,,상대동제8투,2322,1496,267,1165,26,1,16,0,0,0,3,2,0,0,1480,16,826
4700,경상북도,4702,포항시남구,해도동,소계,15127,11148,2026,8736,145,3,122,2,2,3,11,11,1,4,11066,82,3979
4700,경상북도,4702,포항시남구,,관내사전투표,4867,4867,908,3838,51,2,33,1,1,0,2,6,0,1,4843,24,0
4700,경상북도,4702,포항시남구,,해도동제1투,1493,797,130,623,18,0,14,0,1,1,0,2,0,0,789,8,696
4700,경상북도,4702,포항시남구,,해도동제2투,897,588,102,462,7,0,5,0,0,0,4,0,0,1,581,7,309
4700,경상북도,4702,포항시남구,,해도동제3투,1529,938,144,758,15,0,13,1,0,0,1,0,0,1,933,5,591
4700,경상북도,4702,포항시남구,,해도동제4투,1213,850,122,705,7,1,10,0,0,0,0,0,1,0,846,4,363
4700,경상북도,4702,포항시남구,,해도동제5투,779,453,75,355,6,0,12,0,0,0,1,0,0,0,449,4,326
4700,경상북도,4702,포항시남구,,해도동제6투,1896,1135,230,863,10,0,14,0,0,0,2,1,0,1,1121,14,761
4700,경상북도,4702,포항시남구,,해도동제7투,1234,775,162,575,16,0,10,0,0,1,1,1,0,0,766,9,459
4700,경상북도,4702,포항시남구,,해도동제8투,1219,745,153,557,15,0,11,0,0,1,0,1,0,0,738,7,474
4700,경상북도,4702,포항시남구,송도동,소계,10207,7608,1196,6164,101,2,68,2,1,4,9,5,2,4,7558,50,2599
4700,경상북도,4702,포항시남구,,관내사전투표,3303,3301,505,2715,36,2,18,0,1,2,2,2,0,2,3285,16,2
4700,경상북도,4702,포항시남구,,송도동제1투,1220,718,114,576,11,0,10,0,0,0,0,1,0,0,712,6,502
4700,경상북도,4702,포항시남구,,송도동제2투,1173,726,144,555,8,0,10,1,0,1,2,1,1,0,723,3,447
4700,경상북도,4702,포항시남구,,송도동제3투,1447,904,133,739,14,0,9,0,0,0,1,0,1,1,898,6,543
4700,경상북도,4702,포항시남구,,송도동제4투,1876,1261,191,1017,21,0,12,1,0,0,4,1,0,0,1247,14,615
4700,경상북도,4702,포항시남구,,송도동제5투,1188,698,109,562,11,0,9,0,0,1,0,0,0,1,693,5,490
4700,경상북도,4702,포항시남구,청림동,소계,4397,3337,791,2367,59,2,67,1,0,1,2,8,0,1,3299,38,1060
4700,경상북도,4702,포항시남구,,관내사전투표,1890,1890,451,1339,35,1,39,0,0,1,0,4,0,0,1870,20,0
4700,경상북도,4702,포항시남구,,청림동제1투,622,304,70,216,8,0,6,0,0,0,0,0,0,0,300,4,318
4700,경상북도,4702,포항시남구,,청림동제2투,1364,812,205,560,11,1,18,1,0,0,2,4,0,1,803,9,552
4700,경상북도,4702,포항시남구,,청림동제3투,521,331,65,252,5,0,4,0,0,0,0,0,0,0,326,5,190
4700,경상북도,4702,포항시남구,제철동,소계,3091,2498,705,1672,67,1,26,0,0,0,0,2,3,0,2476,22,593
4700,경상북도,4702,포항시남구,,관내사전투표,1691,1691,508,1114,33,1,20,0,0,0,0,1,3,0,1680,11,0
4700,경상북도,4702,포항시남구,,제철동투표소,1400,807,197,558,34,0,6,0,0,0,0,1,0,0,796,11,593
4700,경상북도,4702,포항시남구,효곡동,소계,21768,18092,5863,11496,455,5,111,3,2,7,8,11,1,1,17963,129,3676
4700,경상북도,4702,포항시남구,,관내사전투표,7625,7625,2754,4611,169,2,35,1,2,3,1,3,1,0,7582,43,0
4700,경상북도,4702,포항시남구,,효곡동제1투,1780,1185,311,834,16,0,12,0,0,0,1,0,0,0,1174,11,595
4700,경상북도,4702,포항시남구,,효곡동제2투,1848,1325,407,849,38,0,9,1,0,1,2,0,0,0,1307,18,523
4700,경상북도,4702,포항시남구,,효곡동제3투,1955,1493,473,945,50,1,13,0,0,1,0,1,0,0,1484,9,462
4700,경상북도,4702,포항시남구,,효곡동제4투,2066,1606,463,1075,48,0,8,0,0,0,1,1,0,0,1596,10,460
4700,경상북도,4702,포항시남구,,효곡동제5투,1917,1500,476,945,41,1,13,1,0,2,1,1,0,1,1482,18,417
4700,경상북도,4702,포항시남구,,효곡동제6투,1784,1408,420,924,45,0,7,0,0,0,1,1,0,0,1398,10,376
4700,경상북도,4702,포항시남구,,효곡동제7투,2793,1950,559,1313,48,1,14,0,0,0,1,4,0,0,1940,10,843
4700,경상북도,4702,포항시남구,대이동,소계,18271,14461,4297,9542,372,1,94,4,1,3,22,9,5,3,14353,108,3810
4700,경상북도,4702,포항시남구,,관내사전투표,5960,5960,1961,3778,145,0,32,1,0,1,3,3,2,1,5927,33,0
4700,경상북도,4702,포항시남구,,대이동제1투,1124,774,211,514,30,1,4,0,0,0,0,0,0,1,761,13,350
4700,경상북도,4702,포항시남구,,대이동제2투,1597,1074,256,781,20,0,9,0,0,0,2,0,0,0,1068,6,523
4700,경상북도,4702,포항시남구,,대이동제3투,1178,828,248,535,25,0,4,1,1,1,2,1,1,0,819,9,350
4700,경상북도,4702,포항시남구,,대이동제4투,1571,916,246,633,13,0,12,1,0,0,5,1,0,0,911,5,655
4700,경상북도,4702,포항시남구,,대이동제5투,2175,1488,404,1021,39,0,9,0,0,0,3,2,0,0,1478,10,687
4700,경상북도,4702,포항시남구,,대이동제6투,2408,1615,456,1067,53,0,12,0,0,1,5,2,1,1,1598,17,793
4700,경상북도,4702,포항시남구,,대이동제7투,2258,1806,515,1213,47,0,12,1,0,0,2,0,1,0,1791,15,452
4700,경상북도,4702,포항시남구,잘못 투입·구분된 투표지,,0,0,0,0,0,0,0,0,0,0,0,0,0,0,0,0,0
4700,경상북도,4703,울릉군,합계,,8141,6653,1590,4815,109,3,66,0,3,2,7,3,1,6,6605,48,1488
4700,경상북도,4703,울릉군,거소·선상투표,,27,27,5,19,0,0,1,0,0,0,0,0,0,0,25,2,0
4700,경상북도,4703,울릉군,관외사전투표,,1534,1534,406,1075,29,0,11,0,0,0,3,1,0,1,1526,8,0
4700,경상북도,4703,울릉군,재외투표,,14,11,7,2,0,0,0,0,0,0,0,0,0,0,9,2,3
4700,경상북도,4703,울릉군,울릉읍,소계,4522,3409,818,2457,63,0,35,0,3,2,1,2,1,2,3384,25,1113
4700,경상북도,4703,울릉군,,관내사전투표,1740,1740,445,1236,30,0,14,0,1,0,1,0,1,2,1730,10,0
4700,경상북도,4703,울릉군,,울릉읍제1투,1093,659,153,476,8,0,11,0,0,2,0,0,0,0,650,9,434
4700,경상북도,4703,울릉군,,울릉읍제2투,1340,788,162,587,24,0,7,0,0,0,0,2,0,0,782,6,552
4700,경상북도,4703,울릉군,,울릉읍제3투,349,222,58,158,1,0,3,0,2,0,0,0,0,0,222,0,127
4700,경상북도,4703,울릉군,서면,소계,1080,903,192,684,8,3,10,0,0,0,1,0,0,1,899,4,177
4700,경상북도,4703,울릉군,,관내사전투표,517,517,124,380,6,2,3,0,0,0,0,0,0,0,515,2,0
4700,경상북도,4703,울릉군,,서면제1투,315,204,36,161,2,0,2,0,0,0,1,0,0,1,203,1,111
4700,경상북도,4703,울릉군,,서면제2투,248,182,32,143,0,1,5,0,0,0,0,0,0,0,181,1,66
4700,경상북도,4703,울릉군,북면,소계,964,769,162,578,9,0,9,0,0,0,2,0,0,2,762,7,195
4700,경상북도,4703,울릉군,,관내사전투표,417,417,97,306,3,0,8,0,0,0,0,0,0,0,414,3,0
4700,경상북도,4703,울릉군,,북면제1투,317,182,41,133,3,0,1,0,0,0,1,0,0,1,180,2,135
4700,경상북도,4703,울릉군,,북면제2투,230,170,24,139,3,0,0,0,0,0,1,0,0,1,168,2,60
4700,경상북도,4703,울릉군,잘못 투입·구분된 투표지,,0,0,0,0,0,0,0,0,0,0,0,0,0,0,0,0,0
4700,경상북도,4704,경주시,합계,,220573,173759,43031,123196,3380,72,1818,73,30,52,235,230,102,84,172303,1456,46814
4700,경상북도,4704,경주시,거소·선상투표,,690,647,132,408,5,3,8,4,4,1,2,1,1,1,570,77,43
4700,경상북도,4704,경주시,관외사전투표,,15452,15450,4671,9905,416,8,224,5,2,2,18,24,0,13,15288,162,2
4700,경상북도,4704,경주시,재외투표,,918,599,280,242,20,0,3,1,0,0,0,0,0,0,546,53,319
4700,경상북도,4704,경주시,감포읍,소계,4414,3186,505,2589,30,1,20,2,0,1,4,3,2,0,3157,29,1228
4700,경상북도,4704,경주시,,관내사전투표,1944,1944,319,1576,16,1,8,1,0,1,2,2,0,0,1926,18,0
4700,경상북도,4704,경주시,,감포읍제1투,1528,745,111,614,6,0,7,0,0,0,1,1,2,0,742,3,783
4700,경상북도,4704,경주시,,감포읍제2투,942,497,75,399,8,0,5,1,0,0,1,0,0,0,489,8,445
4700,경상북도,4704,경주시,안강읍,소계,19796,14964,3060,11295,263,7,152,5,8,3,23,13,13,6,14848,116,4832
4700,경상북도,4704,경주시,,관내사전투표,7034,7034,1511,5296,103,6,55,3,2,1,5,6,4,2,6994,40,0
4700,경상북도,4704,경주시,,안강읍제1투,1545,859,132,688,11,0,12,0,0,1,1,1,2,0,848,11,686
4700,경상북도,4704,경주시,,안강읍제2투,2339,1394,204,1133,27,0,11,1,0,0,3,1,1,1,1382,12,945
4700,경상북도,4704,경주시,,안강읍제3투,884,576,88,471,4,0,4,0,0,0,1,0,0,0,568,8,308
4700,경상북도,4704,경주시,,안강읍제4투,2706,1728,368,1279,28,0,30,0,2,0,1,2,2,2,1714,14,978
4700,경상북도,4704,경주시,,안강읍제5투,2191,1340,305,967,27,1,20,1,2,0,7,0,1,0,1331,9,851
4700,경상북도,4704,경주시,,안강읍제6투,2152,1401,348,956,51,0,18,0,1,1,4,3,2,1,1385,16,751
4700,경상북도,4704,경주시,,안강읍제7투,945,632,104,505,12,0,2,0,1,0,1,0,1,0,626,6,313
4700,경상북도,4704,경주시,건천읍,소계,7990,6049,1092,4700,90,5,71,3,1,4,10,6,6,7,5995,54,1941
4700,경상북도,4704,경주시,,관내사전투표,3605,3605,698,2792,46,4,30,1,1,2,5,6,5,3,3593,12,0
4700,경상북도,4704,경주시,,건천읍제1투,1933,1019,184,763,18,1,27,1,0,2,5,0,1,2,1004,15,914
4700,경상북도,4704,경주시,,건천읍제2투,1295,686,109,542,13,0,7,0,0,0,0,0,0,0,671,15,609
4700,경상북도,4704,경주시,,건천읍제3투,1157,739,101,603,13,0,7,1,0,0,0,0,0,2,727,12,418
4700,경상북도,4704,경주시,외동읍,소계,17360,12486,3803,8090,243,7,183,6,2,4,20,19,9,4,12390,96,4874
4700,경상북도,4704,경주시,,관내사전투표,4462,4461,1442,2863,74,2,37,3,1,1,1,4,4,1,4433,28,1
4700,경상북도,4704,경주시,,외동읍제1투,1633,924,215,661,20,0,14,0,0,1,3,0,0,1,915,9,709
4700,경상북도,4704,경주시,,외동읍제2투,1930,1249,333,851,31,0,14,0,1,0,1,3,2,0,1236,13,681
4700,경상북도,4704,경주시,,외동읍제3투,1067,646,121,504,9,1,4,0,0,1,1,1,0,0,642,4,421
4700,경상북도,4704,경주시,,외동읍제4투,1057,660,132,499,14,0,8,1,0,1,1,1,0,0,657,3,397
4700,경상북도,4704,경주시,,외동읍제5투,1238,752,134,584,10,0,10,2,0,0,1,0,0,0,741,11,486
4700,경상북도,4704,경주시,,외동읍제6투,2053,1120,310,745,12,2,36,0,0,0,6,1,1,1,1114,6,933
4700,경상북도,4704,경주시,,외동읍제7투,2193,1471,605,767,46,1,30,0,0,0,2,6,0,1,1458,13,722
4700,경상북도,4704,경주시,,외동읍제8투,1727,1203,511,616,27,1,30,0,0,0,4,3,2,0,1194,9,524
4700,경상북도,4704,경주시,양남면,소계,4997,3903,943,2796,56,3,39,3,1,2,6,10,4,5,3868,35,1094
4700,경상북도,4704,경주시,,관내사전투표,2394,2394,605,1698,37,2,19,3,0,2,3,4,4,0,2377,17,0
4700,경상북도,4704,경주시,,양남면제1투,1411,795,189,567,10,1,15,0,1,0,1,1,0,2,787,8,616
4700,경상북도,4704,경주시,,양남면제2투,1192,714,149,531,9,0,5,0,0,0,2,5,0,3,704,10,478
4700,경상북도,4704,경주시,내남면,소계,4124,3224,663,2448,42,1,26,1,0,0,2,4,7,4,3198,26,900
4700,경상북도,4704,경주시,,관내사전투표,2010,2010,424,1509,35,1,12,0,0,0,1,2,4,3,1991,19,0
4700,경상북도,4704,경주시,,내남면제1투,1176,643,140,478,7,0,9,1,0,0,0,2,2,1,640,3,533
4700,경상북도,4704,경주시,,내남면제2투,938,571,99,461,0,0,5,0,0,0,1,0,1,0,567,4,367
4700,경상북도,4704,경주시,산내면,소계,2644,2008,331,1599,23,2,15,2,0,1,4,2,1,3,1983,25,636
4700,경상북도,4704,경주시,,관내사전투표,1300,1300,212,1040,18,2,6,2,0,1,1,1,1,3,1287,13,0
4700,경상북도,4704,경주시,,산내면투표소,1344,708,119,559,5,0,9,0,0,0,3,1,0,0,696,12,636
4700,경상북도,4704,경주시,서면,소계,2873,2312,402,1831,30,2,18,0,0,1,1,5,5,0,2295,17,561
4700,경상북도,4704,경주시,,관내사전투표,1548,1548,284,1219,20,2,9,0,0,1,1,1,3,0,1540,8,0
4700,경상북도,4704,경주시,,서면투표소,1325,764,118,612,10,0,9,0,0,0,0,4,2,0,755,9,561
4700,경상북도,4704,경주시,현곡면,소계,15206,12067,3669,7863,317,2,100,5,1,3,18,19,2,3,12002,65,3139
4700,경상북도,4704,경주시,,관내사전투표,5315,5315,1707,3423,121,2,29,4,0,1,3,10,0,1,5301,14,0
4700,경상북도,4704,경주시,,현곡면제1투,1124,698,200,458,26,0,6,0,0,0,1,1,0,0,692,6,426
4700,경상북도,4704,경주시,,현곡면제2투,2394,1722,539,1084,64,0,11,0,0,1,4,2,0,0,1705,17,672
4700,경상북도,4704,경주시,,현곡면제3투,2191,1426,358,1001,27,0,23,1,1,0,2,4,0,1,1418,8,765
4700,경상북도,4704,경주시,,현곡면제4투,2037,1313,310,939,31,0,14,0,0,1,6,1,2,0,1304,9,724
4700,경상북도,4704,경주시,,현곡면제5투,2145,1593,555,958,48,0,17,0,0,0,2,1,0,1,1582,11,552
4700,경상북도,4704,경주시,강동면,소계,5016,3797,744,2907,66,1,33,4,0,3,4,7,1,2,3772,25,1219
4700,경상북도,4704,경주시,,관내사전투표,2188,2188,449,1679,29,1,4,3,0,2,1,6,1,2,2177,11,0
4700,경상북도,4704,경주시,,강동면제1투,1392,799,118,643,10,0,15,1,0,0,3,0,0,0,790,9,593
4700,경상북도,4704,경주시,,강동면제2투,1436,810,177,585,27,0,14,0,0,1,0,1,0,0,805,5,626
4700,경상북도,4704,경주시,천북면,소계,5327,4306,972,3162,57,2,52,2,1,0,6,3,6,2,4265,41,1021
4700,경상북도,4704,경주시,,관내사전투표,2652,2652,649,1921,37,2,20,1,1,0,1,2,5,0,2639,13,0
4700,경상북도,4704,경주시,,천북면제1투,1928,1134,234,837,14,0,25,0,0,0,3,1,0,1,1115,19,794
4700,경상북도,4704,경주시,,천북면제2투,747,520,89,404,6,0,7,1,0,0,2,0,1,1,511,9,227
4700,경상북도,4704,경주시,중부동,소계,5565,4519,808,3574,58,0,28,2,2,1,6,7,3,0,4489,30,1046
4700,경상북도,4704,경주시,,관내사전투표,3017,3017,555,2388,32,0,14,1,1,0,3,5,1,0,3000,17,0
4700,경상북도,4704,경주시,,중부동제1투,1310,701,145,529,13,0,4,1,0,0,1,0,1,0,694,7,609
4700,경상북도,4704,경주시,,중부동제2투,1238,801,108,657,13,0,10,0,1,1,2,2,1,0,795,6,437
4700,경상북도,4704,경주시,황오동,소계,6406,5119,959,4009,63,4,41,2,1,1,9,3,4,2,5098,21,1287
4700,경상북도,4704,경주시,,관내사전투표,3325,3325,662,2576,37,1,26,0,0,1,4,2,1,2,3312,13,0
4700,경상북도,4704,경주시,,황오동제1투,1646,934,157,748,11,1,8,1,1,0,2,0,1,0,930,4,712
4700,경상북도,4704,경주시,,황오동제2투,1435,860,140,685,15,2,7,1,0,0,3,1,2,0,856,4,575
4700,경상북도,4704,경주시,성건동,소계,11836,8919,1783,6813,140,3,86,1,2,1,14,5,3,1,8852,67,2917
4700,경상북도,4704,경주시,,관내사전투표,4942,4942,1088,3717,63,0,37,0,1,0,6,1,2,0,4915,27,0
4700,경상북도,4704,경주시,,성건동제1투,1596,970,169,770,14,0,6,1,0,1,3,0,0,1,965,5,626
4700,경상북도,4704,경주시,,성건동제2투,1648,989,163,784,15,1,15,0,0,0,2,1,0,0,981,8,659
4700,경상북도,4704,경주시,,성건동제3투,1652,890,147,692,21,1,13,0,0,0,2,3,0,0,879,11,762
4700,경상북도,4704,경주시,,성건동제4투,1998,1128,216,850,27,1,15,0,1,0,1,0,1,0,1112,16,870
4700,경상북도,4704,경주시,황남동,소계,4192,3277,600,2545,48,0,31,4,0,4,8,3,2,4,3249,28,915
4700,경상북도,4704,경주시,,관내사전투표,2145,2145,413,1659,32,0,15,2,0,1,5,1,2,3,2133,12,0
4700,경상북도,4704,경주시,,황남동제1투,1050,590,95,460,9,0,9,2,0,0,3,2,0,0,580,10,460
4700,경상북도,4704,경주시,,황남동제2투,997,542,92,426,7,0,7,0,0,3,0,0,0,1,536,6,455
4700,경상북도,4704,경주시,월성동,소계,4702,3704,772,2793,51,1,44,0,0,1,8,7,3,2,3682,22,998
4700,경상북도,4704,경주시,,관내사전투표,1841,1841,391,1393,23,0,22,0,0,0,0,3,1,1,1834,7,0
4700,경상북도,4704,경주시,,월성동제1투,1034,611,93,485,8,1,10,0,0,0,4,2,1,0,604,7,423
4700,경상북도,4704,경주시,,월성동제2투,1827,1252,288,915,20,0,12,0,0,1,4,2,1,1,1244,8,575
4700,경상북도,4704,경주시,선도동,소계,11296,8717,2388,5971,188,2,76,4,1,3,13,8,3,5,8662,55,2579
4700,경상북도,4704,경주시,,관내사전투표,4941,4941,1499,3268,111,2,29,2,0,1,4,4,0,4,4924,17,0
4700,경상북도,4704,경주시,,선도동제1투,1797,1029,234,750,19,0,12,0,0,1,2,0,0,1,1019,10,768
4700,경상북도,4704,경주시,,선도동제2투,2738,1685,388,1209,37,0,22,1,1,1,4,1,2,0,1666,19,1053
4700,경상북도,4704,경주시,,선도동제3투,1820,1062,267,744,21,0,13,1,0,0,3,3,1,0,1053,9,758
4700,경상북도,4704,경주시,용강동,소계,16412,12681,3818,8242,317,5,145,3,1,6,17,16,5,3,12578,103,3731
4700,경상북도,4704,경주시,,관내사전투표,5070,5070,1601,3268,116,3,40,0,0,3,4,6,2,2,5045,25,0
4700,경상북도,4704,경주시,,용강동제1투,2276,1354,315,950,36,1,30,1,0,2,1,3,0,0,1339,15,922
4700,경상북도,4704,경주시,,용강동제2투,2632,1674,557,1031,49,0,21,0,0,0,0,1,0,0,1659,15,958
4700,경상북도,4704,경주시,,용강동제3투,2143,1457,311,1068,29,0,15,0,1,0,7,2,3,0,1436,21,686
4700,경상북도,4704,경주시,,용강동제4투,2214,1534,415,1036,34,1,23,1,0,1,5,3,0,0,1519,15,680
4700,경상북도,4704,경주시,,용강동제5투,2077,1592,619,889,53,0,16,1,0,0,0,1,0,1,1580,12,485
4700,경상북도,4704,경주시,황성동,소계,20968,16453,4939,10782,406,6,149,5,1,5,15,23,7,3,16341,112,4515
4700,경상북도,4704,경주시,,관내사전투표,8180,8180,2753,5125,194,1,58,2,1,1,5,13,1,0,8154,26,0
4700,경상북도,4704,경주시,,황성동제1투,2457,1568,381,1132,27,1,13,0,0,0,3,0,0,0,1557,11,889
4700,경상북도,4704,경주시,,황성동제2투,1827,1268,302,905,21,1,19,0,0,1,1,4,2,1,1257,11,559
4700,경상북도,4704,경주시,,황성동제3투,2341,1504,410,1019,38,0,17,0,0,0,2,1,0,0,1487,17,837
4700,경상북도,4704,경주시,,황성동제4투,2367,1514,430,991,51,2,16,3,0,0,2,1,0,2,1498,16,853
4700,경상북도,4704,경주시,,황성동제5투,2189,1386,400,898,51,1,14,0,0,1,2,0,1,0,1368,18,803
4700,경상북도,4704,경주시,,황성동제6투,1607,1033,263,712,24,0,12,0,0,2,0,4,3,0,1020,13,574
4700,경상북도,4704,경주시,동천동,소계,17992,13883,3182,10114,264,1,161,3,1,3,9,22,3,8,13771,112,4109
4700,경상북도,4704,경주시,,관내사전투표,6718,6718,1622,4840,131,0,56,2,1,1,1,8,1,3,6666,52,0
4700,경상북도,4704,경주시,,동천동제1투,1418,813,162,619,9,0,15,0,0,2,1,1,0,0,809,4,605
4700,경상북도,4704,경주시,,동천동제2투,1824,1257,262,944,25,0,10,0,0,0,3,2,0,2,1248,9,567
4700,경상북도,4704,경주시,,동천동제3투,2016,1183,275,827,38,0,22,0,0,0,0,3,1,1,1167,16,833
4700,경상북도,4704,경주시,,동천동제4투,1866,1182,258,864,21,0,24,0,0,0,1,0,1,2,1171,11,684
4700,경상북도,4704,경주시,,동천동제5투,2203,1417,293,1065,19,1,20,1,0,0,2,6,0,0,1407,10,786
4700,경상북도,4704,경주시,,동천동제6투,1947,1313,310,955,21,0,14,0,0,0,1,2,0,0,1303,10,634
4700,경상북도,4704,경주시,불국동,소계,8711,6857,1628,4971,116,1,69,3,0,1,11,8,3,2,6813,44,1854
4700,경상북도,4704,경주시,,관내사전투표,4285,4284,1091,3061,58,0,34,2,0,0,4,5,3,2,4260,24,1
4700,경상북도,4704,경주시,,불국동제1투,2201,1213,266,887,20,0,22,0,0,0,4,1,0,0,1200,13,988
4700,경상북도,4704,경주시,,불국동제2투,2225,1360,271,1023,38,1,13,1,0,1,3,2,0,0,1353,7,865
4700,경상북도,4704,경주시,보덕동,소계,2229,1956,440,1433,38,2,17,1,0,1,2,6,1,1,1942,14,273
4700,경상북도,4704,경주시,,관내사전투표,1588,1588,373,1152,32,1,10,1,0,0,1,6,1,1,1578,10,0
4700,경상북도,4704,경주시,,보덕동투표소,641,368,67,281,6,1,7,0,0,1,1,0,0,0,364,4,273
4700,경상북도,4704,경주시,문무대왕면,소계,3457,2675,447,2113,33,3,27,2,1,0,5,6,8,3,2648,27,782
4700,경상북도,4704,경주시,,관내사전투표,1760,1760,311,1373,27,2,14,2,0,0,4,6,7,1,1747,13,0
4700,경상북도,4704,경주시,,문무대왕면투표소,1697,915,136,740,6,1,13,0,1,0,1,0,1,2,901,14,782
4700,경상북도,4704,경주시,잘못 투입·구분된 투표지,,0,1,0,1,0,0,0,0,0,0,0,0,0,0,1,0,-1
4700,경상북도,4705,김천시,합계,,120746,95575,22122,69272,1838,70,990,21,18,22,116,84,77,63,94693,882,25171
4700,경상북도,4705,김천시,거소·선상투표,,436,405,93,244,9,4,5,2,1,0,2,2,1,0,363,42,31
4700,경상북도,4705,김천시,관외사전투표,,8814,8813,2563,5756,239,7,117,3,4,2,6,15,1,4,8717,96,1
4700,경상북도,4705,김천시,재외투표,,549,312,119,156,7,1,1,0,0,0,0,0,0,0,284,28,237
4700,경상북도,4705,김천시,아포읍,소계,6469,4959,863,3914,58,3,59,1,0,0,8,4,5,3,4918,41,1510
4700,경상북도,4705,김천시,,관내사전투표,2640,2640,543,2013,32,2,26,1,0,0,5,2,1,2,2627,13,0
4700,경상북도,4705,김천시,,아포읍제1투,883,558,49,487,4,0,5,0,0,0,0,0,3,1,549,9,325
4700,경상북도,4705,김천시,,아포읍제2투,790,524,49,463,3,0,2,0,0,0,1,0,0,0,518,6,266
4700,경상북도,4705,김천시,,아포읍제3투,2156,1237,222,951,19,1,26,0,0,0,2,2,1,0,1224,13,919
4700,경상북도,4705,김천시,농소면,소계,2867,2389,541,1741,46,3,39,1,0,0,0,1,2,6,2380,9,478
4700,경상북도,4705,김천시,,관내사전투표,1516,1516,374,1085,28,1,19,1,0,0,0,0,1,3,1512,4,0
4700,경상북도,4705,김천시,,농소면제1투,606,375,50,309,5,1,4,0,0,0,0,1,1,1,372,3,231
4700,경상북도,4705,김천시,,농소면제2투,745,498,117,347,13,1,16,0,0,0,0,0,0,2,496,2,247
4700,경상북도,4705,김천시,남면,소계,2671,2081,352,1641,39,1,18,0,1,0,3,2,1,2,2060,21,590
4700,경상북도,4705,김천시,,관내사전투표,1202,1202,239,920,20,1,11,0,1,0,1,1,0,1,1195,7,0
4700,경상북도,4705,김천시,,남면제1투,804,450,56,369,11,0,3,0,0,0,2,0,0,1,442,8,354
4700,경상북도,4705,김천시,,남면제2투,665,429,57,352,8,0,4,0,0,0,0,1,1,0,423,6,236
4700,경상북도,4705,김천시,개령면,소계,2204,1811,264,1490,15,0,19,1,0,1,3,1,2,1,1797,14,393
4700,경상북도,4705,김천시,,관내사전투표,1094,1094,181,885,7,0,10,1,0,0,1,0,2,1,1088,6,0
4700,경상북도,4705,김천시,,개령면투표소,1110,717,83,605,8,0,9,0,0,1,2,1,0,0,709,8,393
4700,경상북도,4705,김천시,감문면,소계,2772,2222,268,1872,23,3,13,1,1,1,7,4,8,1,2202,20,550
4700,경상북도,4705,김천시,,관내사전투표,1335,1335,171,1118,13,2,6,1,0,1,2,2,6,1,1323,12,0
4700,경상북도,4705,김천시,,감문면제1투,796,445,57,367,6,1,3,0,1,0,4,2,1,0,442,3,351
4700,경상북도,4705,김천시,,감문면제2투,641,442,40,387,4,0,4,0,0,0,1,0,1,0,437,5,199
4700,경상북도,4705,김천시,어모면,소계,3660,2871,450,2304,41,3,30,0,4,1,1,4,4,1,2843,28,789
4700,경상북도,4705,김천시,,관내사전투표,1717,1717,318,1334,28,1,14,0,1,1,0,3,2,1,1703,14,0
4700,경상북도,4705,김천시,,어모면제1투,1050,653,75,543,8,1,12,0,2,0,0,1,2,0,644,9,397
4700,경상북도,4705,김천시,,어모면제2투,893,501,57,427,5,1,4,0,1,0,1,0,0,0,496,5,392
4700,경상북도,4705,김천시,봉산면,소계,3121,2621,528,1999,41,2,17,0,0,0,6,3,1,2,2599,22,500
4700,경상북도,4705,김천시,,관내사전투표,1599,1599,357,1191,27,2,8,0,0,0,2,1,0,0,1588,11,0
4700,경상북도,4705,김천시,,봉산면제1투,812,525,94,408,10,0,4,0,0,0,1,1,0,1,519,6,287
4700,경상북도,4705,김천시,,봉산면제2투,710,497,77,400,4,0,5,0,0,0,3,1,1,1,492,5,213
4700,경상북도,4705,김천시,대항면,소계,3007,2401,404,1888,30,4,27,1,1,2,1,2,4,2,2366,35,606
4700,경상북도,4705,김천시,,관내사전투표,1287,1287,243,995,20,4,8,1,1,2,0,1,0,1,1276,11,0
4700,경상북도,4705,김천시,,대항면제1투,921,537,87,416,6,0,11,0,0,0,1,0,3,0,524,13,384
4700,경상북도,4705,김천시,,대항면제2투,799,577,74,477,4,0,8,0,0,0,0,1,1,1,566,11,222
4700,경상북도,4705,김천시,감천면,소계,1865,1568,256,1260,19,1,10,1,0,0,1,1,6,4,1559,9,297
4700,경상북도,4705,김천시,,관내사전투표,1154,1154,198,921,13,1,7,1,0,0,0,1,4,3,1149,5,0
4700,경상북도,4705,김천시,,감천면투표소,711,414,58,339,6,0,3,0,0,0,1,0,2,1,410,4,297
4700,경상북도,4705,김천시,조마면,소계,1809,1440,196,1202,10,2,10,1,0,1,1,0,2,1,1426,14,369
4700,경상북도,4705,김천시,,관내사전투표,855,855,128,707,7,1,2,1,0,1,0,0,1,1,849,6,0
4700,경상북도,4705,김천시,,조마면투표소,954,585,68,495,3,1,8,0,0,0,1,0,1,0,577,8,369
4700,경상북도,4705,김천시,구성면,소계,2290,1789,248,1468,26,1,15,1,0,1,1,2,3,3,1769,20,501
4700,경상북도,4705,김천시,,관내사전투표,940,940,141,762,15,1,8,1,0,0,0,0,2,2,932,8,0
4700,경상북도,4705,김천시,,구성면제1투,804,553,65,468,7,0,3,0,0,0,0,0,1,1,545,8,251
4700,경상북도,4705,김천시,,구성면제2투,546,296,42,238,4,0,4,0,0,1,1,2,0,0,292,4,250
4700,경상북도,4705,김천시,지례면,소계,1476,1229,228,955,12,0,6,1,0,0,4,4,5,1,1216,13,247
4700,경상북도,4705,김천시,,관내사전투표,775,775,166,584,7,0,5,1,0,0,1,1,4,1,770,5,0
4700,경상북도,4705,김천시,,지례면제1투,500,314,49,249,4,0,1,0,0,0,1,1,1,0,306,8,186
4700,경상북도,4705,김천시,,지례면제2투,201,140,13,122,1,0,0,0,0,0,2,2,0,0,140,0,61
4700,경상북도,4705,김천시,부항면,소계,1015,795,118,645,8,3,5,0,0,1,0,1,3,3,787,8,220
4700,경상북도,4705,김천시,,관내사전투표,586,586,85,479,6,2,2,0,0,1,0,1,2,3,581,5,0
4700,경상북도,4705,김천시,,부항면투표소,429,209,33,166,2,1,3,0,0,0,0,0,1,0,206,3,220
4700,경상북도,4705,김천시,대덕면,소계,1721,1332,206,1058,22,1,11,1,0,1,1,2,5,6,1314,18,389
4700,경상북도,4705,김천시,,관내사전투표,928,928,153,729,14,0,4,1,0,1,1,2,5,6,916,12,0
4700,경상북도,4705,김천시,,대덕면투표소,793,404,53,329,8,1,7,0,0,0,0,0,0,0,398,6,389
4700,경상북도,4705,김천시,증산면,소계,873,718,115,553,15,3,13,0,0,0,2,1,3,1,706,12,155
4700,경상북도,4705,김천시,,관내사전투표,466,466,83,357,11,2,3,0,0,0,1,0,2,1,460,6,0
4700,경상북도,4705,김천시,,증산면투표소,407,252,32,196,4,1,10,0,0,0,1,1,1,0,246,6,155
4700,경상북도,4705,김천시,자산동,소계,6119,4775,791,3809,70,0,52,1,0,1,5,3,2,1,4735,40,1344
4700,경상북도,4705,김천시,,관내사전투표,2660,2659,463,2117,34,0,21,1,0,1,1,2,0,1,2641,18,1
4700,경상북도,4705,김천시,,자산동제1투,807,489,81,390,5,0,8,0,0,0,1,0,1,0,486,3,318
4700,경상북도,4705,김천시,,자산동제2투,1365,806,132,642,13,0,9,0,0,0,0,0,0,0,796,10,559
4700,경상북도,4705,김천시,,자산동제3투,1287,821,115,660,18,0,14,0,0,0,3,1,1,0,812,9,466
4700,경상북도,4705,김천시,평화남산동,소계,6616,4973,868,3919,75,0,53,0,2,3,14,5,2,0,4941,32,1643
4700,경상북도,4705,김천시,,관내사전투표,2599,2599,507,2017,40,0,14,0,0,0,3,3,1,0,2585,14,0
4700,경상북도,4705,김천시,,평화남산동제1투,752,443,57,368,7,0,4,0,0,1,2,0,1,0,440,3,309
4700,경상북도,4705,김천시,,평화남산동제2투,1083,610,92,496,5,0,5,0,1,1,2,1,0,0,603,7,473
4700,경상북도,4705,김천시,,평화남산동제3투,1209,746,117,594,14,0,14,0,1,1,1,0,0,0,742,4,463
4700,경상북도,4705,김천시,,평화남산동제4투,973,575,95,444,9,0,16,0,0,0,6,1,0,0,571,4,398
4700,경상북도,4705,김천시,양금동,소계,3618,2979,469,2408,39,0,26,0,0,2,9,2,1,2,2958,21,639
4700,경상북도,4705,김천시,,관내사전투표,1792,1792,321,1416,26,0,11,0,0,0,6,0,0,2,1782,10,0
4700,경상북도,4705,김천시,,양금동제1투,805,561,56,484,8,0,4,0,0,0,3,1,1,0,557,4,244
4700,경상북도,4705,김천시,,양금동제2투,1021,626,92,508,5,0,11,0,0,2,0,1,0,0,619,7,395
4700,경상북도,4705,김천시,대신동,소계,18309,13634,3465,9503,317,12,163,3,2,1,14,7,6,7,13500,134,4675
4700,경상북도,4705,김천시,,관내사전투표,6239,6238,1721,4218,161,7,59,2,0,0,3,6,2,3,6182,56,1
4700,경상북도,4705,김천시,,대신동제1투,2339,1184,251,856,25,1,21,0,0,0,2,0,2,1,1159,25,1155
4700,경상북도,4705,김천시,,대신동제2투,1576,1055,275,733,27,0,13,0,0,0,0,0,1,0,1049,6,521
4700,경상북도,4705,김천시,,대신동제3투,2343,1470,303,1084,35,1,27,0,0,0,3,0,0,2,1455,15,873
4700,경상북도,4705,김천시,,대신동제4투,1683,1179,298,822,31,1,11,1,1,0,6,0,0,0,1171,8,504
4700,경상북도,4705,김천시,,대신동제5투,1240,764,151,580,12,0,12,0,0,1,0,0,0,0,756,8,476
4700,경상북도,4705,김천시,,대신동제6투,2889,1744,466,1210,26,2,20,0,1,0,0,1,1,1,1728,16,1145
4700,경상북도,4705,김천시,대곡동,소계,15698,11839,2706,8675,225,10,109,0,0,3,13,3,5,6,11755,84,3859
4700,경상북도,4705,김천시,,관내사전투표,6382,6382,1572,4606,116,8,35,0,0,1,6,1,5,2,6352,30,0
4700,경상북도,4705,김천시,,대곡동제1투,1622,963,181,742,21,1,8,0,0,0,1,0,0,1,955,8,659
4700,경상북도,4705,김천시,,대곡동제2투,1176,691,120,542,7,0,8,0,0,0,1,1,0,1,680,11,485
4700,경상북도,4705,김천시,,대곡동제3투,2816,1811,478,1249,42,1,19,0,0,1,3,0,0,1,1794,17,1005
4700,경상북도,4705,김천시,,대곡동제4투,1404,746,102,599,14,0,20,0,0,0,0,1,0,0,736,10,658
4700,경상북도,4705,김천시,,대곡동제5투,1035,533,120,381,16,0,10,0,0,0,1,0,0,1,529,4,502
4700,경상북도,4705,김천시,,대곡동제6투,1263,713,133,556,9,0,9,0,0,1,1,0,0,0,709,4,550
4700,경상북도,4705,김천시,지좌동,소계,8354,6118,1352,4473,130,1,81,0,1,0,7,8,4,2,6059,59,2236
4700,경상북도,4705,김천시,,관내사전투표,3224,3224,757,2344,64,0,32,0,0,0,1,3,3,1,3205,19,0
4700,경상북도,4705,김천시,,지좌동제1투,2576,1424,305,1013,47,1,27,0,1,0,3,2,0,0,1399,25,1152
4700,경상북도,4705,김천시,,지좌동제2투,1284,675,125,517,10,0,10,0,0,0,3,2,0,1,668,7,609
4700,경상북도,4705,김천시,,지좌동제3투,1270,795,165,599,9,0,12,0,0,0,0,1,1,0,787,8,475
4700,경상북도,4705,김천시,율곡동,소계,14413,11498,4659,6336,322,5,91,2,1,1,7,7,1,4,11436,62,2915
4700,경상북도,4705,김천시,,관내사전투표,6536,6535,2900,3386,179,5,34,1,0,0,1,3,1,3,6513,22,1
4700,경상북도,4705,김천시,,율곡동제1투,2217,1419,472,866,46,0,13,1,1,0,4,0,0,1,1404,15,798
4700,경상북도,4705,김천시,,율곡동제2투,2039,1298,507,726,34,0,17,0,0,1,1,0,0,0,1286,12,741
4700,경상북도,4705,김천시,,율곡동제3투,1777,1112,387,676,32,0,12,0,0,0,0,0,0,0,1107,5,665
4700,경상북도,4705,김천시,,율곡동제4투,1844,1134,393,682,31,0,15,0,0,0,1,4,0,0,1126,8,710
4700,경상북도,4705,김천시,잘못 투입·구분된 투표지,,0,3,0,3,0,0,0,0,0,0,0,0,0,0,3,0,-3
4700,경상북도,4706,안동시,합계,,136307,106950,30870,71881,1674,49,979,31,28,31,121,77,133,78,105952,998,29357
4700,경상북도,4706,안동시,거소·선상투표,,542,494,154,269,8,3,7,0,2,1,1,0,1,1,447,47,48
4700,경상북도,4706,안동시,관외사전투표,,9786,9783,3378,5890,235,3,128,2,2,2,15,7,4,8,9674,109,3
4700,경상북도,4706,안동시,재외투표,,458,302,167,98,6,0,1,0,0,0,1,0,0,0,273,29,156
4700,경상북도,4706,안동시,풍산읍,소계,5838,4401,1116,3121,47,2,39,3,1,1,4,3,13,4,4354,47,1437
4700,경상북도,4706,안동시,,관내사전투표,2146,2146,621,1462,19,1,16,1,0,0,1,1,5,0,2127,19,0
4700,경상북도,4706,안동시,,풍산읍제1투,1136,587,137,424,5,0,8,0,1,0,0,0,2,2,579,8,549
4700,경상북도,4706,안동시,,풍산읍제2투,607,437,73,350,5,0,3,0,0,0,0,0,2,0,433,4,170
4700,경상북도,4706,안동시,,풍산읍제3투,795,488,114,347,5,0,6,1,0,0,3,1,3,1,481,7,307
4700,경상북도,4706,안동시,,풍산읍제4투,1154,743,171,538,13,1,6,1,0,1,0,1,1,1,734,9,411
4700,경상북도,4706,안동시,와룡면,소계,3492,2663,700,1877,25,2,17,1,1,0,1,2,10,6,2642,21,829
4700,경상북도,4706,안동시,,관내사전투표,1589,1589,463,1071,20,1,5,0,1,0,1,1,6,4,1573,16,0
4700,경상북도,4706,안동시,,와룡면제1투,1164,648,148,483,3,0,7,1,0,0,0,1,2,1,646,2,516
4700,경상북도,4706,안동시,,와룡면제2투,739,426,89,323,2,1,5,0,0,0,0,0,2,1,423,3,313
4700,경상북도,4706,안동시,북후면,소계,2756,2071,439,1514,24,2,15,0,1,1,2,3,10,4,2015,56,685
4700,경상북도,4706,안동시,,관내사전투표,1212,1212,267,870,16,2,4,0,1,1,0,1,6,1,1169,43,0
4700,경상북도,4706,안동시,,북후면제1투,852,522,95,403,5,0,5,0,0,0,2,2,2,0,514,8,330
4700,경상북도,4706,안동시,,북후면제2투,692,337,77,241,3,0,6,0,0,0,0,0,2,3,332,5,355
4700,경상북도,4706,안동시,서후면,소계,2921,2178,497,1617,26,2,10,0,0,0,1,3,4,0,2160,18,743
4700,경상북도,4706,안동시,,관내사전투표,1064,1064,288,756,10,1,3,0,0,0,0,2,0,0,1060,4,0
4700,경상북도,4706,안동시,,서후면제1투,1072,591,110,459,11,0,2,0,0,0,1,0,3,0,586,5,481
4700,경상북도,4706,안동시,,서후면제2투,785,523,99,402,5,1,5,0,0,0,0,1,1,0,514,9,262
4700,경상북도,4706,안동시,풍천면,소계,4884,3536,886,2488,62,2,40,1,1,0,8,5,8,3,3504,32,1348
4700,경상북도,4706,안동시,,관내사전투표,1406,1406,354,1002,23,0,8,1,0,0,2,2,2,0,1394,12,0
4700,경상북도,4706,안동시,,풍천면제1투,1439,762,178,547,9,1,15,0,0,0,3,0,1,2,756,6,677
4700,경상북도,4706,안동시,,풍천면제2투,687,425,71,334,4,0,6,0,0,0,1,1,3,1,421,4,262
4700,경상북도,4706,안동시,,풍천면제3투,368,264,33,216,2,1,2,0,0,0,2,2,2,0,260,4,104
4700,경상북도,4706,안동시,,풍천면제4투,984,679,250,389,24,0,9,0,1,0,0,0,0,0,673,6,305
4700,경상북도,4706,안동시,일직면,소계,2388,1906,335,1496,12,0,20,0,7,1,0,2,6,4,1883,23,482
4700,경상북도,4706,안동시,,관내사전투표,1165,1165,217,903,9,0,7,0,6,0,0,2,4,3,1151,14,0
4700,경상북도,4706,안동시,,일직면제1투,602,346,56,280,0,0,3,0,0,0,0,0,1,0,340,6,256
4700,경상북도,4706,안동시,,일직면제2투,621,395,62,313,3,0,10,0,1,1,0,0,1,1,392,3,226
4700,경상북도,4706,안동시,남후면,소계,1693,1350,287,1008,15,0,15,2,0,1,1,0,2,3,1334,16,343
4700,경상북도,4706,안동시,,관내사전투표,775,775,190,561,8,0,3,1,0,0,0,0,1,2,766,9,0
4700,경상북도,4706,안동시,,남후면투표소,918,575,97,447,7,0,12,1,0,1,1,0,1,1,568,7,343
4700,경상북도,4706,안동시,남선면,소계,1854,1505,379,1076,18,2,10,1,0,0,2,2,2,0,1492,13,349
4700,경상북도,4706,안동시,,관내사전투표,646,646,186,439,8,1,5,1,0,0,0,0,0,0,640,6,0
4700,경상북도,4706,안동시,,남선면제1투,661,432,77,344,5,0,0,0,0,0,1,1,1,0,429,3,229
4700,경상북도,4706,안동시,,남선면제2투,547,427,116,293,5,1,5,0,0,0,1,1,1,0,423,4,120
4700,경상북도,4706,안동시,임하면,소계,2472,1814,399,1331,23,0,17,6,2,3,4,3,6,1,1795,19,658
4700,경상북도,4706,안동시,,관내사전투표,1099,1099,273,783,19,0,4,4,1,1,3,1,3,0,1092,7,0
4700,경상북도,4706,안동시,,임하면제1투,1015,474,92,349,2,0,10,2,1,2,1,2,1,1,463,11,541
4700,경상북도,4706,안동시,,임하면제2투,358,241,34,199,2,0,3,0,0,0,0,0,2,0,240,1,117
4700,경상북도,4706,안동시,길안면,소계,2451,1909,409,1434,11,2,9,2,1,2,0,3,1,6,1880,29,542
4700,경상북도,4706,안동시,,관내사전투표,1013,1013,252,743,5,0,0,2,0,0,0,2,0,3,1007,6,0
4700,경상북도,4706,안동시,,길안면제1투,888,521,107,383,3,1,7,0,1,1,0,0,0,0,503,18,367
4700,경상북도,4706,안동시,,길안면제2투,332,218,31,175,3,1,2,0,0,1,0,0,0,3,216,2,114
4700,경상북도,4706,안동시,,길안면제3투,218,157,19,133,0,0,0,0,0,0,0,1,1,0,154,3,61
4700,경상북도,4706,안동시,임동면,소계,1443,1124,221,863,9,1,9,1,2,0,0,0,3,4,1113,11,319
4700,경상북도,4706,안동시,,관내사전투표,715,715,147,553,3,1,2,1,0,0,0,0,2,2,711,4,0
4700,경상북도,4706,안동시,,임동면투표소,728,409,74,310,6,0,7,0,2,0,0,0,1,2,402,7,319
4700,경상북도,4706,안동시,예안면,소계,1562,1234,462,723,11,0,4,2,0,3,0,2,8,5,1220,14,328
4700,경상북도,4706,안동시,,관내사전투표,691,691,264,410,7,0,1,1,0,1,0,2,1,0,687,4,0
4700,경상북도,4706,안동시,,예안면제1투,539,313,90,204,3,0,2,1,0,1,0,0,3,3,307,6,226
4700,경상북도,4706,안동시,,예안면제2투,332,230,108,109,1,0,1,0,0,1,0,0,4,2,226,4,102
4700,경상북도,4706,안동시,도산면,소계,1414,1132,281,795,16,0,5,1,1,0,1,0,11,4,1115,17,282
4700,경상북도,4706,안동시,,관내사전투표,539,539,149,369,9,0,1,1,1,0,0,0,2,1,533,6,0
4700,경상북도,4706,안동시,,도산면제1투,544,348,83,244,5,0,4,0,0,0,0,0,6,2,344,4,196
4700,경상북도,4706,안동시,,도산면제2투,331,245,49,182,2,0,0,0,0,0,1,0,3,1,238,7,86
4700,경상북도,4706,안동시,녹전면,소계,1444,1127,242,836,9,1,15,0,0,0,2,1,1,2,1109,18,317
4700,경상북도,4706,안동시,,관내사전투표,463,463,114,331,6,0,3,0,0,0,1,0,0,0,455,8,0
4700,경상북도,4706,안동시,,녹전면제1투,608,404,93,285,3,1,10,0,0,0,1,0,1,1,395,9,204
4700,경상북도,4706,안동시,,녹전면제2투,373,260,35,220,0,0,2,0,0,0,0,1,0,1,259,1,113
4700,경상북도,4706,안동시,중구동,소계,4921,3900,1048,2713,64,5,24,1,1,3,4,4,3,0,3870,30,1021
4700,경상북도,4706,안동시,,관내사전투표,2285,2285,691,1514,48,2,11,1,0,0,2,3,1,0,2273,12,0
4700,경상북도,4706,안동시,,중구동제1투,823,498,107,380,2,0,4,0,0,1,0,0,0,0,494,4,325
4700,경상북도,4706,안동시,,중구동제2투,763,490,104,363,6,1,7,0,0,0,0,0,1,0,482,8,273
4700,경상북도,4706,안동시,,중구동제3투,1050,627,146,456,8,2,2,0,1,2,2,1,1,0,621,6,423
4700,경상북도,4706,안동시,명륜동,소계,4336,3455,958,2393,35,2,24,1,0,1,2,2,4,1,3423,32,881
4700,경상북도,4706,안동시,,관내사전투표,2028,2028,624,1351,19,2,11,1,0,0,1,1,2,1,2013,15,0
4700,경상북도,4706,안동시,,명륜동제1투,1319,810,195,588,8,0,6,0,0,0,1,1,0,0,799,11,509
4700,경상북도,4706,안동시,,명륜동제2투,989,617,139,454,8,0,7,0,0,1,0,0,2,0,611,6,372
4700,경상북도,4706,안동시,용상동,소계,16487,12505,3849,8144,237,5,128,3,0,0,15,11,12,6,12410,95,3982
4700,경상북도,4706,안동시,,관내사전투표,6107,6106,2038,3847,119,2,48,2,0,0,5,3,6,3,6073,33,1
4700,경상북도,4706,안동시,,용상동제1투,1370,781,244,505,15,0,10,0,0,0,1,0,0,1,776,5,589
4700,경상북도,4706,안동시,,용상동제2투,1095,596,180,392,12,0,5,0,0,0,0,1,1,0,591,5,499
4700,경상북도,4706,안동시,,용상동제3투,1683,1036,251,733,19,1,14,0,0,0,1,2,1,1,1023,13,647
4700,경상북도,4706,안동시,,용상동제4투,850,517,130,368,5,0,3,0,0,0,2,1,1,1,511,6,333
4700,경상북도,4706,안동시,,용상동제5투,912,489,122,335,11,0,14,0,0,0,2,0,0,0,484,5,423
4700,경상북도,4706,안동시,,용상동제6투,1712,1186,371,763,29,1,13,0,0,0,1,1,1,0,1180,6,526
4700,경상북도,4706,안동시,,용상동제7투,1859,1251,395,807,17,0,13,1,0,0,2,1,0,0,1236,15,608
4700,경상북도,4706,안동시,,용상동제8투,899,543,118,394,10,1,8,0,0,0,1,2,2,0,536,7,356
4700,경상북도,4706,안동시,서구동,소계,7596,6076,1662,4226,74,2,56,3,0,0,5,5,1,2,6036,40,1520
4700,경상북도,4706,안동시,,관내사전투표,2919,2919,953,1879,40,2,19,3,0,0,1,4,0,1,2902,17,0
4700,경상북도,4706,안동시,,서구동제1투,1529,985,254,699,13,0,16,0,0,0,0,0,0,0,982,3,544
4700,경상북도,4706,안동시,,서구동제2투,1350,909,162,718,8,0,8,0,0,0,0,1,1,1,899,10,441
4700,경상북도,4706,안동시,,서구동제3투,928,647,149,470,9,0,10,0,0,0,4,0,0,0,642,5,281
4700,경상북도,4706,안동시,,서구동제4투,870,616,144,460,4,0,3,0,0,0,0,0,0,0,611,5,254
4700,경상북도,4706,안동시,태화동,소계,9632,7050,1734,5065,98,2,76,0,3,4,12,5,5,0,7004,46,2582
4700,경상북도,4706,안동시,,관내사전투표,3054,3054,830,2153,31,1,17,0,1,1,3,3,0,0,3040,14,0
4700,경상북도,4706,안동시,,태화동제1투,902,542,97,419,8,0,7,0,0,0,3,0,0,0,534,8,360
4700,경상북도,4706,안동시,,태화동제2투,1256,734,156,545,10,0,15,0,0,0,3,0,0,0,729,5,522
4700,경상북도,4706,안동시,,태화동제3투,1225,720,133,542,15,1,16,0,1,0,2,0,2,0,712,8,505
4700,경상북도,4706,안동시,,태화동제4투,1153,729,156,549,8,0,9,0,0,2,0,2,1,0,727,2,424
4700,경상북도,4706,안동시,,태화동제5투,2042,1271,362,857,26,0,12,0,1,1,1,0,2,0,1262,9,771
4700,경상북도,4706,안동시,평화동,소계,5105,3969,1001,2833,66,1,33,0,0,1,3,1,1,0,3940,29,1136
4700,경상북도,4706,안동시,,관내사전투표,1940,1940,518,1364,34,1,9,0,0,0,1,1,1,0,1929,11,0
4700,경상북도,4706,안동시,,평화동제1투,939,577,132,423,14,0,5,0,0,0,0,0,0,0,574,3,362
4700,경상북도,4706,안동시,,평화동제2투,893,552,148,389,5,0,6,0,0,1,2,0,0,0,551,1,341
4700,경상북도,4706,안동시,,평화동제3투,1333,900,203,657,13,0,13,0,0,0,0,0,0,0,886,14,433
4700,경상북도,4706,안동시,안기동,소계,5542,4446,1227,3043,76,1,48,1,0,2,6,4,3,5,4416,30,1096
4700,경상북도,4706,안동시,,관내사전투표,2453,2453,735,1641,40,0,20,1,0,0,2,2,0,2,2443,10,0
4700,경상북도,4706,안동시,,안기동제1투,845,566,156,380,15,1,2,0,0,1,1,0,0,1,557,9,279
4700,경상북도,4706,안동시,,안기동제2투,933,568,126,414,4,0,13,0,0,0,3,1,1,1,563,5,365
4700,경상북도,4706,안동시,,안기동제3투,1311,859,210,608,17,0,13,0,0,1,0,1,2,1,853,6,452
4700,경상북도,4706,안동시,옥동,소계,15435,11560,3733,7393,207,7,105,0,1,3,13,5,9,7,11483,77,3875
4700,경상북도,4706,안동시,,관내사전투표,5047,5046,1703,3188,88,6,34,0,0,0,3,2,3,2,5029,17,1
4700,경상북도,4706,안동시,,옥동제1투,1816,991,266,675,19,0,14,0,0,1,2,0,0,1,978,13,825
4700,경상북도,4706,안동시,,옥동제2투,1841,1199,448,707,28,0,5,0,1,0,1,1,1,0,1192,7,642
4700,경상북도,4706,안동시,,옥동제3투,1562,1099,285,774,12,0,15,0,0,2,0,0,2,1,1091,8,463
4700,경상북도,4706,안동시,,옥동제4투,1403,844,244,555,13,1,14,0,0,0,1,1,2,2,833,11,559
4700,경상북도,4706,안동시,,옥동제5투,1448,911,301,577,15,0,5,0,0,0,5,0,0,0,903,8,537
4700,경상북도,4706,안동시,,옥동제6투,1297,871,324,508,21,0,10,0,0,0,1,1,0,1,866,5,426
4700,경상북도,4706,안동시,,옥동제7투,1021,599,162,409,11,0,8,0,0,0,0,0,1,0,591,8,422
4700,경상북도,4706,안동시,송하동,소계,12230,9460,3148,5991,159,2,83,0,2,0,12,1,3,1,9402,58,2770
4700,경상북도,4706,안동시,,관내사전투표,4710,4710,1714,2860,82,1,26,0,1,0,6,0,1,1,4692,18,0
4700,경상북도,4706,안동시,,송하동제1투,1422,865,232,597,18,1,11,0,0,0,1,0,0,0,860,5,557
4700,경상북도,4706,안동시,,송하동제2투,1562,881,292,557,10,0,14,0,0,0,0,0,1,0,874,7,681
4700,경상북도,4706,안동시,,송하동제3투,1122,665,171,464,12,0,10,0,0,0,2,1,0,0,660,5,457
4700,경상북도,4706,안동시,,송하동제4투,2003,1378,446,882,22,0,11,0,1,0,2,0,1,0,1365,13,625
4700,경상북도,4706,안동시,,송하동제5투,1411,961,293,631,15,0,11,0,0,0,1,0,0,0,951,10,450
4700,경상북도,4706,안동시,강남동,소계,7625,5999,2158,3643,101,0,41,0,0,2,6,3,2,1,5957,42,1626
4700,경상북도,4706,안동시,,관내사전투표,3297,3297,1314,1886,50,0,24,0,0,0,2,3,1,0,3280,17,0
4700,경상북도,4706,안동시,,강남동제1투,1163,705,181,502,11,0,2,0,0,0,0,0,1,1,698,7,458
4700,경상북도,4706,안동시,,강남동제2투,1799,1157,371,735,21,0,11,0,0,2,2,0,0,0,1142,15,642
4700,경상북도,4706,안동시,,강남동제3투,1366,840,292,520,19,0,4,0,0,0,2,0,0,0,837,3,526
4700,경상북도,4706,안동시,잘못 투입·구분된 투표지,,0,1,0,1,0,0,0,0,0,0,0,0,0,0,1,0,-1
4700,경상북도,4707,구미시,합계,,338810,253211,67054,173950,5537,124,3207,57,45,60,327,173,99,110,250743,2468,85599
4700,경상북도,4707,구미시,거소·선상투표,,594,553,109,346,4,3,16,1,0,0,3,3,3,1,489,64,41
4700,경상북도,4707,구미시,관외사전투표,,22622,22616,6397,14772,597,18,389,7,8,6,30,23,12,22,22281,335,6
4700,경상북도,4707,구미시,재외투표,,935,583,256,231,25,1,6,1,0,1,2,0,0,0,523,60,352
4700,경상북도,4707,구미시,선산읍,소계,12326,9452,1494,7626,132,1,108,3,2,1,9,4,5,3,9388,64,2874
4700,경상북도,4707,구미시,,관내사전투표,4560,4560,815,3590,74,1,45,1,1,0,4,2,4,2,4539,21,0
4700,경상북도,4707,구미시,,선산읍제1투,1386,905,106,767,9,0,16,0,0,0,2,0,0,0,900,5,481
4700,경상북도,4707,구미시,,선산읍제2투,1200,731,91,622,7,0,3,0,0,0,0,0,0,0,723,8,469
4700,경상북도,4707,구미시,,선산읍제3투,1622,1032,113,882,11,0,14,2,1,0,0,1,0,0,1024,8,590
4700,경상북도,4707,구미시,,선산읍제4투,603,453,58,383,4,0,3,0,0,0,1,0,0,0,449,4,150
4700,경상북도,4707,구미시,,선산읍제5투,2955,1771,311,1382,27,0,27,0,0,1,2,1,1,1,1753,18,1184
4700,경상북도,4707,구미시,고아읍,소계,24611,18346,4005,13597,340,4,188,5,6,6,21,12,7,7,18198,148,6265
4700,경상북도,4707,구미시,,관내사전투표,4138,4138,971,3044,56,0,37,2,0,0,2,2,1,5,4120,18,0
4700,경상북도,4707,구미시,,고아읍제1투,1291,849,98,711,11,1,9,0,1,0,3,0,1,0,835,14,442
4700,경상북도,4707,구미시,,고아읍제2투,1736,1068,148,877,20,0,10,0,1,1,2,2,0,0,1061,7,668
4700,경상북도,4707,구미시,,고아읍제3투,3012,2073,455,1523,47,1,25,0,0,2,1,2,0,0,2056,17,939
4700,경상북도,4707,구미시,,고아읍제4투,2681,1867,388,1388,40,1,27,1,1,1,1,2,1,0,1851,16,814
4700,경상북도,4707,구미시,,고아읍제5투,939,708,77,596,12,0,14,1,0,0,0,0,2,0,702,6,231
4700,경상북도,4707,구미시,,고아읍제6투,1831,1247,186,1019,9,0,17,1,0,1,4,0,2,1,1240,7,584
4700,경상북도,4707,구미시,,고아읍제7투,3074,2088,552,1446,40,0,23,0,1,0,4,0,0,0,2066,22,986
4700,경상북도,4707,구미시,,고아읍제8투,2543,1803,451,1273,49,0,10,0,0,1,1,2,0,0,1787,16,740
4700,경상북도,4707,구미시,,고아읍제9투,3366,2505,679,1720,56,1,16,0,2,0,3,2,0,1,2480,25,861
4700,경상북도,4707,구미시,무을면,소계,1687,1349,192,1120,14,2,7,0,0,0,3,0,3,1,1342,7,338
4700,경상북도,4707,구미시,,관내사전투표,826,825,138,669,6,1,4,0,0,0,1,0,1,1,821,4,1
4700,경상북도,4707,구미시,,무을면투표소,861,524,54,451,8,1,3,0,0,0,2,0,2,0,521,3,337
4700,경상북도,4707,구미시,옥성면,소계,1499,1191,142,1004,11,1,5,0,0,1,2,1,2,7,1176,15,308
4700,경상북도,4707,구미시,,관내사전투표,756,755,93,625,9,1,4,0,0,1,1,1,1,7,743,12,1
4700,경상북도,4707,구미시,,옥성면투표소,743,436,49,379,2,0,1,0,0,0,1,0,1,0,433,3,307
4700,경상북도,4707,구미시,도개면,소계,2039,1620,215,1358,16,1,13,0,1,0,1,2,2,0,1609,11,419
4700,경상북도,4707,구미시,,관내사전투표,939,939,148,765,11,1,5,0,1,0,0,1,1,0,933,6,0
4700,경상북도,4707,구미시,,도개면투표소,1100,681,67,593,5,0,8,0,0,0,1,1,1,0,676,5,419
4700,경상북도,4707,구미시,해평면,소계,3709,2923,411,2417,27,0,30,0,0,1,3,4,3,4,2900,23,786
4700,경상북도,4707,구미시,,관내사전투표,1617,1617,278,1284,20,0,16,0,0,1,0,2,1,2,1604,13,0
4700,경상북도,4707,구미시,,해평면제1투,1067,653,61,570,3,0,10,0,0,0,1,1,1,1,648,5,414
4700,경상북도,4707,구미시,,해평면제2투,1025,653,72,563,4,0,4,0,0,0,2,1,1,1,648,5,372
4700,경상북도,4707,구미시,장천면,소계,3215,2651,462,2096,40,1,16,0,0,1,5,4,1,1,2627,24,564
4700,경상북도,4707,구미시,,관내사전투표,1722,1722,360,1303,33,1,8,0,0,0,2,1,0,1,1709,13,0
4700,경상북도,4707,구미시,,장천면투표소,1493,929,102,793,7,0,8,0,0,1,3,3,1,0,918,11,564
4700,경상북도,4707,구미시,송정동,소계,18217,13839,3324,9947,288,7,131,4,3,5,16,7,2,3,13737,102,4378
4700,경상북도,4707,구미시,,관내사전투표,5911,5911,1552,4156,120,2,40,1,0,1,6,3,0,1,5882,29,0
4700,경상북도,4707,구미시,,송정동제1투,2332,1390,307,1024,15,0,28,0,0,1,1,0,0,0,1376,14,942
4700,경상북도,4707,구미시,,송정동제2투,1677,995,171,784,17,0,15,0,0,1,1,0,0,0,989,6,682
4700,경상북도,4707,구미시,,송정동제3투,2381,1473,296,1095,32,1,22,1,1,2,5,0,0,1,1456,17,908
4700,경상북도,4707,구미시,,송정동제4투,2457,1499,303,1124,33,2,14,1,1,0,2,3,1,1,1485,14,958
4700,경상북도,4707,구미시,,송정동제5투,3459,2571,695,1764,71,2,12,1,1,0,1,1,1,0,2549,22,888
4700,경상북도,4707,구미시,지산동,소계,3488,3046,672,2244,59,0,38,1,2,0,2,0,0,1,3019,27,442
4700,경상북도,4707,구미시,,관내사전투표,2204,2204,570,1536,53,0,21,1,2,0,1,0,0,1,2185,19,0
4700,경상북도,4707,구미시,,지산동투표소,1284,842,102,708,6,0,17,0,0,0,1,0,0,0,834,8,442
4700,경상북도,4707,구미시,도량동,소계,22690,17329,4127,12417,393,11,194,3,2,8,31,13,5,7,17211,118,5361
4700,경상북도,4707,구미시,,관내사전투표,6300,6298,1589,4495,114,6,48,3,1,3,4,6,0,2,6271,27,2
4700,경상북도,4707,구미시,,도량동제1투,1233,813,137,633,17,0,12,0,0,1,5,1,0,1,807,6,420
4700,경상북도,4707,구미시,,도량동제2투,2098,1449,358,1002,45,2,23,0,0,1,3,3,0,1,1438,11,649
4700,경상북도,4707,구미시,,도량동제3투,1859,1293,301,927,32,0,19,0,0,1,1,1,2,0,1284,9,566
4700,경상북도,4707,구미시,,도량동제4투,2461,1557,307,1174,28,2,25,0,0,0,5,0,0,1,1542,15,904
4700,경상북도,4707,구미시,,도량동제5투,2374,1520,301,1134,40,1,22,0,1,1,7,0,2,1,1510,10,854
4700,경상북도,4707,구미시,,도량동제6투,2820,1886,415,1396,39,0,20,0,0,0,1,2,1,1,1875,11,934
4700,경상북도,4707,구미시,,도량동제7투,3545,2513,719,1656,78,0,25,0,0,1,5,0,0,0,2484,29,1032
4700,경상북도,4707,구미시,선주원남동,소계,27856,20271,5620,13856,403,5,180,5,3,2,26,6,4,8,20118,153,7585
4700,경상북도,4707,구미시,,관내사전투표,6998,6998,2298,4502,123,1,38,1,0,0,3,0,2,2,6970,28,0
4700,경상북도,4707,구미시,,선주원남동제1투,2866,1875,617,1155,54,1,24,0,0,1,5,2,0,0,1859,16,991
4700,경상북도,4707,구미시,,선주원남동제2투,2474,1571,372,1138,33,0,13,1,1,0,1,1,0,0,1560,11,903
4700,경상북도,4707,구미시,,선주원남동제3투,3122,1497,300,1126,24,1,26,0,0,0,1,2,1,0,1481,16,1625
4700,경상북도,4707,구미시,,선주원남동제4투,2160,1523,397,1078,23,0,10,1,0,0,2,0,0,0,1511,12,637
4700,경상북도,4707,구미시,,선주원남동제5투,3289,2226,429,1703,46,1,19,1,1,0,5,0,0,1,2206,20,1063
4700,경상북도,4707,구미시,,선주원남동제6투,1606,1083,156,888,14,0,17,0,1,1,1,0,0,1,1079,4,523
4700,경상북도,4707,구미시,,선주원남동제7투,2205,1575,458,1039,34,1,9,0,0,0,5,1,0,3,1550,25,630
4700,경상북도,4707,구미시,,선주원남동제8투,3136,1923,593,1227,52,0,24,1,0,0,3,0,1,1,1902,21,1213
4700,경상북도,4707,구미시,형곡1동,소계,11601,9145,2204,6538,194,3,102,1,1,3,11,6,3,1,9067,78,2456
4700,경상북도,4707,구미시,,관내사전투표,4407,4407,1177,3079,85,1,31,1,1,1,2,2,2,1,4383,24,0
4700,경상북도,4707,구미시,,형곡1동제1투,1188,781,165,575,18,0,9,0,0,1,0,1,1,0,770,11,407
4700,경상북도,4707,구미시,,형곡1동제2투,2112,1407,296,1042,33,0,25,0,0,1,1,1,0,0,1399,8,705
4700,경상북도,4707,구미시,,형곡1동제3투,1725,1124,266,811,20,0,15,0,0,0,3,0,0,0,1115,9,601
4700,경상북도,4707,구미시,,형곡1동제4투,2169,1426,300,1031,38,2,22,0,0,0,5,2,0,0,1400,26,743
4700,경상북도,4707,구미시,형곡2동,소계,13398,10208,2271,7491,184,6,126,5,1,3,10,9,1,6,10113,95,3190
4700,경상북도,4707,구미시,,관내사전투표,4507,4507,1103,3241,79,2,40,3,0,0,1,4,1,5,4479,28,0
4700,경상북도,4707,구미시,,형곡2동제1투,1899,1262,239,957,30,1,14,0,0,1,2,2,0,0,1246,16,637
4700,경상북도,4707,구미시,,형곡2동제2투,1935,1217,296,872,16,0,14,0,1,0,2,0,0,0,1201,16,718
4700,경상북도,4707,구미시,,형곡2동제3투,1406,913,192,679,11,1,15,0,0,0,1,1,0,0,900,13,493
4700,경상북도,4707,구미시,,형곡2동제4투,1867,1199,232,904,20,1,20,1,0,2,3,1,0,1,1185,14,668
4700,경상북도,4707,구미시,,형곡2동제5투,1784,1110,209,838,28,1,23,1,0,0,1,1,0,0,1102,8,674
4700,경상북도,4707,구미시,신평1동,소계,4091,3350,742,2464,68,2,29,1,2,2,4,2,1,2,3319,31,741
4700,경상북도,4707,구미시,,관내사전투표,2118,2118,539,1481,48,2,16,1,2,1,2,2,1,1,2096,22,0
4700,경상북도,4707,구미시,,신평1동제1투,810,592,82,494,6,0,3,0,0,0,2,0,0,1,588,4,218
4700,경상북도,4707,구미시,,신평1동제2투,1163,640,121,489,14,0,10,0,0,1,0,0,0,0,635,5,523
4700,경상북도,4707,구미시,신평2동,소계,2511,1898,430,1380,39,0,20,1,1,0,7,2,1,1,1882,16,613
4700,경상북도,4707,구미시,,관내사전투표,992,992,246,706,21,0,10,1,0,0,0,1,1,1,987,5,0
4700,경상북도,4707,구미시,,신평2동투표소,1519,906,184,674,18,0,10,0,1,0,7,1,0,0,895,11,613
4700,경상북도,4707,구미시,비산동,소계,9885,7319,1999,4961,180,7,94,1,3,2,4,2,2,4,7259,60,2566
4700,경상북도,4707,구미시,,관내사전투표,3585,3585,1039,2407,77,4,31,1,2,0,3,1,1,3,3569,16,0
4700,경상북도,4707,구미시,,비산동제1투,3081,1789,457,1231,49,1,29,0,0,0,1,1,0,0,1769,20,1292
4700,경상북도,4707,구미시,,비산동제2투,3219,1945,503,1323,54,2,34,0,1,2,0,0,1,1,1921,24,1274
4700,경상북도,4707,구미시,광평동,소계,4467,3601,955,2480,74,0,44,3,2,1,5,4,0,2,3570,31,866
4700,경상북도,4707,구미시,,관내사전투표,2319,2319,652,1580,45,0,22,3,1,0,1,2,0,1,2307,12,0
4700,경상북도,4707,구미시,,광평동투표소,2148,1282,303,900,29,0,22,0,1,1,4,2,0,1,1263,19,866
4700,경상북도,4707,구미시,상모사곡동,소계,23435,17049,4648,11601,380,11,201,4,3,5,30,15,5,7,16910,139,6386
4700,경상북도,4707,구미시,,관내사전투표,6235,6231,1818,4171,129,4,60,2,0,3,3,4,0,2,6196,35,4
4700,경상북도,4707,구미시,,상모사곡동제1투,3305,1780,459,1230,31,2,31,0,0,0,10,3,0,1,1767,13,1525
4700,경상북도,4707,구미시,,상모사곡동제2투,2679,1682,427,1172,38,0,22,0,0,1,3,2,1,1,1667,15,997
4700,경상북도,4707,구미시,,상모사곡동제3투,3862,2163,542,1481,62,2,35,0,2,0,7,3,2,0,2136,27,1699
4700,경상북도,4707,구미시,,상모사곡동제4투,2857,1995,530,1378,41,2,17,2,0,1,3,0,1,0,1975,20,862
4700,경상북도,4707,구미시,,상모사곡동제5투,2279,1533,425,1033,34,0,22,0,1,0,1,1,0,1,1518,15,746
4700,경상북도,4707,구미시,,상모사곡동제6투,2218,1665,447,1136,45,1,14,0,0,0,3,2,1,2,1651,14,553
4700,경상북도,4707,구미시,임오동,소계,12785,9021,2542,5988,221,4,147,1,0,0,14,5,7,2,8931,90,3764
4700,경상북도,4707,구미시,,관내사전투표,2748,2748,816,1827,62,1,24,1,0,0,2,0,1,0,2734,14,0
4700,경상북도,4707,구미시,,임오동제1투,1975,1094,240,795,12,0,26,0,0,0,3,1,2,1,1080,14,881
4700,경상북도,4707,구미시,,임오동제2투,2163,1299,322,893,32,1,36,0,0,0,3,0,1,0,1288,11,864
4700,경상북도,4707,구미시,,임오동제3투,1942,1209,322,804,42,1,18,0,0,0,2,1,1,1,1192,17,733
4700,경상북도,4707,구미시,,임오동제4투,1149,710,182,490,11,0,13,0,0,0,2,0,2,0,700,10,439
4700,경상북도,4707,구미시,,임오동제5투,2808,1961,660,1179,62,1,30,0,0,0,2,3,0,0,1937,24,847
4700,경상북도,4707,구미시,인동동,소계,34652,22184,6521,14428,537,13,360,3,3,2,40,9,10,7,21933,251,12468
4700,경상북도,4707,구미시,,관내사전투표,6767,6767,2229,4246,144,5,86,0,1,1,3,2,2,1,6720,47,0
4700,경상북도,4707,구미시,,인동동제1투,2236,1267,258,934,26,0,23,0,1,0,2,1,0,0,1245,22,969
4700,경상북도,4707,구미시,,인동동제2투,2471,1415,419,921,32,0,21,0,0,0,2,1,0,0,1396,19,1056
4700,경상북도,4707,구미시,,인동동제3투,3127,1571,378,1106,27,1,30,0,0,0,3,2,3,1,1551,20,1556
4700,경상북도,4707,구미시,,인동동제4투,1615,897,192,642,27,0,15,0,0,0,5,1,2,0,884,13,718
4700,경상북도,4707,구미시,,인동동제5투,2084,1184,243,869,20,2,28,0,0,1,1,0,0,1,1165,19,900
4700,경상북도,4707,구미시,,인동동제6투,2342,1445,373,985,43,2,21,0,0,0,2,0,1,2,1429,16,897
4700,경상북도,4707,구미시,,인동동제7투,3083,1394,436,848,41,0,37,2,0,0,8,0,1,0,1373,21,1689
4700,경상북도,4707,구미시,,인동동제8투,1537,669,165,466,18,0,7,0,1,0,1,0,0,0,658,11,868
4700,경상북도,4707,구미시,,인동동제9투,2792,1823,590,1127,59,1,21,0,0,0,4,2,1,0,1805,18,969
4700,경상북도,4707,구미시,,인동동제10투,4060,2385,830,1424,61,0,37,1,0,0,5,0,0,0,2358,27,1675
4700,경상북도,4707,구미시,,인동동제11투,2538,1367,408,860,39,2,34,0,0,0,4,0,0,2,1349,18,1171
4700,경상북도,4707,구미시,진미동,소계,15457,8744,2640,5568,196,6,201,0,0,3,10,10,3,1,8638,106,6713
4700,경상북도,4707,구미시,,관내사전투표,4469,4469,1509,2719,112,4,76,0,0,1,3,1,2,1,4428,41,0
4700,경상북도,4707,구미시,,진미동제1투,798,464,89,331,15,0,6,0,0,0,1,0,1,0,443,21,334
4700,경상북도,4707,구미시,,진미동제2투,2785,1019,259,687,18,0,35,0,0,0,1,3,0,0,1003,16,1766
4700,경상북도,4707,구미시,,진미동제3투,3391,1134,287,766,22,0,35,0,0,1,4,6,0,0,1121,13,2257
4700,경상북도,4707,구미시,,진미동제4투,4014,1658,496,1065,29,2,49,0,0,1,1,0,0,0,1643,15,2356
4700,경상북도,4707,구미시,양포동,소계,31163,22420,7709,13557,586,6,284,3,1,4,17,15,7,5,22194,226,8743
4700,경상북도,4707,구미시,,관내사전투표,7686,7686,2997,4382,172,2,74,0,1,0,4,5,3,1,7641,45,0
4700,경상북도,4707,구미시,,양포동제1투,2641,1339,402,860,32,0,27,1,0,0,0,2,1,0,1325,14,1302
4700,경상북도,4707,구미시,,양포동제2투,3155,2111,771,1247,54,0,23,0,0,1,1,0,0,1,2098,13,1044
4700,경상북도,4707,구미시,,양포동제3투,1418,908,239,607,28,0,14,0,0,1,6,0,1,1,897,11,510
4700,경상북도,4707,구미시,,양포동제4투,2573,1481,413,985,41,0,21,1,0,0,0,4,0,1,1466,15,1092
4700,경상북도,4707,구미시,,양포동제5투,2772,1764,476,1179,59,0,30,0,0,0,1,1,0,0,1746,18,1008
4700,경상북도,4707,구미시,,양포동제6투,2125,1240,356,805,31,2,24,1,0,1,2,0,0,0,1222,18,885
4700,경상북도,4707,구미시,,양포동제7투,2261,1460,382,987,36,0,27,0,0,1,0,0,1,0,1434,26,801
4700,경상북도,4707,구미시,,양포동제8투,1843,1165,402,706,21,0,13,0,0,0,2,0,0,0,1144,21,678
4700,경상북도,4707,구미시,,양포동제9투,2554,1757,716,932,61,2,17,0,0,0,1,1,0,0,1730,27,797
4700,경상북도,4707,구미시,,양포동제10투,2135,1509,555,867,51,0,14,0,0,0,0,2,1,1,1491,18,626
4700,경상북도,4707,구미시,산동읍,소계,17555,13072,4673,7748,324,5,165,1,1,1,7,7,8,4,12944,128,4483
4700,경상북도,4707,구미시,,관내사전투표,4168,4168,1651,2370,91,3,36,0,0,0,2,3,3,0,4159,9,0
4700,경상북도,4707,구미시,,산동읍제1투,1403,910,108,769,9,1,9,0,0,1,1,0,2,2,902,8,493
4700,경상북도,4707,구미시,,산동읍제2투,3784,2649,1036,1470,72,1,35,0,1,0,0,0,1,1,2617,32,1135
4700,경상북도,4707,구미시,,산동읍제3투,3083,2204,794,1292,52,0,28,1,0,0,1,4,1,0,2173,31,879
4700,경상북도,4707,구미시,,산동읍제4투,2001,1270,474,716,47,0,14,0,0,0,1,0,1,0,1253,17,731
4700,경상북도,4707,구미시,,산동읍제5투,3116,1871,610,1131,53,0,43,0,0,0,2,0,0,1,1840,31,1245
4700,경상북도,4707,구미시,공단동,소계,4294,3380,1062,2118,106,2,54,2,0,2,5,3,1,1,3356,24,914
4700,경상북도,4707,구미시,,관내사전투표,2224,2224,749,1354,71,2,30,2,0,0,3,2,0,0,2213,11,0
4700,경상북도,4707,구미시,,공단동투표소,2070,1156,313,764,35,0,24,0,0,2,2,1,1,1,1143,13,914
4700,경상북도,4707,구미시,원평동,소계,8028,6045,1230,4594,99,4,59,1,0,0,9,5,1,2,6004,41,1983
4700,경상북도,4707,구미시,,관내사전투표,3813,3813,900,2782,71,3,29,1,0,0,2,2,1,2,3793,20,0
4700,경상북도,4707,구미시,,원평동제1투,2471,1102,161,887,12,1,20,0,0,0,7,2,0,0,1090,12,1369
4700,경상북도,4707,구미시,,원평동제2투,751,487,71,405,5,0,2,0,0,0,0,1,0,0,484,3,264
4700,경상북도,4707,구미시,,원평동제3투,993,643,98,520,11,0,8,0,0,0,0,0,0,0,637,6,350
4700,경상북도,4707,구미시,잘못 투입·구분된 투표지,,0,6,2,3,0,0,0,0,0,0,0,0,0,0,5,1,-6
4700,경상북도,4708,영주시,합계,,89380,70769,17937,50214,1153,27,571,15,14,18,66,72,77,43,70207,562,18611
4700,경상북도,4708,영주시,거소·선상투표,,360,247,55,160,6,0,3,3,0,0,0,1,1,0,229,18,113
4700,경상북도,4708,영주시,관외사전투표,,5704,5700,1778,3592,169,6,70,1,1,1,2,5,4,4,5633,67,4
4700,경상북도,4708,영주시,재외투표,,267,179,109,39,8,0,1,0,0,0,0,1,0,0,158,21,88
4700,경상북도,4708,영주시,풍기읍,소계,8850,6792,1528,5029,102,2,43,0,4,1,2,14,13,2,6740,52,2058
4700,경상북도,4708,영주시,,관내사전투표,3211,3209,765,2351,47,1,11,0,0,0,1,6,6,1,3189,20,2
4700,경상북도,4708,영주시,,풍기읍제1투,1169,776,163,587,11,0,6,0,1,1,0,1,0,1,771,5,393
4700,경상북도,4708,영주시,,풍기읍제2투,1212,755,168,561,9,1,5,0,1,0,0,0,2,0,747,8,457
4700,경상북도,4708,영주시,,풍기읍제3투,1236,782,156,585,14,0,12,0,1,0,1,2,2,0,773,9,454
4700,경상북도,4708,영주시,,풍기읍제4투,1219,714,184,505,12,0,5,0,1,0,0,1,1,0,709,5,505
4700,경상북도,4708,영주시,,풍기읍제5투,803,556,92,440,9,0,4,0,0,0,0,4,2,0,551,5,247
4700,경상북도,4708,영주시,이산면,소계,1921,1524,312,1162,17,0,12,0,1,0,2,2,3,1,1512,12,397
4700,경상북도,4708,영주시,,관내사전투표,870,870,190,660,9,0,9,0,0,0,1,0,0,0,869,1,0
4700,경상북도,4708,영주시,,이산면제1투,598,372,78,282,5,0,1,0,1,0,0,1,2,0,370,2,226
4700,경상북도,4708,영주시,,이산면제2투,453,282,44,220,3,0,2,0,0,0,1,1,1,1,273,9,171
4700,경상북도,4708,영주시,평은면,소계,1281,1021,161,832,9,0,4,0,0,0,2,0,2,3,1013,8,260
4700,경상북도,4708,영주시,,관내사전투표,670,670,107,553,3,0,0,0,0,0,1,0,0,1,665,5,0
4700,경상북도,4708,영주시,,평은면투표소,611,351,54,279,6,0,4,0,0,0,1,0,2,2,348,3,260
4700,경상북도,4708,영주시,문수면,소계,1780,1404,324,1025,16,1,13,0,0,0,1,3,2,4,1389,15,376
4700,경상북도,4708,영주시,,관내사전투표,976,976,223,723,10,1,6,0,0,0,0,1,0,3,967,9,0
4700,경상북도,4708,영주시,,문수면투표소,804,428,101,302,6,0,7,0,0,0,1,2,2,1,422,6,376
4700,경상북도,4708,영주시,장수면,소계,1998,1648,274,1316,20,0,12,1,0,0,3,1,5,0,1632,16,350
4700,경상북도,4708,영주시,,관내사전투표,1006,1006,176,796,13,0,8,0,0,0,0,1,2,0,996,10,0
4700,경상북도,4708,영주시,,장수면제1투,682,428,70,341,5,0,4,1,0,0,2,0,3,0,426,2,254
4700,경상북도,4708,영주시,,장수면제2투,310,214,28,179,2,0,0,0,0,0,1,0,0,0,210,4,96
4700,경상북도,4708,영주시,안정면,소계,2665,2070,365,1642,16,1,15,0,0,0,3,2,4,1,2049,21,595
4700,경상북도,4708,영주시,,관내사전투표,1134,1134,204,908,6,1,7,0,0,0,0,0,1,0,1127,7,0
4700,경상북도,4708,영주시,,안정면제1투,1043,597,110,456,8,0,6,0,0,0,2,1,1,0,584,13,446
4700,경상북도,4708,영주시,,안정면제2투,488,339,51,278,2,0,2,0,0,0,1,1,2,1,338,1,149
4700,경상북도,4708,영주시,봉현면,소계,2465,1947,330,1558,27,0,18,0,0,0,0,2,2,0,1937,10,518
4700,경상북도,4708,영주시,,관내사전투표,984,984,195,760,17,0,9,0,0,0,0,0,1,0,982,2,0
4700,경상북도,4708,영주시,,봉현면제1투,939,577,83,482,2,0,5,0,0,0,0,1,0,0,573,4,362
4700,경상북도,4708,영주시,,봉현면제2투,542,386,52,316,8,0,4,0,0,0,0,1,1,0,382,4,156
4700,경상북도,4708,영주시,순흥면,소계,1872,1552,290,1190,28,1,24,1,1,0,2,0,0,3,1540,12,320
4700,경상북도,4708,영주시,,관내사전투표,937,937,197,700,19,1,13,1,0,0,0,0,0,1,932,5,0
4700,경상북도,4708,영주시,,순흥면투표소,935,615,93,490,9,0,11,0,1,0,2,0,0,2,608,7,320
4700,경상북도,4708,영주시,단산면,소계,1623,1331,239,1029,24,3,11,1,1,0,1,2,2,4,1317,14,292
4700,경상북도,4708,영주시,,관내사전투표,770,770,136,599,14,3,1,1,1,0,0,2,2,3,762,8,0
4700,경상북도,4708,영주시,,단산면제1투,435,266,70,188,4,0,2,0,0,0,0,0,0,0,264,2,169
4700,경상북도,4708,영주시,,단산면제2투,418,295,33,242,6,0,8,0,0,0,1,0,0,1,291,4,123
4700,경상북도,4708,영주시,부석면,소계,2571,2046,386,1583,32,2,11,0,1,2,4,6,5,2,2034,12,525
4700,경상북도,4708,영주시,,관내사전투표,1181,1181,219,917,18,2,3,0,1,2,1,3,3,2,1171,10,0
4700,경상북도,4708,영주시,,부석면제1투,975,585,120,441,13,0,5,0,0,0,3,2,1,0,585,0,390
4700,경상북도,4708,영주시,,부석면제2투,415,280,47,225,1,0,3,0,0,0,0,1,1,0,278,2,135
4700,경상북도,4708,영주시,상망동,소계,5810,4450,1140,3147,73,0,33,0,0,5,5,3,7,3,4416,34,1360
4700,경상북도,4708,영주시,,관내사전투표,2405,2382,646,1666,37,0,14,0,0,1,0,2,3,1,2370,12,23
4700,경상북도,4708,영주시,,상망동제1투,588,305,57,237,4,0,5,0,0,0,0,0,1,0,304,1,283
4700,경상북도,4708,영주시,,상망동제2투,1713,1108,309,748,21,0,8,0,0,2,4,1,1,0,1094,14,605
4700,경상북도,4708,영주시,,상망동제3투,1104,655,128,496,11,0,6,0,0,2,1,0,2,2,648,7,449
4700,경상북도,4708,영주시,하망동,소계,4807,3827,884,2829,48,2,29,1,4,1,4,3,2,2,3809,18,980
4700,경상북도,4708,영주시,,관내사전투표,2111,2111,509,1549,25,0,11,0,1,0,4,0,1,1,2101,10,0
4700,경상북도,4708,영주시,,하망동제1투,1030,602,130,443,10,0,12,0,1,0,0,2,0,1,599,3,428
4700,경상북도,4708,영주시,,하망동제2투,715,497,132,349,8,1,2,0,1,1,0,0,0,0,494,3,218
4700,경상북도,4708,영주시,,하망동제3투,951,617,113,488,5,1,4,1,1,0,0,1,1,0,615,2,334
4700,경상북도,4708,영주시,영주1동,소계,3649,2815,571,2156,31,0,21,2,0,1,6,3,2,0,2793,22,834
4700,경상북도,4708,영주시,,관내사전투표,1618,1618,326,1253,18,0,8,0,0,0,1,1,1,0,1608,10,0
4700,경상북도,4708,영주시,,영주1동제1투,1024,581,118,439,3,0,8,2,0,1,3,2,0,0,576,5,443
4700,경상북도,4708,영주시,,영주1동제2투,1007,616,127,464,10,0,5,0,0,0,2,0,1,0,609,7,391
4700,경상북도,4708,영주시,영주2동,소계,4801,3908,913,2878,53,0,26,1,1,0,11,2,4,1,3890,18,893
4700,경상북도,4708,영주시,,관내사전투표,2386,2386,609,1716,34,0,13,1,0,0,2,2,1,1,2379,7,0
4700,경상북도,4708,영주시,,영주2동제1투,918,560,138,400,8,0,6,0,1,0,4,0,0,0,557,3,358
4700,경상북도,4708,영주시,,영주2동제2투,659,428,71,346,1,0,6,0,0,0,0,0,1,0,425,3,231
4700,경상북도,4708,영주시,,영주2동제3투,838,534,95,416,10,0,1,0,0,0,5,0,2,0,529,5,304
4700,경상북도,4708,영주시,휴천1동,소계,4682,3550,1031,2389,60,1,35,0,0,1,2,6,4,1,3530,20,1132
4700,경상북도,4708,영주시,,관내사전투표,1969,1969,616,1292,30,0,13,0,0,0,1,0,2,0,1954,15,0
4700,경상북도,4708,영주시,,휴천1동제1투,1097,619,124,469,13,0,7,0,0,0,1,2,1,1,618,1,478
4700,경상북도,4708,영주시,,휴천1동제2투,1616,962,291,628,17,1,15,0,0,1,0,4,1,0,958,4,654
4700,경상북도,4708,영주시,휴천2동,소계,8284,6441,1588,4646,105,4,47,0,0,1,3,1,3,7,6405,36,1843
4700,경상북도,4708,영주시,,관내사전투표,3037,3037,846,2099,56,2,17,0,0,0,1,0,0,3,3024,13,0
4700,경상북도,4708,영주시,,휴천2동제1투,1208,755,149,579,8,1,9,0,0,1,0,1,0,1,749,6,453
4700,경상북도,4708,영주시,,휴천2동제2투,1087,649,156,467,13,0,9,0,0,0,0,0,0,0,645,4,438
4700,경상북도,4708,영주시,,휴천2동제3투,686,477,75,388,3,1,1,0,0,0,2,0,1,1,472,5,209
4700,경상북도,4708,영주시,,휴천2동제4투,1282,884,248,603,19,0,8,0,0,0,0,0,0,1,879,5,398
4700,경상북도,4708,영주시,,휴천2동제5투,984,639,114,510,6,0,3,0,0,0,0,0,2,1,636,3,345
4700,경상북도,4708,영주시,휴천3동,소계,6186,4836,1267,3431,66,0,29,1,0,1,5,1,2,1,4804,32,1350
4700,경상북도,4708,영주시,,관내사전투표,2491,2491,678,1761,30,0,10,0,0,0,0,1,1,0,2481,10,0
4700,경상북도,4708,영주시,,휴천3동제1투,1096,655,131,498,8,0,5,1,0,0,3,0,0,0,646,9,441
4700,경상북도,4708,영주시,,휴천3동제2투,1322,833,206,601,11,0,5,0,0,0,0,0,1,1,825,8,489
4700,경상북도,4708,영주시,,휴천3동제3투,1277,857,252,571,17,0,9,0,0,1,2,0,0,0,852,5,420
4700,경상북도,4708,영주시,가흥1동,소계,10725,8194,2847,5043,146,2,64,2,0,4,3,6,8,1,8126,68,2531
4700,경상북도,4708,영주시,,관내사전투표,4046,4046,1468,2450,66,1,25,2,0,3,0,1,4,1,4021,25,0
4700,경상북도,4708,영주시,,가흥1동제1투,1526,841,264,532,19,0,14,0,0,0,0,3,1,0,833,8,685
4700,경상북도,4708,영주시,,가흥1동제2투,1908,1151,320,782,22,0,12,0,0,0,0,1,1,0,1138,13,757
4700,경상북도,4708,영주시,,가흥1동제3투,2119,1487,600,834,28,1,7,0,0,0,2,1,0,0,1473,14,632
4700,경상북도,4708,영주시,,가흥1동제4투,1126,669,195,445,11,0,6,0,0,1,1,0,2,0,661,8,457
4700,경상북도,4708,영주시,가흥2동,소계,7079,5262,1536,3523,97,2,50,1,0,0,5,8,2,3,5227,35,1817
4700,경상북도,4708,영주시,,관내사전투표,2889,2889,882,1913,46,1,18,0,0,0,2,8,0,1,2871,18,0
4700,경상북도,4708,영주시,,가흥2동제1투,1893,1041,242,757,19,1,13,0,0,0,0,0,1,1,1034,7,852
4700,경상북도,4708,영주시,,가흥2동제2투,2297,1332,412,853,32,0,19,1,0,0,3,0,1,1,1322,10,965
4700,경상북도,4708,영주시,잘못 투입·구분된 투표지,,0,25,9,15,0,0,0,0,0,0,0,0,0,0,24,1,-25
4700,경상북도,4709,영천시,합계,,91044,70942,14332,53537,1119,33,782,17,27,21,120,92,59,64,70203,739,20102
4700,경상북도,4709,영천시,거소·선상투표,,381,355,96,163,11,4,11,0,3,0,3,3,1,3,298,57,26
4700,경상북도,4709,영천시,관외사전투표,,8406,8406,2100,5928,153,4,107,1,4,4,13,8,2,3,8327,79,0
4700,경상북도,4709,영천시,재외투표,,293,178,88,72,7,0,1,0,0,0,0,0,0,0,168,10,115
4700,경상북도,4709,영천시,금호읍,소계,8817,6636,1070,5315,80,1,86,2,3,0,11,5,6,5,6584,52,2181
4700,경상북도,4709,영천시,,관내사전투표,2560,2560,475,1997,43,1,26,2,0,0,3,1,1,1,2550,10,0
4700,경상북도,4709,영천시,,금호읍제1투,1191,728,84,613,7,0,14,0,1,0,0,0,0,0,719,9,463
4700,경상북도,4709,영천시,,금호읍제2투,1602,1052,176,825,13,0,21,0,0,0,1,2,2,2,1042,10,550
4700,경상북도,4709,영천시,,금호읍제3투,753,522,63,435,6,0,9,0,0,0,0,2,0,0,515,7,231
4700,경상북도,4709,영천시,,금호읍제4투,1072,746,95,627,6,0,6,0,2,0,1,0,2,1,740,6,326
4700,경상북도,4709,영천시,,금호읍제5투,605,433,63,357,0,0,3,0,0,0,1,0,1,1,426,7,172
4700,경상북도,4709,영천시,,금호읍제6투,1034,595,114,461,5,0,7,0,0,0,5,0,0,0,592,3,439
4700,경상북도,4709,영천시,청통면,소계,3247,2510,340,2099,25,0,20,2,0,0,1,4,3,1,2495,15,737
4700,경상북도,4709,영천시,,관내사전투표,1131,1131,189,916,9,0,8,0,0,0,0,1,1,1,1125,6,0
4700,경상북도,4709,영천시,,청통면제1투,1344,837,102,715,10,0,3,1,0,0,0,1,1,0,833,4,507
4700,경상북도,4709,영천시,,청통면제2투,772,542,49,468,6,0,9,1,0,0,1,2,1,0,537,5,230
4700,경상북도,4709,영천시,신녕면,소계,3199,2477,348,2040,26,0,31,0,2,1,2,3,3,1,2457,20,722
4700,경상북도,4709,영천시,,관내사전투표,1060,1060,172,860,9,0,10,0,2,0,0,1,2,0,1056,4,0
4700,경상북도,4709,영천시,,신녕면제1투,1065,679,100,554,10,0,8,0,0,0,1,1,1,0,675,4,386
4700,경상북도,4709,영천시,,신녕면제2투,1074,738,76,626,7,0,13,0,0,1,1,1,0,1,726,12,336
4700,경상북도,4709,영천시,화산면,소계,2623,1926,317,1502,24,2,19,3,2,1,3,4,7,7,1891,35,697
4700,경상북도,4709,영천시,,관내사전투표,930,930,180,684,18,1,7,2,1,1,1,3,5,6,909,21,0
4700,경상북도,4709,영천시,,화산면제1투,1073,597,81,488,5,0,11,0,1,0,0,1,1,0,588,9,476
4700,경상북도,4709,영천시,,화산면제2투,620,399,56,330,1,1,1,1,0,0,2,0,1,1,394,5,221
4700,경상북도,4709,영천시,화북면,소계,1818,1415,238,1128,15,1,6,0,0,1,4,6,2,2,1403,12,403
4700,경상북도,4709,영천시,,관내사전투표,782,782,146,608,8,1,1,0,0,1,1,4,2,1,773,9,0
4700,경상북도,4709,영천시,,화북면투표소,1036,633,92,520,7,0,5,0,0,0,3,2,0,1,630,3,403
4700,경상북도,4709,영천시,화남면,소계,2728,2135,327,1750,18,0,14,0,0,0,1,4,2,1,2117,18,593
4700,경상북도,4709,영천시,,관내사전투표,1021,1021,180,819,12,0,3,0,0,0,1,0,2,0,1017,4,0
4700,경상북도,4709,영천시,,화남면제1투,1064,672,84,562,4,0,8,0,0,0,0,4,0,0,662,10,392
4700,경상북도,4709,영천시,,화남면제2투,643,442,63,369,2,0,3,0,0,0,0,0,0,1,438,4,201
4700,경상북도,4709,영천시,자양면,소계,869,668,99,539,7,1,8,1,0,0,0,4,2,1,662,6,201
4700,경상북도,4709,영천시,,관내사전투표,330,330,55,260,5,1,3,1,0,0,0,1,1,0,327,3,0
4700,경상북도,4709,영천시,,자양면투표소,539,338,44,279,2,0,5,0,0,0,0,3,1,1,335,3,201
4700,경상북도,4709,영천시,임고면,소계,3636,2856,493,2269,26,1,27,0,1,0,5,3,1,2,2828,28,780
4700,경상북도,4709,영천시,,관내사전투표,1249,1249,271,935,17,0,13,0,1,0,2,1,0,1,1241,8,0
4700,경상북도,4709,영천시,,임고면제1투,807,529,77,433,4,0,5,0,0,0,1,0,1,0,521,8,278
4700,경상북도,4709,영천시,,임고면제2투,875,606,73,516,3,1,5,0,0,0,0,1,0,1,600,6,269
4700,경상북도,4709,영천시,,임고면제3투,705,472,72,385,2,0,4,0,0,0,2,1,0,0,466,6,233
4700,경상북도,4709,영천시,고경면,소계,4614,3578,653,2769,43,5,44,1,3,1,11,6,3,0,3539,39,1036
4700,경상북도,4709,영천시,,관내사전투표,1714,1714,381,1267,20,2,16,0,1,1,5,2,2,0,1697,17,0
4700,경상북도,4709,영천시,,고경면제1투,779,516,80,406,6,1,8,1,2,0,1,1,1,0,507,9,263
4700,경상북도,4709,영천시,,고경면제2투,1259,764,117,613,11,0,14,0,0,0,3,0,0,0,758,6,495
4700,경상북도,4709,영천시,,고경면제3투,862,584,75,483,6,2,6,0,0,0,2,3,0,0,577,7,278
4700,경상북도,4709,영천시,북안면,소계,3616,2754,510,2091,31,1,25,2,0,3,8,5,6,10,2692,62,862
4700,경상북도,4709,영천시,,관내사전투표,1579,1579,345,1153,17,0,9,0,0,3,2,1,0,5,1535,44,0
4700,경상북도,4709,영천시,,북안면제1투,858,568,87,449,7,0,4,0,0,0,4,1,4,2,558,10,290
4700,경상북도,4709,영천시,,북안면제2투,1179,607,78,489,7,1,12,2,0,0,2,3,2,3,599,8,572
4700,경상북도,4709,영천시,대창면,소계,2597,1981,303,1608,31,1,12,1,1,0,2,3,0,2,1964,17,616
4700,경상북도,4709,영천시,,관내사전투표,1055,1055,175,849,19,1,6,0,1,0,0,0,0,0,1051,4,0
4700,경상북도,4709,영천시,,대창면투표소,1542,926,128,759,12,0,6,1,0,0,2,3,0,2,913,13,616
4700,경상북도,4709,영천시,동부동,소계,20359,14701,3416,10594,275,5,198,1,2,3,26,10,11,13,14554,147,5658
4700,경상북도,4709,영천시,,관내사전투표,4985,4984,1295,3505,87,3,49,0,0,0,4,3,2,0,4948,36,1
4700,경상북도,4709,영천시,,동부동제1투,1849,1177,215,915,13,0,12,0,0,0,1,1,1,1,1159,18,672
4700,경상북도,4709,영천시,,동부동제2투,2515,1529,391,1051,35,0,25,0,1,1,2,1,1,2,1510,19,986
4700,경상북도,4709,영천시,,동부동제3투,2098,1293,233,1008,24,0,14,1,0,1,2,0,2,2,1287,6,805
4700,경상북도,4709,영천시,,동부동제4투,2011,1187,184,935,15,0,21,0,0,1,8,1,2,2,1169,18,824
4700,경상북도,4709,영천시,,동부동제5투,2523,1667,341,1241,29,1,27,0,0,0,5,0,1,4,1649,18,856
4700,경상북도,4709,영천시,,동부동제6투,2232,1441,321,1036,37,0,28,0,1,0,0,2,1,1,1427,14,791
4700,경상북도,4709,영천시,,동부동제7투,2146,1423,436,903,35,1,22,0,0,0,4,2,1,1,1405,18,723
4700,경상북도,4709,영천시,중앙동,소계,8314,6476,1516,4688,146,4,44,0,4,2,5,6,4,0,6419,57,1838
4700,경상북도,4709,영천시,,관내사전투표,3738,3738,985,2605,87,2,23,0,2,1,3,3,3,0,3714,24,0
4700,경상북도,4709,영천시,,중앙동제1투,2287,1306,311,931,31,1,8,0,1,1,1,2,1,0,1288,18,981
4700,경상북도,4709,영천시,,중앙동제2투,1522,943,164,729,27,1,10,0,1,0,1,1,0,0,934,9,579
4700,경상북도,4709,영천시,,중앙동제3투,767,489,56,423,1,0,3,0,0,0,0,0,0,0,483,6,278
4700,경상북도,4709,영천시,서부동,소계,4242,3271,611,2496,57,0,47,2,1,2,8,7,2,7,3240,31,971
4700,경상북도,4709,영천시,,관내사전투표,1798,1798,386,1333,33,0,14,2,1,1,3,5,2,4,1784,14,0
4700,경상북도,4709,영천시,,서부동제1투,1341,821,101,674,8,0,22,0,0,1,4,2,0,2,814,7,520
4700,경상북도,4709,영천시,,서부동제2투,1103,652,124,489,16,0,11,0,0,0,1,0,0,1,642,10,451
4700,경상북도,4709,영천시,완산동,소계,7757,6048,1315,4517,104,2,52,0,0,1,9,7,2,3,6012,36,1709
4700,경상북도,4709,영천시,,관내사전투표,3104,3104,722,2288,52,1,16,0,0,0,4,3,2,1,3089,15,0
4700,경상북도,4709,영천시,,완산동제1투,2728,1744,331,1333,35,1,21,0,0,1,5,3,0,2,1732,12,984
4700,경상북도,4709,영천시,,완산동제2투,1925,1200,262,896,17,0,15,0,0,0,0,1,0,0,1191,9,725
4700,경상북도,4709,영천시,남부동,소계,3528,2571,492,1969,40,1,30,1,1,2,8,4,2,3,2553,18,957
4700,경상북도,4709,영천시,,관내사전투표,1261,1261,287,932,14,1,11,0,1,0,3,2,0,1,1252,9,0
4700,경상북도,4709,영천시,,남부동제1투,674,416,52,347,8,0,3,0,0,0,1,1,0,0,412,4,258
4700,경상북도,4709,영천시,,남부동제2투,1593,894,153,690,18,0,16,1,0,2,4,1,2,2,889,5,699
4700,경상북도,4709,영천시,잘못 투입·구분된 투표지,,0,0,0,0,0,0,0,0,0,0,0,0,0,0,0,0,0
4700,경상북도,4710,상주시,합계,,85100,68459,13660,51935,1097,43,617,29,17,27,100,85,101,57,67768,691,16641
4700,경상북도,4710,상주시,거소·선상투표,,486,438,98,278,9,2,9,3,0,1,0,2,1,0,403,35,48
4700,경상북도,4710,상주시,관외사전투표,,6387,6386,1748,4260,171,1,89,3,3,3,7,10,5,7,6307,79,1
4700,경상북도,4710,상주시,재외투표,,379,225,107,98,5,0,2,0,0,0,0,0,0,0,212,13,154
4700,경상북도,4710,상주시,함창읍,소계,5305,4206,703,3335,63,3,42,2,2,2,5,5,9,3,4174,32,1099
4700,경상북도,4710,상주시,,관내사전투표,2640,2640,442,2118,27,3,17,1,1,1,3,3,7,1,2624,16,0
4700,경상북도,4710,상주시,,함창읍제1투,1207,720,136,546,14,0,12,1,0,0,2,1,1,0,713,7,487
4700,경상북도,4710,상주시,,함창읍제2투,786,452,76,347,16,0,7,0,0,1,0,0,0,2,449,3,334
4700,경상북도,4710,상주시,,함창읍제3투,672,394,49,324,6,0,6,0,1,0,0,1,1,0,388,6,278
4700,경상북도,4710,상주시,중동면,소계,1130,964,92,838,7,0,10,1,0,0,1,2,4,2,957,7,166
4700,경상북도,4710,상주시,,관내사전투표,733,733,64,644,6,0,6,1,0,0,1,1,4,2,729,4,0
4700,경상북도,4710,상주시,,중동면투표소,397,231,28,194,1,0,4,0,0,0,0,1,0,0,228,3,166
4700,경상북도,4710,상주시,낙동면,소계,3273,2547,338,2131,20,3,10,1,1,1,6,3,6,1,2521,26,726
4700,경상북도,4710,상주시,,관내사전투표,1532,1532,205,1277,11,1,7,1,1,0,3,2,3,0,1511,21,0
4700,경상북도,4710,상주시,,낙동면제1투,669,321,44,268,2,1,2,0,0,1,2,0,0,0,320,1,348
4700,경상북도,4710,상주시,,낙동면제2투,534,353,42,308,1,0,0,0,0,0,0,0,1,0,352,1,181
4700,경상북도,4710,상주시,,낙동면제3투,538,341,47,278,6,1,1,0,0,0,1,1,2,1,338,3,197
4700,경상북도,4710,상주시,청리면,소계,2311,1896,240,1604,21,0,14,0,0,0,1,1,2,1,1884,12,415
4700,경상북도,4710,상주시,,관내사전투표,1167,1167,175,955,17,0,7,0,0,0,0,1,1,0,1156,11,0
4700,경상북도,4710,상주시,,청리면제1투,739,449,43,398,2,0,4,0,0,0,1,0,0,0,448,1,290
4700,경상북도,4710,상주시,,청리면제2투,405,280,22,251,2,0,3,0,0,0,0,0,1,1,280,0,125
4700,경상북도,4710,상주시,공성면,소계,3375,2659,344,2225,26,1,23,1,1,2,4,0,4,1,2632,27,716
4700,경상북도,4710,상주시,,관내사전투표,1629,1629,213,1360,15,1,12,1,1,2,1,0,3,1,1610,19,0
4700,경상북도,4710,상주시,,공성면제1투,860,523,48,462,7,0,3,0,0,0,1,0,0,0,521,2,337
4700,경상북도,4710,상주시,,공성면제2투,886,507,83,403,4,0,8,0,0,0,2,0,1,0,501,6,379
4700,경상북도,4710,상주시,외남면,소계,1431,1146,174,923,21,2,3,1,1,0,2,0,5,1,1133,13,285
4700,경상북도,4710,상주시,,관내사전투표,700,700,112,557,12,1,2,1,0,0,1,0,3,0,689,11,0
4700,경상북도,4710,상주시,,외남면투표소,731,446,62,366,9,1,1,0,1,0,1,0,2,1,444,2,285
4700,경상북도,4710,상주시,내서면,소계,1590,1306,233,1024,14,0,4,0,2,0,2,7,4,2,1292,14,284
4700,경상북도,4710,상주시,,관내사전투표,712,712,139,553,7,0,0,0,1,0,0,6,1,1,708,4,0
4700,경상북도,4710,상주시,,내서면제1투,326,218,43,169,1,0,0,0,0,0,0,1,0,1,215,3,108
4700,경상북도,4710,상주시,,내서면제2투,552,376,51,302,6,0,4,0,1,0,2,0,3,0,369,7,176
4700,경상북도,4710,상주시,모동면,소계,2111,1730,411,1247,20,1,23,1,0,2,4,1,1,2,1713,17,381
4700,경상북도,4710,상주시,,관내사전투표,968,968,250,681,12,0,8,0,0,0,3,1,1,1,957,11,0
4700,경상북도,4710,상주시,,모동면제1투,568,377,82,275,4,1,9,1,0,1,1,0,0,0,374,3,191
4700,경상북도,4710,상주시,,모동면제2투,575,385,79,291,4,0,6,0,0,1,0,0,0,1,382,3,190
4700,경상북도,4710,상주시,모서면,소계,2130,1746,346,1315,33,2,22,0,0,0,2,3,3,3,1729,17,384
4700,경상북도,4710,상주시,,관내사전투표,941,941,178,723,20,2,5,0,0,0,1,1,1,2,933,8,0
4700,경상북도,4710,상주시,,모서면제1투,754,493,98,371,8,0,8,0,0,0,0,1,1,1,488,5,261
4700,경상북도,4710,상주시,,모서면제2투,435,312,70,221,5,0,9,0,0,0,1,1,1,0,308,4,123
4700,경상북도,4710,상주시,화동면,소계,1634,1325,258,1022,9,1,14,0,0,1,2,0,1,2,1310,15,309
4700,경상북도,4710,상주시,,관내사전투표,831,831,184,624,4,1,7,0,0,1,1,0,1,1,824,7,0
4700,경상북도,4710,상주시,,화동면투표소,803,494,74,398,5,0,7,0,0,0,1,0,0,1,486,8,309
4700,경상북도,4710,상주시,화서면,소계,2478,1976,297,1592,29,2,23,0,1,0,1,4,1,2,1952,24,502
4700,경상북도,4710,상주시,,관내사전투표,1190,1190,204,937,18,0,8,0,0,0,1,2,1,2,1173,17,0
4700,경상북도,4710,상주시,,화서면제1투,566,367,41,312,4,1,6,0,0,0,0,1,0,0,365,2,199
4700,경상북도,4710,상주시,,화서면제2투,722,419,52,343,7,1,9,0,1,0,0,1,0,0,414,5,303
4700,경상북도,4710,상주시,화북면,소계,1331,1084,250,766,18,1,27,1,0,1,7,0,2,1,1074,10,247
4700,경상북도,4710,상주시,,관내사전투표,692,692,180,483,9,0,9,1,0,1,4,0,2,0,689,3,0
4700,경상북도,4710,상주시,,화북면투표소,639,392,70,283,9,1,18,0,0,0,3,0,0,1,385,7,247
4700,경상북도,4710,상주시,외서면,소계,1846,1349,247,1039,21,0,10,1,0,1,6,3,6,3,1337,12,497
4700,경상북도,4710,상주시,,관내사전투표,832,832,139,652,15,0,5,1,0,0,1,3,5,3,824,8,0
4700,경상북도,4710,상주시,,외서면제1투,620,340,79,251,5,0,1,0,0,0,0,0,1,0,337,3,280
4700,경상북도,4710,상주시,,외서면제2투,394,177,29,136,1,0,4,0,0,1,5,0,0,0,176,1,217
4700,경상북도,4710,상주시,은척면,소계,1314,1097,174,868,8,0,11,1,2,0,5,2,3,3,1077,20,217
4700,경상북도,4710,상주시,,관내사전투표,623,623,93,502,4,0,3,1,2,0,1,2,3,1,612,11,0
4700,경상북도,4710,상주시,,은척면제1투,426,271,49,204,2,0,4,0,0,0,4,0,0,1,264,7,155
4700,경상북도,4710,상주시,,은척면제2투,265,203,32,162,2,0,4,0,0,0,0,0,0,1,201,2,62
4700,경상북도,4710,상주시,공검면,소계,2078,1711,240,1396,20,1,8,0,0,2,1,1,7,5,1681,30,367
4700,경상북도,4710,상주시,,관내사전투표,1071,1071,172,863,10,1,2,0,0,1,1,1,2,2,1055,16,0
4700,경상북도,4710,상주시,,공검면제1투,509,297,38,247,4,0,3,0,0,0,0,0,2,0,294,3,212
4700,경상북도,4710,상주시,,공검면제2투,498,343,30,286,6,0,3,0,0,1,0,0,3,3,332,11,155
4700,경상북도,4710,상주시,이안면,소계,1572,1296,210,1022,13,1,9,1,1,0,5,3,4,1,1270,26,276
4700,경상북도,4710,상주시,,관내사전투표,730,730,124,577,8,1,3,1,1,0,2,1,1,0,719,11,0
4700,경상북도,4710,상주시,,이안면제1투,531,343,51,267,4,0,5,0,0,0,2,2,2,1,334,9,188
4700,경상북도,4710,상주시,,이안면제2투,311,223,35,178,1,0,1,0,0,0,1,0,1,0,217,6,88
4700,경상북도,4710,상주시,화남면,소계,591,458,78,355,8,1,4,0,0,0,2,0,3,3,454,4,133
4700,경상북도,4710,상주시,,관내사전투표,291,291,47,233,4,0,0,0,0,0,1,0,3,2,290,1,0
4700,경상북도,4710,상주시,,화남면투표소,300,167,31,122,4,1,4,0,0,0,1,0,0,1,164,3,133
4700,경상북도,4710,상주시,남원동,소계,9359,7411,1688,5465,125,2,60,2,0,0,3,11,6,3,7365,46,1948
4700,경상북도,4710,상주시,,관내사전투표,3979,3979,1033,2816,63,0,30,2,0,0,1,5,4,2,3956,23,0
4700,경상북도,4710,상주시,,남원동제1투,1057,636,113,492,16,0,6,0,0,0,2,1,2,0,632,4,421
4700,경상북도,4710,상주시,,남원동제2투,726,487,85,389,8,0,4,0,0,0,0,0,0,0,486,1,239
4700,경상북도,4710,상주시,,남원동제3투,789,476,107,352,10,0,3,0,0,0,0,1,0,0,473,3,313
4700,경상북도,4710,상주시,,남원동제4투,852,583,109,455,10,1,5,0,0,0,0,0,0,0,580,3,269
4700,경상북도,4710,상주시,,남원동제5투,969,622,121,468,12,1,8,0,0,0,0,1,0,1,612,10,347
4700,경상북도,4710,상주시,,남원동제6투,987,628,120,493,6,0,4,0,0,0,0,3,0,0,626,2,359
4700,경상북도,4710,상주시,북문동,소계,7202,5568,1216,4113,109,2,51,4,1,3,11,7,4,1,5522,46,1634
4700,경상북도,4710,상주시,,관내사전투표,3006,3006,731,2159,65,1,24,3,1,1,3,3,3,0,2994,12,0
4700,경상북도,4710,상주시,,북문동제1투,777,538,60,458,5,0,5,1,0,0,0,1,0,0,530,8,239
4700,경상북도,4710,상주시,,북문동제2투,831,523,120,384,8,1,3,0,0,1,2,0,0,0,519,4,308
4700,경상북도,4710,상주시,,북문동제3투,1235,668,133,508,14,0,6,0,0,0,1,2,0,0,664,4,567
4700,경상북도,4710,상주시,,북문동제4투,443,312,30,257,8,0,3,0,0,1,2,0,0,1,302,10,131
4700,경상북도,4710,상주시,,북문동제5투,910,521,142,347,9,0,10,0,0,0,3,1,1,0,513,8,389
4700,경상북도,4710,상주시,계림동,소계,6489,4886,1100,3606,82,4,34,1,0,2,5,8,7,4,4853,33,1603
4700,경상북도,4710,상주시,,관내사전투표,2553,2552,582,1876,47,2,15,1,0,1,1,5,5,3,2538,14,1
4700,경상북도,4710,상주시,,계림동제1투,1406,764,162,573,11,0,4,0,0,1,2,1,2,1,757,7,642
4700,경상북도,4710,상주시,,계림동제2투,1576,979,234,704,20,2,9,0,0,0,1,1,0,0,971,8,597
4700,경상북도,4710,상주시,,계림동제3투,954,591,122,453,4,0,6,0,0,0,1,1,0,0,587,4,363
4700,경상북도,4710,상주시,동문동,소계,6435,5026,1018,3833,80,3,44,1,1,0,1,5,2,4,4992,34,1409
4700,경상북도,4710,상주시,,관내사전투표,2637,2637,597,1967,31,2,19,0,1,0,0,2,0,3,2622,15,0
4700,경상북도,4710,상주시,,동문동제1투,1368,822,154,637,18,0,5,0,0,0,1,1,0,0,816,6,546
4700,경상북도,4710,상주시,,동문동제2투,905,607,81,497,9,0,11,0,0,0,0,2,2,0,602,5,298
4700,경상북도,4710,상주시,,동문동제3투,925,563,117,424,13,0,5,0,0,0,0,0,0,1,560,3,362
4700,경상북도,4710,상주시,,동문동제4투,600,397,69,308,9,1,4,1,0,0,0,0,0,0,392,5,203
4700,경상북도,4710,상주시,동성동,소계,3575,2913,599,2210,52,2,18,0,0,1,2,1,3,1,2889,24,662
4700,경상북도,4710,상주시,,관내사전투표,1763,1763,392,1318,37,0,5,0,0,0,0,0,1,0,1753,10,0
4700,경상북도,4710,상주시,,동성동제1투,689,405,87,299,6,0,6,0,0,0,0,1,0,0,399,6,284
4700,경상북도,4710,상주시,,동성동제2투,488,315,56,244,3,1,3,0,0,1,0,0,1,1,310,5,173
4700,경상북도,4710,상주시,,동성동제3투,635,430,64,349,6,1,4,0,0,0,2,0,1,0,427,3,205
4700,경상북도,4710,상주시,신흥동,소계,6087,4560,1047,3346,83,3,40,1,0,0,8,4,2,1,4535,25,1527
4700,경상북도,4710,상주시,,관내사전투표,2411,2411,598,1747,42,3,10,1,0,0,0,2,0,1,2404,7,0
4700,경상북도,4710,상주시,,신흥동제1투,1009,567,126,412,13,0,7,0,0,0,5,1,1,0,565,2,442
4700,경상북도,4710,상주시,,신흥동제2투,1058,602,92,487,8,0,7,0,0,0,0,1,1,0,596,6,456
4700,경상북도,4710,상주시,,신흥동제3투,1609,980,231,700,20,0,16,0,0,0,3,0,0,0,970,10,629
4700,경상북도,4710,상주시,사벌국면,소계,3201,2550,404,2024,30,5,13,3,1,5,7,2,6,0,2500,50,651
4700,경상북도,4710,상주시,,관내사전투표,1590,1590,260,1246,20,5,6,3,0,2,5,0,5,0,1552,38,0
4700,경상북도,4710,상주시,,사벌국면제1투,985,559,86,454,4,0,3,0,0,3,0,1,0,0,551,8,426
4700,경상북도,4710,상주시,,사벌국면제2투,626,401,58,324,6,0,4,0,1,0,2,1,1,0,397,4,225
4700,경상북도,4710,상주시,잘못 투입·구분된 투표지,,0,0,0,0,0,0,0,0,0,0,0,0,0,0,0,0,0
4700,경상북도,4711,문경시,합계,,63035,49720,9912,37738,808,41,413,13,4,22,114,55,83,39,49242,478,13315
4700,경상북도,4711,문경시,거소·선상투표,,371,337,60,218,6,1,6,1,1,2,1,1,0,1,298,39,34
4700,경상북도,4711,문경시,관외사전투표,,5422,5420,1573,3536,150,6,74,1,0,3,4,8,5,6,5366,54,2
4700,경상북도,4711,문경시,재외투표,,233,141,59,61,4,0,0,0,0,0,0,0,0,0,124,17,92
4700,경상북도,4711,문경시,문경읍,소계,5875,4527,814,3564,47,4,35,0,0,0,6,4,10,3,4487,40,1348
4700,경상북도,4711,문경시,,관내사전투표,2409,2409,492,1862,19,4,9,0,0,0,3,1,4,0,2394,15,0
4700,경상북도,4711,문경시,,문경읍제1투,1486,837,114,688,12,0,9,0,0,0,2,1,1,0,827,10,649
4700,경상북도,4711,문경시,,문경읍제2투,1257,738,115,591,11,0,7,0,0,0,0,2,2,2,730,8,519
4700,경상북도,4711,문경시,,문경읍제3투,723,543,93,423,5,0,10,0,0,0,1,0,3,1,536,7,180
4700,경상북도,4711,문경시,가은읍,소계,3388,2670,532,2024,41,6,19,0,0,0,11,5,7,4,2649,21,718
4700,경상북도,4711,문경시,,관내사전투표,1614,1614,350,1206,23,5,8,0,0,0,5,1,3,2,1603,11,0
4700,경상북도,4711,문경시,,가은읍제1투,1378,807,115,649,14,1,7,0,0,0,6,3,2,1,798,9,571
4700,경상북도,4711,문경시,,가은읍제2투,396,249,67,169,4,0,4,0,0,0,0,1,2,1,248,1,147
4700,경상북도,4711,문경시,영순면,소계,1986,1587,218,1310,15,2,9,0,0,1,2,2,8,2,1569,18,399
4700,경상북도,4711,문경시,,관내사전투표,1049,1049,153,865,9,1,5,0,0,1,0,1,4,1,1040,9,0
4700,경상북도,4711,문경시,,영순면투표소,937,538,65,445,6,1,4,0,0,0,2,1,4,1,529,9,399
4700,경상북도,4711,문경시,산양면,소계,2495,1909,268,1574,24,0,16,0,0,2,1,2,5,3,1895,14,586
4700,경상북도,4711,문경시,,관내사전투표,1107,1107,167,912,12,0,5,0,0,1,0,0,2,0,1099,8,0
4700,경상북도,4711,문경시,,산양면제1투,690,393,44,331,3,0,7,0,0,1,0,1,1,2,390,3,297
4700,경상북도,4711,문경시,,산양면제2투,698,409,57,331,9,0,4,0,0,0,1,1,2,1,406,3,289
4700,경상북도,4711,문경시,호계면,소계,1976,1502,241,1210,13,4,11,0,0,0,4,1,2,3,1489,13,474
4700,경상북도,4711,문경시,,관내사전투표,927,927,147,755,6,3,5,0,0,0,1,1,1,1,920,7,0
4700,경상북도,4711,문경시,,호계면투표소,1049,575,94,455,7,1,6,0,0,0,3,0,1,2,569,6,474
4700,경상북도,4711,문경시,산북면,소계,2413,1939,334,1521,24,0,16,0,1,1,4,3,8,2,1914,25,474
4700,경상북도,4711,문경시,,관내사전투표,1327,1327,242,1038,13,0,5,0,0,1,2,2,7,1,1311,16,0
4700,경상북도,4711,문경시,,산북면투표소,1086,612,92,483,11,0,11,0,1,0,2,1,1,1,603,9,474
4700,경상북도,4711,문경시,동로면,소계,1589,1253,223,977,9,2,10,2,0,1,3,1,2,4,1234,19,336
4700,경상북도,4711,문경시,,관내사전투표,828,828,146,643,6,2,7,2,0,0,2,0,2,4,814,14,0
4700,경상북도,4711,문경시,,동로면투표소,761,425,77,334,3,0,3,0,0,1,1,1,0,0,420,5,336
4700,경상북도,4711,문경시,마성면,소계,3028,2327,355,1876,27,5,12,0,0,1,4,4,9,3,2296,31,701
4700,경상북도,4711,문경시,,관내사전투표,1384,1384,245,1080,15,4,6,0,0,1,2,1,8,3,1365,19,0
4700,경상북도,4711,문경시,,마성면제1투,668,341,47,281,3,1,1,0,0,0,2,0,1,0,336,5,327
4700,경상북도,4711,문경시,,마성면제2투,976,602,63,515,9,0,5,0,0,0,0,3,0,0,595,7,374
4700,경상북도,4711,문경시,농암면,소계,2210,1688,260,1307,32,2,23,4,0,7,29,1,8,0,1673,15,522
4700,경상북도,4711,문경시,,관내사전투표,960,960,153,752,21,2,11,2,0,2,4,1,4,0,952,8,0
4700,경상북도,4711,문경시,,농암면제1투,759,454,64,367,7,0,6,0,0,0,5,0,2,0,451,3,305
4700,경상북도,4711,문경시,,농암면제2투,491,274,43,188,4,0,6,2,0,5,20,0,2,0,270,4,217
4700,경상북도,4711,문경시,점촌1동,소계,5312,4220,747,3344,50,0,24,3,1,0,7,2,3,3,4184,36,1092
4700,경상북도,4711,문경시,,관내사전투표,2517,2517,469,1982,30,0,12,0,0,0,2,2,2,2,2501,16,0
4700,경상북도,4711,문경시,,점촌1동제1투,989,559,87,450,10,0,4,1,0,0,1,0,0,1,554,5,430
4700,경상북도,4711,문경시,,점촌1동제2투,817,524,75,431,2,0,3,2,0,0,4,0,1,0,518,6,293
4700,경상북도,4711,문경시,,점촌1동제3투,989,620,116,481,8,0,5,0,1,0,0,0,0,0,611,9,369
4700,경상북도,4711,문경시,점촌2동,소계,5977,4549,796,3604,55,2,39,0,0,1,11,5,2,1,4516,33,1428
4700,경상북도,4711,문경시,,관내사전투표,2595,2594,522,1996,35,2,18,0,0,0,1,5,0,1,2580,14,1
4700,경상북도,4711,문경시,,점촌2동제1투,1296,801,117,660,6,0,7,0,0,0,6,0,1,0,797,4,495
4700,경상북도,4711,문경시,,점촌2동제2투,826,478,57,402,5,0,5,0,0,0,3,0,0,0,472,6,348
4700,경상북도,4711,문경시,,점촌2동제3투,1260,676,100,546,9,0,9,0,0,1,1,0,1,0,667,9,584
4700,경상북도,4711,문경시,점촌3동,소계,7062,5355,1078,4106,71,2,40,0,0,0,8,6,5,3,5319,36,1707
4700,경상북도,4711,문경시,,관내사전투표,2862,2862,618,2172,38,0,11,0,0,0,2,3,2,1,2847,15,0
4700,경상북도,4711,문경시,,점촌3동제1투,1922,1168,230,887,23,1,12,0,0,0,3,1,2,0,1159,9,754
4700,경상북도,4711,문경시,,점촌3동제2투,2278,1325,230,1047,10,1,17,0,0,0,3,2,1,2,1313,12,953
4700,경상북도,4711,문경시,점촌4동,소계,2651,1959,330,1544,33,3,20,0,0,0,7,2,1,1,1941,18,692
4700,경상북도,4711,문경시,,관내사전투표,942,942,175,724,19,0,12,0,0,0,3,0,0,0,933,9,0
4700,경상북도,4711,문경시,,점촌4동제1투,1149,678,101,545,10,1,5,0,0,0,4,2,1,1,670,8,471
4700,경상북도,4711,문경시,,점촌4동제2투,560,339,54,275,4,2,3,0,0,0,0,0,0,0,338,1,221
4700,경상북도,4711,문경시,점촌5동,소계,11047,8336,2024,5961,207,2,59,2,1,3,12,8,8,0,8287,49,2711
4700,경상북도,4711,문경시,,관내사전투표,4585,4586,1111,3312,113,1,23,0,1,0,1,4,4,0,4570,16,-1
4700,경상북도,4711,문경시,,점촌5동제1투,2476,1429,297,1073,26,0,15,1,0,2,0,1,1,0,1416,13,1047
4700,경상북도,4711,문경시,,점촌5동제2투,1984,1145,268,818,26,1,8,1,0,1,7,0,1,0,1131,14,839
4700,경상북도,4711,문경시,,점촌5동제3투,2002,1176,348,758,42,0,13,0,0,0,4,3,2,0,1170,6,826
4700,경상북도,4711,문경시,잘못 투입·구분된 투표지,,0,1,0,1,0,0,0,0,0,0,0,0,0,0,1,0,-1
4700,경상북도,4712,예천군,합계,,47677,39128,9147,28320,653,26,286,17,14,15,74,39,87,37,38715,413,8549
4700,경상북도,4712,예천군,거소·선상투표,,207,194,38,136,1,0,1,1,0,0,1,0,0,0,178,16,13
4700,경상북도,4712,예천군,관외사전투표,,4672,4672,1429,3027,116,2,41,2,2,1,5,3,4,4,4636,36,0
4700,경상북도,4712,예천군,재외투표,,187,113,55,47,3,0,1,0,0,0,0,0,0,0,106,7,74
4700,경상북도,4712,예천군,예천읍,소계,12021,9443,1872,7216,143,5,77,2,6,3,18,6,11,4,9363,80,2578
4700,경상북도,4712,예천군,,관내사전투표,5213,5213,1068,3986,74,2,32,1,3,0,6,3,7,1,5183,30,0
4700,경상북도,4712,예천군,,예천읍제1투,1197,706,149,522,12,1,8,1,1,0,3,0,2,0,699,7,491
4700,경상북도,4712,예천군,,예천읍제2투,1645,1040,215,779,14,1,10,0,1,0,3,1,0,2,1026,14,605
4700,경상북도,4712,예천군,,예천읍제3투,2241,1451,236,1156,24,0,12,0,0,3,1,1,1,0,1434,17,790
4700,경상북도,4712,예천군,,예천읍제4투,1725,1033,204,773,19,1,15,0,1,0,5,1,1,1,1021,12,692
4700,경상북도,4712,예천군,용문면,소계,1984,1608,267,1259,28,1,13,2,0,1,5,2,6,2,1586,22,376
4700,경상북도,4712,예천군,,관내사전투표,1136,1136,197,890,17,1,7,2,0,1,1,1,6,1,1124,12,0
4700,경상북도,4712,예천군,,용문면투표소,848,472,70,369,11,0,6,0,0,0,4,1,0,1,462,10,376
4700,경상북도,4712,예천군,감천면,소계,2336,1921,320,1512,24,2,13,0,1,1,12,6,8,6,1905,16,415
4700,경상북도,4712,예천군,,관내사전투표,1105,1105,184,872,12,0,7,0,0,0,4,4,7,5,1095,10,0
4700,경상북도,4712,예천군,,감천면제1투,726,477,83,377,5,0,4,0,0,0,3,2,0,0,474,3,249
4700,경상북도,4712,예천군,,감천면제2투,505,339,53,263,7,2,2,0,1,1,5,0,1,1,336,3,166
4700,경상북도,4712,예천군,보문면,소계,1503,1238,198,998,11,0,6,0,0,1,2,1,2,1,1220,18,265
4700,경상북도,4712,예천군,,관내사전투표,733,733,114,602,7,0,3,0,0,0,1,0,0,0,727,6,0
4700,경상북도,4712,예천군,,보문면제1투,385,235,43,182,3,0,1,0,0,1,0,0,1,1,232,3,150
4700,경상북도,4712,예천군,,보문면제2투,385,270,41,214,1,0,2,0,0,0,1,1,1,0,261,9,115
4700,경상북도,4712,예천군,호명면,소계,11876,9358,3438,5521,222,3,67,1,0,3,13,7,6,6,9287,71,2518
4700,경상북도,4712,예천군,,관내사전투표,4848,4848,1882,2772,121,2,27,0,0,0,4,2,2,3,4815,33,0
4700,경상북도,4712,예천군,,호명면제1투,1014,612,73,500,7,0,4,0,0,3,5,2,3,1,598,14,402
4700,경상북도,4712,예천군,,호명면제2투,1875,1240,482,707,27,0,15,0,0,0,2,1,1,0,1235,5,635
4700,경상북도,4712,예천군,,호명면제3투,2363,1562,586,905,40,0,18,1,0,0,2,1,0,1,1554,8,801
4700,경상북도,4712,예천군,,호명면제4투,1776,1096,415,637,27,1,3,0,0,0,0,1,0,1,1085,11,680
4700,경상북도,4712,예천군,유천면,소계,2182,1775,308,1365,29,2,20,0,2,1,6,3,11,2,1749,26,407
4700,경상북도,4712,예천군,,관내사전투표,1107,1107,183,865,20,2,15,0,1,1,0,2,6,0,1095,12,0
4700,경상북도,4712,예천군,,유천면투표소,1075,668,125,500,9,0,5,0,1,0,6,1,5,2,654,14,407
4700,경상북도,4712,예천군,용궁면,소계,2171,1795,230,1497,11,2,6,2,2,3,3,1,7,3,1767,28,376
4700,경상북도,4712,예천군,,관내사전투표,1325,1325,168,1114,6,0,3,0,2,3,2,0,6,2,1306,19,0
4700,경상북도,4712,예천군,,용궁면투표소,846,470,62,383,5,2,3,2,0,0,1,1,1,1,461,9,376
4700,경상북도,4712,예천군,개포면,소계,1292,1050,139,881,4,0,4,0,0,0,1,2,5,0,1036,14,242
4700,경상북도,4712,예천군,,관내사전투표,624,624,77,529,1,0,3,0,0,0,0,2,4,0,616,8,0
4700,경상북도,4712,예천군,,개포면투표소,668,426,62,352,3,0,1,0,0,0,1,0,1,0,420,6,242
4700,경상북도,4712,예천군,지보면,소계,2343,1895,272,1541,23,1,14,3,0,1,2,4,11,2,1874,21,448
4700,경상북도,4712,예천군,,관내사전투표,1107,1107,171,893,12,1,7,2,0,0,1,1,5,0,1093,14,0
4700,경상북도,4712,예천군,,지보면제1투,769,454,59,371,6,0,5,0,0,0,1,3,3,0,448,6,315
4700,경상북도,4712,예천군,,지보면제2투,467,334,42,277,5,0,2,1,0,1,0,0,3,2,333,1,133
4700,경상북도,4712,예천군,풍양면,소계,2697,2171,288,1791,13,6,11,1,0,0,3,3,10,6,2132,39,526
4700,경상북도,4712,예천군,,관내사전투표,1437,1437,203,1171,11,4,6,1,0,0,1,2,5,4,1408,29,0
4700,경상북도,4712,예천군,,풍양면제1투,751,429,48,368,0,1,3,0,0,0,0,1,2,2,425,4,322
4700,경상북도,4712,예천군,,풍양면제2투,509,305,37,252,2,1,2,0,0,0,2,0,3,0,299,6,204
4700,경상북도,4712,예천군,효자면,소계,951,814,130,644,15,0,8,1,1,0,1,1,2,1,804,10,137
4700,경상북도,4712,예천군,,관내사전투표,491,491,86,384,6,0,5,0,1,0,0,1,2,1,486,5,0
4700,경상북도,4712,예천군,,효자면투표소,460,323,44,260,9,0,3,1,0,0,1,0,0,0,318,5,137
4700,경상북도,4712,예천군,은풍면,소계,1255,1081,163,885,10,2,4,2,0,0,2,0,4,0,1072,9,174
4700,경상북도,4712,예천군,,관내사전투표,716,716,120,573,8,2,2,2,0,0,2,0,1,0,710,6,0
4700,경상북도,4712,예천군,,은풍면투표소,539,365,43,312,2,0,2,0,0,0,0,0,3,0,362,3,174
4700,경상북도,4712,예천군,잘못 투입·구분된 투표지,,0,0,0,0,0,0,0,0,0,0,0,0,0,0,0,0,0
4700,경상북도,4713,경산시,합계,,230797,176406,40267,128158,3533,103,1859,51,32,48,289,156,69,85,174650,1756,54391
4700,경상북도,4713,경산시,거소·선상투표,,435,401,79,260,4,1,10,0,0,1,0,1,0,1,357,44,34
4700,경상북도,4713,경산시,관외사전투표,,18744,18743,5011,12749,484,15,221,8,6,8,21,15,2,13,18553,190,1
4700,경상북도,4713,경산시,재외투표,,779,529,255,193,21,0,4,0,0,0,2,0,0,0,475,54,250
4700,경상북도,4713,경산시,하양읍,소계,21672,16397,3646,12002,343,12,146,5,0,3,19,14,9,5,16204,193,5275
4700,경상북도,4713,경산시,,관내사전투표,6041,6042,1540,4232,138,4,50,3,0,2,7,8,5,3,5992,50,-1
4700,경상북도,4713,경산시,,하양읍제1투,1804,1046,195,801,19,1,11,0,0,0,1,0,0,1,1029,17,758
4700,경상북도,4713,경산시,,하양읍제2투,1627,950,174,722,25,1,10,0,0,0,1,0,1,0,934,16,677
4700,경상북도,4713,경산시,,하양읍제3투,3315,2292,554,1613,56,2,22,0,0,0,4,2,1,1,2255,37,1023
4700,경상북도,4713,경산시,,하양읍제4투,640,466,39,402,7,0,5,0,0,0,0,1,0,0,454,12,174
4700,경상북도,4713,경산시,,하양읍제5투,982,617,77,511,11,0,3,0,0,0,3,0,0,0,605,12,365
4700,경상북도,4713,경산시,,하양읍제6투,1402,883,135,719,13,0,7,0,0,1,2,1,0,0,878,5,519
4700,경상북도,4713,경산시,,하양읍제7투,2472,1645,343,1247,22,1,14,1,0,0,0,0,1,0,1629,16,827
4700,경상북도,4713,경산시,,하양읍제8투,1442,1086,220,812,24,2,12,0,0,0,1,0,0,0,1071,15,356
4700,경상북도,4713,경산시,,하양읍제9투,1947,1370,369,943,28,1,12,1,0,0,0,2,1,0,1357,13,577
4700,경상북도,4713,경산시,진량읍,소계,27893,19867,4645,14204,367,20,298,4,4,6,47,19,14,16,19644,223,8026
4700,경상북도,4713,경산시,,관내사전투표,5976,5976,1641,4109,93,2,69,1,1,1,8,5,3,2,5935,41,0
4700,경상북도,4713,경산시,,진량읍제1투,3087,1540,368,1086,29,3,26,0,0,1,4,1,0,0,1518,22,1547
4700,경상북도,4713,경산시,,진량읍제2투,1770,1157,270,814,32,2,19,0,0,1,1,1,1,3,1144,13,613
4700,경상북도,4713,경산시,,진량읍제3투,1282,755,98,633,9,0,7,0,0,0,0,0,1,0,748,7,527
4700,경상북도,4713,경산시,,진량읍제4투,1953,1173,197,910,23,3,22,0,0,0,6,1,2,0,1164,9,780
4700,경상북도,4713,경산시,,진량읍제5투,1729,1041,191,755,14,3,16,1,1,0,4,2,4,6,997,44,688
4700,경상북도,4713,경산시,,진량읍제6투,2080,1465,281,1107,23,1,31,0,1,0,2,2,2,0,1450,15,615
4700,경상북도,4713,경산시,,진량읍제7투,1793,1309,311,929,28,1,24,0,1,0,4,1,0,3,1302,7,484
4700,경상북도,4713,경산시,,진량읍제8투,798,582,101,448,14,0,9,0,0,0,3,0,0,1,576,6,216
4700,경상북도,4713,경산시,,진량읍제9투,2447,1528,369,1088,27,1,17,0,0,1,7,3,1,1,1515,13,919
4700,경상북도,4713,경산시,,진량읍제10투,2701,1748,393,1266,33,2,30,0,0,1,2,1,0,0,1728,20,953
4700,경상북도,4713,경산시,,진량읍제11투,2277,1593,425,1059,42,2,28,2,0,1,6,2,0,0,1567,26,684
4700,경상북도,4713,경산시,와촌면,소계,5294,4109,640,3280,57,5,37,1,3,3,4,2,3,5,4040,69,1185
4700,경상북도,4713,경산시,,관내사전투표,1884,1884,336,1447,23,5,16,1,3,3,1,2,1,5,1843,41,0
4700,경상북도,4713,경산시,,와촌면제1투,1205,671,113,530,11,0,6,0,0,0,0,0,0,0,660,11,534
4700,경상북도,4713,경산시,,와촌면제2투,1154,813,108,667,17,0,7,0,0,0,3,0,1,0,803,10,341
4700,경상북도,4713,경산시,,와촌면제3투,1051,741,83,636,6,0,8,0,0,0,0,0,1,0,734,7,310
4700,경상북도,4713,경산시,자인면,소계,5448,4287,667,3471,45,0,35,1,0,1,11,12,3,1,4247,40,1161
4700,경상북도,4713,경산시,,관내사전투표,2434,2434,444,1930,22,0,9,1,0,0,2,8,1,0,2417,17,0
4700,경상북도,4713,경산시,,자인면제1투,1041,676,79,567,8,0,7,0,0,0,5,0,1,0,667,9,365
4700,경상북도,4713,경산시,,자인면제2투,903,568,74,466,10,0,7,0,0,0,1,2,1,1,562,6,335
4700,경상북도,4713,경산시,,자인면제3투,1070,609,70,508,5,0,12,0,0,1,3,2,0,0,601,8,461
4700,경상북도,4713,경산시,용성면,소계,2831,2243,324,1806,26,2,17,1,0,1,6,10,3,3,2199,44,588
4700,경상북도,4713,경산시,,관내사전투표,1148,1148,199,887,15,2,10,0,0,0,2,5,3,2,1125,23,0
4700,경상북도,4713,경산시,,용성면제1투,1441,917,107,768,10,0,3,1,0,1,4,4,0,0,898,19,524
4700,경상북도,4713,경산시,,용성면제2투,242,178,18,151,1,0,4,0,0,0,0,1,0,1,176,2,64
4700,경상북도,4713,경산시,남산면,소계,3431,2741,401,2216,37,0,27,0,1,0,5,4,2,2,2695,46,690
4700,경상북도,4713,경산시,,관내사전투표,1506,1506,265,1188,19,0,12,0,0,0,0,0,0,0,1484,22,0
4700,경상북도,4713,경산시,,남산면제1투,1189,762,84,632,9,0,10,0,1,0,2,3,1,2,744,18,427
4700,경상북도,4713,경산시,,남산면제2투,736,473,52,396,9,0,5,0,0,0,3,1,1,0,467,6,263
4700,경상북도,4713,경산시,남천면,소계,2843,2369,393,1885,40,2,18,0,0,0,10,3,2,1,2354,15,474
4700,경상북도,4713,경산시,,관내사전투표,1243,1243,251,946,24,1,10,0,0,0,2,1,2,1,1238,5,0
4700,경상북도,4713,경산시,,남천면제1투,966,664,85,553,8,0,5,0,0,0,5,0,0,0,656,8,302
4700,경상북도,4713,경산시,,남천면제2투,634,462,57,386,8,1,3,0,0,0,3,2,0,0,460,2,172
4700,경상북도,4713,경산시,중앙동,소계,7384,5870,1261,4320,126,1,79,1,1,1,16,5,2,1,5814,56,1514
4700,경상북도,4713,경산시,,관내사전투표,3485,3484,872,2467,74,1,37,1,0,0,4,3,1,1,3461,23,1
4700,경상북도,4713,경산시,,중앙동제1투,2413,1571,252,1227,37,0,27,0,1,0,7,1,1,0,1553,18,842
4700,경상북도,4713,경산시,,중앙동제2투,1486,815,137,626,15,0,15,0,0,1,5,1,0,0,800,15,671
4700,경상북도,4713,경산시,동부동,소계,28754,20679,4943,14846,393,17,237,9,3,1,29,27,3,9,20517,162,8075
4700,경상북도,4713,경산시,,관내사전투표,6701,6701,1913,4592,120,4,36,2,0,0,5,8,0,2,6682,19,0
4700,경상북도,4713,경산시,,동부동제1투,2197,1325,240,1019,20,1,20,1,1,0,4,1,0,0,1307,18,872
4700,경상북도,4713,경산시,,동부동제2투,1297,809,118,669,8,1,6,1,0,0,2,0,0,1,806,3,488
4700,경상북도,4713,경산시,,동부동제3투,2291,1415,274,1063,27,2,29,2,0,1,3,0,0,0,1401,14,876
4700,경상북도,4713,경산시,,동부동제4투,1178,700,149,515,8,1,13,1,1,0,0,2,1,2,693,7,478
4700,경상북도,4713,경산시,,동부동제5투,1257,740,157,550,7,1,9,0,0,0,3,1,0,0,728,12,517
4700,경상북도,4713,경산시,,동부동제6투,2395,1661,291,1302,28,0,23,0,0,0,2,0,1,1,1648,13,734
4700,경상북도,4713,경산시,,동부동제7투,3352,2107,509,1481,54,3,30,1,0,0,2,4,0,2,2086,21,1245
4700,경상북도,4713,경산시,,동부동제8투,2381,1488,386,1015,33,3,24,0,0,0,5,6,0,0,1472,16,893
4700,경상북도,4713,경산시,,동부동제9투,2816,1834,448,1296,39,0,30,0,0,0,1,2,0,1,1817,17,982
4700,경상북도,4713,경산시,,동부동제10투,2889,1899,458,1344,49,1,17,1,1,0,2,3,1,0,1877,22,990
4700,경상북도,4713,경산시,서부1동,소계,24612,17885,4105,12993,391,5,159,7,2,5,33,9,6,8,17723,162,6727
4700,경상북도,4713,경산시,,관내사전투표,5121,5121,1287,3669,87,0,25,2,0,1,7,4,0,1,5083,38,0
4700,경상북도,4713,경산시,,서부1동제1투,2525,1665,368,1222,36,0,21,0,0,0,4,2,1,1,1655,10,860
4700,경상북도,4713,경산시,,서부1동제2투,1600,967,202,711,18,1,10,0,1,1,1,0,0,2,947,20,633
4700,경상북도,4713,경산시,,서부1동제3투,2665,1484,274,1120,44,0,23,0,0,1,2,2,1,1,1468,16,1181
4700,경상북도,4713,경산시,,서부1동제4투,1759,1110,180,860,32,0,14,0,0,0,4,0,1,0,1091,19,649
4700,경상북도,4713,경산시,,서부1동제5투,1807,1265,226,993,19,1,10,0,0,0,3,0,0,1,1253,12,542
4700,경상북도,4713,경산시,,서부1동제6투,2069,1297,240,977,36,3,16,1,0,1,5,0,0,1,1280,17,772
4700,경상북도,4713,경산시,,서부1동제7투,2417,1609,444,1091,48,0,13,2,0,0,2,0,1,0,1601,8,808
4700,경상북도,4713,경산시,,서부1동제8투,2686,1870,554,1234,44,0,18,1,0,0,4,1,2,1,1859,11,816
4700,경상북도,4713,경산시,,서부1동제9투,1963,1497,330,1116,27,0,9,1,1,1,1,0,0,0,1486,11,466
4700,경상북도,4713,경산시,서부2동,소계,25843,20398,4582,15106,401,4,122,5,1,7,23,8,6,6,20271,127,5445
4700,경상북도,4713,경산시,,관내사전투표,6314,6313,1481,4679,95,1,22,0,0,2,2,2,3,2,6289,24,1
4700,경상북도,4713,경산시,,서부2동제1투,2955,1992,428,1476,41,0,19,1,1,0,5,1,1,2,1975,17,963
4700,경상북도,4713,경산시,,서부2동제2투,1424,919,176,706,14,0,10,1,0,0,1,2,0,1,911,8,505
4700,경상북도,4713,경산시,,서부2동제3투,2152,1595,290,1244,37,0,12,0,0,0,4,1,0,0,1588,7,557
4700,경상북도,4713,경산시,,서부2동제4투,1847,1458,312,1099,27,1,8,1,0,3,1,0,0,0,1452,6,389
4700,경상북도,4713,경산시,,서부2동제5투,3212,2312,509,1695,61,1,16,0,0,0,5,0,1,1,2289,23,900
4700,경상북도,4713,경산시,,서부2동제6투,1313,849,174,634,19,0,8,0,0,1,1,1,1,0,839,10,464
4700,경상북도,4713,경산시,,서부2동제7투,3542,2715,654,1975,46,1,14,2,0,0,3,1,0,0,2696,19,827
4700,경상북도,4713,경산시,,서부2동제8투,3084,2245,558,1598,61,0,13,0,0,1,1,0,0,0,2232,13,839
4700,경상북도,4713,경산시,남부동,소계,16472,12505,2902,9114,244,3,120,2,4,4,18,10,6,0,12427,78,3967
4700,경상북도,4713,경산시,,관내사전투표,4980,4980,1310,3519,91,0,30,0,1,3,2,2,1,0,4959,21,0
4700,경상북도,4713,경산시,,남부동제1투,2234,1432,258,1108,27,3,19,1,0,0,3,0,1,0,1420,12,802
4700,경상북도,4713,경산시,,남부동제2투,540,325,59,256,1,0,3,0,0,0,0,0,0,0,319,6,215
4700,경상북도,4713,경산시,,남부동제3투,3471,2243,496,1630,46,0,33,0,2,1,5,5,2,0,2220,23,1228
4700,경상북도,4713,경산시,,남부동제4투,2900,2036,480,1471,49,0,18,1,0,0,7,1,2,0,2029,7,864
4700,경상북도,4713,경산시,,남부동제5투,2347,1489,299,1130,30,0,17,0,1,0,1,2,0,0,1480,9,858
4700,경상북도,4713,경산시,북부동,소계,12415,8024,1892,5738,188,4,93,3,3,3,16,9,0,3,7952,72,4391
4700,경상북도,4713,경산시,,관내사전투표,2658,2655,754,1804,57,0,22,1,1,0,3,2,0,2,2646,9,3
4700,경상북도,4713,경산시,,북부동제1투,3131,2271,506,1679,48,0,17,1,0,1,1,3,0,0,2256,15,860
4700,경상북도,4713,경산시,,북부동제2투,2967,1302,284,919,36,1,34,0,2,1,5,2,0,0,1284,18,1665
4700,경상북도,4713,경산시,,북부동제3투,3659,1796,348,1336,47,3,20,1,0,1,7,2,0,1,1766,30,1863
4700,경상북도,4713,경산시,중방동,소계,9314,7448,1559,5601,139,4,65,1,1,4,12,3,0,3,7392,56,1866
4700,경상북도,4713,경산시,,관내사전투표,3896,3896,929,2845,67,1,22,0,0,3,3,0,0,2,3872,24,0
4700,경상북도,4713,경산시,,중방동제1투,1382,776,142,589,10,2,19,0,0,0,2,0,0,1,765,11,606
4700,경상북도,4713,경산시,,중방동제2투,1532,949,167,743,16,0,7,1,1,0,3,3,0,0,941,8,583
4700,경상북도,4713,경산시,,중방동제3투,2504,1827,321,1424,46,1,17,0,0,1,4,0,0,0,1814,13,677
4700,경상북도,4713,경산시,압량읍,소계,16633,11910,2961,8374,227,8,171,3,3,0,17,5,8,8,11785,125,4723
4700,경상북도,4713,경산시,,관내사전투표,5099,5099,1409,3457,100,5,54,1,1,0,1,3,3,2,5036,63,0
4700,경상북도,4713,경산시,,압량읍제1투,2864,1361,277,998,23,2,38,1,1,0,2,1,1,0,1344,17,1503
4700,경상북도,4713,경산시,,압량읍제2투,1392,893,130,717,14,1,13,0,0,0,4,1,1,2,883,10,499
4700,경상북도,4713,경산시,,압량읍제3투,2116,1000,253,691,16,0,25,1,0,0,3,0,0,2,991,9,1116
4700,경상북도,4713,경산시,,압량읍제4투,685,520,73,429,9,0,4,0,0,0,1,0,1,0,517,3,165
4700,경상북도,4713,경산시,,압량읍제5투,2281,1572,385,1127,32,0,15,0,0,0,1,0,0,2,1562,10,709
4700,경상북도,4713,경산시,,압량읍제6투,2196,1465,434,955,33,0,22,0,1,0,5,0,2,0,1452,13,731
4700,경상북도,4713,경산시,잘못 투입·구분된 투표지,,0,1,1,0,0,0,0,0,0,0,0,0,0,0,1,0,-1
4700,경상북도,4714,청도군,합계,,38816,30953,5654,24036,489,17,266,12,5,15,50,42,54,27,30667,286,7863
4700,경상북도,4714,청도군,거소·선상투표,,165,151,33,101,1,0,3,1,0,0,0,0,0,1,140,11,14
4700,경상북도,4714,청도군,관외사전투표,,4380,4380,1047,3142,95,1,33,1,0,2,7,3,4,2,4337,43,0
4700,경상북도,4714,청도군,재외투표,,231,125,55,58,4,0,0,0,0,0,0,0,0,0,117,8,106
4700,경상북도,4714,청도군,청도읍,소계,10360,7825,1400,6095,133,7,85,1,1,1,16,12,9,6,7766,59,2535
4700,경상북도,4714,청도군,,관내사전투표,3654,3654,785,2729,79,5,31,1,0,0,3,6,0,2,3641,13,0
4700,경상북도,4714,청도군,,청도읍제1투,1803,1000,173,786,13,0,12,0,1,1,1,1,2,1,991,9,803
4700,경상북도,4714,청도군,,청도읍제2투,2034,1135,196,877,23,1,14,0,0,0,1,2,2,1,1117,18,899
4700,경상북도,4714,청도군,,청도읍제3투,702,504,58,427,3,0,2,0,0,0,5,0,2,2,499,5,198
4700,경상북도,4714,청도군,,청도읍제4투,1053,749,97,611,13,1,12,0,0,0,2,2,2,0,740,9,304
4700,경상북도,4714,청도군,,청도읍제5투,1114,783,91,665,2,0,14,0,0,0,4,1,1,0,778,5,331
4700,경상북도,4714,청도군,화양읍,소계,5840,4400,904,3308,78,4,46,2,0,3,1,5,9,5,4365,35,1440
4700,경상북도,4714,청도군,,관내사전투표,1575,1575,408,1105,29,3,14,0,0,1,0,2,2,1,1565,10,0
4700,경상북도,4714,청도군,,화양읍제1투,820,493,69,410,6,0,3,1,0,0,0,0,0,0,489,4,327
4700,경상북도,4714,청도군,,화양읍제2투,2083,1315,275,980,22,0,15,0,0,1,1,2,5,2,1303,12,768
4700,경상북도,4714,청도군,,화양읍제3투,574,431,68,339,12,0,6,1,0,1,0,1,1,0,429,2,143
4700,경상북도,4714,청도군,,화양읍제4투,788,586,84,474,9,1,8,0,0,0,0,0,1,2,579,7,202
4700,경상북도,4714,청도군,각남면,소계,1841,1473,218,1182,20,3,10,1,0,4,5,3,5,2,1453,20,368
4700,경상북도,4714,청도군,,관내사전투표,865,865,138,687,15,3,4,0,0,1,2,1,3,2,856,9,0
4700,경상북도,4714,청도군,,각남면제1투,611,373,52,309,2,0,4,1,0,1,0,0,0,0,369,4,238
4700,경상북도,4714,청도군,,각남면제2투,365,235,28,186,3,0,2,0,0,2,3,2,2,0,228,7,130
4700,경상북도,4714,청도군,풍각면,소계,3414,2689,415,2167,32,1,26,2,0,1,7,2,10,3,2666,23,725
4700,경상북도,4714,청도군,,관내사전투표,1420,1420,255,1118,19,1,8,0,0,0,1,2,2,1,1407,13,0
4700,경상북도,4714,청도군,,풍각면제1투,1120,670,97,545,6,0,7,1,0,0,4,0,3,1,664,6,450
4700,경상북도,4714,청도군,,풍각면제2투,472,303,30,257,2,0,4,1,0,1,1,0,3,1,300,3,169
4700,경상북도,4714,청도군,,풍각면제3투,402,296,33,247,5,0,7,0,0,0,1,0,2,0,295,1,106
4700,경상북도,4714,청도군,각북면,소계,1724,1368,184,1149,11,0,10,0,0,0,2,1,2,0,1359,9,356
4700,경상북도,4714,청도군,,관내사전투표,773,773,115,643,7,0,5,0,0,0,0,0,0,0,770,3,0
4700,경상북도,4714,청도군,,각북면투표소,951,595,69,506,4,0,5,0,0,0,2,1,2,0,589,6,356
4700,경상북도,4714,청도군,이서면,소계,3542,2794,467,2229,41,0,12,1,1,2,4,3,1,7,2768,26,748
4700,경상북도,4714,청도군,,관내사전투표,1338,1338,282,1016,27,0,2,0,0,1,1,3,0,3,1335,3,0
4700,경상북도,4714,청도군,,이서면제1투,1359,847,110,697,8,0,6,1,0,1,1,0,1,3,828,19,512
4700,경상북도,4714,청도군,,이서면제2투,845,609,75,516,6,0,4,0,1,0,2,0,0,1,605,4,236
4700,경상북도,4714,청도군,운문면,소계,1639,1279,229,1005,18,0,9,0,1,0,2,3,4,0,1271,8,360
4700,경상북도,4714,청도군,,관내사전투표,485,485,103,368,9,0,2,0,0,0,0,0,1,0,483,2,0
4700,경상북도,4714,청도군,,운문면제1투,295,188,30,149,1,0,3,0,0,0,0,2,1,0,186,2,107
4700,경상북도,4714,청도군,,운문면제2투,434,297,49,240,4,0,0,0,1,0,1,0,0,0,295,2,137
4700,경상북도,4714,청도군,,운문면제3투,425,309,47,248,4,0,4,0,0,0,1,1,2,0,307,2,116
4700,경상북도,4714,청도군,금천면,소계,2702,2137,328,1729,25,1,23,0,0,1,5,5,5,0,2122,15,565
4700,경상북도,4714,청도군,,관내사전투표,1020,1020,181,810,13,0,9,0,0,1,1,0,1,0,1016,4,0
4700,경상북도,4714,청도군,,금천면제1투,544,322,48,258,5,0,6,0,0,0,0,2,2,0,321,1,222
4700,경상북도,4714,청도군,,금천면제2투,445,321,43,267,1,0,2,0,0,0,1,2,1,0,317,4,124
4700,경상북도,4714,청도군,,금천면제3투,693,474,56,394,6,1,6,0,0,0,3,1,1,0,468,6,219
4700,경상북도,4714,청도군,매전면,소계,2978,2332,374,1871,31,0,9,3,2,1,1,5,5,1,2303,29,646
4700,경상북도,4714,청도군,,관내사전투표,821,821,178,613,14,0,2,1,0,1,1,1,1,0,812,9,0
4700,경상북도,4714,청도군,,매전면제1투,480,302,29,260,4,0,2,0,0,0,0,2,0,0,297,5,178
4700,경상북도,4714,청도군,,매전면제2투,507,355,43,299,3,0,1,1,1,0,0,1,1,0,350,5,152
4700,경상북도,4714,청도군,,매전면제3투,400,300,53,231,6,0,1,1,0,0,0,0,3,0,295,5,100
4700,경상북도,4714,청도군,,매전면제4투,770,554,71,468,4,0,3,0,1,0,0,1,0,1,549,5,216
4700,경상북도,4714,청도군,잘못 투입·구분된 투표지,,0,0,0,0,0,0,0,0,0,0,0,0,0,0,0,0,0
4700,경상북도,4715,고령군,합계,,27955,22270,3852,17464,317,22,216,8,5,9,50,43,42,18,22046,224,5685
4700,경상북도,4715,고령군,거소·선상투표,,183,168,37,73,6,7,5,2,0,0,1,0,2,3,136,32,15
4700,경상북도,4715,고령군,관외사전투표,,2760,2759,565,2078,60,2,24,0,0,0,4,3,2,3,2741,18,1
4700,경상북도,4715,고령군,재외투표,,180,98,45,45,1,0,0,1,0,0,0,0,0,0,92,6,82
4700,경상북도,4715,고령군,대가야읍,소계,7949,6070,1100,4724,99,4,72,0,1,1,8,6,9,3,6027,43,1879
4700,경상북도,4715,고령군,,관내사전투표,3274,3274,614,2548,52,4,31,0,1,0,2,0,5,2,3259,15,0
4700,경상북도,4715,고령군,,대가야읍제1투,1091,666,98,537,11,0,12,0,0,0,1,1,0,0,660,6,425
4700,경상북도,4715,고령군,,대가야읍제2투,409,288,43,236,2,0,3,0,0,0,0,0,1,0,285,3,121
4700,경상북도,4715,고령군,,대가야읍제3투,1396,740,132,576,8,0,11,0,0,1,1,1,1,0,731,9,656
4700,경상북도,4715,고령군,,대가야읍제4투,252,172,21,145,1,0,1,0,0,0,1,0,1,1,171,1,80
4700,경상북도,4715,고령군,,대가야읍제5투,1527,930,192,682,25,0,14,0,0,0,3,4,1,0,921,9,597
4700,경상북도,4715,고령군,덕곡면,소계,1186,955,138,766,10,3,9,0,0,1,1,9,4,2,943,12,231
4700,경상북도,4715,고령군,,관내사전투표,506,506,72,410,5,3,4,0,0,1,0,2,1,1,499,7,0
4700,경상북도,4715,고령군,,덕곡면제1투,435,298,42,240,2,0,5,0,0,0,1,3,2,0,295,3,137
4700,경상북도,4715,고령군,,덕곡면제2투,245,151,24,116,3,0,0,0,0,0,0,4,1,1,149,2,94
4700,경상북도,4715,고령군,운수면,소계,1551,1251,185,1016,8,2,7,0,1,2,4,2,6,2,1235,16,300
4700,경상북도,4715,고령군,,관내사전투표,618,618,106,487,4,2,2,0,0,0,1,2,3,0,607,11,0
4700,경상북도,4715,고령군,,운수면제1투,680,454,51,386,3,0,4,0,1,2,2,0,1,1,451,3,226
4700,경상북도,4715,고령군,,운수면제2투,253,179,28,143,1,0,1,0,0,0,1,0,2,1,177,2,74
4700,경상북도,4715,고령군,성산면,소계,2113,1648,223,1357,19,1,9,0,2,0,10,4,3,1,1629,19,465
4700,경상북도,4715,고령군,,관내사전투표,838,838,107,707,7,1,5,0,1,0,0,0,3,1,832,6,0
4700,경상북도,4715,고령군,,성산면제1투,819,482,73,382,11,0,3,0,0,0,5,2,0,0,476,6,337
4700,경상북도,4715,고령군,,성산면제2투,456,328,43,268,1,0,1,0,1,0,5,2,0,0,321,7,128
4700,경상북도,4715,고령군,다산면,소계,6550,5046,1012,3835,77,2,53,2,0,2,14,11,2,1,5011,35,1504
4700,경상북도,4715,고령군,,관내사전투표,2515,2515,580,1859,29,1,14,2,0,1,6,7,0,1,2500,15,0
4700,경상북도,4715,고령군,,다산면제1투,1105,698,114,549,14,0,11,0,0,1,3,1,0,0,693,5,407
4700,경상북도,4715,고령군,,다산면제2투,2278,1411,291,1052,29,0,19,0,0,0,5,2,0,0,1398,13,867
4700,경상북도,4715,고령군,,다산면제3투,652,422,27,375,5,1,9,0,0,0,0,1,2,0,420,2,230
4700,경상북도,4715,고령군,개진면,소계,1553,1195,136,1022,11,0,8,1,0,1,4,2,2,1,1188,7,358
4700,경상북도,4715,고령군,,관내사전투표,493,492,61,419,5,0,3,1,0,0,0,0,1,0,490,2,1
4700,경상북도,4715,고령군,,개진면제1투,489,319,34,275,3,0,2,0,0,0,0,2,0,0,316,3,170
4700,경상북도,4715,고령군,,개진면제2투,571,384,41,328,3,0,3,0,0,1,4,0,1,1,382,2,187
4700,경상북도,4715,고령군,우곡면,소계,1270,1010,123,834,12,1,8,1,0,2,2,4,6,1,994,16,260
4700,경상북도,4715,고령군,,관내사전투표,494,494,80,391,4,1,3,0,0,2,0,1,4,1,487,7,0
4700,경상북도,4715,고령군,,우곡면제1투,249,144,14,121,2,0,2,0,0,0,1,0,1,0,141,3,105
4700,경상북도,4715,고령군,,우곡면제2투,527,372,29,322,6,0,3,1,0,0,1,3,1,0,366,6,155
4700,경상북도,4715,고령군,쌍림면,소계,2660,2068,288,1712,14,0,21,1,1,0,2,2,6,1,2048,20,592
4700,경상북도,4715,고령군,,관내사전투표,956,956,143,783,4,0,12,1,1,0,1,1,2,1,949,7,0
4700,경상북도,4715,고령군,,쌍림면제1투,573,348,35,305,3,0,4,0,0,0,0,0,1,0,348,0,225
4700,경상북도,4715,고령군,,쌍림면제2투,485,326,44,268,4,0,3,0,0,0,0,1,0,0,320,6,159
4700,경상북도,4715,고령군,,쌍림면제3투,646,438,66,356,3,0,2,0,0,0,1,0,3,0,431,7,208
4700,경상북도,4715,고령군,잘못 투입·구분된 투표지,,0,2,0,2,0,0,0,0,0,0,0,0,0,0,2,0,-2
4700,경상북도,4716,성주군,합계,,39491,32009,5775,24975,472,24,278,14,7,16,55,42,49,23,31730,279,7482
4700,경상북도,4716,성주군,거소·선상투표,,157,141,19,103,5,2,2,0,0,0,1,0,2,0,134,7,16
4700,경상북도,4716,성주군,관외사전투표,,4278,4275,884,3205,87,3,42,0,0,2,8,1,2,3,4237,38,3
4700,경상북도,4716,성주군,재외투표,,184,82,42,26,6,0,0,0,0,0,0,0,0,0,74,8,102
4700,경상북도,4716,성주군,성주읍,소계,10673,8074,1760,6001,140,3,76,4,0,2,6,11,2,4,8009,65,2599
4700,경상북도,4716,성주군,,관내사전투표,4194,4194,991,3052,73,2,34,3,0,1,2,7,1,2,4168,26,0
4700,경상북도,4716,성주군,,성주읍제1투,1221,766,111,627,7,0,10,0,0,0,1,3,0,1,760,6,455
4700,경상북도,4716,성주군,,성주읍제2투,1731,945,200,708,9,0,10,0,0,0,1,0,0,0,928,17,786
4700,경상북도,4716,성주군,,성주읍제3투,2109,1268,267,944,33,1,11,0,0,0,1,1,1,0,1259,9,841
4700,경상북도,4716,성주군,,성주읍제4투,1418,901,191,670,18,0,11,1,0,1,1,0,0,1,894,7,517
4700,경상북도,4716,성주군,선남면,소계,4986,3988,544,3327,41,3,29,2,2,1,11,1,4,1,3966,22,998
4700,경상북도,4716,성주군,,관내사전투표,2139,2139,300,1784,22,0,11,1,1,0,4,0,3,1,2127,12,0
4700,경상북도,4716,성주군,,선남면제1투,1300,809,123,653,12,1,9,0,1,0,3,1,0,0,803,6,491
4700,경상북도,4716,성주군,,선남면제2투,1547,1040,121,890,7,2,9,1,0,1,4,0,1,0,1036,4,507
4700,경상북도,4716,성주군,용암면,소계,2964,2343,361,1895,29,1,20,1,1,0,3,3,6,1,2321,22,621
4700,경상북도,4716,성주군,,관내사전투표,1403,1403,222,1128,22,1,10,1,0,0,2,1,4,1,1392,11,0
4700,경상북도,4716,성주군,,용암면제1투,743,461,76,372,1,0,3,0,1,0,1,2,1,0,457,4,282
4700,경상북도,4716,성주군,,용암면제2투,818,479,63,395,6,0,7,0,0,0,0,0,1,0,472,7,339
4700,경상북도,4716,성주군,수륜면,소계,2366,1891,282,1529,29,1,6,0,1,2,3,6,8,4,1871,20,475
4700,경상북도,4716,성주군,,관내사전투표,1211,1211,180,983,17,0,5,0,1,2,0,3,6,2,1199,12,0
4700,경상북도,4716,성주군,,수륜면제1투,707,409,63,327,7,1,1,0,0,0,1,1,1,2,404,5,298
4700,경상북도,4716,성주군,,수륜면제2투,448,271,39,219,5,0,0,0,0,0,2,2,1,0,268,3,177
4700,경상북도,4716,성주군,가천면,소계,1737,1418,216,1142,18,2,10,0,1,1,2,4,4,3,1403,15,319
4700,경상북도,4716,성주군,,관내사전투표,947,947,151,753,14,2,6,0,0,1,2,4,4,3,940,7,0
4700,경상북도,4716,성주군,,가천면투표소,790,471,65,389,4,0,4,0,1,0,0,0,0,0,463,8,319
4700,경상북도,4716,성주군,금수면,소계,907,749,131,590,4,2,6,1,0,1,1,2,1,1,740,9,158
4700,경상북도,4716,성주군,,관내사전투표,499,499,83,396,3,1,3,1,0,0,0,2,1,1,491,8,0
4700,경상북도,4716,성주군,,금수면투표소,408,250,48,194,1,1,3,0,0,1,1,0,0,0,249,1,158
4700,경상북도,4716,성주군,대가면,소계,2072,1693,330,1298,19,2,11,2,0,2,1,3,6,1,1675,18,379
4700,경상북도,4716,성주군,,관내사전투표,1081,1081,214,826,11,1,4,1,0,2,0,2,5,0,1066,15,0
4700,경상북도,4716,성주군,,대가면투표소,991,612,116,472,8,1,7,1,0,0,1,1,1,1,609,3,379
4700,경상북도,4716,성주군,벽진면,소계,2598,2085,338,1664,35,1,17,0,0,2,1,2,2,2,2064,21,513
4700,경상북도,4716,성주군,,관내사전투표,1245,1245,218,983,16,1,7,0,0,1,1,1,1,0,1229,16,0
4700,경상북도,4716,성주군,,벽진면투표소,1353,840,120,681,19,0,10,0,0,1,0,1,1,2,835,5,513
4700,경상북도,4716,성주군,초전면,소계,3901,3110,535,2440,36,3,43,2,1,2,10,6,6,2,3086,24,791
4700,경상북도,4716,성주군,,관내사전투표,1950,1950,319,1557,25,1,20,1,1,0,3,4,4,1,1936,14,0
4700,경상북도,4716,성주군,,초전면제1투,1051,581,97,454,3,1,13,0,0,2,3,0,0,1,574,7,470
4700,경상북도,4716,성주군,,초전면제2투,900,579,119,429,8,1,10,1,0,0,4,2,2,0,576,3,321
4700,경상북도,4716,성주군,월항면,소계,2668,2160,333,1755,23,1,16,2,1,1,8,3,6,1,2150,10,508
4700,경상북도,4716,성주군,,관내사전투표,1162,1162,196,928,17,1,8,0,0,1,1,1,3,0,1156,6,0
4700,경상북도,4716,성주군,,월항면제1투,935,610,89,501,4,0,6,0,1,0,6,2,0,1,610,0,325
4700,경상북도,4716,성주군,,월항면제2투,571,388,48,326,2,0,2,2,0,0,1,0,3,0,384,4,183
4700,경상북도,4716,성주군,잘못 투입·구분된 투표지,,0,0,0,0,0,0,0,0,0,0,0,0,0,0,0,0,0
4700,경상북도,4717,칠곡군,합계,,96181,71492,17603,50468,1369,44,1049,26,16,24,103,56,43,32,70833,659,24689
4700,경상북도,4717,칠곡군,거소·선상투표,,199,188,37,130,2,0,6,0,0,1,0,0,0,0,176,12,11
4700,경상북도,4717,칠곡군,관외사전투표,,8148,8147,2191,5479,188,8,147,2,2,2,10,12,7,9,8057,90,1
4700,경상북도,4717,칠곡군,재외투표,,324,199,82,85,9,0,0,0,0,0,0,0,0,0,176,23,125
4700,경상북도,4717,칠곡군,왜관읍,소계,25563,18834,4311,13749,335,12,219,7,3,6,25,6,4,7,18684,150,6729
4700,경상북도,4717,칠곡군,,관내사전투표,7407,7407,1935,5231,122,5,60,1,2,3,4,4,0,2,7369,38,0
4700,경상북도,4717,칠곡군,,왜관읍제1투,2894,1812,312,1405,46,2,19,1,0,0,6,0,0,1,1792,20,1082
4700,경상북도,4717,칠곡군,,왜관읍제2투,1655,1045,173,826,10,1,24,1,0,0,2,0,0,1,1038,7,610
4700,경상북도,4717,칠곡군,,왜관읍제3투,918,504,69,410,11,1,6,0,0,0,1,0,1,0,499,5,414
4700,경상북도,4717,칠곡군,,왜관읍제4투,3059,1788,431,1265,36,0,30,1,1,1,5,1,0,2,1773,15,1271
4700,경상북도,4717,칠곡군,,왜관읍제5투,1533,1013,249,727,15,1,7,0,0,0,2,0,1,0,1002,11,520
4700,경상북도,4717,칠곡군,,왜관읍제6투,1762,1201,241,902,26,1,20,0,0,0,0,0,1,0,1191,10,561
4700,경상북도,4717,칠곡군,,왜관읍제7투,1390,893,157,695,11,0,11,3,0,1,1,0,0,1,880,13,497
4700,경상북도,4717,칠곡군,,왜관읍제8투,2689,1708,368,1266,34,0,24,0,0,1,3,0,0,0,1696,12,981
4700,경상북도,4717,칠곡군,,왜관읍제9투,2256,1463,376,1022,24,1,18,0,0,0,1,1,1,0,1444,19,793
4700,경상북도,4717,칠곡군,북삼읍,소계,18267,13013,3275,9104,271,6,211,7,5,5,21,4,6,3,12918,95,5254
4700,경상북도,4717,칠곡군,,관내사전투표,5606,5606,1527,3866,116,4,53,2,2,4,3,0,3,1,5581,25,0
4700,경상북도,4717,칠곡군,,북삼읍제1투,1912,1042,224,748,35,0,21,0,0,0,2,2,1,0,1033,9,870
4700,경상북도,4717,칠곡군,,북삼읍제2투,1101,687,86,569,7,1,13,0,0,0,4,1,0,0,681,6,414
4700,경상북도,4717,칠곡군,,북삼읍제3투,2230,1242,313,860,25,0,24,1,3,1,1,1,0,1,1230,12,988
4700,경상북도,4717,칠곡군,,북삼읍제4투,3218,1897,497,1284,40,1,46,2,0,0,1,0,0,1,1872,25,1321
4700,경상북도,4717,칠곡군,,북삼읍제5투,1865,1087,188,841,19,0,24,2,0,0,4,0,0,0,1078,9,778
4700,경상북도,4717,칠곡군,,북삼읍제6투,2335,1452,440,936,29,0,30,0,0,0,6,0,2,0,1443,9,883
4700,경상북도,4717,칠곡군,석적읍,소계,21871,14291,4986,8493,330,1,296,2,3,4,16,11,7,5,14154,137,7580
4700,경상북도,4717,칠곡군,,관내사전투표,4695,4695,1796,2681,101,0,76,0,2,1,2,1,3,0,4663,32,0
4700,경상북도,4717,칠곡군,,석적읍제1투,2773,1726,568,1061,58,1,24,0,0,0,2,0,1,0,1715,11,1047
4700,경상북도,4717,칠곡군,,석적읍제2투,1818,737,242,448,15,0,24,0,0,0,0,0,0,2,731,6,1081
4700,경상북도,4717,칠곡군,,석적읍제3투,3733,2186,748,1294,46,0,69,1,0,1,6,2,0,0,2167,19,1547
4700,경상북도,4717,칠곡군,,석적읍제4투,3391,2304,795,1373,56,0,40,1,1,0,2,2,2,2,2274,30,1087
4700,경상북도,4717,칠곡군,,석적읍제5투,425,318,45,259,2,0,6,0,0,0,0,0,0,0,312,6,107
4700,경상북도,4717,칠곡군,,석적읍제6투,2256,798,246,507,5,0,26,0,0,1,1,3,0,0,789,9,1458
4700,경상북도,4717,칠곡군,,석적읍제7투,2780,1527,546,870,47,0,31,0,0,1,3,3,1,1,1503,24,1253
4700,경상북도,4717,칠곡군,지천면,소계,3474,2699,358,2248,24,1,32,0,1,1,4,0,3,1,2673,26,775
4700,경상북도,4717,칠곡군,,관내사전투표,1304,1304,173,1098,11,1,10,0,1,0,1,0,1,0,1296,8,0
4700,경상북도,4717,칠곡군,,지천면제1투,1453,904,131,727,10,0,17,0,0,1,1,0,2,0,889,15,549
4700,경상북도,4717,칠곡군,,지천면제2투,717,491,54,423,3,0,5,0,0,0,2,0,0,1,488,3,226
4700,경상북도,4717,칠곡군,동명면,소계,4569,3511,498,2906,41,3,20,1,1,3,7,3,0,0,3483,28,1058
4700,경상북도,4717,칠곡군,,관내사전투표,1674,1674,290,1348,19,1,3,1,0,2,0,3,0,0,1667,7,0
4700,경상북도,4717,칠곡군,,동명면제1투,795,473,55,404,3,0,1,0,1,0,3,0,0,0,467,6,322
4700,경상북도,4717,칠곡군,,동명면제2투,951,588,71,486,8,1,12,0,0,0,2,0,0,0,580,8,363
4700,경상북도,4717,칠곡군,,동명면제3투,1149,776,82,668,11,1,4,0,0,1,2,0,0,0,769,7,373
4700,경상북도,4717,칠곡군,가산면,소계,2729,2116,299,1735,21,2,20,1,0,0,6,4,6,0,2094,22,613
4700,경상북도,4717,칠곡군,,관내사전투표,857,857,132,694,11,1,7,0,0,0,0,3,3,0,851,6,0
4700,경상북도,4717,칠곡군,,가산면제1투,973,627,81,516,3,0,7,1,0,0,6,1,1,0,616,11,346
4700,경상북도,4717,칠곡군,,가산면제2투,638,446,62,367,7,1,5,0,0,0,0,0,1,0,443,3,192
4700,경상북도,4717,칠곡군,,가산면제3투,261,186,24,158,0,0,1,0,0,0,0,0,1,0,184,2,75
4700,경상북도,4717,칠곡군,약목면,소계,7979,5989,1056,4661,101,8,72,4,0,1,10,10,5,4,5932,57,1990
4700,경상북도,4717,칠곡군,,관내사전투표,2791,2791,504,2182,44,4,19,1,0,0,6,4,4,1,2769,22,0
4700,경상북도,4717,칠곡군,,약목면제1투,1369,863,117,702,14,1,8,2,0,0,3,3,1,1,852,11,506
4700,경상북도,4717,칠곡군,,약목면제2투,1599,936,152,736,12,1,22,0,0,0,0,1,0,0,924,12,663
4700,경상북도,4717,칠곡군,,약목면제3투,798,529,89,412,13,1,7,0,0,1,1,1,0,0,525,4,269
4700,경상북도,4717,칠곡군,,약목면제4투,1422,870,194,629,18,1,16,1,0,0,0,1,0,2,862,8,552
4700,경상북도,4717,칠곡군,기산면,소계,3058,2504,510,1877,47,3,26,2,1,1,4,6,5,3,2485,19,554
4700,경상북도,4717,칠곡군,,관내사전투표,1485,1485,336,1079,32,1,8,2,1,1,3,3,2,3,1471,14,0
4700,경상북도,4717,칠곡군,,기산면제1투,1244,794,133,623,10,2,17,0,0,0,1,2,2,0,790,4,450
4700,경상북도,4717,칠곡군,,기산면제2투,329,225,41,175,5,0,1,0,0,0,0,1,1,0,224,1,104
4700,경상북도,4717,칠곡군,잘못 투입·구분된 투표지,,0,1,0,1,0,0,0,0,0,0,0,0,0,0,1,0,-1
4700,경상북도,4718,군위군,합계,,21784,18239,2511,15032,216,14,155,4,2,11,30,26,46,22,18069,170,3545
4700,경상북도,4718,군위군,거소·선상투표,,76,67,7,57,0,0,0,0,0,0,0,0,0,0,64,3,9
4700,경상북도,4718,군위군,관외사전투표,,2836,2836,508,2222,41,0,30,0,0,0,5,3,2,1,2812,24,0
4700,경상북도,4718,군위군,재외투표,,182,86,36,40,1,0,0,1,0,0,0,1,0,0,79,7,96
4700,경상북도,4718,군위군,군위읍,소계,6607,5306,757,4329,87,5,59,1,1,4,6,1,14,2,5266,40,1301
4700,경상북도,4718,군위군,,관내사전투표,3138,3138,491,2532,56,5,23,1,1,0,1,0,5,2,3117,21,0
4700,경상북도,4718,군위군,,군위읍제1투,1165,696,100,568,10,0,10,0,0,0,3,0,2,0,693,3,469
4700,경상북도,4718,군위군,,군위읍제2투,1200,742,102,595,14,0,16,0,0,2,1,0,0,0,730,12,458
4700,경상북도,4718,군위군,,군위읍제3투,518,342,27,297,4,0,4,0,0,1,0,0,7,0,340,2,176
4700,경상북도,4718,군위군,,군위읍제4투,586,388,37,337,3,0,6,0,0,1,1,1,0,0,386,2,198
4700,경상북도,4718,군위군,소보면,소계,1834,1475,170,1243,8,1,12,0,0,3,5,4,5,5,1456,19,359
4700,경상북도,4718,군위군,,관내사전투표,803,803,111,664,5,0,3,0,0,1,0,1,4,2,791,12,0
4700,경상북도,4718,군위군,,소보면제1투,649,414,23,370,3,0,4,0,0,2,4,2,0,2,410,4,235
4700,경상북도,4718,군위군,,소보면제2투,382,258,36,209,0,1,5,0,0,0,1,1,1,1,255,3,124
4700,경상북도,4718,군위군,효령면,소계,2969,2439,299,2060,24,3,15,1,0,0,0,5,4,2,2413,26,530
4700,경상북도,4718,군위군,,관내사전투표,1402,1402,179,1178,15,2,7,0,0,0,0,4,3,1,1389,13,0
4700,경상북도,4718,군위군,,효령면제1투,886,549,57,471,5,1,7,0,0,0,0,0,0,0,541,8,337
4700,경상북도,4718,군위군,,효령면제2투,681,488,63,411,4,0,1,1,0,0,0,1,1,1,483,5,193
4700,경상북도,4718,군위군,부계면,소계,1696,1416,183,1187,10,4,7,0,1,2,4,0,5,4,1407,9,280
4700,경상북도,4718,군위군,,관내사전투표,731,731,108,601,6,2,2,0,1,0,1,0,2,2,725,6,0
4700,경상북도,4718,군위군,,부계면제1투,415,274,33,230,2,0,2,0,0,2,1,0,2,1,273,1,141
4700,경상북도,4718,군위군,,부계면제2투,550,411,42,356,2,2,3,0,0,0,2,0,1,1,409,2,139
4700,경상북도,4718,군위군,우보면,소계,1600,1326,144,1137,10,0,10,1,0,1,1,4,2,1,1311,15,274
4700,경상북도,4718,군위군,,관내사전투표,697,697,87,594,6,0,4,1,0,0,0,2,1,1,696,1,0
4700,경상북도,4718,군위군,,우보면제1투,572,393,42,334,1,0,1,0,0,1,0,2,1,0,382,11,179
4700,경상북도,4718,군위군,,우보면제2투,331,236,15,209,3,0,5,0,0,0,1,0,0,0,233,3,95
4700,경상북도,4718,군위군,의흥면,소계,1997,1653,192,1408,15,0,8,0,0,1,6,3,4,3,1640,13,344
4700,경상북도,4718,군위군,,관내사전투표,891,891,112,759,5,0,3,0,0,1,1,1,1,2,885,6,0
4700,경상북도,4718,군위군,,의흥면제1투,829,566,61,478,7,0,4,0,0,0,5,1,3,0,559,7,263
4700,경상북도,4718,군위군,,의흥면제2투,277,196,19,171,3,0,1,0,0,0,0,1,0,1,196,0,81
4700,경상북도,4718,군위군,산성면,소계,977,823,93,692,11,0,8,0,0,0,2,2,5,4,817,6,154
4700,경상북도,4718,군위군,,관내사전투표,418,418,43,360,3,0,3,0,0,0,0,1,3,2,415,3,0
4700,경상북도,4718,군위군,,산성면제1투,252,188,23,153,3,0,2,0,0,0,2,1,1,1,186,2,64
4700,경상북도,4718,군위군,,산성면제2투,307,217,27,179,5,0,3,0,0,0,0,0,1,1,216,1,90
4700,경상북도,4718,군위군,삼국유사면,소계,1010,812,122,657,9,1,6,0,0,0,1,3,5,0,804,8,198
4700,경상북도,4718,군위군,,관내사전투표,374,374,65,298,2,0,3,0,0,0,0,1,2,0,371,3,0
4700,경상북도,4718,군위군,,삼국유사면제1투,271,172,23,140,4,1,2,0,0,0,0,0,1,0,171,1,99
4700,경상북도,4718,군위군,,삼국유사면제2투,365,266,34,219,3,0,1,0,0,0,1,2,2,0,262,4,99
4700,경상북도,4718,군위군,잘못 투입·구분된 투표지,,0,0,0,0,0,0,0,0,0,0,0,0,0,0,0,0,0
4700,경상북도,4719,의성군,합계,,47369,39245,6431,31176,545,28,365,15,16,16,45,92,72,38,38839,406,8124
4700,경상북도,4719,의성군,거소·선상투표,,367,327,50,259,6,0,4,0,0,0,1,0,0,0,320,7,40
4700,경상북도,4719,의성군,관외사전투표,,4581,4580,1040,3337,97,5,44,2,1,0,5,6,1,3,4541,39,1
4700,경상북도,4719,의성군,재외투표,,449,208,84,102,6,1,1,0,0,0,0,0,0,0,194,14,241
4700,경상북도,4719,의성군,의성읍,소계,10147,7894,1466,6106,124,3,88,1,2,3,8,15,8,6,7830,64,2253
4700,경상북도,4719,의성군,,관내사전투표,4399,4399,880,3336,72,3,48,1,2,3,4,7,4,2,4362,37,0
4700,경상북도,4719,의성군,,의성읍제1투,917,577,83,473,7,0,7,0,0,0,1,0,0,1,572,5,340
4700,경상북도,4719,의성군,,의성읍제2투,1641,893,177,666,25,0,9,0,0,0,1,3,1,1,883,10,748
4700,경상북도,4719,의성군,,의성읍제3투,1710,1051,204,804,16,0,16,0,0,0,1,2,0,1,1044,7,659
4700,경상북도,4719,의성군,,의성읍제4투,1480,974,122,827,4,0,8,0,0,0,1,3,3,1,969,5,506
4700,경상북도,4719,의성군,단촌면,소계,1722,1418,225,1132,18,3,14,1,0,2,0,4,4,1,1404,14,304
4700,경상북도,4719,의성군,,관내사전투표,892,892,137,718,12,3,7,1,0,2,0,2,1,0,883,9,0
4700,경상북도,4719,의성군,,단촌면투표소,830,526,88,414,6,0,7,0,0,0,0,2,3,1,521,5,304
4700,경상북도,4719,의성군,점곡면,소계,1410,1144,224,865,16,3,15,1,1,0,0,2,2,0,1129,15,266
4700,경상북도,4719,의성군,,관내사전투표,737,737,148,558,11,2,7,1,0,0,0,2,1,0,730,7,0
4700,경상북도,4719,의성군,,점곡면투표소,673,407,76,307,5,1,8,0,1,0,0,0,1,0,399,8,266
4700,경상북도,4719,의성군,옥산면,소계,1506,1267,236,1000,9,1,6,0,0,0,1,1,0,2,1256,11,239
4700,경상북도,4719,의성군,,관내사전투표,719,719,151,555,3,1,0,0,0,0,1,1,0,1,713,6,0
4700,경상북도,4719,의성군,,옥산면투표소,787,548,85,445,6,0,6,0,0,0,0,0,0,1,543,5,239
4700,경상북도,4719,의성군,사곡면,소계,1376,1141,156,947,9,2,11,0,0,1,2,3,2,1,1134,7,235
4700,경상북도,4719,의성군,,관내사전투표,808,808,103,684,6,1,5,0,0,1,2,2,2,1,807,1,0
4700,경상북도,4719,의성군,,사곡면투표소,568,333,53,263,3,1,6,0,0,0,0,1,0,0,327,6,235
4700,경상북도,4719,의성군,춘산면,소계,1164,991,138,798,11,1,15,1,2,0,0,8,4,2,980,11,173
4700,경상북도,4719,의성군,,관내사전투표,678,678,101,544,8,1,8,0,0,0,0,6,2,1,671,7,0
4700,경상북도,4719,의성군,,춘산면투표소,486,313,37,254,3,0,7,1,2,0,0,2,2,1,309,4,173
4700,경상북도,4719,의성군,가음면,소계,1347,1160,172,943,19,0,12,0,0,1,1,3,2,1,1154,6,187
4700,경상북도,4719,의성군,,관내사전투표,823,823,120,670,14,0,7,0,0,1,0,3,2,1,818,5,0
4700,경상북도,4719,의성군,,가음면투표소,524,337,52,273,5,0,5,0,0,0,1,0,0,0,336,1,187
4700,경상북도,4719,의성군,금성면,소계,3602,2913,409,2402,27,1,19,1,1,2,0,10,6,4,2882,31,689
4700,경상북도,4719,의성군,,관내사전투표,1822,1822,275,1499,15,1,8,0,0,1,0,6,5,3,1813,9,0
4700,경상북도,4719,의성군,,금성면투표소,1780,1091,134,903,12,0,11,1,1,1,0,4,1,1,1069,22,689
4700,경상북도,4719,의성군,봉양면,소계,3321,2675,372,2217,37,2,21,2,0,1,1,1,2,2,2658,17,646
4700,경상북도,4719,의성군,,관내사전투표,1691,1691,239,1408,23,1,11,0,0,0,0,0,0,0,1682,9,0
4700,경상북도,4719,의성군,,봉양면투표소,1630,984,133,809,14,1,10,2,0,1,1,1,2,2,976,8,646
4700,경상북도,4719,의성군,비안면,소계,1991,1615,203,1344,19,2,10,1,1,1,1,9,3,3,1597,18,376
4700,경상북도,4719,의성군,,관내사전투표,1044,1044,141,859,9,2,5,1,1,0,0,9,2,3,1032,12,0
4700,경상북도,4719,의성군,,비안면투표소,947,571,62,485,10,0,5,0,0,1,1,0,1,0,565,6,376
4700,경상북도,4719,의성군,구천면,소계,1468,1230,181,991,19,0,10,1,0,0,4,2,3,1,1212,18,238
4700,경상북도,4719,의성군,,관내사전투표,898,898,147,711,15,0,5,1,0,0,3,0,3,1,886,12,0
4700,경상북도,4719,의성군,,구천면투표소,570,332,34,280,4,0,5,0,0,0,1,2,0,0,326,6,238
4700,경상북도,4719,의성군,단밀면,소계,1396,1168,152,966,17,0,7,0,0,0,2,4,3,2,1153,15,228
4700,경상북도,4719,의성군,,관내사전투표,861,861,116,709,12,0,6,0,0,0,1,3,3,1,851,10,0
4700,경상북도,4719,의성군,,단밀면투표소,535,307,36,257,5,0,1,0,0,0,1,1,0,1,302,5,228
4700,경상북도,4719,의성군,단북면,소계,1482,1258,136,1069,12,1,11,1,0,2,2,3,5,1,1243,15,224
4700,경상북도,4719,의성군,,관내사전투표,888,888,94,753,9,1,9,1,0,2,0,3,4,1,877,11,0
4700,경상북도,4719,의성군,,단북면투표소,594,370,42,316,3,0,2,0,0,0,2,0,1,0,366,4,224
4700,경상북도,4719,의성군,안계면,소계,3798,3092,439,2528,43,1,32,0,3,0,5,7,2,1,3061,31,706
4700,경상북도,4719,의성군,,관내사전투표,2051,2051,293,1687,30,1,14,0,2,0,2,4,1,0,2034,17,0
4700,경상북도,4719,의성군,,안계면투표소,1747,1041,146,841,13,0,18,0,1,0,3,3,1,1,1027,14,706
4700,경상북도,4719,의성군,다인면,소계,3045,2491,358,2025,28,1,22,0,1,0,7,5,10,2,2459,32,554
4700,경상북도,4719,의성군,,관내사전투표,1668,1668,244,1358,16,1,10,0,1,0,6,3,8,2,1649,19,0
4700,경상북도,4719,의성군,,다인면투표소,1377,823,114,667,12,0,12,0,0,0,1,2,2,0,810,13,554
4700,경상북도,4719,의성군,신평면,소계,675,567,91,449,5,1,3,0,0,2,2,4,3,1,561,6,108
4700,경상북도,4719,의성군,,관내사전투표,410,410,59,334,3,1,2,0,0,2,1,1,2,1,406,4,0
4700,경상북도,4719,의성군,,신평면투표소,265,157,32,115,2,0,1,0,0,0,1,3,1,0,155,2,108
4700,경상북도,4719,의성군,안평면,소계,1795,1475,205,1216,14,0,10,1,2,0,1,3,5,2,1459,16,320
4700,경상북도,4719,의성군,,관내사전투표,1036,1036,140,864,6,0,5,1,1,0,0,3,5,1,1026,10,0
4700,경상북도,4719,의성군,,안평면투표소,759,439,65,352,8,0,5,0,1,0,1,0,0,1,433,6,320
4700,경상북도,4719,의성군,안사면,소계,727,631,94,480,9,0,10,2,2,1,2,2,7,3,612,19,96
4700,경상북도,4719,의성군,,관내사전투표,482,482,64,390,7,0,6,1,0,1,0,1,4,2,476,6,0
4700,경상북도,4719,의성군,,안사면투표소,245,149,30,90,2,0,4,1,2,0,2,1,3,1,136,13,96
4700,경상북도,4719,의성군,잘못 투입·구분된 투표지,,0,0,0,0,0,0,0,0,0,0,0,0,0,0,0,0,0
4700,경상북도,4720,청송군,합계,,22793,18789,3716,14268,298,16,155,5,4,4,48,32,52,13,18611,178,4004
4700,경상북도,4720,청송군,거소·선상투표,,148,141,17,106,2,1,1,0,0,0,0,1,0,0,128,13,7
4700,경상북도,4720,청송군,관외사전투표,,2158,2157,558,1487,54,3,26,0,0,0,2,3,1,2,2136,21,1
4700,경상북도,4720,청송군,재외투표,,113,70,24,38,2,1,0,0,0,0,0,0,0,0,65,5,43
4700,경상북도,4720,청송군,청송읍,소계,4220,3401,702,2557,67,1,18,1,0,2,10,4,8,3,3373,28,819
4700,경상북도,4720,청송군,,관내사전투표,1752,1752,397,1286,46,1,6,0,0,1,0,2,3,0,1742,10,0
4700,경상북도,4720,청송군,,청송읍제1투,784,514,86,405,5,0,5,0,0,0,6,1,1,0,509,5,270
4700,경상북도,4720,청송군,,청송읍제2투,490,353,55,278,6,0,0,1,0,1,4,0,2,1,348,5,137
4700,경상북도,4720,청송군,,청송읍제3투,728,476,91,363,7,0,4,0,0,0,0,1,2,2,470,6,252
4700,경상북도,4720,청송군,,청송읍제4투,466,306,73,225,3,0,3,0,0,0,0,0,0,0,304,2,160
4700,경상북도,4720,청송군,부남면,소계,2181,1803,320,1398,25,5,17,0,1,0,6,6,8,3,1789,14,378
4700,경상북도,4720,청송군,,관내사전투표,987,987,194,751,12,1,11,0,1,0,1,1,5,3,980,7,0
4700,경상북도,4720,청송군,,부남면제1투,507,325,44,264,8,1,4,0,0,0,1,0,0,0,322,3,182
4700,경상북도,4720,청송군,,부남면제2투,687,491,82,383,5,3,2,0,0,0,4,5,3,0,487,4,196
4700,경상북도,4720,청송군,현동면,소계,1779,1447,232,1173,14,0,8,0,0,0,6,2,1,1,1437,10,332
4700,경상북도,4720,청송군,,관내사전투표,922,922,148,748,7,0,5,0,0,0,3,1,1,1,914,8,0
4700,경상북도,4720,청송군,,현동면투표소,857,525,84,425,7,0,3,0,0,0,3,1,0,0,523,2,332
4700,경상북도,4720,청송군,현서면,소계,2065,1726,306,1349,21,0,21,0,0,0,0,2,11,2,1712,14,339
4700,경상북도,4720,청송군,,관내사전투표,989,989,186,767,12,0,8,0,0,0,0,2,5,0,980,9,0
4700,경상북도,4720,청송군,,현서면제1투,688,450,82,347,5,0,9,0,0,0,0,0,4,1,448,2,238
4700,경상북도,4720,청송군,,현서면제2투,388,287,38,235,4,0,4,0,0,0,0,0,2,1,284,3,101
4700,경상북도,4720,청송군,안덕면,소계,2083,1613,295,1237,17,1,16,0,2,2,14,10,8,0,1602,11,470
4700,경상북도,4720,청송군,,관내사전투표,805,805,167,616,5,0,5,0,1,0,0,1,4,0,799,6,0
4700,경상북도,4720,청송군,,안덕면제1투,939,585,96,471,6,1,8,0,0,0,0,0,1,0,583,2,354
4700,경상북도,4720,청송군,,안덕면제2투,339,223,32,150,6,0,3,0,1,2,14,9,3,0,220,3,116
4700,경상북도,4720,청송군,파천면,소계,1504,1224,212,964,24,1,3,0,0,0,2,0,4,0,1210,14,280
4700,경상북도,4720,청송군,,관내사전투표,591,591,120,448,13,1,1,0,0,0,0,0,2,0,585,6,0
4700,경상북도,4720,청송군,,파천면제1투,523,346,53,280,7,0,1,0,0,0,1,0,0,0,342,4,177
4700,경상북도,4720,청송군,,파천면제2투,390,287,39,236,4,0,1,0,0,0,1,0,2,0,283,4,103
4700,경상북도,4720,청송군,진보면,소계,5124,4063,860,3058,50,3,35,2,1,0,4,3,8,2,4026,37,1061
4700,경상북도,4720,청송군,,관내사전투표,2392,2392,517,1791,30,1,21,1,1,0,1,2,4,1,2370,22,0
4700,경상북도,4720,청송군,,진보면제1투,752,464,97,355,5,1,0,0,0,0,1,0,0,1,460,4,288
4700,경상북도,4720,청송군,,진보면제2투,949,577,106,442,9,1,7,0,0,0,0,1,3,0,569,8,372
4700,경상북도,4720,청송군,,진보면제3투,498,280,74,197,2,0,3,0,0,0,1,0,0,0,277,3,218
4700,경상북도,4720,청송군,,진보면제4투,533,350,66,273,4,0,4,1,0,0,1,0,1,0,350,0,183
4700,경상북도,4720,청송군,주왕산면,소계,1418,1143,189,901,22,0,10,2,0,0,4,1,3,0,1132,11,275
4700,경상북도,4720,청송군,,관내사전투표,527,527,82,424,8,0,5,1,0,0,2,1,1,0,524,3,0
4700,경상북도,4720,청송군,,주왕산면제1투,399,241,33,192,7,0,1,1,0,0,2,0,1,0,237,4,158
4700,경상북도,4720,청송군,,주왕산면제2투,492,375,74,285,7,0,4,0,0,0,0,0,1,0,371,4,117
4700,경상북도,4720,청송군,잘못 투입·구분된 투표지,,0,1,1,0,0,0,0,0,0,0,0,0,0,0,1,0,-1
4700,경상북도,4721,영양군,합계,,14932,12337,2855,8968,208,11,68,5,1,9,19,11,35,11,12201,136,2595
4700,경상북도,4721,영양군,거소·선상투표,,92,87,12,44,2,0,1,2,0,4,2,0,0,0,67,20,5
4700,경상북도,4721,영양군,관외사전투표,,1376,1376,398,909,33,1,9,0,1,0,2,2,3,1,1359,17,0
4700,경상북도,4721,영양군,재외투표,,48,25,5,15,0,0,0,0,0,0,0,0,0,0,20,5,23
4700,경상북도,4721,영양군,영양읍,소계,5539,4433,1036,3238,76,4,24,1,0,3,2,1,8,5,4398,35,1106
4700,경상북도,4721,영양군,,관내사전투표,2578,2578,630,1871,45,2,11,0,0,2,2,0,3,1,2567,11,0
4700,경상북도,4721,영양군,,영양읍제1투,1184,727,156,531,16,2,5,0,0,0,0,1,2,2,715,12,457
4700,경상북도,4721,영양군,,영양읍제2투,931,601,112,465,11,0,7,0,0,0,0,0,2,1,598,3,330
4700,경상북도,4721,영양군,,영양읍제3투,846,527,138,371,4,0,1,1,0,1,0,0,1,1,518,9,319
4700,경상북도,4721,영양군,입암면,소계,1788,1453,288,1114,20,4,9,0,0,1,4,2,1,2,1445,8,335
4700,경상북도,4721,영양군,,관내사전투표,1043,1043,204,809,13,4,3,0,0,0,3,1,1,1,1039,4,0
4700,경상북도,4721,영양군,,입암면투표소,745,410,84,305,7,0,6,0,0,1,1,1,0,1,406,4,335
4700,경상북도,4721,영양군,청기면,소계,1458,1180,228,900,18,1,4,0,0,0,2,2,6,1,1162,18,278
4700,경상북도,4721,영양군,,관내사전투표,686,686,131,525,11,1,2,0,0,0,0,1,3,1,675,11,0
4700,경상북도,4721,영양군,,청기면제1투,423,239,44,187,2,0,2,0,0,0,2,0,1,0,238,1,184
4700,경상북도,4721,영양군,,청기면제2투,349,255,53,188,5,0,0,0,0,0,0,1,2,0,249,6,94
4700,경상북도,4721,영양군,일월면,소계,1566,1250,303,896,21,0,11,0,0,1,4,0,5,1,1242,8,316
4700,경상북도,4721,영양군,,관내사전투표,825,825,218,581,12,0,4,0,0,0,2,0,4,1,822,3,0
4700,경상북도,4721,영양군,,일월면투표소,741,425,85,315,9,0,7,0,0,1,2,0,1,0,420,5,316
4700,경상북도,4721,영양군,수비면,소계,1341,1085,258,788,20,1,1,1,0,0,2,3,3,1,1078,7,256
4700,경상북도,4721,영양군,,관내사전투표,678,678,171,482,11,1,0,1,0,0,1,2,3,0,672,6,0
4700,경상북도,4721,영양군,,수비면투표소,663,407,87,306,9,0,1,0,0,0,1,1,0,1,406,1,256
4700,경상북도,4721,영양군,석보면,소계,1724,1448,327,1064,18,0,9,1,0,0,1,1,9,0,1430,18,276
4700,경상북도,4721,영양군,,관내사전투표,893,893,209,653,7,0,2,1,0,0,1,1,5,0,879,14,0
4700,경상북도,4721,영양군,,석보면제1투,563,366,77,267,10,0,7,0,0,0,0,0,2,0,363,3,197
4700,경상북도,4721,영양군,,석보면제2투,268,189,41,144,1,0,0,0,0,0,0,0,2,0,188,1,79
4700,경상북도,4721,영양군,잘못 투입·구분된 투표지,,0,0,0,0,0,0,0,0,0,0,0,0,0,0,0,0,0
4700,경상북도,4722,영덕군,합계,,32227,25897,4342,20611,310,16,184,17,3,7,44,21,46,23,25624,273,6330
4700,경상북도,4722,영덕군,거소·선상투표,,262,219,33,161,0,1,3,1,0,0,0,0,0,2,201,18,43
4700,경상북도,4722,영덕군,관외사전투표,,2529,2529,617,1783,61,1,31,4,0,0,6,6,0,0,2509,20,0
4700,경상북도,4722,영덕군,재외투표,,105,62,34,21,0,0,1,0,0,0,0,0,0,0,56,6,43
4700,경상북도,4722,영덕군,영덕읍,소계,8480,6704,1272,5208,89,2,42,3,1,1,19,6,9,2,6654,50,1776
4700,경상북도,4722,영덕군,,관내사전투표,3801,3801,768,2914,50,1,24,3,0,0,6,5,5,1,3777,24,0
4700,경상북도,4722,영덕군,,영덕읍제1투,1630,990,219,734,17,1,8,0,0,1,0,0,0,0,980,10,640
4700,경상북도,4722,영덕군,,영덕읍제2투,1270,790,123,634,12,0,6,0,0,0,9,0,0,0,784,6,480
4700,경상북도,4722,영덕군,,영덕읍제3투,1113,689,104,568,3,0,4,0,0,0,4,0,1,1,685,4,424
4700,경상북도,4722,영덕군,,영덕읍제4투,666,434,58,358,7,0,0,0,1,0,0,1,3,0,428,6,232
4700,경상북도,4722,영덕군,강구면,소계,5098,3870,558,3200,27,4,31,1,0,2,4,2,0,2,3831,39,1228
4700,경상북도,4722,영덕군,,관내사전투표,2205,2205,306,1840,15,3,12,1,0,1,1,2,0,2,2183,22,0
4700,경상북도,4722,영덕군,,강구면제1투,994,570,86,460,3,1,11,0,0,1,1,0,0,0,563,7,424
4700,경상북도,4722,영덕군,,강구면제2투,1075,655,83,556,3,0,3,0,0,0,2,0,0,0,647,8,420
4700,경상북도,4722,영덕군,,강구면제3투,824,440,83,344,6,0,5,0,0,0,0,0,0,0,438,2,384
4700,경상북도,4722,영덕군,남정면,소계,1957,1533,214,1261,16,1,7,0,0,1,4,2,5,5,1516,17,424
4700,경상북도,4722,영덕군,,관내사전투표,982,982,130,818,9,1,3,0,0,0,4,0,3,3,971,11,0
4700,경상북도,4722,영덕군,,남정면제1투,644,338,61,260,7,0,4,0,0,1,0,1,1,0,335,3,306
4700,경상북도,4722,영덕군,,남정면제2투,331,213,23,183,0,0,0,0,0,0,0,1,1,2,210,3,118
4700,경상북도,4722,영덕군,달산면,소계,916,743,110,604,9,2,3,2,0,0,1,0,4,3,738,5,173
4700,경상북도,4722,영덕군,,관내사전투표,487,487,70,397,6,1,3,2,0,0,1,0,2,1,483,4,0
4700,경상북도,4722,영덕군,,달산면제1투,284,158,25,129,2,1,0,0,0,0,0,0,0,0,157,1,126
4700,경상북도,4722,영덕군,,달산면제2투,145,98,15,78,1,0,0,0,0,0,0,0,2,2,98,0,47
4700,경상북도,4722,영덕군,지품면,소계,1676,1404,221,1118,22,1,11,1,0,1,3,0,4,2,1384,20,272
4700,경상북도,4722,영덕군,,관내사전투표,941,941,132,777,9,1,7,0,0,1,1,0,3,0,931,10,0
4700,경상북도,4722,영덕군,,지품면제1투,419,232,45,175,4,0,2,1,0,0,0,0,0,0,227,5,187
4700,경상북도,4722,영덕군,,지품면제2투,316,231,44,166,9,0,2,0,0,0,2,0,1,2,226,5,85
4700,경상북도,4722,영덕군,축산면,소계,2198,1752,222,1484,13,2,7,1,0,0,0,2,5,1,1737,15,446
4700,경상북도,4722,영덕군,,관내사전투표,1172,1172,135,1007,11,2,4,1,0,0,0,0,5,0,1165,7,0
4700,경상북도,4722,영덕군,,축산면제1투,369,217,26,181,2,0,0,0,0,0,0,1,0,1,211,6,152
4700,경상북도,4722,영덕군,,축산면제2투,657,363,61,296,0,0,3,0,0,0,0,1,0,0,361,2,294
4700,경상북도,4722,영덕군,영해면,소계,5347,4141,675,3340,43,1,25,1,0,1,2,1,7,2,4098,43,1206
4700,경상북도,4722,영덕군,,관내사전투표,2406,2406,396,1938,23,1,13,0,0,0,2,1,4,2,2380,26,0
4700,경상북도,4722,영덕군,,영해면제1투,935,499,99,387,4,0,4,0,0,0,0,0,2,0,496,3,436
4700,경상북도,4722,영덕군,,영해면제2투,1126,711,105,586,11,0,4,0,0,1,0,0,0,0,707,4,415
4700,경상북도,4722,영덕군,,영해면제3투,880,525,75,429,5,0,4,1,0,0,0,0,1,0,515,10,355
4700,경상북도,4722,영덕군,병곡면,소계,2227,1761,196,1499,18,1,9,2,1,0,2,1,6,3,1738,23,466
4700,경상북도,4722,영덕군,,관내사전투표,1148,1148,120,994,7,0,5,1,1,0,1,1,5,2,1137,11,0
4700,경상북도,4722,영덕군,,병곡면제1투,458,237,37,195,2,0,0,1,0,0,0,0,0,0,235,2,221
4700,경상북도,4722,영덕군,,병곡면제2투,621,376,39,310,9,1,4,0,0,0,1,0,1,1,366,10,245
4700,경상북도,4722,영덕군,창수면,소계,1432,1179,190,932,12,0,14,1,1,1,3,1,6,1,1162,17,253
4700,경상북도,4722,영덕군,,관내사전투표,707,707,120,554,9,0,5,1,1,0,1,1,3,1,696,11,0
4700,경상북도,4722,영덕군,,창수면제1투,419,245,33,203,1,0,4,0,0,1,0,0,2,0,244,1,174
4700,경상북도,4722,영덕군,,창수면제2투,306,227,37,175,2,0,5,0,0,0,2,0,1,0,222,5,79
4700,경상북도,4722,영덕군,잘못 투입·구분된 투표지,,0,0,0,0,0,0,0,0,0,0,0,0,0,0,0,0,0
4700,경상북도,4723,봉화군,합계,,28052,22707,5252,16451,361,15,209,7,9,10,49,24,76,22,22485,222,5345
4700,경상북도,4723,봉화군,거소·선상투표,,118,109,24,71,1,0,3,0,1,0,1,1,0,0,102,7,9
4700,경상북도,4723,봉화군,관외사전투표,,2761,2761,909,1718,59,3,32,1,1,0,4,4,1,0,2732,29,0
4700,경상북도,4723,봉화군,재외투표,,79,56,29,22,1,0,0,0,0,0,0,0,0,0,52,4,23
4700,경상북도,4723,봉화군,봉화읍,소계,7785,6099,1439,4420,111,3,39,2,0,2,13,4,10,6,6049,50,1686
4700,경상북도,4723,봉화군,,관내사전투표,3428,3428,898,2404,61,2,17,2,0,1,7,3,4,4,3403,25,0
4700,경상북도,4723,봉화군,,봉화읍제1투,1318,755,180,544,12,0,4,0,0,0,0,1,3,0,744,11,563
4700,경상북도,4723,봉화군,,봉화읍제2투,1077,638,112,497,15,0,8,0,0,1,2,0,0,0,635,3,439
4700,경상북도,4723,봉화군,,봉화읍제3투,1087,671,132,512,15,0,4,0,0,0,1,0,1,1,666,5,416
4700,경상북도,4723,봉화군,,봉화읍제4투,875,607,117,463,8,1,6,0,0,0,3,0,2,1,601,6,268
4700,경상북도,4723,봉화군,물야면,소계,2412,1873,387,1418,24,0,12,1,1,0,0,1,7,1,1852,21,539
4700,경상북도,4723,봉화군,,관내사전투표,908,908,229,648,13,0,3,1,1,0,0,0,4,1,900,8,0
4700,경상북도,4723,봉화군,,물야면제1투,740,481,78,385,7,0,5,0,0,0,0,0,1,0,476,5,259
4700,경상북도,4723,봉화군,,물야면제2투,764,484,80,385,4,0,4,0,0,0,0,1,2,0,476,8,280
4700,경상북도,4723,봉화군,봉성면,소계,1739,1392,245,1086,17,1,12,2,0,1,2,3,8,2,1379,13,347
4700,경상북도,4723,봉화군,,관내사전투표,689,689,139,530,7,1,1,2,0,0,0,0,2,0,682,7,0
4700,경상북도,4723,봉화군,,봉성면제1투,417,264,44,200,3,0,6,0,0,0,2,1,3,2,261,3,153
4700,경상북도,4723,봉화군,,봉성면제2투,633,439,62,356,7,0,5,0,0,1,0,2,3,0,436,3,194
4700,경상북도,4723,봉화군,법전면,소계,1615,1265,252,954,9,0,18,0,0,0,4,3,5,2,1247,18,350
4700,경상북도,4723,봉화군,,관내사전투표,737,737,163,549,3,0,5,0,0,0,1,0,5,2,728,9,0
4700,경상북도,4723,봉화군,,법전면투표소,878,528,89,405,6,0,13,0,0,0,3,3,0,0,519,9,350
4700,경상북도,4723,봉화군,춘양면,소계,3854,3128,617,2360,61,4,32,0,0,1,10,2,13,2,3102,26,726
4700,경상북도,4723,봉화군,,관내사전투표,1608,1608,342,1195,30,2,11,0,0,1,4,0,9,1,1595,13,0
4700,경상북도,4723,봉화군,,춘양면제1투,665,422,74,331,4,0,8,0,0,0,1,1,0,0,419,3,243
4700,경상북도,4723,봉화군,,춘양면제2투,798,553,102,423,10,2,5,0,0,0,4,1,1,0,548,5,245
4700,경상북도,4723,봉화군,,춘양면제3투,783,545,99,411,17,0,8,0,0,0,1,0,3,1,540,5,238
4700,경상북도,4723,봉화군,소천면,소계,1753,1387,305,1010,15,2,16,0,0,2,8,1,8,1,1368,19,366
4700,경상북도,4723,봉화군,,관내사전투표,689,689,162,500,8,1,3,0,0,0,2,0,3,1,680,9,0
4700,경상북도,4723,봉화군,,소천면제1투,400,205,46,147,2,0,5,0,0,2,1,0,0,0,203,2,195
4700,경상북도,4723,봉화군,,소천면제2투,342,267,41,206,3,1,7,0,0,0,4,0,3,0,265,2,75
4700,경상북도,4723,봉화군,,소천면제3투,322,226,56,157,2,0,1,0,0,0,1,1,2,0,220,6,96
4700,경상북도,4723,봉화군,석포면,소계,1534,1165,305,810,19,0,16,0,1,0,1,1,4,1,1158,7,369
4700,경상북도,4723,봉화군,,관내사전투표,679,679,175,476,14,0,7,0,0,0,1,0,3,1,677,2,0
4700,경상북도,4723,봉화군,,석포면투표소,855,486,130,334,5,0,9,0,1,0,0,1,1,0,481,5,369
4700,경상북도,4723,봉화군,재산면,소계,1240,968,256,658,13,1,10,0,4,0,3,0,8,4,957,11,272
4700,경상북도,4723,봉화군,,관내사전투표,570,570,156,390,8,1,2,0,0,0,3,0,3,3,566,4,0
4700,경상북도,4723,봉화군,,재산면투표소,670,398,100,268,5,0,8,0,4,0,0,0,5,1,391,7,272
4700,경상북도,4723,봉화군,명호면,소계,1683,1311,287,964,18,1,13,0,1,3,1,4,7,2,1301,10,372
4700,경상북도,4723,봉화군,,관내사전투표,730,730,198,503,12,1,3,0,0,2,1,3,4,0,727,3,0
4700,경상북도,4723,봉화군,,명호면투표소,953,581,89,461,6,0,10,0,1,1,0,1,3,2,574,7,372
4700,경상북도,4723,봉화군,상운면,소계,1479,1193,197,960,13,0,6,1,0,1,2,0,5,1,1186,7,286
4700,경상북도,4723,봉화군,,관내사전투표,774,774,143,605,9,0,4,1,0,1,1,0,4,1,769,5,0
4700,경상북도,4723,봉화군,,상운면투표소,705,419,54,355,4,0,2,0,0,0,1,0,1,0,417,2,286
4700,경상북도,4723,봉화군,잘못 투입·구분된 투표지,,0,0,0,0,0,0,0,0,0,0,0,0,0,0,0,0,0
4700,경상북도,4724,울진군,합계,,42282,33544,6888,25287,476,21,266,12,7,10,66,40,50,41,33164,380,8738
4700,경상북도,4724,울진군,거소·선상투표,,183,165,31,109,3,1,2,0,0,0,1,0,1,1,149,16,18
4700,경상북도,4724,울진군,관외사전투표,,3604,3602,1004,2401,81,6,39,3,3,1,6,4,2,5,3555,47,2
4700,경상북도,4724,울진군,재외투표,,136,92,34,45,4,0,1,0,0,0,0,0,0,0,84,8,44
4700,경상북도,4724,울진군,울진읍,소계,10167,7909,1809,5807,123,0,71,1,0,1,19,8,8,3,7850,59,2258
4700,경상북도,4724,울진군,,관내사전투표,3145,3145,795,2250,42,0,22,1,0,1,7,5,2,1,3126,19,0
4700,경상북도,4724,울진군,,울진읍제1투,1505,985,202,750,12,0,9,0,0,0,2,0,2,0,977,8,520
4700,경상북도,4724,울진군,,울진읍제2투,1801,1225,317,857,27,0,12,0,0,0,3,1,0,0,1217,8,576
4700,경상북도,4724,울진군,,울진읍제3투,2148,1506,269,1171,21,0,23,0,0,0,3,2,3,2,1494,12,642
4700,경상북도,4724,울진군,,울진읍제4투,1568,1048,226,779,21,0,5,0,0,0,4,0,1,0,1036,12,520
4700,경상북도,4724,울진군,평해읍,소계,2402,1873,287,1524,26,0,7,1,0,1,5,4,4,3,1862,11,529
4700,경상북도,4724,울진군,,관내사전투표,1126,1126,156,936,15,0,3,1,0,0,0,3,4,3,1121,5,0
4700,경상북도,4724,울진군,,평해읍제1투,613,360,72,275,8,0,2,0,0,0,1,0,0,0,358,2,253
4700,경상북도,4724,울진군,,평해읍제2투,663,387,59,313,3,0,2,0,0,1,4,1,0,0,383,4,276
4700,경상북도,4724,울진군,북면,소계,5368,4221,964,3096,74,1,23,1,2,0,6,5,7,1,4180,41,1147
4700,경상북도,4724,울진군,,관내사전투표,1550,1548,352,1149,19,0,6,0,0,0,2,5,5,0,1538,10,2
4700,경상북도,4724,울진군,,북면제1투,1730,1150,232,866,27,0,9,1,1,0,2,0,1,0,1139,11,580
4700,경상북도,4724,울진군,,북면제2투,516,402,75,303,5,0,4,0,0,0,2,0,0,1,390,12,114
4700,경상북도,4724,울진군,,북면제3투,1572,1121,305,778,23,1,4,0,1,0,0,0,1,0,1113,8,451
4700,경상북도,4724,울진군,금강송면,소계,1093,835,146,624,12,3,17,0,1,1,8,1,8,3,824,11,258
4700,경상북도,4724,울진군,,관내사전투표,509,509,85,396,6,1,6,0,0,0,1,1,3,3,502,7,0
4700,경상북도,4724,울진군,,금강송면제1투,405,190,34,127,3,2,10,0,1,1,7,0,2,0,187,3,215
4700,경상북도,4724,울진군,,금강송면제2투,179,136,27,101,3,0,1,0,0,0,0,0,3,0,135,1,43
4700,경상북도,4724,울진군,근남면,소계,2562,2075,441,1554,24,2,16,0,0,0,4,5,0,4,2050,25,487
4700,경상북도,4724,울진군,,관내사전투표,1324,1324,300,984,15,2,4,0,0,0,1,3,0,2,1311,13,0
4700,경상북도,4724,울진군,,근남면투표소,1238,751,141,570,9,0,12,0,0,0,3,2,0,2,739,12,487
4700,경상북도,4724,울진군,매화면,소계,1867,1453,265,1128,13,1,10,1,0,2,3,3,5,2,1433,20,414
4700,경상북도,4724,울진군,,관내사전투표,980,980,187,751,11,0,6,1,0,2,3,3,3,1,968,12,0
4700,경상북도,4724,울진군,,매화면투표소,887,473,78,377,2,1,4,0,0,0,0,0,2,1,465,8,414
4700,경상북도,4724,울진군,기성면,소계,2085,1624,273,1276,21,0,9,1,0,2,2,2,6,4,1596,28,461
4700,경상북도,4724,울진군,,관내사전투표,1148,1147,184,918,14,0,3,1,0,1,0,1,4,2,1128,19,1
4700,경상북도,4724,울진군,,기성면투표소,937,477,89,358,7,0,6,0,0,1,2,1,2,2,468,9,460
4700,경상북도,4724,울진군,온정면,소계,1474,1196,163,988,8,1,10,0,0,0,6,0,2,5,1183,13,278
4700,경상북도,4724,울진군,,관내사전투표,721,721,98,607,5,1,2,0,0,0,0,0,1,2,716,5,0
4700,경상북도,4724,울진군,,온정면투표소,753,475,65,381,3,0,8,0,0,0,6,0,1,3,467,8,278
4700,경상북도,4724,울진군,죽변면,소계,5226,3835,681,3035,43,2,20,0,1,1,4,3,3,3,3796,39,1391
4700,경상북도,4724,울진군,,관내사전투표,1832,1832,325,1455,15,1,4,0,1,0,4,1,3,1,1810,22,0
4700,경상북도,4724,울진군,,죽변면제1투,1362,798,125,654,6,0,2,0,0,0,0,0,0,1,788,10,564
4700,경상북도,4724,울진군,,죽변면제2투,2032,1205,231,926,22,1,14,0,0,1,0,2,0,1,1198,7,827
4700,경상북도,4724,울진군,후포면,소계,6115,4664,790,3700,44,4,41,4,0,1,2,5,4,7,4602,62,1451
4700,경상북도,4724,울진군,,관내사전투표,2360,2360,409,1887,20,3,13,3,0,1,1,0,2,3,2342,18,0
4700,경상북도,4724,울진군,,후포면제1투,957,654,78,549,2,0,7,1,0,0,0,2,0,2,641,13,303
4700,경상북도,4724,울진군,,후포면제2투,1415,847,141,669,10,0,9,0,0,0,0,2,1,1,833,14,568
4700,경상북도,4724,울진군,,후포면제3투,1383,803,162,595,12,1,12,0,0,0,1,1,1,1,786,17,580
4700,경상북도,4724,울진군,잘못 투입·구분된 투표지,,0,0,0,0,0,0,0,0,0,0,0,0,0,0,0,0,04800,경상남도,4821,창원시의창구,합계,,185646,143063,52289,82914,3805,68,1874,55,18,30,141,275,52,69,141590,1473,42583
4800,경상남도,4821,창원시의창구,거소·선상투표,,523,478,137,254,11,0,15,0,0,1,0,2,0,1,421,57,45
4800,경상남도,4821,창원시의창구,관외사전투표,,17267,17265,6735,9442,527,12,262,9,2,9,11,33,14,15,17071,194,2
4800,경상남도,4821,창원시의창구,재외투표,,595,376,187,129,18,0,1,0,0,0,0,0,0,0,335,41,219
4800,경상남도,4821,창원시의창구,동읍,소계,15577,11620,4400,6590,288,3,169,5,1,2,13,24,3,6,11504,116,3957
4800,경상남도,4821,창원시의창구,,관내사전투표,4177,4177,1818,2165,104,1,54,3,0,1,3,7,2,1,4159,18,0
4800,경상남도,4821,창원시의창구,,동읍제1투,927,660,275,350,19,0,6,0,0,0,0,1,0,0,651,9,267
4800,경상남도,4821,창원시의창구,,동읍제2투,1875,1078,366,651,24,1,20,0,1,0,1,2,0,0,1066,12,797
4800,경상남도,4821,창원시의창구,,동읍제3투,1541,1033,349,620,29,0,12,0,0,1,0,8,1,0,1020,13,508
4800,경상남도,4821,창원시의창구,,동읍제4투,2319,1622,679,845,44,0,30,0,0,0,2,1,0,1,1602,20,697
4800,경상남도,4821,창원시의창구,,동읍제5투,2490,1525,540,870,41,1,34,1,0,0,5,2,0,3,1497,28,965
4800,경상남도,4821,창원시의창구,,동읍제6투,1193,779,200,550,15,0,3,1,0,0,0,2,0,1,772,7,414
4800,경상남도,4821,창원시의창구,,동읍제7투,1055,746,173,539,12,0,10,0,0,0,2,1,0,0,737,9,309
4800,경상남도,4821,창원시의창구,북면,소계,29996,22460,8928,12454,584,11,239,8,3,5,24,31,3,8,22298,162,7536
4800,경상남도,4821,창원시의창구,,관내사전투표,7481,7478,3400,3785,193,5,44,3,1,2,3,10,1,2,7449,29,3
4800,경상남도,4821,창원시의창구,,북면제1투,3269,2257,816,1331,61,1,23,0,1,1,1,3,0,2,2240,17,1012
4800,경상남도,4821,창원시의창구,,북면제2투,1987,1226,462,691,32,0,21,0,0,0,0,4,0,0,1210,16,761
4800,경상남도,4821,창원시의창구,,북면제3투,3561,2497,1023,1341,72,2,28,0,0,0,7,1,1,0,2475,22,1064
4800,경상남도,4821,창원시의창구,,북면제4투,3162,2029,723,1201,42,0,36,1,0,1,2,4,1,2,2013,16,1133
4800,경상남도,4821,창원시의창구,,북면제5투,3817,2557,1142,1270,81,0,37,0,0,0,1,3,0,0,2534,23,1260
4800,경상남도,4821,창원시의창구,,북면제6투,3185,2019,538,1382,38,1,26,3,1,1,7,5,0,0,2002,17,1166
4800,경상남도,4821,창원시의창구,,북면제7투,848,610,117,470,10,0,3,0,0,0,2,0,0,0,602,8,238
4800,경상남도,4821,창원시의창구,,북면제8투,2686,1787,707,983,55,2,21,1,0,0,1,1,0,2,1773,14,899
4800,경상남도,4821,창원시의창구,대산면,소계,6103,4425,1575,2636,77,1,59,1,0,0,7,5,3,5,4369,56,1678
4800,경상남도,4821,창원시의창구,,관내사전투표,1891,1891,813,1013,27,0,13,0,0,0,3,4,2,1,1876,15,0
4800,경상남도,4821,창원시의창구,,대산면제1투,1184,793,201,558,13,0,6,1,0,0,1,1,1,1,783,10,391
4800,경상남도,4821,창원시의창구,,대산면제2투,2168,1212,395,741,21,1,28,0,0,0,3,0,0,2,1191,21,956
4800,경상남도,4821,창원시의창구,,대산면제3투,860,529,166,324,16,0,12,0,0,0,0,0,0,1,519,10,331
4800,경상남도,4821,창원시의창구,의창동,소계,37007,28093,9376,17245,761,11,336,4,2,0,29,39,10,12,27825,268,8914
4800,경상남도,4821,창원시의창구,,관내사전투표,7919,7919,2860,4720,186,6,63,1,1,0,3,13,4,4,7861,58,0
4800,경상남도,4821,창원시의창구,,의창동제1투,1612,1002,255,674,36,1,21,0,0,0,2,1,1,0,991,11,610
4800,경상남도,4821,창원시의창구,,의창동제2투,2232,1472,421,966,41,0,23,1,0,0,6,0,1,1,1460,12,760
4800,경상남도,4821,창원시의창구,,의창동제3투,2328,1544,555,869,47,0,41,0,0,0,4,4,0,0,1520,24,784
4800,경상남도,4821,창원시의창구,,의창동제4투,2435,1515,493,911,44,0,41,0,0,0,5,2,0,1,1497,18,920
4800,경상남도,4821,창원시의창구,,의창동제5투,2360,1549,486,1003,29,0,13,0,0,0,1,1,1,1,1535,14,811
4800,경상남도,4821,창원시의창구,,의창동제6투,2192,1307,428,795,36,1,23,0,0,0,3,0,0,2,1288,19,885
4800,경상남도,4821,창원시의창구,,의창동제7투,1709,1195,360,773,29,0,17,0,0,0,1,3,1,2,1186,9,514
4800,경상남도,4821,창원시의창구,,의창동제8투,1544,1119,343,721,22,0,17,0,0,0,1,4,1,0,1109,10,425
4800,경상남도,4821,창원시의창구,,의창동제9투,2637,1437,501,826,53,1,25,1,0,0,0,6,0,0,1413,24,1200
4800,경상남도,4821,창원시의창구,,의창동제10투,2871,2323,772,1453,64,0,18,1,0,0,1,1,1,0,2311,12,548
4800,경상남도,4821,창원시의창구,,의창동제11투,2050,1538,501,950,54,1,14,0,0,0,1,1,0,0,1522,16,512
4800,경상남도,4821,창원시의창구,,의창동제12투,2285,1881,620,1183,50,0,7,0,0,0,0,2,0,0,1862,19,404
4800,경상남도,4821,창원시의창구,,의창동제13투,2833,2292,781,1401,70,1,13,0,1,0,1,1,0,1,2270,22,541
4800,경상남도,4821,창원시의창구,팔룡동,소계,20703,15838,6055,8922,479,8,173,6,3,1,7,24,7,7,15692,146,4865
4800,경상남도,4821,창원시의창구,,관내사전투표,6443,6443,2622,3561,165,4,41,2,1,1,1,8,2,3,6411,32,0
4800,경상남도,4821,창원시의창구,,팔룡동제1투,2129,1356,458,809,49,0,23,0,0,0,0,3,1,0,1343,13,773
4800,경상남도,4821,창원시의창구,,팔룡동제2투,2044,1187,371,734,35,2,18,2,1,0,4,2,0,0,1169,18,857
4800,경상남도,4821,창원시의창구,,팔룡동제3투,2495,1502,505,905,40,0,26,0,0,0,2,1,0,1,1480,22,993
4800,경상남도,4821,창원시의창구,,팔룡동제4투,2714,1852,730,989,72,0,31,0,1,0,0,5,1,3,1832,20,862
4800,경상남도,4821,창원시의창구,,팔룡동제5투,2961,2195,854,1204,75,2,27,2,0,0,0,4,2,0,2170,25,766
4800,경상남도,4821,창원시의창구,,팔룡동제6투,1917,1303,515,720,43,0,7,0,0,0,0,1,1,0,1287,16,614
4800,경상남도,4821,창원시의창구,명곡동,소계,33825,25090,8739,14977,640,15,366,14,2,6,27,54,5,6,24851,239,8735
4800,경상남도,4821,창원시의창구,,관내사전투표,8802,8794,3501,4933,197,5,72,7,0,1,1,15,1,1,8734,60,8
4800,경상남도,4821,창원시의창구,,명곡동제1투,2810,1804,562,1106,61,2,36,0,1,1,1,4,0,0,1774,30,1006
4800,경상남도,4821,창원시의창구,,명곡동제2투,2938,1962,664,1163,62,2,38,1,0,0,1,7,0,1,1939,23,976
4800,경상남도,4821,창원시의창구,,명곡동제3투,2517,1741,627,978,57,4,36,1,0,0,3,5,0,2,1713,28,776
4800,경상남도,4821,창원시의창구,,명곡동제4투,2050,1117,379,660,30,0,29,1,0,0,2,1,0,1,1103,14,933
4800,경상남도,4821,창원시의창구,,명곡동제5투,2096,1561,468,1022,47,0,14,1,0,0,2,0,0,1,1555,6,535
4800,경상남도,4821,창원시의창구,,명곡동제6투,2051,1288,401,822,31,1,21,0,0,0,0,3,1,0,1280,8,763
4800,경상남도,4821,창원시의창구,,명곡동제7투,2423,1584,447,1040,47,0,27,1,0,1,2,2,1,0,1568,16,839
4800,경상남도,4821,창원시의창구,,명곡동제8투,2186,1395,425,889,33,0,21,1,0,1,4,4,0,0,1378,17,791
4800,경상남도,4821,창원시의창구,,명곡동제9투,2278,1506,491,939,23,0,30,0,1,2,4,5,0,0,1495,11,772
4800,경상남도,4821,창원시의창구,,명곡동제10투,1862,1207,444,685,28,1,26,1,0,0,5,4,0,0,1194,13,655
4800,경상남도,4821,창원시의창구,,명곡동제11투,1812,1131,330,740,24,0,16,0,0,0,2,4,2,0,1118,13,681
4800,경상남도,4821,창원시의창구,봉림동,소계,24050,17415,6156,10263,420,7,254,8,5,6,23,63,7,9,17221,194,6635
4800,경상남도,4821,창원시의창구,,관내사전투표,6039,6039,2507,3294,119,1,54,0,0,1,7,24,0,0,6007,32,0
4800,경상남도,4821,창원시의창구,,봉림동제1투,2701,1705,481,1120,35,1,31,2,0,0,2,4,2,2,1680,25,996
4800,경상남도,4821,창원시의창구,,봉림동제2투,2393,1582,500,980,49,0,24,1,0,1,1,5,1,1,1563,19,811
4800,경상남도,4821,창원시의창구,,봉림동제3투,2122,1271,419,753,36,1,27,1,0,1,4,1,2,3,1248,23,851
4800,경상남도,4821,창원시의창구,,봉림동제4투,2175,1344,440,809,35,1,25,0,1,0,1,4,0,1,1317,27,831
4800,경상남도,4821,창원시의창구,,봉림동제5투,2929,1902,644,1119,51,2,46,2,2,0,5,6,1,1,1879,23,1027
4800,경상남도,4821,창원시의창구,,봉림동제6투,3218,2037,652,1258,50,1,29,1,2,0,2,11,1,1,2008,29,1181
4800,경상남도,4821,창원시의창구,,봉림동제7투,2473,1535,513,930,45,0,18,1,0,3,1,8,0,0,1519,16,938
4800,경상남도,4821,창원시의창구,잘못 투입·구분된 투표지,,0,3,1,2,0,0,0,0,0,0,0,0,0,0,3,0,-3
4800,경상남도,4822,창원시성산구,합계,,213187,170073,67177,93082,5428,70,1920,65,30,37,145,267,51,86,168358,1715,43114
4800,경상남도,4822,창원시성산구,거소·선상투표,,566,527,131,293,8,1,23,1,0,0,1,2,0,1,461,66,39
4800,경상남도,4822,창원시성산구,관외사전투표,,18671,18668,7183,10272,637,15,256,11,5,5,10,29,6,18,18447,221,3
4800,경상남도,4822,창원시성산구,재외투표,,750,505,252,162,21,1,4,0,0,0,0,0,0,0,440,65,245
4800,경상남도,4822,창원시성산구,반송동,소계,30064,24106,9304,13588,746,7,191,8,6,2,18,35,4,9,23918,188,5958
4800,경상남도,4822,창원시성산구,,관내사전투표,7492,7492,3376,3827,197,2,32,1,3,2,2,15,1,1,7459,33,0
4800,경상남도,4822,창원시성산구,,반송동제1투,1767,1332,462,806,38,0,13,0,1,0,0,2,0,1,1323,9,435
4800,경상남도,4822,창원시성산구,,반송동제2투,1977,1479,483,924,42,1,15,0,0,0,0,0,0,1,1466,13,498
4800,경상남도,4822,창원시성산구,,반송동제3투,1801,1396,516,803,54,3,6,2,1,0,2,1,0,2,1390,6,405
4800,경상남도,4822,창원시성산구,,반송동제4투,1976,1529,577,877,51,0,9,0,0,0,2,2,0,1,1519,10,447
4800,경상남도,4822,창원시성산구,,반송동제5투,1903,1446,557,821,46,0,5,0,0,0,1,1,0,0,1431,15,457
4800,경상남도,4822,창원시성산구,,반송동제6투,2002,1501,536,888,47,1,16,0,0,0,0,3,0,0,1491,10,501
4800,경상남도,4822,창원시성산구,,반송동제7투,2192,1581,583,903,56,0,13,0,1,0,3,1,0,1,1561,20,611
4800,경상남도,4822,창원시성산구,,반송동제8투,2184,1453,486,894,32,0,18,0,0,0,1,4,1,0,1436,17,731
4800,경상남도,4822,창원시성산구,,반송동제9투,2152,1494,490,899,52,0,25,0,0,0,3,2,0,1,1472,22,658
4800,경상남도,4822,창원시성산구,,반송동제10투,2193,1479,530,847,52,0,21,3,0,0,1,3,1,1,1459,20,714
4800,경상남도,4822,창원시성산구,,반송동제11투,2425,1924,708,1099,79,0,18,2,0,0,3,1,1,0,1911,13,501
4800,경상남도,4822,창원시성산구,중앙동,소계,26909,19244,7243,10938,531,11,251,7,1,4,26,32,7,9,19060,184,7665
4800,경상남도,4822,창원시성산구,,관내사전투표,5309,5309,2347,2739,123,3,48,1,1,1,3,6,1,1,5274,35,0
4800,경상남도,4822,창원시성산구,,중앙동제1투,2102,1042,341,627,41,0,18,0,0,0,1,1,0,1,1030,12,1060
4800,경상남도,4822,창원시성산구,,중앙동제2투,2933,1407,443,870,34,2,30,0,0,1,3,3,0,1,1387,20,1526
4800,경상남도,4822,창원시성산구,,중앙동제3투,1766,1079,320,687,28,0,22,1,0,0,2,4,0,0,1064,15,687
4800,경상남도,4822,창원시성산구,,중앙동제4투,2909,1577,553,923,43,1,36,0,0,1,2,2,0,3,1564,13,1332
4800,경상남도,4822,창원시성산구,,중앙동제5투,1760,1119,422,613,33,0,24,1,0,0,4,5,4,0,1106,13,641
4800,경상남도,4822,창원시성산구,,중앙동제6투,2690,1949,769,1068,66,2,14,1,0,1,2,4,1,2,1930,19,741
4800,경상남도,4822,창원시성산구,,중앙동제7투,3368,2570,1017,1388,90,1,37,2,0,0,5,6,1,0,2547,23,798
4800,경상남도,4822,창원시성산구,,중앙동제8투,2249,1759,655,1008,55,2,16,1,0,0,1,1,0,1,1740,19,490
4800,경상남도,4822,창원시성산구,,중앙동제9투,1823,1433,376,1015,18,0,6,0,0,0,3,0,0,0,1418,15,390
4800,경상남도,4822,창원시성산구,상남동,소계,22820,18370,7374,10066,549,3,193,4,2,4,11,24,9,6,18245,125,4450
4800,경상남도,4822,창원시성산구,,관내사전투표,8783,8783,3916,4510,221,3,69,2,2,0,2,12,4,3,8744,39,0
4800,경상남도,4822,창원시성산구,,상남동제1투,2251,1513,628,787,55,0,26,0,0,0,1,2,0,0,1499,14,738
4800,경상남도,4822,창원시성산구,,상남동제2투,1868,1212,480,652,43,0,15,1,0,2,0,0,1,1,1195,17,656
4800,경상남도,4822,창원시성산구,,상남동제3투,2219,1596,528,971,64,0,13,0,0,0,1,3,0,2,1582,14,623
4800,경상남도,4822,창원시성산구,,상남동제4투,2518,1846,635,1108,58,0,21,0,0,2,2,1,3,0,1830,16,672
4800,경상남도,4822,창원시성산구,,상남동제5투,2729,1896,711,1069,68,0,24,0,0,0,3,5,1,0,1881,15,833
4800,경상남도,4822,창원시성산구,,상남동제6투,2452,1524,476,969,40,0,25,1,0,0,2,1,0,0,1514,10,928
4800,경상남도,4822,창원시성산구,사파동,소계,34883,27115,11318,14090,995,10,328,8,5,8,30,50,6,13,26861,254,7768
4800,경상남도,4822,창원시성산구,,관내사전투표,9418,9418,4420,4536,305,3,84,1,2,1,3,16,2,7,9380,38,0
4800,경상남도,4822,창원시성산구,,사파동제1투,3196,2133,813,1199,54,1,28,2,0,0,7,7,0,0,2111,22,1063
4800,경상남도,4822,창원시성산구,,사파동제2투,2264,1557,539,913,49,1,28,0,0,1,2,1,1,0,1535,22,707
4800,경상남도,4822,창원시성산구,,사파동제3투,1487,1038,427,543,34,1,10,1,0,0,1,0,1,0,1018,20,449
4800,경상남도,4822,창원시성산구,,사파동제4투,2529,1789,664,982,81,0,25,1,0,0,5,1,0,2,1761,28,740
4800,경상남도,4822,창원시성산구,,사파동제5투,2663,1771,680,969,80,0,20,0,0,0,1,7,0,1,1758,13,892
4800,경상남도,4822,창원시성산구,,사파동제6투,2150,1624,631,881,66,1,18,1,0,0,1,8,0,0,1607,17,526
4800,경상남도,4822,창원시성산구,,사파동제7투,1510,834,250,522,25,0,21,0,0,2,0,1,0,1,822,12,676
4800,경상남도,4822,창원시성산구,,사파동제8투,2223,1501,558,816,68,1,33,1,0,3,2,4,0,0,1486,15,722
4800,경상남도,4822,창원시성산구,,사파동제9투,2577,1871,789,958,71,1,17,0,2,0,2,1,1,0,1842,29,706
4800,경상남도,4822,창원시성산구,,사파동제10투,2143,1583,678,800,70,0,17,0,0,1,3,1,1,1,1572,11,560
4800,경상남도,4822,창원시성산구,,사파동제11투,2723,1996,869,971,92,1,27,1,1,0,3,3,0,1,1969,27,727
4800,경상남도,4822,창원시성산구,가음정동,소계,30911,24500,10195,12890,820,12,257,8,2,1,15,43,11,15,24269,231,6411
4800,경상남도,4822,창원시성산구,,관내사전투표,8427,8427,3988,4032,254,8,64,3,1,0,4,19,3,7,8383,44,0
4800,경상남도,4822,창원시성산구,,가음정동제1투,1711,1098,420,624,31,0,9,0,0,0,0,1,0,0,1085,13,613
4800,경상남도,4822,창원시성산구,,가음정동제2투,2487,1878,786,973,80,0,15,1,0,0,3,1,0,1,1860,18,609
4800,경상남도,4822,창원시성산구,,가음정동제3투,2466,1831,695,1031,65,0,17,1,0,1,1,0,0,2,1813,18,635
4800,경상남도,4822,창원시성산구,,가음정동제4투,1535,1008,347,581,41,0,21,0,0,0,1,3,0,0,994,14,527
4800,경상남도,4822,창원시성산구,,가음정동제5투,2883,2169,892,1163,60,2,23,0,0,0,2,4,1,1,2148,21,714
4800,경상남도,4822,창원시성산구,,가음정동제6투,2603,1974,747,1113,77,0,15,0,0,0,1,2,1,0,1956,18,629
4800,경상남도,4822,창원시성산구,,가음정동제7투,2260,1688,656,942,53,2,11,1,0,0,0,2,0,0,1667,21,572
4800,경상남도,4822,창원시성산구,,가음정동제8투,1842,1145,390,687,34,0,22,0,0,0,0,3,1,1,1138,7,697
4800,경상남도,4822,창원시성산구,,가음정동제9투,1860,1265,509,651,48,0,28,0,0,0,1,1,1,3,1242,23,595
4800,경상남도,4822,창원시성산구,,가음정동제10투,2837,2017,765,1093,77,0,32,2,1,0,2,7,4,0,1983,34,820
4800,경상남도,4822,창원시성산구,성주동,소계,18521,14766,6142,7829,443,6,146,8,3,3,9,28,4,7,14628,138,3755
4800,경상남도,4822,창원시성산구,,관내사전투표,5104,5104,2484,2405,144,1,24,2,1,3,0,7,1,3,5075,29,0
4800,경상남도,4822,창원시성산구,,성주동제1투,2663,1891,568,1211,58,1,29,1,0,0,0,3,1,0,1872,19,772
4800,경상남도,4822,창원시성산구,,성주동제2투,1954,1229,505,641,35,0,24,1,0,0,1,7,2,0,1216,13,725
4800,경상남도,4822,창원시성산구,,성주동제3투,2289,1547,694,748,50,0,25,1,1,0,3,2,0,2,1526,21,742
4800,경상남도,4822,창원시성산구,,성주동제4투,1985,1449,638,711,51,2,23,1,1,0,3,4,0,2,1436,13,536
4800,경상남도,4822,창원시성산구,,성주동제5투,2402,1899,709,1093,60,0,8,0,0,0,0,1,0,0,1871,28,503
4800,경상남도,4822,창원시성산구,,성주동제6투,2124,1647,544,1020,45,2,13,2,0,0,2,4,0,0,1632,15,477
4800,경상남도,4822,창원시성산구,웅남동,소계,6332,5002,1847,2848,138,1,90,1,3,0,8,4,0,2,4942,60,1330
4800,경상남도,4822,창원시성산구,,관내사전투표,2204,2204,928,1165,65,1,31,0,1,0,0,1,0,0,2192,12,0
4800,경상남도,4822,창원시성산구,,웅남동제1투,957,593,159,403,11,0,12,0,0,0,1,0,0,0,586,7,364
4800,경상남도,4822,창원시성산구,,웅남동제2투,1512,1066,405,580,37,0,22,0,0,0,4,2,0,1,1051,15,446
4800,경상남도,4822,창원시성산구,,웅남동제3투,1261,839,269,504,23,0,16,1,2,0,3,0,0,0,818,21,422
4800,경상남도,4822,창원시성산구,,웅남동제4투,398,300,86,196,2,0,9,0,0,0,0,1,0,1,295,5,98
4800,경상남도,4822,창원시성산구,용지동,소계,22760,17269,6188,10105,540,3,181,9,3,10,17,20,4,6,17086,183,5491
4800,경상남도,4822,창원시성산구,,관내사전투표,6207,6206,2579,3368,168,0,31,2,1,1,2,10,1,3,6166,40,1
4800,경상남도,4822,창원시성산구,,용지동제1투,3136,2217,765,1345,69,0,13,0,1,1,2,2,1,0,2199,18,919
4800,경상남도,4822,창원시성산구,,용지동제2투,2027,1302,399,821,32,0,18,0,0,2,3,2,1,0,1278,24,725
4800,경상남도,4822,창원시성산구,,용지동제3투,2377,1587,541,916,71,1,27,1,0,3,1,0,1,1,1563,24,790
4800,경상남도,4822,창원시성산구,,용지동제4투,2254,1510,514,907,40,0,19,4,1,1,0,3,0,0,1489,21,744
4800,경상남도,4822,창원시성산구,,용지동제5투,2991,1874,562,1179,62,0,36,1,0,0,5,1,0,2,1848,26,1117
4800,경상남도,4822,창원시성산구,,용지동제6투,2388,1728,537,1087,60,1,17,0,0,2,2,2,0,0,1708,20,660
4800,경상남도,4822,창원시성산구,,용지동제7투,1380,845,291,482,38,1,20,1,0,0,2,0,0,0,835,10,535
4800,경상남도,4822,창원시성산구,잘못 투입·구분된 투표지,,0,1,0,1,0,0,0,0,0,0,0,0,0,0,1,0,-1
4800,경상남도,4823,창원시마산합포구,합계,,156984,120928,37657,77518,2618,48,1469,33,20,31,143,154,68,60,119819,1109,36056
4800,경상남도,4823,창원시마산합포구,거소·선상투표,,496,456,125,244,11,3,13,0,1,2,0,1,1,0,401,55,40
4800,경상남도,4823,창원시마산합포구,관외사전투표,,11616,11615,4235,6716,319,9,176,2,4,2,12,20,6,8,11509,106,1
4800,경상남도,4823,창원시마산합포구,재외투표,,740,453,233,164,7,0,1,0,0,1,0,0,0,0,406,47,287
4800,경상남도,4823,창원시마산합포구,구산면,소계,3472,2547,590,1870,22,0,16,2,0,3,2,3,4,4,2516,31,925
4800,경상남도,4823,창원시마산합포구,,관내사전투표,791,791,239,526,6,0,8,2,0,1,0,1,1,1,785,6,0
4800,경상남도,4823,창원시마산합포구,,구산면제1투,904,593,125,442,10,0,5,0,0,0,1,1,2,0,586,7,311
4800,경상남도,4823,창원시마산합포구,,구산면제2투,1777,1163,226,902,6,0,3,0,0,2,1,1,1,3,1145,18,614
4800,경상남도,4823,창원시마산합포구,진동면,소계,9745,7209,2310,4556,140,2,117,2,0,2,5,10,4,7,7155,54,2536
4800,경상남도,4823,창원시마산합포구,,관내사전투표,3290,3290,1183,1963,63,1,45,0,0,1,2,8,1,3,3270,20,0
4800,경상남도,4823,창원시마산합포구,,진동면제1투,710,495,98,376,7,0,6,0,0,0,0,0,1,2,490,5,215
4800,경상남도,4823,창원시마산합포구,,진동면제2투,2289,1373,347,964,26,0,20,2,0,0,1,0,1,0,1361,12,916
4800,경상남도,4823,창원시마산합포구,,진동면제3투,1389,797,198,553,14,0,19,0,0,0,2,2,0,2,790,7,592
4800,경상남도,4823,창원시마산합포구,,진동면제4투,2067,1254,484,700,30,1,27,0,0,1,0,0,1,0,1244,10,813
4800,경상남도,4823,창원시마산합포구,진북면,소계,2943,2080,500,1470,39,2,31,0,1,1,2,5,3,3,2057,23,863
4800,경상남도,4823,창원시마산합포구,,관내사전투표,951,951,277,638,15,2,7,0,0,0,0,2,2,3,946,5,0
4800,경상남도,4823,창원시마산합포구,,진북면제1투,1377,780,158,568,19,0,16,0,0,1,1,1,0,0,764,16,597
4800,경상남도,4823,창원시마산합포구,,진북면제2투,615,349,65,264,5,0,8,0,1,0,1,2,1,0,347,2,266
4800,경상남도,4823,창원시마산합포구,진전면,소계,3190,2428,508,1807,40,3,24,5,0,0,3,0,8,1,2399,29,762
4800,경상남도,4823,창원시마산합포구,,관내사전투표,1048,1048,251,752,14,2,8,3,0,0,1,0,2,0,1033,15,0
4800,경상남도,4823,창원시마산합포구,,진전면제1투,1154,700,129,535,13,0,10,0,0,0,1,0,2,1,691,9,454
4800,경상남도,4823,창원시마산합포구,,진전면제2투,988,680,128,520,13,1,6,2,0,0,1,0,4,0,675,5,308
4800,경상남도,4823,창원시마산합포구,현동,소계,10459,8310,3169,4743,209,2,96,1,1,0,8,11,7,2,8249,61,2149
4800,경상남도,4823,창원시마산합포구,,관내사전투표,4198,4197,1707,2329,94,1,33,0,1,0,1,4,4,1,4175,22,1
4800,경상남도,4823,창원시마산합포구,,현동제1투,1945,1321,469,772,42,0,23,1,0,0,1,1,0,0,1309,12,624
4800,경상남도,4823,창원시마산합포구,,현동제2투,2250,1378,415,888,24,1,27,0,0,0,5,4,2,0,1366,12,872
4800,경상남도,4823,창원시마산합포구,,현동제3투,2066,1414,578,754,49,0,13,0,0,0,1,2,1,1,1399,15,652
4800,경상남도,4823,창원시마산합포구,가포동,소계,1919,1576,614,888,35,1,21,0,1,0,2,3,1,1,1567,9,343
4800,경상남도,4823,창원시마산합포구,,관내사전투표,1098,1098,474,581,22,0,10,0,0,0,2,3,0,1,1093,5,0
4800,경상남도,4823,창원시마산합포구,,가포동투표소,821,478,140,307,13,1,11,0,1,0,0,0,1,0,474,4,343
4800,경상남도,4823,창원시마산합포구,월영동,소계,29920,22926,7906,13964,554,6,250,5,3,6,21,28,5,7,22755,171,6994
4800,경상남도,4823,창원시마산합포구,,관내사전투표,8798,8798,3211,5277,193,2,58,2,1,0,4,14,1,2,8765,33,0
4800,경상남도,4823,창원시마산합포구,,월영동제1투,1445,778,193,541,15,0,12,0,0,0,2,0,0,0,763,15,667
4800,경상남도,4823,창원시마산합포구,,월영동제2투,1462,925,216,659,14,1,21,0,0,2,2,1,0,2,918,7,537
4800,경상남도,4823,창원시마산합포구,,월영동제3투,2385,1553,511,942,50,1,22,0,1,0,4,0,2,1,1534,19,832
4800,경상남도,4823,창원시마산합포구,,월영동제4투,2180,1428,404,948,35,1,23,1,0,1,1,1,0,0,1415,13,752
4800,경상남도,4823,창원시마산합포구,,월영동제5투,1718,1236,360,822,25,0,8,0,0,0,2,4,0,0,1221,15,482
4800,경상남도,4823,창원시마산합포구,,월영동제6투,2540,1572,550,939,44,0,20,1,1,0,1,0,0,0,1556,16,968
4800,경상남도,4823,창원시마산합포구,,월영동제7투,1786,1087,378,644,26,1,16,1,0,2,3,1,1,0,1073,14,699
4800,경상남도,4823,창원시마산합포구,,월영동제8투,1822,1215,402,746,29,0,22,0,0,0,0,4,0,0,1203,12,607
4800,경상남도,4823,창원시마산합포구,,월영동제9투,2983,2241,893,1236,65,0,27,0,0,1,1,1,1,1,2226,15,742
4800,경상남도,4823,창원시마산합포구,,월영동제10투,2801,2093,788,1210,58,0,21,0,0,0,1,2,0,1,2081,12,708
4800,경상남도,4823,창원시마산합포구,문화동,소계,9619,7189,2068,4818,141,1,75,2,3,1,10,8,1,1,7129,60,2430
4800,경상남도,4823,창원시마산합포구,,관내사전투표,3619,3618,1113,2389,62,1,25,1,1,1,0,3,0,0,3596,22,1
4800,경상남도,4823,창원시마산합포구,,문화동제1투,2004,1156,312,770,32,0,21,0,0,0,4,1,0,1,1141,15,848
4800,경상남도,4823,창원시마산합포구,,문화동제2투,1723,1064,293,716,20,0,16,0,2,0,5,2,1,0,1055,9,659
4800,경상남도,4823,창원시마산합포구,,문화동제3투,2273,1351,350,943,27,0,13,1,0,0,1,2,0,0,1337,14,922
4800,경상남도,4823,창원시마산합포구,완월동,소계,8023,6071,1752,4037,132,1,67,0,0,3,5,17,3,3,6020,51,1952
4800,경상남도,4823,창원시마산합포구,,관내사전투표,2821,2821,942,1773,55,0,20,0,0,2,1,8,1,1,2803,18,0
4800,경상남도,4823,창원시마산합포구,,완월동제1투,1247,710,173,491,16,0,14,0,0,0,1,2,1,1,699,11,537
4800,경상남도,4823,창원시마산합포구,,완월동제2투,1767,1115,268,789,21,0,16,0,0,0,3,6,0,0,1103,12,652
4800,경상남도,4823,창원시마산합포구,,완월동제3투,2188,1425,369,984,40,1,17,0,0,1,0,1,1,1,1415,10,763
4800,경상남도,4823,창원시마산합포구,자산동,소계,8581,6479,1740,4436,122,3,91,2,1,2,18,9,4,1,6429,50,2102
4800,경상남도,4823,창원시마산합포구,,관내사전투표,2926,2926,878,1941,51,1,29,1,0,0,3,6,1,0,2911,15,0
4800,경상남도,4823,창원시마산합포구,,자산동제1투,2008,1336,322,931,28,0,26,0,1,2,10,2,1,0,1323,13,672
4800,경상남도,4823,창원시마산합포구,,자산동제2투,896,485,101,366,6,0,1,1,0,0,1,0,1,0,477,8,411
4800,경상남도,4823,창원시마산합포구,,자산동제3투,1099,665,159,464,17,1,15,0,0,0,2,0,1,1,660,5,434
4800,경상남도,4823,창원시마산합포구,,자산동제4투,1652,1067,280,734,20,1,20,0,0,0,2,1,0,0,1058,9,585
4800,경상남도,4823,창원시마산합포구,교방동,소계,12300,9300,2776,6076,215,3,110,4,1,2,6,8,6,6,9213,87,3000
4800,경상남도,4823,창원시마산합포구,,관내사전투표,3640,3640,1189,2299,88,0,31,3,0,0,1,3,2,0,3616,24,0
4800,경상남도,4823,창원시마산합포구,,교방동제1투,1688,1050,270,723,22,0,15,0,0,1,0,0,1,0,1032,18,638
4800,경상남도,4823,창원시마산합포구,,교방동제2투,1897,1248,363,817,39,0,13,1,0,0,1,1,0,1,1236,12,649
4800,경상남도,4823,창원시마산합포구,,교방동제3투,717,503,111,372,7,0,3,0,0,0,1,0,1,1,496,7,214
4800,경상남도,4823,창원시마산합포구,,교방동제4투,2421,1686,546,1051,40,2,28,0,0,1,1,3,0,2,1674,12,735
4800,경상남도,4823,창원시마산합포구,,교방동제5투,1937,1173,297,814,19,1,20,0,1,0,2,1,2,2,1159,14,764
4800,경상남도,4823,창원시마산합포구,합포동,소계,6726,5041,1561,3268,98,1,56,0,2,0,7,7,0,1,5001,40,1685
4800,경상남도,4823,창원시마산합포구,,관내사전투표,2681,2681,882,1709,39,1,25,0,1,0,4,4,0,1,2666,15,0
4800,경상남도,4823,창원시마산합포구,,합포동제1투,2702,1679,533,1061,46,0,16,0,0,0,3,2,0,0,1661,18,1023
4800,경상남도,4823,창원시마산합포구,,합포동제2투,1343,681,146,498,13,0,15,0,1,0,0,1,0,0,674,7,662
4800,경상남도,4823,창원시마산합포구,산호동,소계,10163,7445,2180,4902,157,5,99,4,0,3,11,4,6,3,7374,71,2718
4800,경상남도,4823,창원시마산합포구,,관내사전투표,3165,3165,1012,2050,50,2,22,1,0,2,3,2,4,0,3148,17,0
4800,경상남도,4823,창원시마산합포구,,산호동제1투,1820,1227,324,834,28,1,22,2,0,0,3,0,1,0,1215,12,593
4800,경상남도,4823,창원시마산합포구,,산호동제2투,1588,925,257,606,26,0,21,0,0,1,1,0,0,2,914,11,663
4800,경상남도,4823,창원시마산합포구,,산호동제3투,1967,1211,341,795,33,1,13,1,0,0,3,2,1,1,1191,20,756
4800,경상남도,4823,창원시마산합포구,,산호동제4투,1623,917,246,617,20,1,21,0,0,0,1,0,0,0,906,11,706
4800,경상남도,4823,창원시마산합포구,반월중앙동,소계,11516,8788,2562,5829,194,3,89,2,1,1,12,9,3,7,8712,76,2728
4800,경상남도,4823,창원시마산합포구,,관내사전투표,3579,3579,1156,2313,52,1,26,1,0,0,1,3,2,2,3557,22,0
4800,경상남도,4823,창원시마산합포구,,반월중앙동제1투,2493,1611,480,1040,57,0,12,0,0,0,4,0,0,1,1594,17,882
4800,경상남도,4823,창원시마산합포구,,반월중앙동제2투,974,572,121,409,17,0,12,0,1,0,2,2,0,1,565,7,402
4800,경상남도,4823,창원시마산합포구,,반월중앙동제3투,2071,1320,337,914,32,1,18,1,0,1,1,1,1,3,1310,10,751
4800,경상남도,4823,창원시마산합포구,,반월중앙동제4투,2399,1706,468,1153,36,1,21,0,0,0,4,3,0,0,1686,20,693
4800,경상남도,4823,창원시마산합포구,오동동,소계,15556,11012,2828,7727,183,3,137,2,1,2,19,11,6,5,10924,88,4544
4800,경상남도,4823,창원시마산합포구,,관내사전투표,3848,3848,1026,2712,54,0,19,1,1,1,2,4,3,1,3824,24,0
4800,경상남도,4823,창원시마산합포구,,오동동제1투,2496,1350,307,984,17,1,25,0,0,0,6,1,1,0,1342,8,1146
4800,경상남도,4823,창원시마산합포구,,오동동제2투,2008,1370,360,928,32,0,23,0,0,0,3,2,1,0,1349,21,638
4800,경상남도,4823,창원시마산합포구,,오동동제3투,1692,1298,353,892,24,1,17,0,0,1,2,1,0,0,1291,7,394
4800,경상남도,4823,창원시마산합포구,,오동동제4투,1925,1142,274,786,30,1,23,1,0,0,4,2,1,2,1124,18,783
4800,경상남도,4823,창원시마산합포구,,오동동제5투,2208,1244,362,831,20,0,20,0,0,0,1,1,0,2,1237,7,964
4800,경상남도,4823,창원시마산합포구,,오동동제6투,1379,760,146,594,6,0,10,0,0,0,1,0,0,0,757,3,619
4800,경상남도,4823,창원시마산합포구,잘못 투입·구분된 투표지,,0,3,0,3,0,0,0,0,0,0,0,0,0,0,3,0,-3
4800,경상남도,4824,창원시마산회원구,합계,,160587,125233,41527,77282,2911,87,1657,31,21,16,136,200,36,57,123961,1272,35354
4800,경상남도,4824,창원시마산회원구,거소·선상투표,,485,464,125,258,7,3,18,1,0,0,2,0,0,2,416,48,21
4800,경상남도,4824,창원시마산회원구,관외사전투표,,13627,13624,5116,7667,396,18,224,5,5,1,10,22,6,13,13483,141,3
4800,경상남도,4824,창원시마산회원구,재외투표,,458,310,169,90,11,0,1,0,0,0,1,2,0,0,274,36,148
4800,경상남도,4824,창원시마산회원구,내서읍,소계,46491,35307,13331,20128,882,28,470,5,5,5,23,74,10,12,34973,334,11184
4800,경상남도,4824,창원시마산회원구,,관내사전투표,9163,9163,3984,4846,176,6,77,2,3,0,1,10,2,4,9111,52,0
4800,경상남도,4824,창원시마산회원구,,내서읍제1투,376,293,49,230,5,0,2,0,0,0,0,0,0,1,287,6,83
4800,경상남도,4824,창원시마산회원구,,내서읍제2투,3352,2444,875,1442,65,1,26,0,1,0,1,5,0,2,2418,26,908
4800,경상남도,4824,창원시마산회원구,,내서읍제3투,2056,1470,477,890,41,0,34,0,0,0,3,6,1,0,1452,18,586
4800,경상남도,4824,창원시마산회원구,,내서읍제4투,2941,2283,845,1326,66,1,16,0,0,0,1,7,1,1,2264,19,658
4800,경상남도,4824,창원시마산회원구,,내서읍제5투,2796,1963,650,1204,46,1,35,0,0,0,1,3,2,1,1943,20,833
4800,경상남도,4824,창원시마산회원구,,내서읍제6투,2065,1487,447,960,38,0,24,0,0,0,2,2,0,0,1473,14,578
4800,경상남도,4824,창원시마산회원구,,내서읍제7투,2537,1607,492,1020,44,1,25,1,1,0,4,3,0,0,1591,16,930
4800,경상남도,4824,창원시마산회원구,,내서읍제8투,2411,1514,508,911,39,1,29,0,0,0,0,7,0,0,1495,19,897
4800,경상남도,4824,창원시마산회원구,,내서읍제9투,1910,1183,341,766,29,0,27,0,0,1,0,1,1,0,1166,17,727
4800,경상남도,4824,창원시마산회원구,,내서읍제10투,3732,2534,956,1433,67,2,45,0,0,1,2,3,1,1,2511,23,1198
4800,경상남도,4824,창원시마산회원구,,내서읍제11투,2445,1645,650,887,45,3,26,0,0,0,0,5,0,0,1616,29,800
4800,경상남도,4824,창원시마산회원구,,내서읍제12투,3463,2424,929,1347,61,5,41,1,0,1,4,6,2,0,2397,27,1039
4800,경상남도,4824,창원시마산회원구,,내서읍제13투,3413,2473,1021,1314,65,4,30,0,0,2,4,13,0,1,2454,19,940
4800,경상남도,4824,창원시마산회원구,,내서읍제14투,3214,2373,1014,1224,82,3,25,1,0,0,0,3,0,1,2353,20,841
4800,경상남도,4824,창원시마산회원구,,내서읍제15투,617,451,93,328,13,0,8,0,0,0,0,0,0,0,442,9,166
4800,경상남도,4824,창원시마산회원구,회원1동,소계,8977,6777,1734,4717,142,2,62,3,1,0,14,12,3,5,6695,82,2200
4800,경상남도,4824,창원시마산회원구,,관내사전투표,3020,3019,917,1997,50,0,19,1,0,0,1,6,0,3,2994,25,1
4800,경상남도,4824,창원시마산회원구,,회원1동제1투,2123,1426,276,1064,37,1,16,0,1,0,6,2,0,0,1403,23,697
4800,경상남도,4824,창원시마산회원구,,회원1동제2투,2127,1288,291,934,22,1,14,2,0,0,4,3,1,1,1273,15,839
4800,경상남도,4824,창원시마산회원구,,회원1동제3투,1707,1044,250,722,33,0,13,0,0,0,3,1,2,1,1025,19,663
4800,경상남도,4824,창원시마산회원구,회원2동,소계,7598,5619,1634,3720,127,2,67,1,0,1,9,3,0,3,5567,52,1979
4800,경상남도,4824,창원시마산회원구,,관내사전투표,2141,2141,686,1383,41,1,13,0,0,0,3,0,0,1,2128,13,0
4800,경상남도,4824,창원시마산회원구,,회원2동제1투,1685,937,234,651,19,0,15,1,0,0,3,1,0,1,925,12,748
4800,경상남도,4824,창원시마산회원구,,회원2동제2투,2414,1680,539,1041,47,1,29,0,0,1,1,1,0,1,1661,19,734
4800,경상남도,4824,창원시마산회원구,,회원2동제3투,1358,861,175,645,20,0,10,0,0,0,2,1,0,0,853,8,497
4800,경상남도,4824,창원시마산회원구,회성동,소계,5443,4059,1034,2832,82,6,41,2,1,0,4,7,1,4,4014,45,1384
4800,경상남도,4824,창원시마산회원구,,관내사전투표,1952,1952,567,1303,37,5,11,2,1,0,1,6,1,2,1936,16,0
4800,경상남도,4824,창원시마산회원구,,회성동제1투,1657,980,233,679,26,1,21,0,0,0,2,0,0,2,964,16,677
4800,경상남도,4824,창원시마산회원구,,회성동제2투,1345,821,170,614,17,0,8,0,0,0,1,1,0,0,811,10,524
4800,경상남도,4824,창원시마산회원구,,회성동제3투,489,306,64,236,2,0,1,0,0,0,0,0,0,0,303,3,183
4800,경상남도,4824,창원시마산회원구,양덕1동,소계,9005,6571,1928,4308,133,6,111,1,0,0,9,13,1,2,6512,59,2434
4800,경상남도,4824,창원시마산회원구,,관내사전투표,3100,3100,958,2020,57,2,35,1,0,0,3,5,1,2,3084,16,0
4800,경상남도,4824,창원시마산회원구,,양덕1동제1투,2020,1136,302,761,27,1,26,0,0,0,5,4,0,0,1126,10,884
4800,경상남도,4824,창원시마산회원구,,양덕1동제2투,2013,1226,363,802,17,2,23,0,0,0,1,2,0,0,1210,16,787
4800,경상남도,4824,창원시마산회원구,,양덕1동제3투,1872,1109,305,725,32,1,27,0,0,0,0,2,0,0,1092,17,763
4800,경상남도,4824,창원시마산회원구,양덕2동,소계,22392,17778,5795,11216,393,4,174,3,1,5,13,21,4,4,17633,145,4614
4800,경상남도,4824,창원시마산회원구,,관내사전투표,6521,6521,2366,3919,144,1,48,2,0,1,2,10,2,2,6497,24,0
4800,경상남도,4824,창원시마산회원구,,양덕2동제1투,2821,1961,685,1165,53,0,20,0,1,1,0,3,1,0,1929,32,860
4800,경상남도,4824,창원시마산회원구,,양덕2동제2투,2317,1625,443,1111,42,0,13,0,0,0,2,1,0,0,1612,13,692
4800,경상남도,4824,창원시마산회원구,,양덕2동제3투,1740,1044,310,681,13,1,17,0,0,3,2,3,0,1,1031,13,696
4800,경상남도,4824,창원시마산회원구,,양덕2동제4투,3167,2063,673,1271,37,0,48,0,0,0,4,3,1,0,2037,26,1104
4800,경상남도,4824,창원시마산회원구,,양덕2동제5투,3016,2362,616,1658,49,0,17,0,0,0,2,0,0,0,2342,20,654
4800,경상남도,4824,창원시마산회원구,,양덕2동제6투,2810,2202,702,1411,55,2,11,1,0,0,1,1,0,1,2185,17,608
4800,경상남도,4824,창원시마산회원구,합성1동,소계,7705,5833,1844,3743,118,3,63,0,0,1,12,8,1,1,5794,39,1872
4800,경상남도,4824,창원시마산회원구,,관내사전투표,2883,2883,968,1819,56,0,17,0,0,1,1,6,1,0,2869,14,0
4800,경상남도,4824,창원시마산회원구,,합성1동제1투,1738,1005,291,662,18,1,21,0,0,0,5,1,0,0,999,6,733
4800,경상남도,4824,창원시마산회원구,,합성1동제2투,3084,1945,585,1262,44,2,25,0,0,0,6,1,0,1,1926,19,1139
4800,경상남도,4824,창원시마산회원구,합성2동,소계,6862,5054,1367,3422,104,3,75,2,2,2,10,7,4,3,5001,53,1808
4800,경상남도,4824,창원시마산회원구,,관내사전투표,2534,2533,738,1690,45,2,26,1,0,0,3,4,2,3,2514,19,1
4800,경상남도,4824,창원시마산회원구,,합성2동제1투,1976,1204,294,838,28,1,18,0,2,1,4,1,1,0,1188,16,772
4800,경상남도,4824,창원시마산회원구,,합성2동제2투,2352,1317,335,894,31,0,31,1,0,1,3,2,1,0,1299,18,1035
4800,경상남도,4824,창원시마산회원구,구암1동,소계,7633,5854,1824,3727,119,0,110,0,1,1,9,7,1,2,5801,53,1779
4800,경상남도,4824,창원시마산회원구,,관내사전투표,2316,2316,814,1411,45,0,21,0,0,1,2,6,0,0,2300,16,0
4800,경상남도,4824,창원시마산회원구,,구암1동제1투,1609,987,274,658,17,0,21,0,0,0,6,1,0,1,978,9,622
4800,경상남도,4824,창원시마산회원구,,구암1동제2투,1357,906,225,626,12,0,28,0,0,0,0,0,1,0,892,14,451
4800,경상남도,4824,창원시마산회원구,,구암1동제3투,2351,1645,511,1032,45,0,40,0,1,0,1,0,0,1,1631,14,706
4800,경상남도,4824,창원시마산회원구,구암2동,소계,7198,5389,1783,3315,140,2,72,1,1,0,7,9,2,1,5333,56,1809
4800,경상남도,4824,창원시마산회원구,,관내사전투표,1947,1946,749,1122,38,0,23,0,0,0,3,1,1,1,1938,8,1
4800,경상남도,4824,창원시마산회원구,,구암2동제1투,1776,1184,368,737,39,1,14,1,1,0,2,4,0,0,1167,17,592
4800,경상남도,4824,창원시마산회원구,,구암2동제2투,2262,1465,440,937,44,1,21,0,0,0,1,0,0,0,1444,21,797
4800,경상남도,4824,창원시마산회원구,,구암2동제3투,1213,794,226,519,19,0,14,0,0,0,1,4,1,0,784,10,419
4800,경상남도,4824,창원시마산회원구,봉암동,소계,2961,2139,661,1380,32,2,32,2,0,0,2,1,1,0,2113,26,822
4800,경상남도,4824,창원시마산회원구,,관내사전투표,969,969,369,561,16,1,13,2,0,0,2,0,1,0,965,4,0
4800,경상남도,4824,창원시마산회원구,,봉암동제1투,856,474,134,315,6,0,9,0,0,0,0,1,0,0,465,9,382
4800,경상남도,4824,창원시마산회원구,,봉암동제2투,1136,696,158,504,10,1,10,0,0,0,0,0,0,0,683,13,440
4800,경상남도,4824,창원시마산회원구,석전동,소계,13752,10453,3181,6758,225,8,137,5,4,0,11,14,2,5,10350,103,3299
4800,경상남도,4824,창원시마산회원구,,관내사전투표,4249,4247,1412,2682,85,2,34,4,0,0,2,2,1,1,4225,22,2
4800,경상남도,4824,창원시마산회원구,,석전동제1투,890,601,185,386,8,0,14,0,0,0,1,0,1,1,596,5,289
4800,경상남도,4824,창원시마산회원구,,석전동제2투,2832,2031,674,1243,60,1,27,0,0,0,0,6,0,0,2011,20,801
4800,경상남도,4824,창원시마산회원구,,석전동제3투,1387,958,253,654,21,1,11,0,1,0,1,1,0,0,943,15,429
4800,경상남도,4824,창원시마산회원구,,석전동제4투,1072,701,182,470,13,2,13,1,3,0,3,0,0,0,687,14,371
4800,경상남도,4824,창원시마산회원구,,석전동제5투,1123,624,136,457,9,2,12,0,0,0,0,0,0,0,616,8,499
4800,경상남도,4824,창원시마산회원구,,석전동제6투,2199,1291,339,866,29,0,26,0,0,0,4,5,0,3,1272,19,908
4800,경상남도,4824,창원시마산회원구,잘못 투입·구분된 투표지,,0,2,1,1,0,0,0,0,0,0,0,0,0,0,2,0,-2
4800,경상남도,4825,창원시진해구,합계,,159611,119212,45890,66298,3075,53,1956,41,21,36,90,214,46,74,117794,1418,40399
4800,경상남도,4825,창원시진해구,거소·선상투표,,2733,2638,771,1221,94,3,175,1,4,2,2,6,1,14,2294,344,95
4800,경상남도,4825,창원시진해구,관외사전투표,,10350,10347,4314,5391,304,6,180,1,2,1,0,17,7,6,10229,118,3
4800,경상남도,4825,창원시진해구,재외투표,,610,432,199,157,13,0,4,0,0,0,0,1,1,0,375,57,178
4800,경상남도,4825,창원시진해구,충무동,소계,12536,9215,2926,5808,208,2,123,3,0,3,10,22,5,11,9121,94,3321
4800,경상남도,4825,창원시진해구,,관내사전투표,3873,3873,1387,2297,96,1,48,1,0,0,0,12,2,2,3846,27,0
4800,경상남도,4825,창원시진해구,,충무동제1투,2139,1314,328,927,15,0,17,0,0,0,5,4,0,3,1299,15,825
4800,경상남도,4825,창원시진해구,,충무동제2투,3011,1719,556,1053,51,0,26,1,0,1,4,5,0,1,1698,21,1292
4800,경상남도,4825,창원시진해구,,충무동제3투,1797,1139,305,785,20,1,15,1,0,0,0,0,1,2,1130,9,658
4800,경상남도,4825,창원시진해구,,충무동제4투,1716,1170,350,746,26,0,17,0,0,2,1,1,2,3,1148,22,546
4800,경상남도,4825,창원시진해구,여좌동,소계,7196,5390,1551,3590,116,3,59,2,0,1,6,11,1,3,5343,47,1806
4800,경상남도,4825,창원시진해구,,관내사전투표,2425,2425,811,1508,57,1,17,2,0,0,2,4,0,2,2404,21,0
4800,경상남도,4825,창원시진해구,,여좌동제1투,922,561,149,384,11,0,8,0,0,1,0,2,0,1,556,5,361
4800,경상남도,4825,창원시진해구,,여좌동제2투,1707,1036,264,725,17,0,15,0,0,0,2,2,1,0,1026,10,671
4800,경상남도,4825,창원시진해구,,여좌동제3투,2142,1368,327,973,31,2,19,0,0,0,2,3,0,0,1357,11,774
4800,경상남도,4825,창원시진해구,태백동,소계,3793,2789,818,1844,56,1,39,1,1,2,4,8,1,0,2775,14,1004
4800,경상남도,4825,창원시진해구,,관내사전투표,1428,1428,462,915,27,0,15,0,0,2,1,2,0,0,1424,4,0
4800,경상남도,4825,창원시진해구,,태백동제1투,1603,916,232,634,22,0,16,1,0,0,2,3,0,0,910,6,687
4800,경상남도,4825,창원시진해구,,태백동제2투,762,445,124,295,7,1,8,0,1,0,1,3,1,0,441,4,317
4800,경상남도,4825,창원시진해구,경화동,소계,8783,6627,2287,3956,174,4,108,1,2,4,12,20,8,0,6576,51,2156
4800,경상남도,4825,창원시진해구,,관내사전투표,3291,3291,1241,1895,73,1,41,0,1,3,5,8,2,0,3270,21,0
4800,경상남도,4825,창원시진해구,,경화동제1투,2141,1233,296,844,32,1,31,1,1,0,5,4,4,0,1219,14,908
4800,경상남도,4825,창원시진해구,,경화동제2투,3351,2103,750,1217,69,2,36,0,0,1,2,8,2,0,2087,16,1248
4800,경상남도,4825,창원시진해구,병암동,소계,5699,4083,1431,2428,102,0,67,1,4,2,3,3,0,5,4046,37,1616
4800,경상남도,4825,창원시진해구,,관내사전투표,1858,1858,728,1040,57,0,21,1,0,0,0,1,0,3,1851,7,0
4800,경상남도,4825,창원시진해구,,병암동제1투,1822,1146,359,726,21,0,23,0,1,2,2,0,0,0,1134,12,676
4800,경상남도,4825,창원시진해구,,병암동제2투,2019,1079,344,662,24,0,23,0,3,0,1,2,0,2,1061,18,940
4800,경상남도,4825,창원시진해구,석동,소계,12959,9933,3945,5497,251,5,116,3,0,4,2,16,3,2,9844,89,3026
4800,경상남도,4825,창원시진해구,,관내사전투표,4450,4450,1968,2304,107,3,40,2,0,0,0,8,1,1,4434,16,0
4800,경상남도,4825,창원시진해구,,석동제1투,2989,1665,541,1026,38,2,23,1,0,2,1,2,0,1,1637,28,1324
4800,경상남도,4825,창원시진해구,,석동제2투,2941,1920,744,1050,60,0,33,0,0,0,0,6,0,0,1893,27,1021
4800,경상남도,4825,창원시진해구,,석동제3투,2579,1898,692,1117,46,0,20,0,0,2,1,0,2,0,1880,18,681
4800,경상남도,4825,창원시진해구,이동,소계,7058,4985,1523,3191,107,3,86,4,1,3,9,9,1,3,4940,45,2073
4800,경상남도,4825,창원시진해구,,관내사전투표,1903,1903,706,1130,36,1,15,2,0,0,1,5,0,0,1896,7,0
4800,경상남도,4825,창원시진해구,,이동제1투,1844,995,290,648,19,0,19,1,0,0,3,4,1,1,986,9,849
4800,경상남도,4825,창원시진해구,,이동제2투,1534,895,224,605,23,0,25,0,0,3,0,0,0,1,881,14,639
4800,경상남도,4825,창원시진해구,,이동제3투,1777,1192,303,808,29,2,27,1,1,0,5,0,0,1,1177,15,585
4800,경상남도,4825,창원시진해구,자은동,소계,15414,11675,4778,6292,331,6,130,1,2,1,8,21,2,4,11576,99,3739
4800,경상남도,4825,창원시진해구,,관내사전투표,4460,4460,1930,2345,105,2,41,0,0,1,2,12,0,0,4438,22,0
4800,경상남도,4825,창원시진해구,,자은동제1투,2258,1405,472,847,31,0,28,0,0,0,0,2,1,0,1381,24,853
4800,경상남도,4825,창원시진해구,,자은동제2투,2897,1720,576,1047,46,0,22,0,1,0,2,3,1,2,1700,20,1177
4800,경상남도,4825,창원시진해구,,자은동제3투,2997,2287,1073,1081,85,3,18,0,1,0,0,4,0,2,2267,20,710
4800,경상남도,4825,창원시진해구,,자은동제4투,2802,1803,727,972,64,1,21,1,0,0,4,0,0,0,1790,13,999
4800,경상남도,4825,창원시진해구,덕산동,소계,8054,6061,2131,3565,167,3,109,4,0,0,9,12,0,2,6002,59,1993
4800,경상남도,4825,창원시진해구,,관내사전투표,3185,3185,1213,1817,82,3,34,2,0,0,2,2,0,2,3157,28,0
4800,경상남도,4825,창원시진해구,,덕산동제1투,2793,1694,529,1030,55,0,52,1,0,0,6,3,0,0,1676,18,1099
4800,경상남도,4825,창원시진해구,,덕산동제2투,2076,1182,389,718,30,0,23,1,0,0,1,7,0,0,1169,13,894
4800,경상남도,4825,창원시진해구,풍호동,소계,17300,13316,5206,7387,405,1,165,4,1,5,5,23,5,10,13217,99,3984
4800,경상남도,4825,창원시진해구,,관내사전투표,5287,5287,2298,2720,157,1,70,0,0,1,3,6,2,4,5262,25,0
4800,경상남도,4825,창원시진해구,,풍호동제1투,2819,1760,590,1065,46,0,25,2,1,2,1,2,1,1,1736,24,1059
4800,경상남도,4825,창원시진해구,,풍호동제2투,2516,1784,545,1130,57,0,27,1,0,1,1,8,1,0,1771,13,732
4800,경상남도,4825,창원시진해구,,풍호동제3투,3354,2197,828,1255,72,0,21,1,0,0,0,4,1,3,2185,12,1157
4800,경상남도,4825,창원시진해구,,풍호동제4투,3324,2288,945,1217,73,0,22,0,0,1,0,3,0,2,2263,25,1036
4800,경상남도,4825,창원시진해구,웅천동,소계,9315,6702,2574,3766,176,2,104,1,1,0,5,15,2,1,6647,55,2613
4800,경상남도,4825,창원시진해구,,관내사전투표,2967,2967,1226,1615,56,2,38,0,0,0,2,4,1,1,2945,22,0
4800,경상남도,4825,창원시진해구,,웅천동제1투,1744,944,215,695,16,0,4,1,0,0,2,2,0,0,935,9,800
4800,경상남도,4825,창원시진해구,,웅천동제2투,2694,1685,703,877,57,0,29,0,0,0,0,6,0,0,1672,13,1009
4800,경상남도,4825,창원시진해구,,웅천동제3투,1910,1106,430,579,47,0,33,0,1,0,1,3,1,0,1095,11,804
4800,경상남도,4825,창원시진해구,웅동1동,소계,5742,3980,1491,2273,92,1,72,1,0,3,0,9,4,4,3950,30,1762
4800,경상남도,4825,창원시진해구,,관내사전투표,1959,1959,798,1073,45,1,24,1,0,0,0,2,0,2,1946,13,0
4800,경상남도,4825,창원시진해구,,웅동1동제1투,1958,1089,419,599,25,0,28,0,0,2,0,3,3,0,1079,10,869
4800,경상남도,4825,창원시진해구,,웅동1동제2투,1825,932,274,601,22,0,20,0,0,1,0,4,1,2,925,7,893
4800,경상남도,4825,창원시진해구,웅동2동,소계,32069,21037,9945,9930,479,13,419,13,3,5,15,21,5,9,20857,180,11032
4800,경상남도,4825,창원시진해구,,관내사전투표,7727,7727,4056,3364,159,2,94,3,2,0,1,9,0,1,7691,36,0
4800,경상남도,4825,창원시진해구,,웅동2동제1투,1437,683,224,423,5,0,16,1,0,0,3,0,1,0,673,10,754
4800,경상남도,4825,창원시진해구,,웅동2동제2투,3691,2106,916,1059,47,2,41,4,0,1,4,1,1,1,2077,29,1585
4800,경상남도,4825,창원시진해구,,웅동2동제3투,3417,2171,1002,1047,60,1,31,1,0,0,2,1,3,3,2151,20,1246
4800,경상남도,4825,창원시진해구,,웅동2동제4투,2710,1468,671,709,41,1,26,1,0,2,1,5,0,1,1458,10,1242
4800,경상남도,4825,창원시진해구,,웅동2동제5투,2035,1233,525,627,37,1,24,0,0,0,0,2,0,1,1217,16,802
4800,경상남도,4825,창원시진해구,,웅동2동제6투,3153,1242,471,676,14,3,53,1,1,0,2,2,0,2,1225,17,1911
4800,경상남도,4825,창원시진해구,,웅동2동제7투,3924,2144,981,1014,60,3,61,2,0,2,0,1,0,0,2124,20,1780
4800,경상남도,4825,창원시진해구,,웅동2동제8투,3975,2263,1099,1011,56,0,73,0,0,0,2,0,0,0,2241,22,1712
4800,경상남도,4825,창원시진해구,잘못 투입·구분된 투표지,,0,2,0,2,0,0,0,0,0,0,0,0,0,0,2,0,-2
4800,경상남도,4803,진주시,합계,,292842,228238,74975,141433,5578,105,2573,76,40,33,184,500,125,138,225760,2478,64604
4800,경상남도,4803,진주시,거소·선상투표,,592,532,119,317,10,0,11,0,0,1,1,1,1,1,462,70,60
4800,경상남도,4803,진주시,관외사전투표,,19145,19139,7207,10672,603,15,310,15,7,4,10,24,8,17,18892,247,6
4800,경상남도,4803,진주시,재외투표,,1071,635,322,223,22,0,1,0,0,0,0,1,0,0,569,66,436
4800,경상남도,4803,진주시,문산읍,소계,7378,5619,1882,3428,125,4,75,4,2,0,6,14,2,11,5553,66,1759
4800,경상남도,4803,진주시,,관내사전투표,2817,2817,1139,1514,72,4,33,2,0,0,3,6,1,8,2782,35,0
4800,경상남도,4803,진주시,,문산읍제1투,2345,1360,343,951,25,0,22,1,0,0,2,2,1,3,1350,10,985
4800,경상남도,4803,진주시,,문산읍제2투,2216,1442,400,963,28,0,20,1,2,0,1,6,0,0,1421,21,774
4800,경상남도,4803,진주시,내동면,소계,3620,3044,1048,1871,70,0,26,0,0,0,0,13,4,0,3032,12,576
4800,경상남도,4803,진주시,,관내사전투표,1897,1896,725,1116,39,0,8,0,0,0,0,4,1,0,1893,3,1
4800,경상남도,4803,진주시,,내동면투표소,1723,1148,323,755,31,0,18,0,0,0,0,9,3,0,1139,9,575
4800,경상남도,4803,진주시,정촌면,소계,7095,5529,1908,3315,140,2,89,2,0,0,3,11,3,7,5480,49,1566
4800,경상남도,4803,진주시,,관내사전투표,2912,2912,1080,1708,70,1,25,0,0,0,0,8,2,1,2895,17,0
4800,경상남도,4803,진주시,,정촌면제1투,1179,738,168,541,9,0,10,0,0,0,0,0,0,4,732,6,441
4800,경상남도,4803,진주시,,정촌면제2투,3004,1879,660,1066,61,1,54,2,0,0,3,3,1,2,1853,26,1125
4800,경상남도,4803,진주시,금곡면,소계,2017,1533,359,1090,22,0,16,0,2,1,2,17,3,1,1513,20,484
4800,경상남도,4803,진주시,,관내사전투표,721,721,182,504,11,0,8,0,0,0,1,6,2,0,714,7,0
4800,경상남도,4803,진주시,,금곡면투표소,1296,812,177,586,11,0,8,0,2,1,1,11,1,1,799,13,484
4800,경상남도,4803,진주시,진성면,소계,1819,1422,389,948,37,0,13,2,0,0,0,13,3,0,1405,17,397
4800,경상남도,4803,진주시,,관내사전투표,829,829,243,543,22,0,3,0,0,0,0,9,2,0,822,7,0
4800,경상남도,4803,진주시,,진성면투표소,990,593,146,405,15,0,10,2,0,0,0,4,1,0,583,10,397
4800,경상남도,4803,진주시,일반성면,소계,2548,2037,553,1384,44,4,20,2,0,0,0,3,4,4,2018,19,511
4800,경상남도,4803,진주시,,관내사전투표,1266,1266,365,853,28,3,6,1,0,0,0,1,0,0,1257,9,0
4800,경상남도,4803,진주시,,일반성면투표소,1282,771,188,531,16,1,14,1,0,0,0,2,4,4,761,10,511
4800,경상남도,4803,진주시,이반성면,소계,1358,1041,287,701,18,3,8,0,0,0,0,1,3,1,1022,19,317
4800,경상남도,4803,진주시,,관내사전투표,593,593,182,382,11,3,1,0,0,0,0,1,2,1,583,10,0
4800,경상남도,4803,진주시,,이반성면투표소,765,448,105,319,7,0,7,0,0,0,0,0,1,0,439,9,317
4800,경상남도,4803,진주시,사봉면,소계,1387,1087,330,711,17,2,11,3,1,1,0,2,0,1,1079,8,300
4800,경상남도,4803,진주시,,관내사전투표,640,640,217,402,7,2,4,2,0,1,0,1,0,1,637,3,0
4800,경상남도,4803,진주시,,사봉면투표소,747,447,113,309,10,0,7,1,1,0,0,1,0,0,442,5,300
4800,경상남도,4803,진주시,지수면,소계,1274,988,305,588,28,1,31,1,0,0,4,14,2,2,976,12,286
4800,경상남도,4803,진주시,,관내사전투표,503,503,180,282,15,0,10,1,0,0,1,8,2,0,499,4,0
4800,경상남도,4803,진주시,,지수면투표소,771,485,125,306,13,1,21,0,0,0,3,6,0,2,477,8,286
4800,경상남도,4803,진주시,대곡면,소계,3037,2293,600,1573,47,0,26,4,1,0,2,5,3,5,2266,27,744
4800,경상남도,4803,진주시,,관내사전투표,1158,1158,350,759,24,0,11,1,0,0,2,2,0,1,1150,8,0
4800,경상남도,4803,진주시,,대곡면투표소,1879,1135,250,814,23,0,15,3,1,0,0,3,3,4,1116,19,744
4800,경상남도,4803,진주시,금산면,소계,14870,11319,4245,6504,265,6,135,3,0,0,3,48,4,7,11220,99,3551
4800,경상남도,4803,진주시,,관내사전투표,5309,5309,2208,2881,115,3,46,2,0,0,1,22,1,3,5282,27,0
4800,경상남도,4803,진주시,,금산면제1투,2172,1308,377,848,32,2,18,0,0,0,0,4,1,2,1284,24,864
4800,경상남도,4803,진주시,,금산면제2투,2810,1678,546,1034,41,1,30,1,0,0,0,9,1,1,1664,14,1132
4800,경상남도,4803,진주시,,금산면제3투,1956,1304,439,782,33,0,23,0,0,0,1,8,0,0,1286,18,652
4800,경상남도,4803,진주시,,금산면제4투,2623,1720,675,959,44,0,18,0,0,0,1,5,1,1,1704,16,903
4800,경상남도,4803,진주시,집현면,소계,3791,2785,762,1881,53,0,32,1,2,1,1,9,5,2,2749,36,1006
4800,경상남도,4803,진주시,,관내사전투표,1457,1457,453,941,28,0,14,1,1,1,1,4,3,1,1448,9,0
4800,경상남도,4803,진주시,,집현면투표소,2334,1328,309,940,25,0,18,0,1,0,0,5,2,1,1301,27,1006
4800,경상남도,4803,진주시,미천면,소계,1327,1000,214,731,21,1,7,0,0,0,2,3,6,2,987,13,327
4800,경상남도,4803,진주시,,관내사전투표,498,498,117,359,11,1,0,0,0,0,1,1,2,0,492,6,0
4800,경상남도,4803,진주시,,미천면투표소,829,502,97,372,10,0,7,0,0,0,1,2,4,2,495,7,327
4800,경상남도,4803,진주시,명석면,소계,3623,2798,640,2037,52,0,23,0,1,0,1,9,6,3,2772,26,825
4800,경상남도,4803,진주시,,관내사전투표,1620,1619,415,1135,33,0,9,0,0,0,1,5,2,1,1601,18,1
4800,경상남도,4803,진주시,,명석면투표소,2003,1179,225,902,19,0,14,0,1,0,0,4,4,2,1171,8,824
4800,경상남도,4803,진주시,대평면,소계,977,793,209,538,11,1,11,1,0,0,0,2,1,1,775,18,184
4800,경상남도,4803,진주시,,관내사전투표,501,501,143,331,9,1,6,1,0,0,0,1,1,0,493,8,0
4800,경상남도,4803,진주시,,대평면투표소,476,292,66,207,2,0,5,0,0,0,0,1,0,1,282,10,184
4800,경상남도,4803,진주시,수곡면,소계,2034,1603,467,1078,19,0,11,0,0,0,0,4,4,3,1586,17,431
4800,경상남도,4803,진주시,,관내사전투표,863,863,282,553,10,0,4,0,0,0,0,3,1,2,855,8,0
4800,경상남도,4803,진주시,,수곡면투표소,1171,740,185,525,9,0,7,0,0,0,0,1,3,1,731,9,431
4800,경상남도,4803,진주시,중앙동,소계,10040,7435,1694,5408,128,3,93,1,0,3,11,16,3,4,7364,71,2605
4800,경상남도,4803,진주시,,관내사전투표,3301,3301,811,2371,56,1,23,0,0,1,3,6,1,1,3274,27,0
4800,경상남도,4803,진주시,,중앙동제1투,1720,1020,203,768,15,1,16,0,0,0,2,4,0,1,1010,10,700
4800,경상남도,4803,진주시,,중앙동제2투,2041,1278,275,943,18,0,21,1,0,1,2,1,0,2,1264,14,763
4800,경상남도,4803,진주시,,중앙동제3투,1399,865,159,660,17,1,14,0,0,1,0,1,1,0,854,11,534
4800,경상남도,4803,진주시,,중앙동제4투,1579,971,246,666,22,0,19,0,0,0,4,4,1,0,962,9,608
4800,경상남도,4803,진주시,상평동,소계,9951,7614,2230,5002,184,1,90,0,2,1,10,21,2,5,7548,66,2337
4800,경상남도,4803,진주시,,관내사전투표,3768,3768,1214,2403,82,0,33,0,0,0,6,12,0,1,3751,17,0
4800,경상남도,4803,진주시,,상평동제1투,1665,985,222,699,28,1,16,0,1,1,0,4,2,0,974,11,680
4800,경상남도,4803,진주시,,상평동제2투,1909,1217,292,856,32,0,17,0,0,0,2,2,0,1,1202,15,692
4800,경상남도,4803,진주시,,상평동제3투,2609,1644,502,1044,42,0,24,0,1,0,2,3,0,3,1621,23,965
4800,경상남도,4803,진주시,초장동,소계,18554,14657,5456,8465,410,5,145,0,2,2,9,28,2,6,14530,127,3897
4800,경상남도,4803,진주시,,관내사전투표,6304,6303,2498,3535,167,4,46,0,1,0,1,9,1,2,6264,39,1
4800,경상남도,4803,진주시,,초장동제1투,2319,1429,394,942,39,1,16,0,0,2,1,7,0,0,1402,27,890
4800,경상남도,4803,진주시,,초장동제2투,2009,1363,388,912,31,0,16,0,1,0,0,1,0,1,1350,13,646
4800,경상남도,4803,진주시,,초장동제3투,2164,1581,549,961,35,0,21,0,0,0,3,2,0,2,1573,8,583
4800,경상남도,4803,진주시,,초장동제4투,2751,1796,708,975,70,0,19,0,0,0,2,2,0,0,1776,20,955
4800,경상남도,4803,진주시,,초장동제5투,3007,2185,919,1140,68,0,27,0,0,0,2,7,1,1,2165,20,822
4800,경상남도,4803,진주시,평거동,소계,19865,15073,5290,9063,378,4,129,5,1,3,17,14,5,4,14913,160,4792
4800,경상남도,4803,진주시,,관내사전투표,6855,6855,2696,3902,136,2,53,3,1,0,4,7,1,3,6808,47,0
4800,경상남도,4803,진주시,,평거동제1투,3185,1869,585,1178,59,0,18,1,0,1,5,1,3,0,1851,18,1316
4800,경상남도,4803,진주시,,평거동제2투,2852,1938,632,1185,67,0,24,0,0,0,4,2,1,0,1915,23,914
4800,경상남도,4803,진주시,,평거동제3투,2038,1291,417,802,38,0,7,1,0,0,1,2,0,1,1269,22,747
4800,경상남도,4803,진주시,,평거동제4투,2289,1375,425,871,32,2,16,0,0,1,2,1,0,0,1350,25,914
4800,경상남도,4803,진주시,,평거동제5투,2646,1745,535,1125,46,0,11,0,0,1,1,1,0,0,1720,25,901
4800,경상남도,4803,진주시,신안동,소계,10037,7920,2251,5352,157,2,77,0,1,2,5,14,1,2,7864,56,2117
4800,경상남도,4803,진주시,,관내사전투표,3937,3936,1216,2594,73,0,30,0,1,0,1,4,0,1,3920,16,1
4800,경상남도,4803,진주시,,신안동제1투,2573,1794,486,1231,37,1,13,0,0,0,2,6,0,1,1777,17,779
4800,경상남도,4803,진주시,,신안동제2투,1840,1200,298,833,31,0,18,0,0,1,1,3,0,0,1185,15,640
4800,경상남도,4803,진주시,,신안동제3투,1687,990,251,694,16,1,16,0,0,1,1,1,1,0,982,8,697
4800,경상남도,4803,진주시,이현동,소계,9108,6900,1977,4607,143,0,85,5,0,3,5,13,4,7,6849,51,2208
4800,경상남도,4803,진주시,,관내사전투표,3167,3167,975,2069,62,0,26,3,0,2,2,3,3,1,3146,21,0
4800,경상남도,4803,진주시,,이현동제1투,2218,1523,469,985,39,0,11,0,0,0,1,2,0,2,1509,14,695
4800,경상남도,4803,진주시,,이현동제2투,1822,1063,231,766,22,0,22,2,0,1,0,7,1,0,1052,11,759
4800,경상남도,4803,진주시,,이현동제3투,1901,1147,302,787,20,0,26,0,0,0,2,1,0,4,1142,5,754
4800,경상남도,4803,진주시,판문동,소계,14676,11472,4313,6586,312,7,92,5,5,0,11,20,5,6,11362,110,3204
4800,경상남도,4803,진주시,,관내사전투표,4763,4763,1926,2633,130,0,21,3,1,0,1,13,1,2,4731,32,0
4800,경상남도,4803,진주시,,판문동제1투,1981,1254,369,797,31,4,17,1,1,0,4,1,3,3,1231,23,727
4800,경상남도,4803,진주시,,판문동제2투,2056,1330,368,890,28,1,16,0,1,0,1,1,1,1,1308,22,726
4800,경상남도,4803,진주시,,판문동제3투,1850,1157,463,630,36,0,13,0,0,0,2,4,0,0,1148,9,693
4800,경상남도,4803,진주시,,판문동제4투,2353,1820,713,1010,58,1,15,1,2,0,2,1,0,0,1803,17,533
4800,경상남도,4803,진주시,,판문동제5투,1673,1148,474,626,29,1,10,0,0,0,1,0,0,0,1141,7,525
4800,경상남도,4803,진주시,가호동,소계,21265,16323,5901,9438,491,10,177,3,0,1,12,37,5,7,16082,241,4942
4800,경상남도,4803,진주시,,관내사전투표,5797,5796,2408,3060,189,3,42,2,0,0,1,15,2,2,5724,72,1
4800,경상남도,4803,진주시,,가호동제1투,2655,1835,666,1054,67,0,22,0,0,0,2,0,0,1,1812,23,820
4800,경상남도,4803,진주시,,가호동제2투,3121,1782,481,1182,39,1,31,1,0,0,2,7,0,1,1745,37,1339
4800,경상남도,4803,진주시,,가호동제3투,2981,2130,618,1379,58,1,25,0,0,1,4,3,3,1,2093,37,851
4800,경상남도,4803,진주시,,가호동제4투,2377,1610,531,968,45,2,25,0,0,0,0,4,0,1,1576,34,767
4800,경상남도,4803,진주시,,가호동제5투,2207,1590,544,959,45,2,19,0,0,0,1,7,0,1,1578,12,617
4800,경상남도,4803,진주시,,가호동제6투,2127,1580,653,836,48,1,13,0,0,0,2,1,0,0,1554,26,547
4800,경상남도,4803,진주시,천전동,소계,21881,16724,4903,11053,341,6,145,4,4,4,20,27,8,9,16524,200,5157
4800,경상남도,4803,진주시,,관내사전투표,6195,6195,2002,3954,119,1,47,1,1,1,2,14,1,4,6147,48,0
4800,경상남도,4803,진주시,,천전동제1투,1451,956,206,703,15,2,11,1,0,0,1,3,1,0,943,13,495
4800,경상남도,4803,진주시,,천전동제2투,1755,1083,342,671,23,2,14,1,2,1,1,0,1,0,1058,25,672
4800,경상남도,4803,진주시,,천전동제3투,1662,1138,289,792,22,0,8,0,0,0,2,1,0,0,1114,24,524
4800,경상남도,4803,진주시,,천전동제4투,1664,1172,328,790,26,0,9,1,0,0,4,1,0,0,1159,13,492
4800,경상남도,4803,진주시,,천전동제5투,2945,1739,446,1186,45,1,23,0,1,0,8,1,1,2,1714,25,1206
4800,경상남도,4803,진주시,,천전동제6투,2140,1346,369,908,23,0,24,0,0,2,1,3,1,1,1332,14,794
4800,경상남도,4803,진주시,,천전동제7투,1969,1497,378,1067,29,0,4,0,0,0,0,0,0,0,1478,19,472
4800,경상남도,4803,진주시,,천전동제8투,2100,1598,543,982,39,0,5,0,0,0,1,4,3,2,1579,19,502
4800,경상남도,4803,진주시,성북동,소계,8641,6009,1481,4241,99,3,85,0,2,1,8,11,6,1,5938,71,2632
4800,경상남도,4803,진주시,,관내사전투표,2424,2424,670,1676,30,1,21,0,0,0,2,4,0,1,2405,19,0
4800,경상남도,4803,진주시,,성북동제1투,2336,1360,307,968,19,2,34,0,0,0,2,3,4,0,1339,21,976
4800,경상남도,4803,진주시,,성북동제2투,1785,950,227,678,23,0,11,0,1,1,0,2,0,0,943,7,835
4800,경상남도,4803,진주시,,성북동제3투,2096,1275,277,919,27,0,19,0,1,0,4,2,2,0,1251,24,821
4800,경상남도,4803,진주시,상봉동,소계,12114,8945,2310,6224,164,2,126,5,1,0,12,10,7,5,8866,79,3169
4800,경상남도,4803,진주시,,관내사전투표,4303,4302,1196,2932,78,2,48,1,0,0,2,9,1,3,4272,30,1
4800,경상남도,4803,진주시,,상봉동제1투,1673,982,215,720,18,0,13,2,0,0,5,0,0,0,973,9,691
4800,경상남도,4803,진주시,,상봉동제2투,1589,968,226,700,15,0,13,0,1,0,2,0,1,2,960,8,621
4800,경상남도,4803,진주시,,상봉동제3투,2195,1314,301,938,30,0,27,1,0,0,1,0,3,0,1301,13,881
4800,경상남도,4803,진주시,,상봉동제4투,2354,1379,372,934,23,0,25,1,0,0,2,1,2,0,1360,19,975
4800,경상남도,4803,진주시,충무공동,소계,20898,16794,7372,8543,555,6,124,4,2,3,5,34,2,4,16654,140,4104
4800,경상남도,4803,진주시,,관내사전투표,7712,7710,3778,3597,221,1,55,1,1,2,1,14,1,2,7674,36,2
4800,경상남도,4803,진주시,,충무공동제1투,2847,1930,789,1009,82,1,15,1,0,1,0,6,0,0,1904,26,917
4800,경상남도,4803,진주시,,충무공동제2투,3344,2331,936,1267,85,1,14,1,1,0,0,3,0,1,2309,22,1013
4800,경상남도,4803,진주시,,충무공동제3투,2468,1665,621,938,59,0,17,0,0,0,0,6,1,1,1643,22,803
4800,경상남도,4803,진주시,,충무공동제4투,2146,1506,577,840,54,1,10,1,0,0,4,2,0,0,1489,17,640
4800,경상남도,4803,진주시,,충무공동제5투,2381,1652,671,892,54,2,13,0,0,0,0,3,0,0,1635,17,729
4800,경상남도,4803,진주시,상대동,소계,16977,12543,3626,8298,277,7,168,4,1,2,1,24,9,6,12423,120,4434
4800,경상남도,4803,진주시,,관내사전투표,5734,5733,1933,3536,142,5,54,2,1,0,0,15,3,4,5695,38,1
4800,경상남도,4803,진주시,,상대동제1투,2135,1345,333,938,24,1,27,1,0,0,0,3,2,0,1329,16,790
4800,경상남도,4803,진주시,,상대동제2투,2206,1276,345,860,27,1,23,0,0,0,0,1,2,1,1260,16,930
4800,경상남도,4803,진주시,,상대동제3투,2149,1201,278,856,23,0,21,1,0,0,0,2,0,0,1181,20,948
4800,경상남도,4803,진주시,,상대동제4투,2187,1340,333,950,18,0,18,0,0,1,1,2,1,0,1324,16,847
4800,경상남도,4803,진주시,,상대동제5투,2566,1648,404,1158,43,0,25,0,0,1,0,1,1,1,1634,14,918
4800,경상남도,4803,진주시,하대동,소계,19872,14622,4323,9555,335,10,181,2,3,0,23,37,4,4,14477,145,5250
4800,경상남도,4803,진주시,,관내사전투표,6378,6378,2059,4052,135,6,56,1,3,0,5,18,0,2,6337,41,0
4800,경상남도,4803,진주시,,하대동제1투,1774,1125,333,713,37,1,21,0,0,0,2,5,0,0,1112,13,649
4800,경상남도,4803,진주시,,하대동제2투,2172,1310,317,907,31,2,26,0,0,0,0,3,3,1,1290,20,862
4800,경상남도,4803,진주시,,하대동제3투,2343,1374,383,908,41,1,20,0,0,0,3,3,0,0,1359,15,969
4800,경상남도,4803,진주시,,하대동제4투,2184,1257,356,852,20,0,8,0,0,0,5,2,1,1,1245,12,927
4800,경상남도,4803,진주시,,하대동제5투,2660,1717,490,1134,39,0,23,1,0,0,3,4,0,0,1694,23,943
4800,경상남도,4803,진주시,,하대동제6투,2361,1461,385,989,32,0,27,0,0,0,5,2,0,0,1440,21,900
4800,경상남도,4803,진주시,잘못 투입·구분된 투표지,,0,10,2,8,0,0,0,0,0,0,0,0,0,0,10,0,-10
4800,경상남도,4805,통영시,합계,,106361,80080,26387,49772,1573,42,1151,22,14,19,89,146,71,50,79336,744,26281
4800,경상남도,4805,통영시,거소·선상투표,,312,293,91,151,4,3,8,0,0,0,0,2,0,0,259,34,19
4800,경상남도,4805,통영시,관외사전투표,,7169,7169,2879,3842,189,9,141,2,5,2,5,10,1,3,7088,81,0
4800,경상남도,4805,통영시,재외투표,,226,158,82,53,5,0,0,0,0,0,1,0,0,0,141,17,68
4800,경상남도,4805,통영시,산양읍,소계,3709,2666,728,1812,40,0,40,2,0,0,6,6,7,3,2644,22,1043
4800,경상남도,4805,통영시,,관내사전투표,1143,1143,401,694,21,0,16,1,0,0,2,1,1,0,1137,6,0
4800,경상남도,4805,통영시,,산양읍제1투,1832,1023,254,711,17,0,18,0,0,0,1,2,5,3,1011,12,809
4800,경상남도,4805,통영시,,산양읍제2투,469,308,46,249,2,0,4,0,0,0,2,2,1,0,306,2,161
4800,경상남도,4805,통영시,,산양읍제3투,181,127,15,108,0,0,1,0,0,0,1,1,0,0,126,1,54
4800,경상남도,4805,통영시,,산양읍제4투,84,65,12,50,0,0,1,1,0,0,0,0,0,0,64,1,19
4800,경상남도,4805,통영시,용남면,소계,9116,6609,2232,4045,132,2,118,1,2,1,2,13,6,5,6559,50,2507
4800,경상남도,4805,통영시,,관내사전투표,2677,2677,1101,1463,58,0,37,1,0,0,0,7,0,0,2667,10,0
4800,경상남도,4805,통영시,,용남면제1투,2197,1291,441,776,28,1,27,0,1,0,0,1,4,0,1279,12,906
4800,경상남도,4805,통영시,,용남면제2투,2353,1496,367,1055,27,1,24,0,0,1,1,2,1,1,1480,16,857
4800,경상남도,4805,통영시,,용남면제3투,164,103,10,88,1,0,0,0,0,0,0,0,0,0,99,4,61
4800,경상남도,4805,통영시,,용남면제4투,1725,1042,313,663,18,0,30,0,1,0,1,3,1,4,1034,8,683
4800,경상남도,4805,통영시,도산면,소계,2783,2209,670,1424,30,2,40,1,0,0,2,15,3,0,2187,22,574
4800,경상남도,4805,통영시,,관내사전투표,1047,1047,396,607,14,0,11,0,0,0,0,9,1,0,1038,9,0
4800,경상남도,4805,통영시,,도산면제1투,975,608,138,434,11,2,15,0,0,0,1,0,0,0,601,7,367
4800,경상남도,4805,통영시,,도산면제2투,405,300,58,223,2,0,7,0,0,0,1,4,1,0,296,4,105
4800,경상남도,4805,통영시,,도산면제3투,356,254,78,160,3,0,7,1,0,0,0,2,1,0,252,2,102
4800,경상남도,4805,통영시,광도면,소계,21114,15163,6058,8369,332,7,224,3,0,5,17,23,11,7,15056,107,5951
4800,경상남도,4805,통영시,,관내사전투표,5659,5659,2540,2913,112,1,55,2,0,1,5,8,2,0,5639,20,0
4800,경상남도,4805,통영시,,광도면제1투,1269,856,228,583,17,0,15,0,0,0,1,1,1,1,847,9,413
4800,경상남도,4805,통영시,,광도면제2투,2529,1639,696,842,28,1,40,0,0,1,1,6,3,2,1620,19,890
4800,경상남도,4805,통영시,,광도면제3투,1914,1254,409,783,19,2,26,1,0,1,1,0,1,1,1244,10,660
4800,경상남도,4805,통영시,,광도면제4투,3071,1650,606,947,44,3,28,0,0,2,5,2,1,0,1638,12,1421
4800,경상남도,4805,통영시,,광도면제5투,2301,1542,629,819,53,0,16,0,0,0,1,4,0,2,1524,18,759
4800,경상남도,4805,통영시,,광도면제6투,2128,1304,490,753,28,0,22,0,0,0,1,1,2,0,1297,7,824
4800,경상남도,4805,통영시,,광도면제7투,2243,1259,460,729,31,0,22,0,0,0,2,1,1,1,1247,12,984
4800,경상남도,4805,통영시,욕지면,소계,1527,1127,336,736,20,1,17,0,0,0,1,4,1,2,1118,9,400
4800,경상남도,4805,통영시,,관내사전투표,537,537,195,317,12,0,6,0,0,0,0,3,0,1,534,3,0
4800,경상남도,4805,통영시,,욕지면제1투,643,350,89,242,5,0,8,0,0,0,0,1,0,1,346,4,293
4800,경상남도,4805,통영시,,욕지면제2투,152,101,30,68,1,0,0,0,0,0,0,0,1,0,100,1,51
4800,경상남도,4805,통영시,,욕지면제3투,195,139,22,109,2,1,3,0,0,0,1,0,0,0,138,1,56
4800,경상남도,4805,통영시,한산면,소계,1450,1102,214,827,14,1,10,0,0,0,4,1,5,3,1079,23,348
4800,경상남도,4805,통영시,,관내사전투표,488,488,111,357,11,0,3,0,0,0,0,0,2,2,486,2,0
4800,경상남도,4805,통영시,,한산면제1투,756,457,80,342,2,1,7,0,0,0,4,1,2,1,440,17,299
4800,경상남도,4805,통영시,,한산면제2투,126,107,14,89,1,0,0,0,0,0,0,0,0,0,104,3,19
4800,경상남도,4805,통영시,,한산면제3투,80,50,9,39,0,0,0,0,0,0,0,0,1,0,49,1,30
4800,경상남도,4805,통영시,사량면,소계,1226,946,253,638,14,2,13,0,0,0,1,4,3,2,930,16,280
4800,경상남도,4805,통영시,,관내사전투표,573,573,176,371,8,1,5,0,0,0,1,2,1,0,565,8,0
4800,경상남도,4805,통영시,,사량면투표소,653,373,77,267,6,1,8,0,0,0,0,2,2,2,365,8,280
4800,경상남도,4805,통영시,도천동,소계,7099,5092,1350,3490,100,0,74,1,0,2,4,12,8,9,5050,42,2007
4800,경상남도,4805,통영시,,관내사전투표,1781,1781,558,1154,33,0,17,0,0,0,1,3,1,2,1769,12,0
4800,경상남도,4805,통영시,,도천동제1투,1606,1002,220,732,14,0,21,0,0,0,1,3,2,2,995,7,604
4800,경상남도,4805,통영시,,도천동제2투,1315,748,176,533,8,0,16,0,0,0,1,3,2,1,740,8,567
4800,경상남도,4805,통영시,,도천동제3투,1451,923,252,619,25,0,12,1,0,2,0,1,0,0,912,11,528
4800,경상남도,4805,통영시,,도천동제4투,946,638,144,452,20,0,8,0,0,0,1,2,3,4,634,4,308
4800,경상남도,4805,통영시,명정동,소계,2949,2312,608,1617,28,1,14,2,1,1,4,2,3,2,2283,29,637
4800,경상남도,4805,통영시,,관내사전투표,1326,1326,405,880,18,1,7,2,0,0,3,1,0,1,1318,8,0
4800,경상남도,4805,통영시,,명정동제1투,846,536,101,409,7,0,2,0,0,1,0,0,2,1,523,13,310
4800,경상남도,4805,통영시,,명정동제2투,777,450,102,328,3,0,5,0,1,0,1,1,1,0,442,8,327
4800,경상남도,4805,통영시,중앙동,소계,3676,2749,690,1971,38,3,17,2,0,1,4,2,0,1,2729,20,927
4800,경상남도,4805,통영시,,관내사전투표,1369,1369,406,923,14,2,12,0,0,0,0,2,0,0,1359,10,0
4800,경상남도,4805,통영시,,중앙동제1투,1429,838,179,624,15,0,4,2,0,1,2,0,0,1,828,10,591
4800,경상남도,4805,통영시,,중앙동제2투,878,542,105,424,9,1,1,0,0,0,2,0,0,0,542,0,336
4800,경상남도,4805,통영시,정량동,소계,7520,5444,1469,3739,79,3,74,3,1,3,10,12,5,3,5401,43,2076
4800,경상남도,4805,통영시,,관내사전투표,2430,2430,740,1622,31,1,18,1,1,0,2,4,1,0,2421,9,0
4800,경상남도,4805,통영시,,정량동제1투,1665,988,216,719,20,0,19,1,0,2,1,3,1,0,982,6,677
4800,경상남도,4805,통영시,,정량동제2투,1574,922,214,664,11,1,11,1,0,0,5,4,0,0,911,11,652
4800,경상남도,4805,통영시,,정량동제3투,1851,1104,299,734,17,1,26,0,0,1,2,1,3,3,1087,17,747
4800,경상남도,4805,통영시,북신동,소계,8025,6027,1627,4145,117,3,73,0,2,1,6,3,4,2,5983,44,1998
4800,경상남도,4805,통영시,,관내사전투표,2385,2385,751,1550,49,2,22,0,0,0,0,0,2,0,2376,9,0
4800,경상남도,4805,통영시,,북신동제1투,2342,1585,395,1120,20,0,28,0,1,0,2,2,0,1,1569,16,757
4800,경상남도,4805,통영시,,북신동제2투,1540,920,201,674,18,0,13,0,0,1,3,0,1,1,912,8,620
4800,경상남도,4805,통영시,,북신동제3투,1758,1137,280,801,30,1,10,0,1,0,1,1,1,0,1126,11,621
4800,경상남도,4805,통영시,무전동,소계,11359,8568,2949,5246,171,3,98,2,1,2,4,15,6,2,8499,69,2791
4800,경상남도,4805,통영시,,관내사전투표,3865,3865,1483,2228,81,0,27,1,0,2,0,7,2,2,3833,32,0
4800,경상남도,4805,통영시,,무전동제1투,2683,1461,391,991,24,3,34,0,1,0,2,4,1,0,1451,10,1222
4800,경상남도,4805,통영시,,무전동제2투,2466,1622,523,1023,35,0,22,0,0,0,1,3,1,0,1608,14,844
4800,경상남도,4805,통영시,,무전동제3투,2345,1620,552,1004,31,0,15,1,0,0,1,1,2,0,1607,13,725
4800,경상남도,4805,통영시,미수동,소계,8447,6251,2151,3773,132,0,105,2,2,1,7,12,3,3,6191,60,2196
4800,경상남도,4805,통영시,,관내사전투표,2928,2928,1095,1706,57,0,39,2,0,0,4,8,1,1,2913,15,0
4800,경상남도,4805,통영시,,미수동제1투,1449,856,260,546,18,0,17,0,1,0,2,1,1,0,846,10,593
4800,경상남도,4805,통영시,,미수동제2투,1730,1044,324,645,26,0,30,0,0,0,0,1,1,0,1027,17,686
4800,경상남도,4805,통영시,,미수동제3투,1022,608,216,364,11,0,7,0,0,0,0,0,0,1,599,9,414
4800,경상남도,4805,통영시,,미수동제4투,1318,815,256,512,20,0,12,0,1,1,1,2,0,1,806,9,503
4800,경상남도,4805,통영시,봉평동,소계,8654,6195,2000,3894,128,2,85,1,0,0,11,10,5,3,6139,56,2459
4800,경상남도,4805,통영시,,관내사전투표,2840,2840,1042,1696,56,1,20,0,0,0,0,6,2,0,2823,17,0
4800,경상남도,4805,통영시,,봉평동제1투,1538,903,281,563,15,0,25,0,0,0,3,2,0,2,891,12,635
4800,경상남도,4805,통영시,,봉평동제2투,1773,1005,285,659,29,1,14,1,0,0,6,1,1,1,998,7,768
4800,경상남도,4805,통영시,,봉평동제3투,1269,712,193,475,13,0,20,0,0,0,0,1,1,0,703,9,557
4800,경상남도,4805,통영시,,봉평동제4투,1234,735,199,501,15,0,6,0,0,0,2,0,1,0,724,11,499
4800,경상남도,4805,통영시,잘못 투입·구분된 투표지,,0,0,0,0,0,0,0,0,0,0,0,0,0,0,0,0,0
4800,경상남도,4806,고성군,합계,,45053,34327,10348,22213,645,25,495,14,11,12,43,47,51,31,33935,392,10726
4800,경상남도,4806,고성군,거소·선상투표,,300,289,108,122,8,2,7,0,1,1,0,1,0,0,250,39,11
4800,경상남도,4806,고성군,관외사전투표,,4081,4081,1511,2352,86,2,66,1,0,1,4,6,3,2,4034,47,0
4800,경상남도,4806,고성군,재외투표,,313,122,48,60,2,1,0,0,0,0,0,0,0,0,111,11,191
4800,경상남도,4806,고성군,고성읍,소계,18410,13290,4371,8257,260,4,211,6,2,3,16,11,16,10,13167,123,5120
4800,경상남도,4806,고성군,,관내사전투표,5614,5614,2125,3235,108,1,75,5,2,0,2,4,4,6,5567,47,0
4800,경상남도,4806,고성군,,고성읍제1투,2304,1323,396,849,37,0,25,0,0,1,4,1,0,1,1314,9,981
4800,경상남도,4806,고성군,,고성읍제2투,3480,2121,611,1392,42,2,31,0,0,2,5,1,4,0,2090,31,1359
4800,경상남도,4806,고성군,,고성읍제3투,1873,1129,360,699,28,0,26,1,0,0,1,3,2,1,1121,8,744
4800,경상남도,4806,고성군,,고성읍제4투,1463,952,235,671,15,0,17,0,0,0,2,0,1,0,941,11,511
4800,경상남도,4806,고성군,,고성읍제5투,1978,1085,349,685,17,1,15,0,0,0,0,2,2,1,1072,13,893
4800,경상남도,4806,고성군,,고성읍제6투,773,484,134,333,4,0,7,0,0,0,2,0,2,0,482,2,289
4800,경상남도,4806,고성군,,고성읍제7투,925,582,161,393,9,0,15,0,0,0,0,0,1,1,580,2,343
4800,경상남도,4806,고성군,삼산면,소계,1425,1097,329,724,15,0,7,1,1,2,2,1,3,1,1086,11,328
4800,경상남도,4806,고성군,,관내사전투표,604,604,207,373,10,0,3,1,0,2,0,0,3,1,600,4,0
4800,경상남도,4806,고성군,,삼산면투표소,821,493,122,351,5,0,4,0,1,0,2,1,0,0,486,7,328
4800,경상남도,4806,고성군,하일면,소계,1527,1141,208,890,13,0,8,0,0,1,0,5,3,3,1131,10,386
4800,경상남도,4806,고성군,,관내사전투표,620,620,130,467,8,0,5,0,0,0,0,2,1,2,615,5,0
4800,경상남도,4806,고성군,,하일면투표소,907,521,78,423,5,0,3,0,0,1,0,3,2,1,516,5,386
4800,경상남도,4806,고성군,하이면,소계,2088,1606,388,1129,32,0,24,2,0,1,7,5,1,3,1592,14,482
4800,경상남도,4806,고성군,,관내사전투표,855,855,224,594,15,0,9,1,0,0,2,2,1,2,850,5,0
4800,경상남도,4806,고성군,,하이면투표소,1233,751,164,535,17,0,15,1,0,1,5,3,0,1,742,9,482
4800,경상남도,4806,고성군,상리면,소계,1367,1067,324,698,18,0,9,1,1,0,2,0,1,3,1057,10,300
4800,경상남도,4806,고성군,,관내사전투표,585,585,187,375,10,0,5,1,0,0,0,0,1,1,580,5,0
4800,경상남도,4806,고성군,,상리면투표소,782,482,137,323,8,0,4,0,1,0,2,0,0,2,477,5,300
4800,경상남도,4806,고성군,대가면,소계,1520,1170,322,774,35,0,20,0,1,0,2,2,3,2,1161,9,350
4800,경상남도,4806,고성군,,관내사전투표,730,730,239,450,20,0,12,0,1,0,0,1,1,0,724,6,0
4800,경상남도,4806,고성군,,대가면투표소,790,440,83,324,15,0,8,0,0,0,2,1,2,2,437,3,350
4800,경상남도,4806,고성군,영현면,소계,720,586,158,399,12,2,4,0,0,0,0,1,1,0,577,9,134
4800,경상남도,4806,고성군,,관내사전투표,303,303,87,206,6,1,1,0,0,0,0,0,0,0,301,2,0
4800,경상남도,4806,고성군,,영현면투표소,417,283,71,193,6,1,3,0,0,0,0,1,1,0,276,7,134
4800,경상남도,4806,고성군,영오면,소계,1174,880,220,610,20,1,15,0,2,0,0,0,1,1,870,10,294
4800,경상남도,4806,고성군,,관내사전투표,428,428,112,296,9,1,6,0,1,0,0,0,1,1,427,1,0
4800,경상남도,4806,고성군,,영오면투표소,746,452,108,314,11,0,9,0,1,0,0,0,0,0,443,9,294
4800,경상남도,4806,고성군,개천면,소계,871,682,161,500,8,2,3,0,0,0,1,0,0,0,675,7,189
4800,경상남도,4806,고성군,,관내사전투표,267,267,71,191,2,0,0,0,0,0,0,0,0,0,264,3,0
4800,경상남도,4806,고성군,,개천면제1투,368,244,58,174,3,2,2,0,0,0,1,0,0,0,240,4,124
4800,경상남도,4806,고성군,,개천면제2투,236,171,32,135,3,0,1,0,0,0,0,0,0,0,171,0,65
4800,경상남도,4806,고성군,구만면,소계,877,684,239,417,9,1,7,0,0,0,2,0,1,2,678,6,193
4800,경상남도,4806,고성군,,관내사전투표,407,407,148,240,8,1,4,0,0,0,1,0,0,2,404,3,0
4800,경상남도,4806,고성군,,구만면투표소,470,277,91,177,1,0,3,0,0,0,1,0,1,0,274,3,193
4800,경상남도,4806,고성군,회화면,소계,2965,2289,564,1633,31,2,30,0,0,0,2,4,2,0,2268,21,676
4800,경상남도,4806,고성군,,관내사전투표,1253,1253,361,854,21,2,8,0,0,0,0,0,1,0,1247,6,0
4800,경상남도,4806,고성군,,회화면투표소,1712,1036,203,779,10,0,22,0,0,0,2,4,1,0,1021,15,676
4800,경상남도,4806,고성군,마암면,소계,1377,986,249,671,26,2,18,0,0,0,0,4,4,1,975,11,391
4800,경상남도,4806,고성군,,관내사전투표,472,471,122,321,16,0,5,0,0,0,0,2,2,1,469,2,1
4800,경상남도,4806,고성군,,마암면투표소,905,515,127,350,10,2,13,0,0,0,0,2,2,0,506,9,390
4800,경상남도,4806,고성군,동해면,소계,2417,1768,456,1215,30,2,23,0,1,1,4,2,5,1,1740,28,649
4800,경상남도,4806,고성군,,관내사전투표,772,772,221,513,16,1,6,0,1,1,0,1,1,1,762,10,0
4800,경상남도,4806,고성군,,동해면제1투,838,493,114,349,4,1,8,0,0,0,3,1,3,0,483,10,345
4800,경상남도,4806,고성군,,동해면제2투,807,503,121,353,10,0,9,0,0,0,1,0,1,0,495,8,304
4800,경상남도,4806,고성군,거류면,소계,3621,2589,692,1762,40,4,43,3,2,2,1,5,7,2,2563,26,1032
4800,경상남도,4806,고성군,,관내사전투표,1119,1119,336,723,21,3,12,0,2,0,0,4,0,2,1103,16,0
4800,경상남도,4806,고성군,,거류면제1투,1572,858,213,602,10,0,20,3,0,0,1,0,5,0,854,4,714
4800,경상남도,4806,고성군,,거류면제2투,930,612,143,437,9,1,11,0,0,2,0,1,2,0,606,6,318
4800,경상남도,4806,고성군,잘못 투입·구분된 투표지,,0,0,0,0,0,0,0,0,0,0,0,0,0,0,0,0,0
4800,경상남도,4807,사천시,합계,,94303,71772,23424,44656,1581,34,926,25,13,16,65,147,65,64,71016,756,22531
4800,경상남도,4807,사천시,거소·선상투표,,323,303,78,166,5,2,8,1,0,0,0,0,1,3,264,39,20
4800,경상남도,4807,사천시,관외사전투표,,7353,7352,2851,4050,198,1,139,5,0,2,8,8,3,8,7273,79,1
4800,경상남도,4807,사천시,재외투표,,334,201,100,82,6,0,0,0,0,0,0,0,0,0,188,13,133
4800,경상남도,4807,사천시,사천읍,소계,14305,10481,3728,6211,251,3,143,3,1,1,9,22,6,4,10382,99,3824
4800,경상남도,4807,사천시,,관내사전투표,5164,5164,2107,2793,142,1,59,2,1,0,5,10,2,1,5123,41,0
4800,경상남도,4807,사천시,,사천읍제1투,2906,1671,532,1041,33,2,33,0,0,1,2,5,2,0,1651,20,1235
4800,경상남도,4807,사천시,,사천읍제2투,1744,1077,378,646,22,0,17,1,0,0,2,2,1,0,1069,8,667
4800,경상남도,4807,사천시,,사천읍제3투,1357,779,204,534,21,0,6,0,0,0,0,1,0,0,766,13,578
4800,경상남도,4807,사천시,,사천읍제4투,3134,1790,507,1197,33,0,28,0,0,0,0,4,1,3,1773,17,1344
4800,경상남도,4807,사천시,정동면,소계,8527,6027,2198,3462,163,6,90,2,0,1,4,21,7,2,5956,71,2500
4800,경상남도,4807,사천시,,관내사전투표,2060,2060,808,1162,42,2,16,2,0,0,0,8,2,1,2043,17,0
4800,경상남도,4807,사천시,,정동면제1투,2834,1754,596,1035,53,2,34,0,0,0,0,4,1,1,1726,28,1080
4800,경상남도,4807,사천시,,정동면제2투,1703,1144,439,624,40,2,20,0,0,1,1,1,1,0,1129,15,559
4800,경상남도,4807,사천시,,정동면제3투,1930,1069,355,641,28,0,20,0,0,0,3,8,3,0,1058,11,861
4800,경상남도,4807,사천시,사남면,소계,10899,8220,3331,4448,209,3,105,3,2,1,6,26,5,4,8143,77,2679
4800,경상남도,4807,사천시,,관내사전투표,3978,3979,1791,2020,90,0,29,2,2,0,2,14,1,3,3954,25,-1
4800,경상남도,4807,사천시,,사남면제1투,1594,888,225,612,9,3,17,0,0,0,0,5,3,1,875,13,706
4800,경상남도,4807,사천시,,사남면제2투,2633,1610,549,952,54,0,27,0,0,1,1,3,1,0,1588,22,1023
4800,경상남도,4807,사천시,,사남면제3투,2694,1743,766,864,56,0,32,1,0,0,3,4,0,0,1726,17,951
4800,경상남도,4807,사천시,용현면,소계,5746,4222,1383,2636,92,0,56,2,2,1,3,5,7,3,4190,32,1524
4800,경상남도,4807,사천시,,관내사전투표,2365,2365,833,1436,49,0,24,0,0,0,1,2,4,2,2351,14,0
4800,경상남도,4807,사천시,,용현면제1투,1487,783,249,491,16,0,13,0,2,0,1,1,1,1,775,8,704
4800,경상남도,4807,사천시,,용현면제2투,1894,1074,301,709,27,0,19,2,0,1,1,2,2,0,1064,10,820
4800,경상남도,4807,사천시,축동면,소계,1690,1383,366,950,30,1,15,1,0,2,1,1,2,2,1371,12,307
4800,경상남도,4807,사천시,,관내사전투표,837,837,268,531,18,1,8,1,0,1,1,0,1,0,830,7,0
4800,경상남도,4807,사천시,,축동면투표소,853,546,98,419,12,0,7,0,0,1,0,1,1,2,541,5,307
4800,경상남도,4807,사천시,곤양면,소계,2935,2279,604,1557,37,0,24,2,3,2,2,8,4,7,2250,29,656
4800,경상남도,4807,사천시,,관내사전투표,1085,1085,311,712,19,0,7,2,1,1,2,2,3,6,1066,19,0
4800,경상남도,4807,사천시,,곤양면제1투,1302,822,217,564,11,0,16,0,2,1,0,2,1,0,814,8,480
4800,경상남도,4807,사천시,,곤양면제2투,548,372,76,281,7,0,1,0,0,0,0,4,0,1,370,2,176
4800,경상남도,4807,사천시,곤명면,소계,2261,1733,433,1230,33,0,14,0,0,0,0,1,4,0,1715,18,528
4800,경상남도,4807,사천시,,관내사전투표,697,697,194,482,12,0,5,0,0,0,0,0,0,0,693,4,0
4800,경상남도,4807,사천시,,곤명면제1투,673,409,97,298,6,0,3,0,0,0,0,0,0,0,404,5,264
4800,경상남도,4807,사천시,,곤명면제2투,891,627,142,450,15,0,6,0,0,0,0,1,4,0,618,9,264
4800,경상남도,4807,사천시,서포면,소계,2973,2122,549,1487,26,2,17,0,0,1,2,2,5,7,2098,24,851
4800,경상남도,4807,사천시,,관내사전투표,1040,1040,301,708,13,1,5,0,0,1,0,0,1,2,1032,8,0
4800,경상남도,4807,사천시,,서포면투표소,1933,1082,248,779,13,1,12,0,0,0,2,2,4,5,1066,16,851
4800,경상남도,4807,사천시,동서동,소계,5204,3827,725,2956,47,4,32,0,0,1,4,1,7,8,3785,42,1377
4800,경상남도,4807,사천시,,관내사전투표,1707,1707,325,1331,17,1,10,0,0,0,1,1,0,4,1690,17,0
4800,경상남도,4807,사천시,,동서동제1투,1201,682,129,520,13,2,10,0,0,0,1,0,1,0,676,6,519
4800,경상남도,4807,사천시,,동서동제2투,1152,692,146,518,4,1,6,0,0,0,2,0,2,1,680,12,460
4800,경상남도,4807,사천시,,동서동제3투,951,602,109,470,8,0,6,0,0,0,0,0,3,2,598,4,349
4800,경상남도,4807,사천시,,동서동제4투,193,144,16,117,5,0,0,0,0,1,0,0,1,1,141,3,49
4800,경상남도,4807,사천시,선구동,소계,4166,3029,760,2146,51,0,34,1,0,0,4,4,0,0,3000,29,1137
4800,경상남도,4807,사천시,,관내사전투표,1285,1285,370,881,20,0,6,0,0,0,0,1,0,0,1278,7,0
4800,경상남도,4807,사천시,,선구동제1투,865,498,93,386,6,0,7,0,0,0,0,0,0,0,492,6,367
4800,경상남도,4807,사천시,,선구동제2투,766,459,104,334,10,0,3,0,0,0,1,0,0,0,452,7,307
4800,경상남도,4807,사천시,,선구동제3투,1250,787,193,545,15,0,18,1,0,0,3,3,0,0,778,9,463
4800,경상남도,4807,사천시,동서금동,소계,5064,3743,974,2618,55,0,46,0,0,1,3,3,2,4,3706,37,1321
4800,경상남도,4807,사천시,,관내사전투표,1947,1946,507,1378,22,0,19,0,0,1,1,2,1,2,1933,13,1
4800,경상남도,4807,사천시,,동서금동제1투,2196,1294,367,863,23,0,20,0,0,0,1,1,1,1,1277,17,902
4800,경상남도,4807,사천시,,동서금동제2투,921,503,100,377,10,0,7,0,0,0,1,0,0,1,496,7,418
4800,경상남도,4807,사천시,벌용동,소계,12569,9363,2982,5922,230,6,99,3,3,1,14,25,3,6,9294,69,3206
4800,경상남도,4807,사천시,,관내사전투표,4527,4527,1582,2744,105,4,34,1,2,0,5,13,1,3,4494,33,0
4800,경상남도,4807,사천시,,벌용동제1투,3086,1815,565,1134,58,1,28,0,1,1,5,2,1,1,1797,18,1271
4800,경상남도,4807,사천시,,벌용동제2투,1566,965,233,693,18,0,12,1,0,0,2,3,1,0,963,2,601
4800,경상남도,4807,사천시,,벌용동제3투,1547,934,268,629,14,0,13,0,0,0,0,1,0,1,926,8,613
4800,경상남도,4807,사천시,,벌용동제4투,1843,1122,334,722,35,1,12,1,0,0,2,6,0,1,1114,8,721
4800,경상남도,4807,사천시,향촌동,소계,5593,4118,1336,2564,82,2,60,1,2,1,2,10,4,2,4066,52,1475
4800,경상남도,4807,사천시,,관내사전투표,2273,2273,803,1361,42,1,29,1,1,0,2,5,2,0,2247,26,0
4800,경상남도,4807,사천시,,향촌동제1투,2363,1290,380,835,29,0,23,0,1,1,0,4,2,0,1275,15,1073
4800,경상남도,4807,사천시,,향촌동제2투,957,555,153,368,11,1,8,0,0,0,0,1,0,2,544,11,402
4800,경상남도,4807,사천시,남양동,소계,4361,3369,1026,2171,66,4,44,1,0,1,3,10,5,4,3335,34,992
4800,경상남도,4807,사천시,,관내사전투표,1821,1821,623,1126,40,3,10,1,0,0,1,6,0,1,1811,10,0
4800,경상남도,4807,사천시,,남양동제1투,2126,1279,352,843,23,0,29,0,0,1,1,1,5,2,1257,22,847
4800,경상남도,4807,사천시,,남양동제2투,414,269,51,202,3,1,5,0,0,0,1,3,0,1,267,2,145
4800,경상남도,4807,사천시,잘못 투입·구분된 투표지,,0,0,0,0,0,0,0,0,0,0,0,0,0,0,0,0,0
4800,경상남도,4808,김해시,합계,,444342,328521,150338,160401,8587,162,4534,75,48,67,251,418,106,171,325158,3363,115821
4800,경상남도,4808,김해시,거소·선상투표,,1159,1084,350,471,25,3,45,1,1,3,3,3,1,6,912,172,75
4800,경상남도,4808,김해시,관외사전투표,,29188,29171,12805,14500,822,22,512,11,8,8,15,51,9,37,28800,371,17
4800,경상남도,4808,김해시,재외투표,,1284,855,455,274,37,0,1,0,0,0,0,0,0,1,768,87,429
4800,경상남도,4808,김해시,진영읍,소계,40381,28386,14161,12578,803,12,467,2,4,4,33,42,8,21,28135,251,11995
4800,경상남도,4808,김해시,,관내사전투표,9760,9760,5349,3960,251,3,118,1,1,2,8,10,3,8,9714,46,0
4800,경상남도,4808,김해시,,진영읍제1투,1408,943,383,495,35,2,11,0,0,0,0,1,0,2,929,14,465
4800,경상남도,4808,김해시,,진영읍제2투,2943,1781,806,852,48,0,41,0,1,1,4,2,2,1,1758,23,1162
4800,경상남도,4808,김해시,,진영읍제3투,3302,1943,968,846,57,1,33,0,0,0,3,4,0,3,1915,28,1359
4800,경상남도,4808,김해시,,진영읍제4투,3481,2290,1126,1020,77,0,39,0,0,0,1,5,1,1,2270,20,1191
4800,경상남도,4808,김해시,,진영읍제5투,2970,1768,903,756,51,1,33,0,2,0,5,0,0,1,1752,16,1202
4800,경상남도,4808,김해시,,진영읍제6투,2685,1808,886,824,53,0,23,0,0,0,4,3,0,0,1793,15,877
4800,경상남도,4808,김해시,,진영읍제7투,3077,1716,811,786,52,2,31,0,0,0,4,3,1,0,1690,26,1361
4800,경상남도,4808,김해시,,진영읍제8투,2620,1324,583,660,33,0,29,0,0,0,0,1,0,2,1308,16,1296
4800,경상남도,4808,김해시,,진영읍제9투,3688,2160,1005,992,65,1,55,1,0,1,2,9,1,1,2133,27,1528
4800,경상남도,4808,김해시,,진영읍제10투,1562,912,371,502,13,1,11,0,0,0,1,2,0,1,902,10,650
4800,경상남도,4808,김해시,,진영읍제11투,2885,1981,970,885,68,1,43,0,0,0,1,2,0,1,1971,10,904
4800,경상남도,4808,김해시,주촌면,소계,14352,11016,5044,5421,293,6,129,0,3,2,2,9,3,3,10915,101,3336
4800,경상남도,4808,김해시,,관내사전투표,4696,4696,2301,2222,109,2,33,0,0,0,0,5,1,0,4673,23,0
4800,경상남도,4808,김해시,,주촌면제1투,2607,1475,498,882,27,2,38,0,0,1,1,2,1,0,1452,23,1132
4800,경상남도,4808,김해시,,주촌면제2투,2145,1293,567,650,44,0,12,0,2,1,1,0,0,1,1278,15,852
4800,경상남도,4808,김해시,,주촌면제3투,2992,2189,1025,1040,68,1,31,0,1,0,0,1,0,0,2167,22,803
4800,경상남도,4808,김해시,,주촌면제4투,1912,1363,653,627,45,1,15,0,0,0,0,1,1,2,1345,18,549
4800,경상남도,4808,김해시,진례면,소계,6020,4516,1805,2511,64,4,85,1,0,0,2,10,3,5,4490,26,1504
4800,경상남도,4808,김해시,,관내사전투표,2494,2494,1138,1265,34,2,35,1,0,0,1,3,2,3,2484,10,0
4800,경상남도,4808,김해시,,진례면제1투,1864,1119,371,697,11,0,21,0,0,0,0,7,1,2,1110,9,745
4800,경상남도,4808,김해시,,진례면제2투,1662,903,296,549,19,2,29,0,0,0,1,0,0,0,896,7,759
4800,경상남도,4808,김해시,한림면,소계,6500,4738,1966,2544,79,6,56,2,1,1,1,4,9,5,4674,64,1762
4800,경상남도,4808,김해시,,관내사전투표,2103,2103,1000,1005,23,5,21,2,1,1,0,2,5,4,2069,34,0
4800,경상남도,4808,김해시,,한림면제1투,995,599,200,367,12,0,13,0,0,0,0,1,0,0,593,6,396
4800,경상남도,4808,김해시,,한림면제2투,1196,756,236,486,20,0,6,0,0,0,0,0,0,0,748,8,440
4800,경상남도,4808,김해시,,한림면제3투,1207,667,293,342,12,1,8,0,0,0,0,1,0,0,657,10,540
4800,경상남도,4808,김해시,,한림면제4투,999,613,237,344,12,0,8,0,0,0,1,0,4,1,607,6,386
4800,경상남도,4808,김해시,생림면,소계,3857,2964,1083,1763,55,2,34,1,0,0,1,1,2,0,2942,22,893
4800,경상남도,4808,김해시,,관내사전투표,1648,1647,723,865,32,2,12,1,0,0,0,1,2,0,1638,9,1
4800,경상남도,4808,김해시,,생림면제1투,1147,650,182,437,14,0,11,0,0,0,1,0,0,0,645,5,497
4800,경상남도,4808,김해시,,생림면제2투,1062,667,178,461,9,0,11,0,0,0,0,0,0,0,659,8,395
4800,경상남도,4808,김해시,상동면,소계,2857,2202,772,1337,31,1,31,0,0,0,4,3,2,1,2182,20,655
4800,경상남도,4808,김해시,,관내사전투표,1126,1126,471,621,15,1,6,0,0,0,0,1,2,0,1117,9,0
4800,경상남도,4808,김해시,,상동면제1투,1237,730,197,502,11,0,14,0,0,0,3,0,0,0,727,3,507
4800,경상남도,4808,김해시,,상동면제2투,494,346,104,214,5,0,11,0,0,0,1,2,0,1,338,8,148
4800,경상남도,4808,김해시,대동면,소계,4771,3590,1148,2304,55,0,35,0,1,1,7,5,0,2,3558,32,1181
4800,경상남도,4808,김해시,,관내사전투표,1340,1340,509,792,21,0,9,0,0,1,0,4,0,0,1336,4,0
4800,경상남도,4808,김해시,,대동면제1투,1293,864,235,589,14,0,14,0,0,0,3,0,0,1,856,8,429
4800,경상남도,4808,김해시,,대동면제2투,1200,765,219,509,14,0,8,0,1,0,2,0,0,1,754,11,435
4800,경상남도,4808,김해시,,대동면제3투,938,621,185,414,6,0,4,0,0,0,2,1,0,0,612,9,317
4800,경상남도,4808,김해시,동상동,소계,8807,6222,2422,3492,135,5,96,1,0,2,5,10,3,3,6174,48,2585
4800,경상남도,4808,김해시,,관내사전투표,3250,3250,1401,1710,65,1,37,1,0,2,0,7,2,1,3227,23,0
4800,경상남도,4808,김해시,,동상동제1투,3137,1776,618,1061,42,3,31,0,0,0,2,2,1,2,1762,14,1361
4800,경상남도,4808,김해시,,동상동제2투,2420,1196,403,721,28,1,28,0,0,0,3,1,0,0,1185,11,1224
4800,경상남도,4808,김해시,회현동,소계,8946,7010,2851,3822,169,2,83,0,1,6,6,5,2,2,6949,61,1936
4800,경상남도,4808,김해시,,관내사전투표,4166,4166,1842,2149,94,1,32,0,0,4,3,3,1,2,4131,35,0
4800,경상남도,4808,김해시,,회현동제1투,1877,1027,333,641,21,0,23,0,1,1,3,0,0,0,1023,4,850
4800,경상남도,4808,김해시,,회현동제2투,2903,1817,676,1032,54,1,28,0,0,1,0,2,1,0,1795,22,1086
4800,경상남도,4808,김해시,부원동,소계,9396,6962,2964,3663,178,1,85,0,1,2,7,3,2,0,6906,56,2434
4800,경상남도,4808,김해시,,관내사전투표,3943,3943,1867,1904,112,0,36,0,1,0,1,1,0,0,3922,21,0
4800,경상남도,4808,김해시,,부원동제1투,2332,1318,486,766,28,1,16,0,0,1,2,0,0,0,1300,18,1014
4800,경상남도,4808,김해시,,부원동제2투,3121,1701,611,993,38,0,33,0,0,1,4,2,2,0,1684,17,1420
4800,경상남도,4808,김해시,내외동,소계,56964,39040,17565,19311,1028,29,568,11,8,6,27,57,15,17,38642,398,17924
4800,경상남도,4808,김해시,,관내사전투표,12086,12085,6040,5566,262,8,93,5,2,4,6,16,2,4,12008,77,1
4800,경상남도,4808,김해시,,내외동제1투,1982,1131,515,540,33,1,21,1,1,0,1,1,0,1,1115,16,851
4800,경상남도,4808,김해시,,내외동제2투,2199,1205,504,631,21,2,25,1,2,0,3,1,0,0,1190,15,994
4800,경상남도,4808,김해시,,내외동제3투,2000,1134,441,610,37,3,20,0,1,1,0,3,1,3,1120,14,866
4800,경상남도,4808,김해시,,내외동제4투,2823,1613,616,918,38,0,23,0,0,0,0,3,0,0,1598,15,1210
4800,경상남도,4808,김해시,,내외동제5투,3544,2025,806,1091,71,0,33,1,0,0,1,2,0,0,2005,20,1519
4800,경상남도,4808,김해시,,내외동제6투,3510,2381,1012,1258,60,3,19,0,1,0,1,1,2,1,2358,23,1129
4800,경상남도,4808,김해시,,내외동제7투,2571,1263,528,650,24,0,37,0,0,0,0,1,0,1,1241,22,1308
4800,경상남도,4808,김해시,,내외동제8투,2613,1486,638,737,40,2,35,1,0,0,4,5,1,2,1465,21,1127
4800,경상남도,4808,김해시,,내외동제9투,2894,1867,855,909,46,1,24,1,0,0,3,1,2,1,1843,24,1027
4800,경상남도,4808,김해시,,내외동제10투,2591,1615,694,819,49,1,32,0,0,0,1,0,0,2,1598,17,976
4800,경상남도,4808,김해시,,내외동제11투,1924,1097,445,572,30,2,27,0,0,0,2,4,2,0,1084,13,827
4800,경상남도,4808,김해시,,내외동제12투,3239,2305,1019,1146,62,2,43,1,0,0,0,1,1,1,2276,29,934
4800,경상남도,4808,김해시,,내외동제13투,3293,1790,743,925,50,3,40,0,0,1,2,4,2,0,1770,20,1503
4800,경상남도,4808,김해시,,내외동제14투,3783,2205,1012,1036,85,0,38,0,1,0,1,2,0,0,2175,30,1578
4800,경상남도,4808,김해시,,내외동제15투,3422,2113,869,1110,53,1,39,0,0,0,2,8,1,0,2083,30,1309
4800,경상남도,4808,김해시,,내외동제16투,2490,1725,828,793,67,0,19,0,0,0,0,4,1,1,1713,12,765
4800,경상남도,4808,김해시,북부동,소계,58776,42225,19552,20407,1187,10,557,11,3,12,35,56,11,20,41861,364,16551
4800,경상남도,4808,김해시,,관내사전투표,14431,14431,7539,6276,371,4,130,4,0,4,5,25,0,8,14366,65,0
4800,경상남도,4808,김해시,,북부동제1투,2830,1448,553,798,33,0,28,0,0,3,2,0,1,1,1419,29,1382
4800,경상남도,4808,김해시,,북부동제2투,2605,1608,598,913,33,1,30,1,1,3,4,0,2,0,1586,22,997
4800,경상남도,4808,김해시,,북부동제3투,2869,1791,709,982,44,1,31,0,0,0,0,2,1,0,1770,21,1078
4800,경상남도,4808,김해시,,북부동제4투,3232,2140,1045,966,77,0,24,0,0,1,2,2,1,0,2118,22,1092
4800,경상남도,4808,김해시,,북부동제5투,3189,2006,910,983,40,1,39,2,0,0,2,3,0,3,1983,23,1183
4800,경상남도,4808,김해시,,북부동제6투,3410,2173,897,1139,66,1,37,1,0,0,1,0,1,1,2144,29,1237
4800,경상남도,4808,김해시,,북부동제7투,2830,2014,755,1164,52,0,23,0,0,0,0,0,0,2,1996,18,816
4800,경상남도,4808,김해시,,북부동제8투,2675,1570,648,838,45,0,14,0,1,0,3,1,1,0,1551,19,1105
4800,경상남도,4808,김해시,,북부동제9투,2747,1544,660,789,48,1,28,0,0,1,1,1,0,2,1531,13,1203
4800,경상남도,4808,김해시,,북부동제10투,1054,765,395,326,25,0,14,0,0,0,0,0,0,0,760,5,289
4800,경상남도,4808,김해시,,북부동제11투,2634,1713,801,812,57,0,24,0,0,0,1,2,1,0,1698,15,921
4800,경상남도,4808,김해시,,북부동제12투,2336,1236,481,672,45,0,14,0,0,0,2,4,1,1,1220,16,1100
4800,경상남도,4808,김해시,,북부동제13투,2983,1844,795,930,54,0,41,1,0,0,2,5,1,1,1830,14,1139
4800,경상남도,4808,김해시,,북부동제14투,2894,1820,812,891,70,0,26,0,0,0,3,2,1,0,1805,15,1074
4800,경상남도,4808,김해시,,북부동제15투,1914,1276,625,569,45,0,18,1,0,0,0,1,0,0,1259,17,638
4800,경상남도,4808,김해시,,북부동제16투,2914,1953,906,950,53,0,24,0,1,0,4,5,0,1,1944,9,961
4800,경상남도,4808,김해시,,북부동제17투,1229,893,423,409,29,1,12,1,0,0,3,3,0,0,881,12,336
4800,경상남도,4808,김해시,칠산서부동,소계,9007,6811,2941,3570,146,1,75,1,0,4,6,9,2,4,6759,52,2196
4800,경상남도,4808,김해시,,관내사전투표,3656,3656,1802,1749,60,0,24,1,0,1,1,3,1,0,3642,14,0
4800,경상남도,4808,김해시,,칠산서부동제1투,1870,1135,357,723,24,0,15,0,0,2,0,2,0,4,1127,8,735
4800,경상남도,4808,김해시,,칠산서부동제2투,1843,1013,392,548,27,1,19,0,0,0,3,2,0,0,992,21,830
4800,경상남도,4808,김해시,,칠산서부동제3투,1638,1007,390,550,35,0,17,0,0,1,2,2,1,0,998,9,631
4800,경상남도,4808,김해시,활천동,소계,30152,19944,8655,10212,472,14,314,7,6,5,13,19,2,6,19725,219,10208
4800,경상남도,4808,김해시,,관내사전투표,6353,6352,3079,3038,130,5,51,0,0,0,4,5,1,2,6315,37,1
4800,경상남도,4808,김해시,,활천동제1투,3249,1717,688,934,38,3,28,2,3,1,0,1,0,0,1698,19,1532
4800,경상남도,4808,김해시,,활천동제2투,2976,1779,752,908,47,0,38,0,0,1,2,3,0,1,1752,27,1197
4800,경상남도,4808,김해시,,활천동제3투,3037,1774,709,957,47,0,25,0,0,1,2,1,0,2,1744,30,1263
4800,경상남도,4808,김해시,,활천동제4투,4121,2325,963,1211,47,3,55,2,1,0,1,2,0,0,2285,40,1796
4800,경상남도,4808,김해시,,활천동제5투,3734,2099,898,1068,57,2,45,1,0,1,0,5,0,0,2077,22,1635
4800,경상남도,4808,김해시,,활천동제6투,3225,2141,890,1137,58,1,33,1,0,0,0,0,1,0,2121,20,1084
4800,경상남도,4808,김해시,,활천동제7투,3457,1757,676,959,48,0,39,1,2,1,4,2,0,1,1733,24,1700
4800,경상남도,4808,김해시,삼안동,소계,28779,20339,8899,10285,504,18,310,8,2,4,19,30,7,12,20098,241,8440
4800,경상남도,4808,김해시,,관내사전투표,8845,8845,4271,4186,198,8,93,7,0,1,7,17,2,3,8793,52,0
4800,경상남도,4808,김해시,,삼안동제1투,3062,1605,642,842,43,3,36,0,1,1,1,2,0,1,1572,33,1457
4800,경상남도,4808,김해시,,삼안동제2투,1186,710,259,407,8,0,19,0,0,1,1,0,0,0,695,15,476
4800,경상남도,4808,김해시,,삼안동제3투,3485,2169,932,1106,64,2,34,0,0,0,0,3,0,1,2142,27,1316
4800,경상남도,4808,김해시,,삼안동제4투,2371,1258,483,690,31,0,31,0,0,0,1,1,1,1,1239,19,1113
4800,경상남도,4808,김해시,,삼안동제5투,2932,1943,779,1041,55,2,26,1,0,1,2,3,1,3,1914,29,989
4800,경상남도,4808,김해시,,삼안동제6투,2144,1355,605,673,38,0,17,0,0,0,2,3,0,1,1339,16,789
4800,경상남도,4808,김해시,,삼안동제7투,2287,1307,509,708,40,1,24,0,0,0,3,1,1,2,1289,18,980
4800,경상남도,4808,김해시,,삼안동제8투,2467,1147,419,632,27,2,30,0,1,0,2,0,2,0,1115,32,1320
4800,경상남도,4808,김해시,불암동,소계,6472,4900,2213,2456,114,2,55,2,0,0,4,7,1,2,4856,44,1572
4800,경상남도,4808,김해시,,관내사전투표,2358,2358,1167,1104,52,0,20,0,0,0,0,2,0,0,2345,13,0
4800,경상남도,4808,김해시,,불암동제1투,3401,2148,896,1129,57,2,31,1,0,0,3,4,1,1,2125,23,1253
4800,경상남도,4808,김해시,,불암동제2투,713,394,150,223,5,0,4,1,0,0,1,1,0,1,386,8,319
4800,경상남도,4808,김해시,장유1동,소계,40157,28975,13809,13590,810,10,394,7,4,2,30,24,15,10,28705,270,11182
4800,경상남도,4808,김해시,,관내사전투표,9740,9740,5188,4162,219,3,75,4,1,1,4,9,4,2,9672,68,0
4800,경상남도,4808,김해시,,장유1동제1투,3513,2424,1227,1055,74,3,32,1,0,0,1,1,3,2,2399,25,1089
4800,경상남도,4808,김해시,,장유1동제2투,3767,2378,1102,1100,81,1,64,1,0,0,6,4,0,2,2361,17,1389
4800,경상남도,4808,김해시,,장유1동제3투,3072,2000,918,949,75,0,33,0,0,0,1,1,1,0,1978,22,1072
4800,경상남도,4808,김해시,,장유1동제4투,3183,2196,1062,996,78,0,24,0,0,1,4,1,3,3,2172,24,987
4800,경상남도,4808,김해시,,장유1동제5투,3355,2175,945,1111,52,2,36,1,1,0,1,2,1,0,2152,23,1180
4800,경상남도,4808,김해시,,장유1동제6투,3025,1747,728,876,59,0,40,0,0,0,4,3,1,0,1711,36,1278
4800,경상남도,4808,김해시,,장유1동제7투,3934,2280,926,1234,63,0,33,0,1,0,3,0,1,0,2261,19,1654
4800,경상남도,4808,김해시,,장유1동제8투,3527,2189,940,1128,66,1,24,0,0,0,4,2,1,1,2167,22,1338
4800,경상남도,4808,김해시,,장유1동제9투,3041,1846,773,979,43,0,33,0,1,0,2,1,0,0,1832,14,1195
4800,경상남도,4808,김해시,장유2동,소계,27730,20615,10317,9258,544,8,252,2,1,3,9,27,7,5,20433,182,7115
4800,경상남도,4808,김해시,,관내사전투표,9106,9106,5132,3604,225,5,73,1,0,1,4,13,1,3,9062,44,0
4800,경상남도,4808,김해시,,장유2동제1투,2178,1210,564,569,26,0,33,0,0,0,0,0,1,0,1193,17,968
4800,경상남도,4808,김해시,,장유2동제2투,2383,1433,600,760,31,1,20,0,0,0,0,2,0,0,1414,19,950
4800,경상남도,4808,김해시,,장유2동제3투,2344,1374,649,652,39,0,16,0,0,0,1,1,1,0,1359,15,970
4800,경상남도,4808,김해시,,장유2동제4투,4135,2610,1207,1243,76,1,39,0,0,2,2,5,3,0,2578,32,1525
4800,경상남도,4808,김해시,,장유2동제5투,2879,1765,786,873,50,0,32,0,1,0,0,2,0,1,1745,20,1114
4800,경상남도,4808,김해시,,장유2동제6투,2987,2007,917,976,64,1,27,1,0,0,2,0,0,1,1989,18,980
4800,경상남도,4808,김해시,,장유2동제7투,1718,1110,462,581,33,0,12,0,0,0,0,4,1,0,1093,17,608
4800,경상남도,4808,김해시,장유3동,소계,48787,36951,18561,16628,1035,6,350,7,4,2,22,43,2,9,36669,282,11836
4800,경상남도,4808,김해시,,관내사전투표,12570,12570,7003,5111,294,1,81,4,0,1,5,17,0,2,12519,51,0
4800,경상남도,4808,김해시,,장유3동제1투,3538,2424,1082,1230,59,1,31,0,0,0,0,2,0,1,2406,18,1114
4800,경상남도,4808,김해시,,장유3동제2투,2838,1995,943,925,73,0,19,0,0,0,0,1,0,2,1963,32,843
4800,경상남도,4808,김해시,,장유3동제3투,3527,2328,1162,1038,66,1,34,0,0,0,4,3,0,1,2309,19,1199
4800,경상남도,4808,김해시,,장유3동제4투,2769,1710,800,830,49,1,14,0,1,0,1,0,0,0,1696,14,1059
4800,경상남도,4808,김해시,,장유3동제5투,3389,2297,1158,1029,68,1,21,1,0,0,2,1,0,0,2281,16,1092
4800,경상남도,4808,김해시,,장유3동제6투,3743,2498,1083,1295,68,0,27,0,0,1,3,6,1,1,2485,13,1245
4800,경상남도,4808,김해시,,장유3동제7투,3920,2659,1373,1139,104,0,24,0,1,0,1,0,0,0,2642,17,1261
4800,경상남도,4808,김해시,,장유3동제8투,2920,1810,844,854,46,0,34,0,0,0,2,5,0,0,1785,25,1110
4800,경상남도,4808,김해시,,장유3동제9투,3704,2666,1284,1247,88,0,18,0,0,0,2,0,0,1,2640,26,1038
4800,경상남도,4808,김해시,,장유3동제10투,3195,2365,1108,1138,66,1,11,1,2,0,1,5,1,1,2335,30,830
4800,경상남도,4808,김해시,,장유3동제11투,2674,1629,721,792,54,0,36,1,0,0,1,3,0,0,1608,21,1045
4800,경상남도,4808,김해시,잘못 투입·구분된 투표지,,0,5,0,4,1,0,0,0,0,0,0,0,0,0,5,0,-5
4800,경상남도,4809,밀양시,합계,,92517,70249,21906,44881,1457,37,848,27,11,22,74,136,55,63,69517,732,22268
4800,경상남도,4809,밀양시,거소·선상투표,,432,399,121,178,9,2,9,2,1,3,7,2,1,3,338,61,33
4800,경상남도,4809,밀양시,관외사전투표,,6748,6748,2305,4039,214,6,84,2,1,0,1,15,1,4,6672,76,0
4800,경상남도,4809,밀양시,재외투표,,406,237,131,76,4,0,1,0,0,0,0,0,0,0,212,25,169
4800,경상남도,4809,밀양시,삼랑진읍,소계,5420,3858,1035,2664,54,1,48,1,1,1,1,7,2,3,3818,40,1562
4800,경상남도,4809,밀양시,,관내사전투표,1486,1486,486,955,19,0,14,1,0,0,0,1,0,0,1476,10,0
4800,경상남도,4809,밀양시,,삼랑진읍제1투,1574,957,214,697,12,1,16,0,0,0,0,3,1,1,945,12,617
4800,경상남도,4809,밀양시,,삼랑진읍제2투,1404,752,170,544,12,0,12,0,0,0,1,1,0,1,741,11,652
4800,경상남도,4809,밀양시,,삼랑진읍제3투,956,663,165,468,11,0,6,0,1,1,0,2,1,1,656,7,293
4800,경상남도,4809,밀양시,하남읍,소계,6152,4487,1360,2916,81,3,60,3,1,0,3,5,5,5,4442,45,1665
4800,경상남도,4809,밀양시,,관내사전투표,1926,1926,688,1143,40,1,22,3,0,0,2,2,2,2,1905,21,0
4800,경상남도,4809,밀양시,,하남읍제1투,781,482,85,375,4,0,11,0,1,0,0,1,0,1,478,4,299
4800,경상남도,4809,밀양시,,하남읍제2투,949,526,166,340,6,0,7,0,0,0,1,0,1,0,521,5,423
4800,경상남도,4809,밀양시,,하남읍제3투,1032,683,171,485,10,0,7,0,0,0,0,0,1,1,675,8,349
4800,경상남도,4809,밀양시,,하남읍제4투,1464,870,250,573,21,2,13,0,0,0,0,2,1,1,863,7,594
4800,경상남도,4809,밀양시,부북면,소계,4435,3344,897,2320,50,0,36,1,0,1,5,3,3,0,3316,28,1091
4800,경상남도,4809,밀양시,,관내사전투표,1621,1621,491,1086,19,0,8,0,0,0,2,1,3,0,1610,11,0
4800,경상남도,4809,밀양시,,부북면제1투,840,523,123,379,11,0,8,0,0,0,0,0,0,0,521,2,317
4800,경상남도,4809,밀양시,,부북면제2투,1024,652,159,469,9,0,6,1,0,1,1,1,0,0,647,5,372
4800,경상남도,4809,밀양시,,부북면제3투,950,548,124,386,11,0,14,0,0,0,2,1,0,0,538,10,402
4800,경상남도,4809,밀양시,상동면,소계,2666,2102,590,1418,39,0,18,1,0,1,7,0,3,7,2084,18,564
4800,경상남도,4809,밀양시,,관내사전투표,1082,1082,367,676,22,0,6,0,0,1,3,0,0,2,1077,5,0
4800,경상남도,4809,밀양시,,상동면제1투,1085,690,160,493,11,0,10,1,0,0,2,0,2,2,681,9,395
4800,경상남도,4809,밀양시,,상동면제2투,499,330,63,249,6,0,2,0,0,0,2,0,1,3,326,4,169
4800,경상남도,4809,밀양시,산외면,소계,2587,2021,577,1367,24,1,16,0,0,2,3,4,2,1,1997,24,566
4800,경상남도,4809,밀양시,,관내사전투표,1073,1073,371,664,13,0,10,0,0,0,0,2,1,0,1061,12,0
4800,경상남도,4809,밀양시,,산외면제1투,869,538,116,402,6,1,3,0,0,2,1,0,1,0,532,6,331
4800,경상남도,4809,밀양시,,산외면제2투,645,410,90,301,5,0,3,0,0,0,2,2,0,1,404,6,235
4800,경상남도,4809,밀양시,산내면,소계,3157,2424,670,1650,39,1,31,2,1,1,1,4,1,2,2403,21,733
4800,경상남도,4809,밀양시,,관내사전투표,1047,1047,351,656,15,1,8,1,1,1,1,3,0,2,1040,7,0
4800,경상남도,4809,밀양시,,산내면제1투,1231,775,172,569,9,0,16,1,0,0,0,1,0,0,768,7,456
4800,경상남도,4809,밀양시,,산내면제2투,879,602,147,425,15,0,7,0,0,0,0,0,1,0,595,7,277
4800,경상남도,4809,밀양시,단장면,소계,3555,2713,716,1877,37,2,31,1,0,2,1,12,3,4,2686,27,842
4800,경상남도,4809,밀양시,,관내사전투표,1230,1230,384,798,17,2,7,1,0,1,0,7,1,2,1220,10,0
4800,경상남도,4809,밀양시,,단장면제1투,640,442,94,317,9,0,11,0,0,0,0,3,0,2,436,6,198
4800,경상남도,4809,밀양시,,단장면제2투,840,486,117,353,1,0,6,0,0,1,1,1,1,0,481,5,354
4800,경상남도,4809,밀양시,,단장면제3투,845,555,121,409,10,0,7,0,0,0,0,1,1,0,549,6,290
4800,경상남도,4809,밀양시,상남면,소계,6404,4475,1255,2989,96,1,50,2,0,1,5,16,8,6,4429,46,1929
4800,경상남도,4809,밀양시,,관내사전투표,1471,1471,476,926,34,0,9,1,0,0,2,6,4,2,1460,11,0
4800,경상남도,4809,밀양시,,상남면제1투,1749,1114,298,762,25,0,14,0,0,0,0,0,1,1,1101,13,635
4800,경상남도,4809,밀양시,,상남면제2투,1614,1005,294,653,27,1,9,0,0,1,2,4,1,2,994,11,609
4800,경상남도,4809,밀양시,,상남면제3투,1570,885,187,648,10,0,18,1,0,0,1,6,2,1,874,11,685
4800,경상남도,4809,밀양시,초동면,소계,2693,2029,541,1413,25,1,17,1,1,2,5,3,1,3,2013,16,664
4800,경상남도,4809,밀양시,,관내사전투표,1009,1009,297,678,14,0,6,1,1,0,2,1,0,2,1002,7,0
4800,경상남도,4809,밀양시,,초동면투표소,1684,1020,244,735,11,1,11,0,0,2,3,2,1,1,1011,9,664
4800,경상남도,4809,밀양시,무안면,소계,4181,3139,773,2242,38,2,27,1,1,0,5,7,3,3,3102,37,1042
4800,경상남도,4809,밀양시,,관내사전투표,1635,1635,468,1104,25,1,11,1,0,0,1,4,1,2,1618,17,0
4800,경상남도,4809,밀양시,,무안면제1투,1431,834,164,635,8,0,10,0,0,0,3,3,0,0,823,11,597
4800,경상남도,4809,밀양시,,무안면제2투,1115,670,141,503,5,1,6,0,1,0,1,0,2,1,661,9,445
4800,경상남도,4809,밀양시,청도면,소계,1583,1256,359,832,21,3,11,1,1,0,4,0,7,2,1241,15,327
4800,경상남도,4809,밀양시,,관내사전투표,729,729,230,463,15,2,8,0,0,0,1,0,2,2,723,6,0
4800,경상남도,4809,밀양시,,청도면투표소,854,527,129,369,6,1,3,1,1,0,3,0,5,0,518,9,327
4800,경상남도,4809,밀양시,내일동,소계,2992,2349,588,1676,43,1,20,0,0,0,1,3,3,2,2337,12,643
4800,경상남도,4809,밀양시,,관내사전투표,1412,1412,384,991,21,1,6,0,0,0,0,1,1,0,1405,7,0
4800,경상남도,4809,밀양시,,내일동제1투,1170,664,150,476,19,0,12,0,0,0,1,2,2,0,662,2,506
4800,경상남도,4809,밀양시,,내일동제2투,410,273,54,209,3,0,2,0,0,0,0,0,0,2,270,3,137
4800,경상남도,4809,밀양시,내이동,소계,11181,7508,2459,4658,172,4,119,4,1,2,12,9,5,6,7451,57,3673
4800,경상남도,4809,밀양시,,관내사전투표,2995,2995,1087,1782,69,3,31,1,0,0,0,4,2,3,2982,13,0
4800,경상남도,4809,밀양시,,내이동제1투,1888,1106,307,745,20,0,14,1,0,2,0,3,0,2,1094,12,782
4800,경상남도,4809,밀양시,,내이동제2투,1499,874,205,620,16,0,17,0,0,0,7,0,2,0,867,7,625
4800,경상남도,4809,밀양시,,내이동제3투,2993,1520,502,917,34,1,37,2,0,0,5,1,1,1,1501,19,1473
4800,경상남도,4809,밀양시,,내이동제4투,1806,1013,358,594,33,0,20,0,1,0,0,1,0,0,1007,6,793
4800,경상남도,4809,밀양시,교동,소계,6531,5255,1934,3037,145,2,72,0,0,1,2,16,0,3,5212,43,1276
4800,경상남도,4809,밀양시,,관내사전투표,3255,3255,1380,1716,94,2,31,0,0,1,0,8,0,2,3234,21,0
4800,경상남도,4809,밀양시,,교동제1투,1102,726,201,477,19,0,12,0,0,0,2,2,0,1,714,12,376
4800,경상남도,4809,밀양시,,교동제2투,2174,1274,353,844,32,0,29,0,0,0,0,6,0,0,1264,10,900
4800,경상남도,4809,밀양시,삼문동,소계,14600,10919,3928,6466,263,4,124,3,2,3,7,21,3,4,10828,91,3681
4800,경상남도,4809,밀양시,,관내사전투표,5152,5152,2080,2874,110,2,43,1,1,1,2,4,1,3,5122,30,0
4800,경상남도,4809,밀양시,,삼문동제1투,1672,1150,337,761,22,0,14,0,1,1,2,2,0,0,1140,10,522
4800,경상남도,4809,밀양시,,삼문동제2투,1378,792,190,558,21,1,12,1,0,0,0,2,1,0,786,6,586
4800,경상남도,4809,밀양시,,삼문동제3투,1761,971,345,560,25,0,18,1,0,1,2,3,1,1,957,14,790
4800,경상남도,4809,밀양시,,삼문동제4투,2167,1331,417,842,34,1,17,0,0,0,0,5,0,0,1316,15,836
4800,경상남도,4809,밀양시,,삼문동제5투,2470,1523,559,871,51,0,20,0,0,0,1,5,0,0,1507,16,947
4800,경상남도,4809,밀양시,가곡동,소계,6794,4985,1666,3063,103,3,74,2,0,2,4,9,4,5,4935,50,1809
4800,경상남도,4809,밀양시,,관내사전투표,2404,2404,938,1371,56,1,17,1,0,0,0,4,0,3,2391,13,0
4800,경상남도,4809,밀양시,,가곡동제1투,1949,1077,275,746,19,0,23,0,0,0,0,1,2,0,1066,11,872
4800,경상남도,4809,밀양시,,가곡동제2투,2441,1504,453,946,28,2,34,1,0,2,4,4,2,2,1478,26,937
4800,경상남도,4809,밀양시,잘못 투입·구분된 투표지,,0,1,1,0,0,0,0,0,0,0,0,0,0,0,1,0,-1
4800,경상남도,4810,거제시,합계,,194074,145481,64355,71772,4186,84,2810,73,52,25,122,323,79,102,143983,1498,48593
4800,경상남도,4810,거제시,거소·선상투표,,665,598,179,256,14,2,22,6,2,0,1,1,4,2,489,109,67
4800,경상남도,4810,거제시,관외사전투표,,14121,14119,6236,6854,422,16,331,7,8,1,7,24,7,25,13938,181,2
4800,경상남도,4810,거제시,재외투표,,646,442,275,113,17,0,5,0,1,0,0,0,0,1,412,30,204
4800,경상남도,4810,거제시,일운면,소계,6482,4755,1907,2584,108,0,88,4,1,1,2,11,0,3,4709,46,1727
4800,경상남도,4810,거제시,,관내사전투표,2560,2560,1115,1336,49,0,33,2,0,0,1,8,0,3,2547,13,0
4800,경상남도,4810,거제시,,일운면제1투,3190,1727,669,943,46,0,42,2,1,0,0,3,0,0,1706,21,1463
4800,경상남도,4810,거제시,,일운면제2투,732,468,123,305,13,0,13,0,0,1,1,0,0,0,456,12,264
4800,경상남도,4810,거제시,동부면,소계,2723,2148,633,1426,30,2,21,1,1,0,3,5,3,0,2125,23,575
4800,경상남도,4810,거제시,,관내사전투표,1226,1226,416,775,18,0,6,1,1,0,0,2,0,0,1219,7,0
4800,경상남도,4810,거제시,,동부면투표소,1497,922,217,651,12,2,15,0,0,0,3,3,3,0,906,16,575
4800,경상남도,4810,거제시,남부면,소계,1334,1001,273,689,11,0,9,0,0,0,2,5,1,0,990,11,333
4800,경상남도,4810,거제시,,관내사전투표,545,545,181,341,8,0,5,0,0,0,1,4,1,0,541,4,0
4800,경상남도,4810,거제시,,남부면투표소,789,456,92,348,3,0,4,0,0,0,1,1,0,0,449,7,333
4800,경상남도,4810,거제시,거제면,소계,6227,4629,1634,2760,72,3,82,4,3,3,5,10,9,7,4592,37,1598
4800,경상남도,4810,거제시,,관내사전투표,2391,2391,988,1303,36,2,27,2,3,1,3,8,3,3,2379,12,0
4800,경상남도,4810,거제시,,거제면제1투,1923,1146,315,755,18,1,28,1,0,1,2,2,3,2,1128,18,777
4800,경상남도,4810,거제시,,거제면제2투,1913,1092,331,702,18,0,27,1,0,1,0,0,3,2,1085,7,821
4800,경상남도,4810,거제시,둔덕면,소계,2548,1983,544,1339,41,1,29,0,0,2,0,1,1,5,1963,20,565
4800,경상남도,4810,거제시,,관내사전투표,1133,1133,351,736,20,0,11,0,0,2,0,0,1,1,1122,11,0
4800,경상남도,4810,거제시,,둔덕면투표소,1415,850,193,603,21,1,18,0,0,0,0,1,0,4,841,9,565
4800,경상남도,4810,거제시,사등면,소계,9172,6635,2274,3940,166,8,133,4,3,1,10,24,3,6,6572,63,2537
4800,경상남도,4810,거제시,,관내사전투표,2702,2694,1071,1475,77,3,40,1,0,0,4,9,0,1,2681,13,8
4800,경상남도,4810,거제시,,사등면제1투,1261,711,168,483,23,1,18,0,0,0,3,4,0,1,701,10,550
4800,경상남도,4810,거제시,,사등면제2투,1367,852,190,610,10,1,16,1,1,1,1,4,1,2,838,14,515
4800,경상남도,4810,거제시,,사등면제3투,700,522,104,382,11,1,9,1,1,0,2,1,1,0,513,9,178
4800,경상남도,4810,거제시,,사등면제4투,3142,1856,741,990,45,2,50,1,1,0,0,6,1,2,1839,17,1286
4800,경상남도,4810,거제시,연초면,소계,6659,4718,1787,2615,130,1,111,0,5,1,9,8,5,2,4674,44,1941
4800,경상남도,4810,거제시,,관내사전투표,2211,2211,972,1130,55,1,32,0,1,0,2,2,1,0,2196,15,0
4800,경상남도,4810,거제시,,연초면제1투,2288,1294,434,744,40,0,48,0,2,1,4,3,3,1,1280,14,994
4800,경상남도,4810,거제시,,연초면제2투,1652,908,301,546,23,0,19,0,0,0,2,2,1,1,895,13,744
4800,경상남도,4810,거제시,,연초면제3투,508,305,80,195,12,0,12,0,2,0,1,1,0,0,303,2,203
4800,경상남도,4810,거제시,하청면,소계,3897,2934,913,1869,65,2,45,2,2,0,2,8,1,4,2913,21,963
4800,경상남도,4810,거제시,,관내사전투표,1597,1597,581,950,37,0,12,1,1,0,1,3,0,3,1589,8,0
4800,경상남도,4810,거제시,,하청면제1투,1669,920,251,600,25,2,26,1,0,0,0,3,0,1,909,11,749
4800,경상남도,4810,거제시,,하청면제2투,631,417,81,319,3,0,7,0,1,0,1,2,1,0,415,2,214
4800,경상남도,4810,거제시,장목면,소계,3856,2800,666,2001,38,0,40,0,2,3,4,11,4,2,2771,29,1056
4800,경상남도,4810,거제시,,관내사전투표,1281,1281,359,867,14,0,13,0,1,0,2,7,2,1,1266,15,0
4800,경상남도,4810,거제시,,장목면제1투,1631,897,162,692,10,0,19,0,0,3,2,1,2,0,891,6,734
4800,경상남도,4810,거제시,,장목면제2투,944,622,145,442,14,0,8,0,1,0,0,3,0,1,614,8,322
4800,경상남도,4810,거제시,장승포동,소계,5063,3685,1668,1767,113,4,73,2,2,0,6,6,2,1,3644,41,1378
4800,경상남도,4810,거제시,,관내사전투표,2107,2107,1031,965,63,1,27,1,1,0,2,2,1,0,2094,13,0
4800,경상남도,4810,거제시,,장승포동제1투,1414,716,240,420,16,1,19,0,1,0,4,0,1,0,702,14,698
4800,경상남도,4810,거제시,,장승포동제2투,1542,862,397,382,34,2,27,1,0,0,0,4,0,1,848,14,680
4800,경상남도,4810,거제시,능포동,소계,7155,5239,2477,2440,170,3,79,3,0,2,1,13,2,1,5191,48,1916
4800,경상남도,4810,거제시,,관내사전투표,2567,2567,1329,1113,70,3,24,1,0,1,0,4,1,1,2547,20,0
4800,경상남도,4810,거제시,,능포동제1투,1282,604,230,316,26,0,17,0,0,0,0,1,0,0,590,14,678
4800,경상남도,4810,거제시,,능포동제2투,1656,1161,574,510,49,0,20,0,0,1,0,3,1,0,1158,3,495
4800,경상남도,4810,거제시,,능포동제3투,1650,907,344,501,25,0,18,2,0,0,1,5,0,0,896,11,743
4800,경상남도,4810,거제시,아주동,소계,17799,12931,7287,4711,482,4,252,8,2,0,8,37,2,8,12801,130,4868
4800,경상남도,4810,거제시,,관내사전투표,4703,4701,2886,1511,179,1,70,3,1,0,2,14,2,2,4671,30,2
4800,경상남도,4810,거제시,,아주동제1투,3065,1512,741,638,45,0,45,2,1,0,0,7,0,5,1484,28,1553
4800,경상남도,4810,거제시,,아주동제2투,2131,1245,592,551,42,0,43,2,0,0,1,4,0,0,1235,10,886
4800,경상남도,4810,거제시,,아주동제3투,2492,1605,853,645,56,0,30,0,0,0,0,4,0,0,1588,17,887
4800,경상남도,4810,거제시,,아주동제4투,1744,1191,685,429,42,2,19,0,0,0,0,2,0,0,1179,12,553
4800,경상남도,4810,거제시,,아주동제5투,1690,1302,758,447,59,0,19,1,0,0,4,3,0,0,1291,11,388
4800,경상남도,4810,거제시,,아주동제6투,1974,1375,772,490,59,1,26,0,0,0,1,3,0,1,1353,22,599
4800,경상남도,4810,거제시,옥포1동,소계,6855,5251,2456,2484,137,3,95,4,0,0,6,18,2,1,5206,45,1604
4800,경상남도,4810,거제시,,관내사전투표,3244,3244,1639,1439,86,0,45,1,0,0,3,10,1,1,3225,19,0
4800,경상남도,4810,거제시,,옥포1동제1투,2267,1251,514,647,32,3,33,2,0,0,2,6,1,0,1240,11,1016
4800,경상남도,4810,거제시,,옥포1동제2투,1344,756,303,398,19,0,17,1,0,0,1,2,0,0,741,15,588
4800,경상남도,4810,거제시,옥포2동,소계,18811,13029,6215,5940,396,12,268,8,6,0,12,29,2,12,12900,129,5782
4800,경상남도,4810,거제시,,관내사전투표,4801,4801,2513,2036,115,5,76,3,2,0,0,8,0,2,4760,41,0
4800,경상남도,4810,거제시,,옥포2동제1투,1898,972,376,514,32,0,26,0,1,0,1,3,0,3,956,16,926
4800,경상남도,4810,거제시,,옥포2동제2투,2405,1352,590,664,45,2,26,0,0,0,2,5,1,1,1336,16,1053
4800,경상남도,4810,거제시,,옥포2동제3투,2813,1903,962,800,67,2,42,1,2,0,6,4,0,2,1888,15,910
4800,경상남도,4810,거제시,,옥포2동제4투,1949,1056,399,580,34,0,27,1,1,0,2,2,0,2,1048,8,893
4800,경상남도,4810,거제시,,옥포2동제5투,1745,984,447,450,41,2,27,2,0,0,1,0,1,1,972,12,761
4800,경상남도,4810,거제시,,옥포2동제6투,2144,1287,648,536,49,0,35,1,0,0,0,6,0,1,1276,11,857
4800,경상남도,4810,거제시,,옥포2동제7투,1056,674,280,360,13,1,9,0,0,0,0,1,0,0,664,10,382
4800,경상남도,4810,거제시,장평동,소계,16808,11781,5236,5768,356,6,257,5,2,4,14,18,5,6,11677,104,5027
4800,경상남도,4810,거제시,,관내사전투표,6024,6014,2913,2781,170,4,87,3,0,2,5,12,3,4,5984,30,10
4800,경상남도,4810,거제시,,장평동제1투,1896,957,380,504,26,0,31,0,1,0,5,1,0,0,948,9,939
4800,경상남도,4810,거제시,,장평동제2투,2234,1251,537,602,52,1,33,0,1,0,0,1,2,0,1229,22,983
4800,경상남도,4810,거제시,,장평동제3투,2224,1036,403,557,28,1,33,0,0,0,2,1,0,1,1026,10,1188
4800,경상남도,4810,거제시,,장평동제4투,1849,1054,413,561,32,0,29,2,0,0,1,0,0,0,1038,16,795
4800,경상남도,4810,거제시,,장평동제5투,2581,1469,590,763,48,0,44,0,0,2,1,3,0,1,1452,17,1112
4800,경상남도,4810,거제시,고현동,소계,25456,18436,7602,9688,521,7,360,7,4,3,21,31,15,6,18265,171,7020
4800,경상남도,4810,거제시,,관내사전투표,6608,6604,2919,3388,154,3,79,2,4,1,4,8,1,2,6565,39,4
4800,경상남도,4810,거제시,,고현동제1투,1283,669,213,405,16,0,25,1,0,0,1,1,0,0,662,7,614
4800,경상남도,4810,거제시,,고현동제2투,2194,1271,354,850,23,0,29,0,0,0,1,1,1,1,1260,11,923
4800,경상남도,4810,거제시,,고현동제3투,1514,966,330,572,23,0,26,0,0,1,1,1,0,0,954,12,548
4800,경상남도,4810,거제시,,고현동제4투,1542,819,274,498,16,0,16,0,0,1,2,2,3,0,812,7,723
4800,경상남도,4810,거제시,,고현동제5투,1735,908,264,591,20,0,20,0,0,0,4,1,0,1,901,7,827
4800,경상남도,4810,거제시,,고현동제6투,3267,2245,962,1122,73,1,45,2,0,0,5,5,3,2,2220,25,1022
4800,경상남도,4810,거제시,,고현동제7투,2267,1535,676,726,73,1,34,0,0,0,0,0,4,0,1514,21,732
4800,경상남도,4810,거제시,,고현동제8투,2301,1615,748,741,58,1,37,1,0,0,2,6,0,0,1594,21,686
4800,경상남도,4810,거제시,,고현동제9투,2745,1804,862,795,65,1,49,1,0,0,1,6,3,0,1783,21,941
4800,경상남도,4810,거제시,상문동,소계,21839,15824,7982,6803,527,6,310,3,3,1,7,35,7,7,15691,133,6015
4800,경상남도,4810,거제시,,관내사전투표,6090,6090,3397,2362,176,2,92,1,1,0,3,12,4,3,6053,37,0
4800,경상남도,4810,거제시,,상문동제1투,2241,1320,491,751,39,0,25,0,0,0,1,5,0,0,1312,8,921
4800,경상남도,4810,거제시,,상문동제2투,2747,1960,955,861,84,0,37,0,1,0,1,4,1,0,1944,16,787
4800,경상남도,4810,거제시,,상문동제3투,3227,1851,850,863,71,0,41,1,0,1,0,3,0,2,1832,19,1376
4800,경상남도,4810,거제시,,상문동제4투,3276,1984,893,941,61,2,53,1,0,0,0,7,2,1,1961,23,1292
4800,경상남도,4810,거제시,,상문동제5투,4258,2619,1396,1025,96,2,62,0,1,0,2,4,0,1,2589,30,1639
4800,경상남도,4810,거제시,수양동,소계,15958,12540,6110,5723,370,4,200,5,5,3,2,28,4,3,12457,83,3418
4800,경상남도,4810,거제시,,관내사전투표,6026,6026,3206,2520,161,2,79,1,5,0,2,16,2,3,5997,29,0
4800,경상남도,4810,거제시,,수양동제1투,1168,799,369,371,34,0,12,0,0,1,0,2,0,0,789,10,369
4800,경상남도,4810,거제시,,수양동제2투,1983,1158,448,629,29,1,35,0,0,1,0,1,0,0,1144,14,825
4800,경상남도,4810,거제시,,수양동제3투,2062,1436,610,749,53,0,16,0,0,0,0,0,0,0,1428,8,626
4800,경상남도,4810,거제시,,수양동제4투,1455,1021,487,469,34,1,14,3,0,0,0,3,0,0,1011,10,434
4800,경상남도,4810,거제시,,수양동제5투,3264,2100,990,985,59,0,44,1,0,1,0,6,2,0,2088,12,1164
4800,경상남도,4810,거제시,잘못 투입·구분된 투표지,,0,3,1,2,0,0,0,0,0,0,0,0,0,0,3,0,-3
4800,경상남도,4811,의령군,합계,,24419,19089,5396,12625,349,22,190,9,6,7,25,74,47,47,18797,292,5330
4800,경상남도,4811,의령군,거소·선상투표,,117,112,35,60,1,0,1,0,0,0,1,0,0,8,106,6,5
4800,경상남도,4811,의령군,관외사전투표,,2662,2661,866,1662,71,0,23,1,2,1,2,9,2,2,2641,20,1
4800,경상남도,4811,의령군,재외투표,,268,96,33,54,3,0,1,0,0,0,0,0,0,1,92,4,172
4800,경상남도,4811,의령군,의령읍,소계,7179,5456,1822,3370,106,3,70,1,1,0,6,13,3,5,5400,56,1723
4800,경상남도,4811,의령군,,관내사전투표,2655,2655,1028,1535,43,2,27,0,0,0,1,4,0,0,2640,15,0
4800,경상남도,4811,의령군,,의령읍제1투,1842,1099,287,733,31,1,25,0,0,0,1,3,2,1,1084,15,743
4800,경상남도,4811,의령군,,의령읍제2투,2682,1702,507,1102,32,0,18,1,1,0,4,6,1,4,1676,26,980
4800,경상남도,4811,의령군,가례면,소계,1527,1131,311,724,16,2,8,2,0,0,0,11,7,4,1085,46,396
4800,경상남도,4811,의령군,,관내사전투표,693,693,194,430,10,2,5,2,0,0,0,8,5,3,659,34,0
4800,경상남도,4811,의령군,,가례면투표소,834,438,117,294,6,0,3,0,0,0,0,3,2,1,426,12,396
4800,경상남도,4811,의령군,칠곡면,소계,1003,791,237,516,13,0,4,0,0,0,0,6,1,4,781,10,212
4800,경상남도,4811,의령군,,관내사전투표,441,441,145,277,8,0,2,0,0,0,0,4,0,3,439,2,0
4800,경상남도,4811,의령군,,칠곡면투표소,562,350,92,239,5,0,2,0,0,0,0,2,1,1,342,8,212
4800,경상남도,4811,의령군,대의면,소계,835,663,154,465,14,1,8,0,1,0,0,4,1,3,651,12,172
4800,경상남도,4811,의령군,,관내사전투표,327,327,88,218,10,1,5,0,1,0,0,0,0,1,324,3,0
4800,경상남도,4811,의령군,,대의면투표소,508,336,66,247,4,0,3,0,0,0,0,4,1,2,327,9,172
4800,경상남도,4811,의령군,화정면,소계,1192,918,232,640,13,0,15,0,0,0,6,5,2,0,913,5,274
4800,경상남도,4811,의령군,,관내사전투표,447,447,135,297,5,0,4,0,0,0,0,2,2,0,445,2,0
4800,경상남도,4811,의령군,,화정면투표소,745,471,97,343,8,0,11,0,0,0,6,3,0,0,468,3,274
4800,경상남도,4811,의령군,용덕면,소계,1234,941,226,667,15,1,10,0,0,0,3,2,2,1,927,14,293
4800,경상남도,4811,의령군,,관내사전투표,364,364,113,234,8,1,2,0,0,0,0,2,1,0,361,3,0
4800,경상남도,4811,의령군,,용덕면제1투,456,314,47,247,6,0,5,0,0,0,3,0,1,1,310,4,142
4800,경상남도,4811,의령군,,용덕면제2투,414,263,66,186,1,0,3,0,0,0,0,0,0,0,256,7,151
4800,경상남도,4811,의령군,정곡면,소계,1171,860,209,596,15,3,8,2,0,1,1,0,7,3,845,15,311
4800,경상남도,4811,의령군,,관내사전투표,526,526,136,363,7,2,0,0,0,0,1,0,4,3,516,10,0
4800,경상남도,4811,의령군,,정곡면투표소,645,334,73,233,8,1,8,2,0,1,0,0,3,0,329,5,311
4800,경상남도,4811,의령군,지정면,소계,1485,1102,311,733,16,3,7,0,0,1,1,4,1,4,1081,21,383
4800,경상남도,4811,의령군,,관내사전투표,522,522,160,336,8,2,4,0,0,0,1,0,1,0,512,10,0
4800,경상남도,4811,의령군,,지정면투표소,963,580,151,397,8,1,3,0,0,1,0,4,0,4,569,11,383
4800,경상남도,4811,의령군,낙서면,소계,615,459,75,358,10,0,2,0,0,0,0,6,2,0,453,6,156
4800,경상남도,4811,의령군,,관내사전투표,203,203,50,147,4,0,1,0,0,0,0,1,0,0,203,0,0
4800,경상남도,4811,의령군,,낙서면투표소,412,256,25,211,6,0,1,0,0,0,0,5,2,0,250,6,156
4800,경상남도,4811,의령군,부림면,소계,2484,1869,477,1303,23,4,10,0,0,3,2,11,5,3,1841,28,615
4800,경상남도,4811,의령군,,관내사전투표,1027,1027,281,705,11,3,6,0,0,1,0,5,1,2,1015,12,0
4800,경상남도,4811,의령군,,부림면투표소,1457,842,196,598,12,1,4,0,0,2,2,6,4,1,826,16,615
4800,경상남도,4811,의령군,봉수면,소계,737,539,100,404,8,1,5,1,1,0,1,2,5,2,530,9,198
4800,경상남도,4811,의령군,,관내사전투표,304,304,62,222,6,1,3,1,0,0,0,0,3,0,298,6,0
4800,경상남도,4811,의령군,,봉수면투표소,433,235,38,182,2,0,2,0,1,0,1,2,2,2,232,3,198
4800,경상남도,4811,의령군,궁류면,소계,956,729,149,520,14,2,9,1,0,1,2,0,6,5,709,20,227
4800,경상남도,4811,의령군,,관내사전투표,432,432,80,318,7,1,5,1,0,1,2,0,3,3,421,11,0
4800,경상남도,4811,의령군,,궁류면투표소,524,297,69,202,7,1,4,0,0,0,0,0,3,2,288,9,227
4800,경상남도,4811,의령군,유곡면,소계,954,761,159,552,11,2,9,1,1,0,0,1,3,2,741,20,193
4800,경상남도,4811,의령군,,관내사전투표,323,323,76,229,2,1,6,1,0,0,0,0,1,1,317,6,0
4800,경상남도,4811,의령군,,유곡면제1투,360,261,46,196,6,0,1,0,1,0,0,0,2,0,252,9,99
4800,경상남도,4811,의령군,,유곡면제2투,271,177,37,127,3,1,2,0,0,0,0,1,0,1,172,5,94
4800,경상남도,4811,의령군,잘못 투입·구분된 투표지,,0,1,0,1,0,0,0,0,0,0,0,0,0,0,1,0,-1
4800,경상남도,4812,함안군,합계,,54570,41791,13504,26066,921,25,614,23,12,9,60,78,32,33,41377,414,12779
4800,경상남도,4812,함안군,거소·선상투표,,313,283,74,153,2,2,7,1,0,0,1,1,1,7,249,34,30
4800,경상남도,4812,함안군,관외사전투표,,5113,5112,1841,2981,127,2,83,5,1,1,11,6,1,1,5060,52,1
4800,경상남도,4812,함안군,재외투표,,389,178,64,88,6,0,0,0,0,0,0,1,0,0,159,19,211
4800,경상남도,4812,함안군,가야읍,소계,13138,9344,3101,5715,223,1,169,4,3,2,11,21,5,7,9262,82,3794
4800,경상남도,4812,함안군,,관내사전투표,3919,3918,1509,2228,91,1,47,2,1,0,2,8,2,2,3893,25,1
4800,경상남도,4812,함안군,,가야읍제1투,1607,919,249,597,29,0,33,1,0,0,1,3,0,0,913,6,688
4800,경상남도,4812,함안군,,가야읍제2투,2962,1743,550,1084,33,0,37,0,1,2,3,6,0,3,1719,24,1219
4800,경상남도,4812,함안군,,가야읍제3투,2349,1346,398,854,39,0,29,1,0,0,4,2,0,1,1328,18,1003
4800,경상남도,4812,함안군,,가야읍제4투,2301,1418,395,952,31,0,23,0,1,0,1,2,3,1,1409,9,883
4800,경상남도,4812,함안군,함안면,소계,2133,1630,496,1068,24,1,16,0,0,0,3,2,3,2,1615,15,503
4800,경상남도,4812,함안군,,관내사전투표,859,859,316,514,14,0,4,0,0,0,2,1,3,1,855,4,0
4800,경상남도,4812,함안군,,함안면투표소,1274,771,180,554,10,1,12,0,0,0,1,1,0,1,760,11,503
4800,경상남도,4812,함안군,군북면,소계,5027,3655,1000,2437,77,3,69,2,4,1,6,7,6,3,3615,40,1372
4800,경상남도,4812,함안군,,관내사전투표,1623,1623,513,1021,32,0,29,2,2,1,4,4,2,2,1612,11,0
4800,경상남도,4812,함안군,,군북면제1투,1558,851,205,600,19,0,15,0,1,0,1,0,0,0,841,10,707
4800,경상남도,4812,함안군,,군북면제2투,623,414,111,271,11,1,7,0,0,0,1,0,2,0,404,10,209
4800,경상남도,4812,함안군,,군북면제3투,746,453,100,326,7,1,10,0,0,0,0,1,1,1,447,6,293
4800,경상남도,4812,함안군,,군북면제4투,477,314,71,219,8,1,8,0,1,0,0,2,1,0,311,3,163
4800,경상남도,4812,함안군,법수면,소계,2462,1802,510,1206,30,2,21,1,0,0,3,3,3,1,1780,22,660
4800,경상남도,4812,함안군,,관내사전투표,922,922,266,614,17,1,7,1,0,0,1,2,2,0,911,11,0
4800,경상남도,4812,함안군,,법수면투표소,1540,880,244,592,13,1,14,0,0,0,2,1,1,1,869,11,660
4800,경상남도,4812,함안군,대산면,소계,2906,2138,556,1487,34,3,20,3,0,1,1,4,4,4,2117,21,768
4800,경상남도,4812,함안군,,관내사전투표,1092,1092,325,726,21,2,7,2,0,0,0,1,1,1,1086,6,0
4800,경상남도,4812,함안군,,대산면투표소,1814,1046,231,761,13,1,13,1,0,1,1,3,3,3,1031,15,768
4800,경상남도,4812,함안군,칠서면,소계,3859,2704,773,1787,67,1,36,2,1,1,4,7,3,2,2684,20,1155
4800,경상남도,4812,함안군,,관내사전투표,769,769,253,481,20,1,4,1,0,0,3,2,1,0,766,3,0
4800,경상남도,4812,함안군,,칠서면제1투,1716,1052,347,641,33,0,18,1,0,0,0,1,1,2,1044,8,664
4800,경상남도,4812,함안군,,칠서면제2투,522,318,62,237,8,0,5,0,0,0,0,2,0,0,314,4,204
4800,경상남도,4812,함안군,,칠서면제3투,852,565,111,428,6,0,9,0,1,1,1,2,1,0,560,5,287
4800,경상남도,4812,함안군,칠북면,소계,1681,1347,286,1015,16,1,17,2,0,1,0,1,0,1,1340,7,334
4800,경상남도,4812,함안군,,관내사전투표,695,695,180,495,9,1,4,2,0,0,0,1,0,0,692,3,0
4800,경상남도,4812,함안군,,칠북면투표소,986,652,106,520,7,0,13,0,0,1,0,0,0,1,648,4,334
4800,경상남도,4812,함안군,칠원읍,소계,13688,10391,3779,6085,251,8,140,3,1,2,16,17,5,3,10310,81,3297
4800,경상남도,4812,함안군,,관내사전투표,3514,3514,1350,2016,79,4,43,0,0,0,0,5,1,1,3499,15,0
4800,경상남도,4812,함안군,,칠원읍제1투,2566,1521,412,1023,30,1,33,1,1,0,2,2,2,1,1508,13,1045
4800,경상남도,4812,함안군,,칠원읍제2투,774,545,111,399,12,0,4,1,0,0,9,1,1,1,539,6,229
4800,경상남도,4812,함안군,,칠원읍제3투,2873,2159,937,1098,76,1,21,0,0,0,2,3,0,0,2138,21,714
4800,경상남도,4812,함안군,,칠원읍제4투,1653,1010,277,681,17,1,19,0,0,1,1,1,1,0,999,11,643
4800,경상남도,4812,함안군,,칠원읍제5투,2308,1642,692,868,37,1,20,1,0,1,2,5,0,0,1627,15,666
4800,경상남도,4812,함안군,산인면,소계,3057,2542,849,1583,52,1,31,0,1,0,4,6,1,0,2528,14,515
4800,경상남도,4812,함안군,,관내사전투표,1729,1729,648,1005,36,1,22,0,1,0,0,6,1,0,1720,9,0
4800,경상남도,4812,함안군,,산인면투표소,1328,813,201,578,16,0,9,0,0,0,4,0,0,0,808,5,515
4800,경상남도,4812,함안군,여항면,소계,804,664,175,460,12,0,5,0,1,0,0,2,0,2,657,7,140
4800,경상남도,4812,함안군,,관내사전투표,401,401,119,262,7,0,3,0,1,0,0,2,0,2,396,5,0
4800,경상남도,4812,함안군,,여항면투표소,403,263,56,198,5,0,2,0,0,0,0,0,0,0,261,2,140
4800,경상남도,4812,함안군,잘못 투입·구분된 투표지,,0,1,0,1,0,0,0,0,0,0,0,0,0,0,1,0,-1
4800,경상남도,4813,창녕군,합계,,54037,41401,10934,28492,716,37,506,18,7,12,67,79,48,36,40952,449,12636
4800,경상남도,4813,창녕군,거소·선상투표,,212,192,42,116,6,0,4,0,0,0,1,0,0,2,171,21,20
4800,경상남도,4813,창녕군,관외사전투표,,5097,5096,1661,3188,100,7,71,2,2,0,8,7,1,5,5052,44,1
4800,경상남도,4813,창녕군,재외투표,,306,153,76,60,3,0,0,0,0,0,0,0,0,0,139,14,153
4800,경상남도,4813,창녕군,창녕읍,소계,12697,9179,2514,6192,188,5,134,3,1,5,9,18,10,6,9085,94,3518
4800,경상남도,4813,창녕군,,관내사전투표,3725,3725,1203,2345,80,2,50,1,1,2,5,7,0,4,3700,25,0
4800,경상남도,4813,창녕군,,창녕읍제1투,1660,1075,217,812,19,1,10,0,0,1,1,1,4,0,1066,9,585
4800,경상남도,4813,창녕군,,창녕읍제2투,2249,1294,307,922,25,1,18,1,0,0,1,3,2,1,1281,13,955
4800,경상남도,4813,창녕군,,창녕읍제3투,2419,1503,383,1038,32,0,24,0,0,0,2,3,1,1,1484,19,916
4800,경상남도,4813,창녕군,,창녕읍제4투,2644,1582,404,1075,32,1,32,1,0,2,0,4,3,0,1554,28,1062
4800,경상남도,4813,창녕군,남지읍,소계,9477,6947,1978,4668,98,4,94,1,0,1,10,15,7,5,6881,66,2530
4800,경상남도,4813,창녕군,,관내사전투표,3299,3298,1023,2165,45,4,25,1,0,1,3,6,1,1,3275,23,1
4800,경상남도,4813,창녕군,,남지읍제1투,2396,1366,363,911,25,0,35,0,0,0,3,4,2,3,1346,20,1030
4800,경상남도,4813,창녕군,,남지읍제2투,3033,1758,491,1189,23,0,27,0,0,0,2,4,1,0,1737,21,1275
4800,경상남도,4813,창녕군,,남지읍제3투,749,525,101,403,5,0,7,0,0,0,2,1,3,1,523,2,224
4800,경상남도,4813,창녕군,고암면,소계,1658,1275,294,902,33,0,13,0,0,2,4,1,1,1,1251,24,383
4800,경상남도,4813,창녕군,,관내사전투표,720,720,190,499,15,0,4,0,0,1,1,1,1,0,712,8,0
4800,경상남도,4813,창녕군,,고암면투표소,938,555,104,403,18,0,9,0,0,1,3,0,0,1,539,16,383
4800,경상남도,4813,창녕군,성산면,소계,1303,984,186,760,10,1,4,2,0,0,6,3,6,2,980,4,319
4800,경상남도,4813,창녕군,,관내사전투표,486,486,101,369,4,1,1,2,0,0,1,1,4,0,484,2,0
4800,경상남도,4813,창녕군,,성산면투표소,817,498,85,391,6,0,3,0,0,0,5,2,2,2,496,2,319
4800,경상남도,4813,창녕군,대합면,소계,3134,2275,438,1743,32,2,22,1,1,0,5,4,1,4,2253,22,859
4800,경상남도,4813,창녕군,,관내사전투표,1164,1164,257,870,18,0,6,0,0,0,1,1,1,2,1156,8,0
4800,경상남도,4813,창녕군,,대합면투표소,1970,1111,181,873,14,2,16,1,1,0,4,3,0,2,1097,14,859
4800,경상남도,4813,창녕군,이방면,소계,1838,1397,227,1108,16,4,10,2,1,2,2,1,4,1,1378,19,441
4800,경상남도,4813,창녕군,,관내사전투표,839,839,149,653,10,4,3,2,1,2,0,0,3,1,828,11,0
4800,경상남도,4813,창녕군,,이방면투표소,999,558,78,455,6,0,7,0,0,0,2,1,1,0,550,8,441
4800,경상남도,4813,창녕군,유어면,소계,1645,1269,260,958,14,2,15,0,0,0,2,4,2,0,1257,12,376
4800,경상남도,4813,창녕군,,관내사전투표,706,706,164,525,8,2,4,0,0,0,0,0,0,0,703,3,0
4800,경상남도,4813,창녕군,,유어면투표소,939,563,96,433,6,0,11,0,0,0,2,4,2,0,554,9,376
4800,경상남도,4813,창녕군,대지면,소계,2287,1757,436,1241,36,1,17,2,0,1,2,2,1,2,1741,16,530
4800,경상남도,4813,창녕군,,관내사전투표,924,924,272,612,21,1,5,2,0,1,0,0,1,2,917,7,0
4800,경상남도,4813,창녕군,,대지면투표소,1363,833,164,629,15,0,12,0,0,0,2,2,0,0,824,9,530
4800,경상남도,4813,창녕군,계성면,소계,1922,1438,322,1047,21,2,16,1,0,0,1,2,4,3,1419,19,484
4800,경상남도,4813,창녕군,,관내사전투표,680,680,162,495,7,2,1,0,0,0,0,2,3,1,673,7,0
4800,경상남도,4813,창녕군,,계성면투표소,1242,758,160,552,14,0,15,1,0,0,1,0,1,2,746,12,484
4800,경상남도,4813,창녕군,영산면,소계,4415,3288,956,2173,61,3,42,1,1,1,10,7,2,0,3257,31,1127
4800,경상남도,4813,창녕군,,관내사전투표,1509,1509,490,955,26,2,14,1,1,0,0,2,2,0,1493,16,0
4800,경상남도,4813,창녕군,,영산면제1투,2243,1314,353,887,25,1,25,0,0,0,9,4,0,0,1304,10,929
4800,경상남도,4813,창녕군,,영산면제2투,663,465,113,331,10,0,3,0,0,1,1,1,0,0,460,5,198
4800,경상남도,4813,창녕군,장마면,소계,1549,1163,297,828,12,0,7,0,0,0,2,1,2,0,1149,14,386
4800,경상남도,4813,창녕군,,관내사전투표,557,557,154,388,6,0,1,0,0,0,0,1,1,0,551,6,0
4800,경상남도,4813,창녕군,,장마면투표소,992,606,143,440,6,0,6,0,0,0,2,0,1,0,598,8,386
4800,경상남도,4813,창녕군,도천면,소계,2282,1723,425,1208,36,3,15,1,0,0,1,8,1,1,1699,24,559
4800,경상남도,4813,창녕군,,관내사전투표,965,965,265,656,15,1,5,1,0,0,1,5,1,1,951,14,0
4800,경상남도,4813,창녕군,,도천면투표소,1317,758,160,552,21,2,10,0,0,0,0,3,0,0,748,10,559
4800,경상남도,4813,창녕군,길곡면,소계,1237,996,264,698,12,1,8,1,0,0,2,1,2,2,991,5,241
4800,경상남도,4813,창녕군,,관내사전투표,458,458,144,299,3,1,5,1,0,0,0,1,2,2,458,0,0
4800,경상남도,4813,창녕군,,길곡면투표소,779,538,120,399,9,0,3,0,0,0,2,0,0,0,533,5,241
4800,경상남도,4813,창녕군,부곡면,소계,2978,2267,557,1601,38,2,34,1,1,0,2,5,4,2,2247,20,711
4800,경상남도,4813,창녕군,,관내사전투표,1203,1203,337,821,18,0,10,1,1,0,0,5,2,2,1197,6,0
4800,경상남도,4813,창녕군,,부곡면투표소,1775,1064,220,780,20,2,24,0,0,0,2,0,2,0,1050,14,711
4800,경상남도,4813,창녕군,잘못 투입·구분된 투표지,,0,2,1,1,0,0,0,0,0,0,0,0,0,0,2,0,-2
4800,경상남도,4814,양산시,합계,,294133,220501,92137,116904,5364,107,3002,57,42,48,169,359,83,126,218398,2103,73632
4800,경상남도,4814,양산시,거소·선상투표,,903,841,268,381,24,1,18,0,2,0,3,2,4,5,708,133,62
4800,경상남도,4814,양산시,관외사전투표,,19775,19771,8496,10096,545,19,338,6,7,5,8,24,8,16,19568,203,4
4800,경상남도,4814,양산시,재외투표,,886,629,341,202,16,0,3,0,0,0,0,1,0,0,563,66,257
4800,경상남도,4814,양산시,물금읍,소계,84461,61945,27357,31551,1574,23,704,10,6,5,36,101,16,26,61409,536,22516
4800,경상남도,4814,양산시,,관내사전투표,15399,15398,7677,7174,302,10,107,3,2,2,2,22,2,1,15304,94,1
4800,경상남도,4814,양산시,,물금읍제1투,1270,797,247,513,12,2,10,0,1,0,2,3,1,0,791,6,473
4800,경상남도,4814,양산시,,물금읍제2투,3134,1973,857,995,64,1,29,0,0,0,1,2,0,1,1950,23,1161
4800,경상남도,4814,양산시,,물금읍제3투,3442,2250,785,1338,53,1,37,1,1,0,2,5,2,3,2228,22,1192
4800,경상남도,4814,양산시,,물금읍제4투,2249,1351,477,782,41,0,27,0,0,0,0,4,1,0,1332,19,898
4800,경상남도,4814,양산시,,물금읍제5투,4018,2946,1339,1497,75,0,15,0,0,0,1,4,0,2,2933,13,1072
4800,경상남도,4814,양산시,,물금읍제6투,2307,1439,531,811,36,0,27,0,1,0,2,4,0,0,1412,27,868
4800,경상남도,4814,양산시,,물금읍제7투,1651,1035,399,570,25,1,21,0,0,0,1,4,0,2,1023,12,616
4800,경상남도,4814,양산시,,물금읍제8투,1988,1464,604,753,51,1,20,1,0,0,1,3,1,1,1436,28,524
4800,경상남도,4814,양산시,,물금읍제9투,2765,1547,590,864,45,0,26,0,0,0,2,4,0,1,1532,15,1218
4800,경상남도,4814,양산시,,물금읍제10투,2917,2143,978,1075,50,1,17,0,0,0,2,0,0,0,2123,20,774
4800,경상남도,4814,양산시,,물금읍제11투,4175,2688,1152,1395,68,1,34,1,0,0,1,4,0,3,2659,29,1487
4800,경상남도,4814,양산시,,물금읍제12투,2237,1648,723,838,48,0,24,0,0,1,1,2,1,0,1638,10,589
4800,경상남도,4814,양산시,,물금읍제13투,2459,1877,890,880,62,0,19,0,0,0,1,4,3,1,1860,17,582
4800,경상남도,4814,양산시,,물금읍제14투,4021,2614,1196,1279,82,1,27,1,0,1,2,7,1,2,2599,15,1407
4800,경상남도,4814,양산시,,물금읍제15투,1783,1007,403,553,20,0,21,0,0,0,0,1,0,1,999,8,776
4800,경상남도,4814,양산시,,물금읍제16투,2499,1895,806,1014,45,0,16,0,0,0,0,1,1,1,1884,11,604
4800,경상남도,4814,양산시,,물금읍제17투,4341,2812,1336,1318,83,0,39,0,0,0,1,5,0,3,2785,27,1529
4800,경상남도,4814,양산시,,물금읍제18투,3955,2672,1198,1358,61,1,26,0,1,0,1,2,0,0,2648,24,1283
4800,경상남도,4814,양산시,,물금읍제19투,4043,2544,1030,1371,72,1,47,0,0,0,4,3,1,0,2529,15,1499
4800,경상남도,4814,양산시,,물금읍제20투,2143,1657,774,788,48,1,16,0,0,0,3,3,0,0,1633,24,486
4800,경상남도,4814,양산시,,물금읍제21투,4518,3230,1324,1770,78,1,23,0,0,0,0,4,2,1,3203,27,1288
4800,경상남도,4814,양산시,,물금읍제22투,2582,1660,666,874,61,0,34,2,0,1,0,2,0,1,1641,19,922
4800,경상남도,4814,양산시,,물금읍제23투,1771,1390,553,781,26,0,12,0,0,0,4,2,0,0,1378,12,381
4800,경상남도,4814,양산시,,물금읍제24투,1712,1214,519,627,39,0,14,1,0,0,0,4,0,1,1205,9,498
4800,경상남도,4814,양산시,,물금읍제25투,1082,694,303,333,27,0,16,0,0,0,2,2,0,1,684,10,388
4800,경상남도,4814,양산시,동면,소계,26096,18445,8006,9599,426,6,196,4,4,4,15,27,6,8,18301,144,7651
4800,경상남도,4814,양산시,,관내사전투표,3843,3843,1831,1894,67,0,19,2,0,1,0,5,1,1,3821,22,0
4800,경상남도,4814,양산시,,동면제1투,4383,2459,906,1440,40,4,38,1,1,1,3,4,1,1,2440,19,1924
4800,경상남도,4814,양산시,,동면제2투,2462,1615,607,920,35,1,34,0,1,0,3,0,0,1,1602,13,847
4800,경상남도,4814,양산시,,동면제3투,1841,1303,490,740,25,0,25,1,1,0,5,4,0,0,1291,12,538
4800,경상남도,4814,양산시,,동면제4투,692,487,103,364,6,0,7,0,0,1,0,0,2,0,483,4,205
4800,경상남도,4814,양산시,,동면제5투,3554,2405,1153,1138,69,1,22,0,0,0,1,5,0,2,2391,14,1149
4800,경상남도,4814,양산시,,동면제6투,3991,2408,1136,1151,73,0,27,0,0,0,0,2,0,0,2389,19,1583
4800,경상남도,4814,양산시,,동면제7투,3566,2652,1285,1246,74,0,19,0,0,1,1,5,1,0,2632,20,914
4800,경상남도,4814,양산시,,동면제8투,1764,1273,495,706,37,0,5,0,1,0,2,2,1,3,1252,21,491
4800,경상남도,4814,양산시,원동면,소계,2903,2228,539,1612,27,1,24,0,1,0,1,2,3,4,2214,14,675
4800,경상남도,4814,양산시,,관내사전투표,832,832,277,530,12,1,4,0,0,0,0,0,0,3,827,5,0
4800,경상남도,4814,양산시,,원동면제1투,786,475,91,360,3,0,13,0,1,0,0,0,1,1,470,5,311
4800,경상남도,4814,양산시,,원동면제2투,860,631,116,499,8,0,2,0,0,0,0,1,2,0,628,3,229
4800,경상남도,4814,양산시,,원동면제3투,425,290,55,223,4,0,5,0,0,0,1,1,0,0,289,1,135
4800,경상남도,4814,양산시,상북면,소계,11145,8331,2815,5136,159,4,109,2,0,4,8,13,5,7,8262,69,2814
4800,경상남도,4814,양산시,,관내사전투표,3700,3700,1383,2195,61,2,27,1,0,1,1,7,2,4,3684,16,0
4800,경상남도,4814,양산시,,상북면제1투,979,594,175,381,17,0,10,0,0,0,1,1,1,1,587,7,385
4800,경상남도,4814,양산시,,상북면제2투,994,620,159,425,6,0,18,0,0,1,4,0,0,0,613,7,374
4800,경상남도,4814,양산시,,상북면제3투,1195,710,230,444,17,0,8,0,0,0,0,2,1,0,702,8,485
4800,경상남도,4814,양산시,,상북면제4투,1997,1309,454,771,37,0,24,1,0,2,1,2,1,1,1294,15,688
4800,경상남도,4814,양산시,,상북면제5투,1373,857,310,510,12,1,13,0,0,0,0,0,0,0,846,11,516
4800,경상남도,4814,양산시,,상북면제6투,907,541,104,410,9,1,9,0,0,0,1,1,0,1,536,5,366
4800,경상남도,4814,양산시,하북면,소계,6923,5130,1568,3364,65,5,65,0,0,3,6,6,2,2,5086,44,1793
4800,경상남도,4814,양산시,,관내사전투표,2385,2385,849,1462,31,3,22,0,0,3,1,2,1,0,2374,11,0
4800,경상남도,4814,양산시,,하북면제1투,1900,1103,315,734,17,1,18,0,0,0,2,3,0,0,1090,13,797
4800,경상남도,4814,양산시,,하북면제2투,604,382,107,260,3,0,3,0,0,0,2,1,1,0,377,5,222
4800,경상남도,4814,양산시,,하북면제3투,691,428,81,327,5,1,11,0,0,0,0,0,0,1,426,2,263
4800,경상남도,4814,양산시,,하북면제4투,1343,832,216,581,9,0,11,0,0,0,1,0,0,1,819,13,511
4800,경상남도,4814,양산시,중앙동,소계,11229,8036,2805,4877,133,5,113,2,0,0,7,13,5,4,7964,72,3193
4800,경상남도,4814,양산시,,관내사전투표,3979,3979,1585,2268,68,2,31,1,0,0,1,4,2,2,3964,15,0
4800,경상남도,4814,양산시,,중앙동제1투,2194,1206,422,694,32,0,30,0,0,0,1,4,1,0,1184,22,988
4800,경상남도,4814,양산시,,중앙동제2투,1906,1117,320,746,17,1,15,0,0,0,2,0,0,0,1101,16,789
4800,경상남도,4814,양산시,,중앙동제3투,1489,807,238,532,8,1,13,1,0,0,1,4,2,0,800,7,682
4800,경상남도,4814,양산시,,중앙동제4투,1661,927,240,637,8,1,24,0,0,0,2,1,0,2,915,12,734
4800,경상남도,4814,양산시,양주동,소계,28322,22685,9960,11495,649,8,244,8,2,3,10,56,11,10,22456,229,5637
4800,경상남도,4814,양산시,,관내사전투표,8999,8999,4389,4257,199,3,52,1,0,0,3,30,4,4,8942,57,0
4800,경상남도,4814,양산시,,양주동제1투,1689,987,343,583,28,0,16,0,0,0,0,1,1,1,973,14,702
4800,경상남도,4814,양산시,,양주동제2투,1898,1283,492,708,45,0,21,1,0,1,0,3,1,0,1272,11,615
4800,경상남도,4814,양산시,,양주동제3투,1752,1277,512,671,46,0,25,0,0,0,2,2,0,1,1259,18,475
4800,경상남도,4814,양산시,,양주동제4투,1400,976,354,557,32,0,14,0,0,2,1,0,0,1,961,15,424
4800,경상남도,4814,양산시,,양주동제5투,1533,1065,415,583,37,0,14,1,1,0,0,5,0,0,1056,9,468
4800,경상남도,4814,양산시,,양주동제6투,2318,1599,626,867,60,1,16,1,0,0,0,4,2,0,1577,22,719
4800,경상남도,4814,양산시,,양주동제7투,2757,2077,948,996,73,1,27,1,0,0,3,1,0,2,2052,25,680
4800,경상남도,4814,양산시,,양주동제8투,2428,1748,766,890,43,0,24,1,1,0,0,6,1,1,1733,15,680
4800,경상남도,4814,양산시,,양주동제9투,1955,1558,729,735,53,2,11,1,0,0,0,3,1,0,1535,23,397
4800,경상남도,4814,양산시,,양주동제10투,1593,1116,386,648,33,1,24,1,0,0,1,1,1,0,1096,20,477
4800,경상남도,4814,양산시,삼성동,소계,17824,12327,4912,6712,259,10,260,1,1,5,7,18,4,11,12200,127,5497
4800,경상남도,4814,양산시,,관내사전투표,4535,4535,2038,2311,78,5,66,1,0,1,0,5,1,6,4512,23,0
4800,경상남도,4814,양산시,,삼성동제1투,2628,1598,571,898,50,1,35,0,0,1,3,6,1,0,1566,32,1030
4800,경상남도,4814,양산시,,삼성동제2투,2033,1423,447,903,24,2,29,0,0,1,1,0,0,2,1409,14,610
4800,경상남도,4814,양산시,,삼성동제3투,2597,1402,537,776,31,2,39,0,0,0,0,2,1,0,1388,14,1195
4800,경상남도,4814,양산시,,삼성동제4투,2157,1164,448,629,31,0,36,0,1,1,2,0,0,2,1150,14,993
4800,경상남도,4814,양산시,,삼성동제5투,1728,994,388,537,27,0,21,0,0,0,1,5,1,0,980,14,734
4800,경상남도,4814,양산시,,삼성동제6투,2146,1211,483,658,18,0,34,0,0,1,0,0,0,1,1195,16,935
4800,경상남도,4814,양산시,강서동,소계,6765,4783,2005,2495,139,4,74,3,3,0,4,7,2,1,4737,46,1982
4800,경상남도,4814,양산시,,관내사전투표,1453,1453,682,695,44,1,15,2,2,0,1,2,0,0,1444,9,0
4800,경상남도,4814,양산시,,강서동제1투,3388,2210,913,1167,63,1,32,0,1,0,2,3,2,1,2185,25,1178
4800,경상남도,4814,양산시,,강서동제2투,1924,1120,410,633,32,2,27,1,0,0,1,2,0,0,1108,12,804
4800,경상남도,4814,양산시,서창동,소계,22301,15837,6703,8278,390,2,257,10,8,3,8,34,6,7,15706,131,6464
4800,경상남도,4814,양산시,,관내사전투표,6283,6283,2872,3142,133,0,66,4,3,1,2,17,3,2,6245,38,0
4800,경상남도,4814,양산시,,서창동제1투,1466,837,232,557,17,0,19,2,0,0,0,3,0,0,830,7,629
4800,경상남도,4814,양산시,,서창동제2투,2391,1500,600,793,50,0,27,0,1,1,3,4,1,1,1481,19,891
4800,경상남도,4814,양산시,,서창동제3투,1832,953,314,571,21,1,33,1,1,0,1,1,0,0,944,9,879
4800,경상남도,4814,양산시,,서창동제4투,3474,2265,1031,1096,72,0,35,1,2,1,0,4,0,1,2243,22,1209
4800,경상남도,4814,양산시,,서창동제5투,1871,1075,381,627,30,1,24,0,0,0,1,1,1,1,1067,8,796
4800,경상남도,4814,양산시,,서창동제6투,2123,993,368,566,19,0,20,2,0,0,0,3,1,1,980,13,1130
4800,경상남도,4814,양산시,,서창동제7투,2861,1931,905,926,48,0,33,0,1,0,1,1,0,1,1916,15,930
4800,경상남도,4814,양산시,소주동,소계,15945,11297,4602,6028,298,8,198,4,1,8,16,18,6,11,11198,99,4648
4800,경상남도,4814,양산시,,관내사전투표,4084,4084,1948,1976,86,2,33,2,0,2,1,6,1,1,4058,26,0
4800,경상남도,4814,양산시,,소주동제1투,1527,1024,354,607,27,1,26,0,0,0,3,4,1,0,1023,1,503
4800,경상남도,4814,양산시,,소주동제2투,2077,1268,491,689,32,0,31,0,1,0,2,2,1,3,1252,16,809
4800,경상남도,4814,양산시,,소주동제3투,1960,1131,400,637,35,0,30,0,0,4,3,2,2,0,1113,18,829
4800,경상남도,4814,양산시,,소주동제4투,1459,960,373,517,38,0,21,0,0,1,2,0,0,1,953,7,499
4800,경상남도,4814,양산시,,소주동제5투,1755,937,268,600,20,1,24,1,0,0,2,0,0,6,922,15,818
4800,경상남도,4814,양산시,,소주동제6투,3083,1893,768,1002,60,4,33,1,0,1,3,4,1,0,1877,16,1190
4800,경상남도,4814,양산시,평산동,소계,22796,15914,6616,8492,376,5,229,6,5,5,25,24,2,10,15795,119,6882
4800,경상남도,4814,양산시,,관내사전투표,5545,5546,2765,2569,119,3,40,3,0,1,4,8,1,2,5515,31,-1
4800,경상남도,4814,양산시,,평산동제1투,1812,1115,432,607,38,0,20,1,2,0,3,1,0,1,1105,10,697
4800,경상남도,4814,양산시,,평산동제2투,2118,1257,439,736,29,0,28,0,2,0,2,5,0,3,1244,13,861
4800,경상남도,4814,양산시,,평산동제3투,2325,1523,574,871,30,1,28,0,0,1,6,0,1,2,1514,9,802
4800,경상남도,4814,양산시,,평산동제4투,1527,1059,393,607,30,0,14,0,0,0,2,2,0,1,1049,10,468
4800,경상남도,4814,양산시,,평산동제5투,3395,1706,605,998,40,0,35,1,1,1,4,2,0,0,1687,19,1689
4800,경상남도,4814,양산시,,평산동제6투,2079,1143,453,625,26,0,27,1,0,1,2,5,0,0,1140,3,936
4800,경상남도,4814,양산시,,평산동제7투,1643,1031,278,697,29,0,14,0,0,0,1,0,0,1,1020,11,612
4800,경상남도,4814,양산시,,평산동제8투,2352,1534,677,782,35,1,23,0,0,1,1,1,0,0,1521,13,818
4800,경상남도,4814,양산시,덕계동,소계,15859,12302,5144,6586,284,6,170,1,2,3,15,13,3,4,12231,71,3557
4800,경상남도,4814,양산시,,관내사전투표,6498,6498,2892,3364,129,2,73,1,1,2,2,7,2,1,6476,22,0
4800,경상남도,4814,양산시,,덕계동제1투,2684,1622,564,973,40,0,27,0,1,0,2,2,0,1,1610,12,1062
4800,경상남도,4814,양산시,,덕계동제2투,2725,1675,677,906,41,0,30,0,0,1,1,2,0,1,1659,16,1050
4800,경상남도,4814,양산시,,덕계동제3투,1974,1180,420,686,34,1,16,0,0,0,9,2,1,1,1170,10,794
4800,경상남도,4814,양산시,,덕계동제4투,1978,1327,591,657,40,3,24,0,0,0,1,0,0,0,1316,11,651
4800,경상남도,4814,양산시,잘못 투입·구분된 투표지,,0,0,0,0,0,0,0,0,0,0,0,0,0,0,0,0,0
4800,경상남도,4815,하동군,합계,,39640,32089,11218,18974,723,32,415,15,10,11,34,72,83,59,31646,443,7551
4800,경상남도,4815,하동군,거소·선상투표,,389,332,117,139,7,1,5,2,1,1,1,4,3,1,282,50,57
4800,경상남도,4815,하동군,관외사전투표,,4228,4226,1671,2319,115,3,64,4,0,2,1,5,1,7,4192,34,2
4800,경상남도,4815,하동군,재외투표,,194,124,59,51,5,0,0,0,0,0,0,0,0,0,115,9,70
4800,경상남도,4815,하동군,하동읍,소계,7663,6025,2293,3406,155,6,70,3,1,0,6,6,8,2,5956,69,1638
4800,경상남도,4815,하동군,,관내사전투표,3480,3480,1428,1878,92,5,28,2,0,0,3,6,4,0,3446,34,0
4800,경상남도,4815,하동군,,하동읍제1투,1091,624,228,356,15,1,15,0,0,0,1,0,0,1,617,7,467
4800,경상남도,4815,하동군,,하동읍제2투,1148,692,263,390,23,0,6,0,0,0,1,0,1,0,684,8,456
4800,경상남도,4815,하동군,,하동읍제3투,670,455,123,307,8,0,7,0,0,0,0,0,1,0,446,9,215
4800,경상남도,4815,하동군,,하동읍제4투,1274,774,251,475,17,0,14,1,1,0,1,0,2,1,763,11,500
4800,경상남도,4815,하동군,화개면,소계,2424,1947,842,1012,30,0,26,0,0,0,0,4,8,4,1926,21,477
4800,경상남도,4815,하동군,,관내사전투표,1292,1292,577,663,17,0,14,0,0,0,0,4,5,2,1282,10,0
4800,경상남도,4815,하동군,,화개면제1투,714,363,143,200,8,0,6,0,0,0,0,0,1,1,359,4,351
4800,경상남도,4815,하동군,,화개면제2투,418,292,122,149,5,0,6,0,0,0,0,0,2,1,285,7,126
4800,경상남도,4815,하동군,악양면,소계,2821,2194,810,1243,51,5,33,1,1,1,3,5,9,3,2165,29,627
4800,경상남도,4815,하동군,,관내사전투표,1510,1510,598,833,30,5,10,1,1,0,3,5,5,2,1493,17,0
4800,경상남도,4815,하동군,,악양면투표소,1311,684,212,410,21,0,23,0,0,1,0,0,4,1,672,12,627
4800,경상남도,4815,하동군,적량면,소계,1630,1278,464,745,30,2,12,0,0,0,1,3,6,1,1264,14,352
4800,경상남도,4815,하동군,,관내사전투표,818,818,312,466,17,2,5,0,0,0,0,1,5,0,808,10,0
4800,경상남도,4815,하동군,,적량면투표소,812,460,152,279,13,0,7,0,0,0,1,2,1,1,456,4,352
4800,경상남도,4815,하동군,횡천면,소계,1597,1279,380,838,25,1,10,0,1,0,1,4,5,1,1266,13,318
4800,경상남도,4815,하동군,,관내사전투표,856,856,249,567,17,0,6,0,1,0,1,2,4,1,848,8,0
4800,경상남도,4815,하동군,,횡천면투표소,741,423,131,271,8,1,4,0,0,0,0,2,1,0,418,5,318
4800,경상남도,4815,하동군,고전면,소계,1745,1347,465,812,25,1,16,1,1,0,4,1,7,0,1333,14,398
4800,경상남도,4815,하동군,,관내사전투표,787,787,271,485,12,1,4,1,0,0,0,1,6,0,781,6,0
4800,경상남도,4815,하동군,,고전면제1투,548,306,92,187,10,0,9,0,1,0,2,0,0,0,301,5,242
4800,경상남도,4815,하동군,,고전면제2투,410,254,102,140,3,0,3,0,0,0,2,0,1,0,251,3,156
4800,경상남도,4815,하동군,금남면,소계,2567,2013,653,1233,32,3,36,2,2,0,3,6,6,9,1985,28,554
4800,경상남도,4815,하동군,,관내사전투표,1055,1055,380,621,18,1,12,1,2,0,1,2,3,3,1044,11,0
4800,경상남도,4815,하동군,,금남면제1투,844,508,153,319,9,0,11,1,0,0,0,1,2,3,499,9,336
4800,경상남도,4815,하동군,,금남면제2투,668,450,120,293,5,2,13,0,0,0,2,3,1,3,442,8,218
4800,경상남도,4815,하동군,금성면,소계,2231,1716,592,1030,33,1,15,1,0,0,3,1,4,5,1685,31,515
4800,경상남도,4815,하동군,,관내사전투표,995,995,346,605,19,0,4,0,0,0,1,1,1,2,979,16,0
4800,경상남도,4815,하동군,,금성면투표소,1236,721,246,425,14,1,11,1,0,0,2,0,3,3,706,15,515
4800,경상남도,4815,하동군,진교면,소계,4859,3813,1255,2301,98,5,56,0,0,2,7,14,9,6,3753,60,1046
4800,경상남도,4815,하동군,,관내사전투표,2433,2433,843,1445,61,3,22,0,0,2,2,9,6,4,2397,36,0
4800,경상남도,4815,하동군,,진교면제1투,1403,762,211,491,20,1,20,0,0,0,3,2,0,1,749,13,641
4800,경상남도,4815,하동군,,진교면제2투,1023,618,201,365,17,1,14,0,0,0,2,3,3,1,607,11,405
4800,경상남도,4815,하동군,양보면,소계,1423,1150,297,784,25,0,13,1,1,1,0,4,3,2,1131,19,273
4800,경상남도,4815,하동군,,관내사전투표,656,656,181,440,15,0,7,1,1,0,0,2,2,2,651,5,0
4800,경상남도,4815,하동군,,양보면투표소,767,494,116,344,10,0,6,0,0,1,0,2,1,0,480,14,273
4800,경상남도,4815,하동군,북천면,소계,1375,1099,264,769,24,2,11,0,1,1,1,3,8,5,1089,10,276
4800,경상남도,4815,하동군,,관내사전투표,748,748,183,526,16,1,3,0,1,1,1,1,6,4,743,5,0
4800,경상남도,4815,하동군,,북천면투표소,627,351,81,243,8,1,8,0,0,0,0,2,2,1,346,5,276
4800,경상남도,4815,하동군,청암면,소계,1028,844,267,520,6,0,21,0,1,1,1,4,1,9,831,13,184
4800,경상남도,4815,하동군,,관내사전투표,498,498,148,314,4,0,13,0,1,0,1,1,1,7,490,8,0
4800,경상남도,4815,하동군,,청암면제1투,263,141,33,105,0,0,2,0,0,0,0,0,0,0,140,1,122
4800,경상남도,4815,하동군,,청암면제2투,267,205,86,101,2,0,6,0,0,1,0,3,0,2,201,4,62
4800,경상남도,4815,하동군,옥종면,소계,3466,2702,789,1772,62,2,27,0,0,2,2,8,5,4,2673,29,764
4800,경상남도,4815,하동군,,관내사전투표,1636,1636,510,1042,38,2,10,0,0,0,1,7,5,4,1619,17,0
4800,경상남도,4815,하동군,,옥종면투표소,1830,1066,279,730,24,0,17,0,0,2,1,1,0,0,1054,12,764
4800,경상남도,4815,하동군,잘못 투입·구분된 투표지,,0,0,0,0,0,0,0,0,0,0,0,0,0,0,0,0,0
4800,경상남도,4816,남해군,합계,,38680,30297,10143,18503,676,19,346,21,3,12,29,66,44,46,29908,389,8383
4800,경상남도,4816,남해군,거소·선상투표,,224,187,49,122,3,0,7,0,0,0,0,0,0,0,181,6,37
4800,경상남도,4816,남해군,관외사전투표,,3080,3079,1189,1699,88,1,49,1,1,0,1,5,5,1,3040,39,1
4800,경상남도,4816,남해군,재외투표,,231,117,74,36,2,0,0,0,0,0,0,0,0,0,112,5,114
4800,경상남도,4816,남해군,남해읍,소계,10461,7957,3002,4491,219,5,97,6,2,4,8,24,5,12,7875,82,2504
4800,경상남도,4816,남해군,,관내사전투표,4395,4395,1812,2328,127,3,55,3,2,3,3,13,1,6,4356,39,0
4800,경상남도,4816,남해군,,남해읍제1투,1522,880,328,508,26,1,8,0,0,0,0,3,0,0,874,6,642
4800,경상남도,4816,남해군,,남해읍제2투,920,581,165,389,8,0,7,0,0,0,1,0,1,1,572,9,339
4800,경상남도,4816,남해군,,남해읍제3투,1586,916,345,505,27,0,13,1,0,1,0,3,2,3,900,16,670
4800,경상남도,4816,남해군,,남해읍제4투,2038,1185,352,761,31,1,14,2,0,0,4,5,1,2,1173,12,853
4800,경상남도,4816,남해군,이동면,소계,3116,2468,735,1609,58,1,20,2,0,1,4,5,3,0,2438,30,648
4800,경상남도,4816,남해군,,관내사전투표,1181,1181,396,741,26,0,4,1,0,0,0,1,1,0,1170,11,0
4800,경상남도,4816,남해군,,이동면제1투,674,439,116,302,8,0,3,1,0,0,0,1,1,0,432,7,235
4800,경상남도,4816,남해군,,이동면제2투,637,422,130,258,14,1,5,0,0,1,2,2,0,0,413,9,215
4800,경상남도,4816,남해군,,이동면제3투,624,426,93,308,10,0,8,0,0,0,2,1,1,0,423,3,198
4800,경상남도,4816,남해군,상주면,소계,1322,994,349,594,25,0,11,0,0,0,0,1,5,4,989,5,328
4800,경상남도,4816,남해군,,관내사전투표,597,597,213,362,13,0,4,0,0,0,0,0,1,1,594,3,0
4800,경상남도,4816,남해군,,상주면투표소,725,397,136,232,12,0,7,0,0,0,0,1,4,3,395,2,328
4800,경상남도,4816,남해군,삼동면,소계,3224,2455,824,1504,48,3,26,1,0,0,2,3,3,4,2418,37,769
4800,경상남도,4816,남해군,,관내사전투표,1166,1166,423,688,28,2,9,1,0,0,0,1,0,1,1153,13,0
4800,경상남도,4816,남해군,,삼동면제1투,903,532,157,343,9,1,8,0,0,0,0,0,1,3,522,10,371
4800,경상남도,4816,남해군,,삼동면제2투,1155,757,244,473,11,0,9,0,0,0,2,2,2,0,743,14,398
4800,경상남도,4816,남해군,미조면,소계,1952,1512,441,1009,24,2,15,2,0,0,1,0,3,4,1501,11,440
4800,경상남도,4816,남해군,,관내사전투표,869,869,273,559,20,1,5,1,0,0,0,0,3,1,863,6,0
4800,경상남도,4816,남해군,,미조면투표소,1083,643,168,450,4,1,10,1,0,0,1,0,0,3,638,5,440
4800,경상남도,4816,남해군,남면,소계,2964,2201,695,1379,48,1,23,4,0,0,4,3,5,2,2164,37,763
4800,경상남도,4816,남해군,,관내사전투표,1290,1290,444,784,26,0,6,3,0,0,3,2,2,2,1272,18,0
4800,경상남도,4816,남해군,,남면제1투,922,513,127,337,15,1,16,0,0,0,1,1,2,0,500,13,409
4800,경상남도,4816,남해군,,남면제2투,752,398,124,258,7,0,1,1,0,0,0,0,1,0,392,6,354
4800,경상남도,4816,남해군,서면,소계,2188,1700,501,1111,33,1,12,2,0,2,2,5,3,5,1677,23,488
4800,경상남도,4816,남해군,,관내사전투표,823,822,270,513,19,1,3,2,0,2,1,3,1,1,816,6,1
4800,경상남도,4816,남해군,,서면제1투,840,496,147,322,8,0,7,0,0,0,0,1,2,2,489,7,344
4800,경상남도,4816,남해군,,서면제2투,525,382,84,276,6,0,2,0,0,0,1,1,0,2,372,10,143
4800,경상남도,4816,남해군,고현면,소계,2983,2337,895,1305,51,4,29,1,0,2,3,8,5,4,2307,30,646
4800,경상남도,4816,남해군,,관내사전투표,1279,1279,504,705,28,3,13,0,0,0,2,7,2,2,1266,13,0
4800,경상남도,4816,남해군,,고현면제1투,815,445,143,272,5,0,9,0,0,0,0,0,3,1,433,12,370
4800,경상남도,4816,남해군,,고현면제2투,889,613,248,328,18,1,7,1,0,2,1,1,0,1,608,5,276
4800,경상남도,4816,남해군,설천면,소계,2301,1790,580,1128,31,0,13,1,0,1,1,5,2,3,1765,25,511
4800,경상남도,4816,남해군,,관내사전투표,819,819,288,499,14,0,7,0,0,0,1,3,1,1,814,5,0
4800,경상남도,4816,남해군,,설천면제1투,952,592,175,386,10,0,5,1,0,1,0,0,1,1,580,12,360
4800,경상남도,4816,남해군,,설천면제2투,530,379,117,243,7,0,1,0,0,0,0,2,0,1,371,8,151
4800,경상남도,4816,남해군,창선면,소계,4634,3500,809,2516,46,1,44,1,0,2,3,7,5,7,3441,59,1134
4800,경상남도,4816,남해군,,관내사전투표,1800,1800,442,1287,21,1,18,0,0,1,2,3,1,3,1779,21,0
4800,경상남도,4816,남해군,,창선면제1투,1341,765,168,546,16,0,15,1,0,0,0,0,1,0,747,18,576
4800,경상남도,4816,남해군,,창선면제2투,904,565,111,425,5,0,4,0,0,1,1,2,3,3,555,10,339
4800,경상남도,4816,남해군,,창선면제3투,589,370,88,258,4,0,7,0,0,0,0,2,0,1,360,10,219
4800,경상남도,4816,남해군,잘못 투입·구분된 투표지,,0,0,0,0,0,0,0,0,0,0,0,0,0,0,0,0,0
4800,경상남도,4817,함양군,합계,,34459,26955,8526,16957,528,23,340,17,14,11,39,67,65,29,26616,339,7504
4800,경상남도,4817,함양군,거소·선상투표,,198,185,45,86,6,1,8,0,0,1,0,1,2,0,150,35,13
4800,경상남도,4817,함양군,관외사전투표,,2906,2906,1066,1667,73,1,45,5,3,0,2,6,1,2,2871,35,0
4800,경상남도,4817,함양군,재외투표,,213,112,60,35,4,0,3,1,0,0,0,0,0,0,103,9,101
4800,경상남도,4817,함양군,함양읍,소계,13648,10097,3391,6236,209,5,117,2,5,0,7,24,10,5,10011,86,3551
4800,경상남도,4817,함양군,,관내사전투표,5005,5005,1874,2909,112,4,47,1,3,0,2,12,4,3,4971,34,0
4800,경상남도,4817,함양군,,함양읍제1투,990,537,154,366,2,0,5,1,0,0,1,1,0,0,530,7,453
4800,경상남도,4817,함양군,,함양읍제2투,1244,748,164,550,13,1,11,0,0,0,0,1,0,1,741,7,496
4800,경상남도,4817,함양군,,함양읍제3투,2587,1509,552,863,41,0,26,0,2,0,2,4,2,0,1492,17,1078
4800,경상남도,4817,함양군,,함양읍제4투,736,438,117,297,5,0,9,0,0,0,1,3,1,1,434,4,298
4800,경상남도,4817,함양군,,함양읍제5투,1584,1033,300,698,22,0,7,0,0,0,0,0,0,0,1027,6,551
4800,경상남도,4817,함양군,,함양읍제6투,957,497,149,320,9,0,8,0,0,0,1,2,1,0,490,7,460
4800,경상남도,4817,함양군,,함양읍제7투,545,330,81,233,5,0,4,0,0,0,0,1,2,0,326,4,215
4800,경상남도,4817,함양군,마천면,소계,1823,1388,497,814,19,0,17,2,2,2,0,4,14,5,1376,12,435
4800,경상남도,4817,함양군,,관내사전투표,799,799,302,465,10,0,4,1,1,1,0,1,6,2,793,6,0
4800,경상남도,4817,함양군,,마천면투표소,1024,589,195,349,9,0,13,1,1,1,0,3,8,3,583,6,435
4800,경상남도,4817,함양군,휴천면,소계,1276,976,317,605,14,1,11,1,0,0,1,3,5,3,961,15,300
4800,경상남도,4817,함양군,,관내사전투표,595,595,221,345,7,1,5,0,0,0,0,2,4,1,586,9,0
4800,경상남도,4817,함양군,,휴천면투표소,681,381,96,260,7,0,6,1,0,0,1,1,1,2,375,6,300
4800,경상남도,4817,함양군,유림면,소계,1344,998,258,673,17,2,20,1,0,1,1,4,3,6,986,12,346
4800,경상남도,4817,함양군,,관내사전투표,592,592,172,390,9,1,5,1,0,0,0,2,2,3,585,7,0
4800,경상남도,4817,함양군,,유림면투표소,752,406,86,283,8,1,15,0,0,1,1,2,1,3,401,5,346
4800,경상남도,4817,함양군,수동면,소계,2047,1636,477,1086,29,0,13,0,0,0,1,6,2,1,1615,21,411
4800,경상남도,4817,함양군,,관내사전투표,939,939,289,611,20,0,6,0,0,0,1,2,0,0,929,10,0
4800,경상남도,4817,함양군,,수동면투표소,1108,697,188,475,9,0,7,0,0,0,0,4,2,1,686,11,411
4800,경상남도,4817,함양군,지곡면,소계,1940,1558,455,1017,32,3,17,1,1,1,1,3,6,2,1539,19,382
4800,경상남도,4817,함양군,,관내사전투표,1039,1039,318,656,24,3,11,1,1,1,1,1,6,1,1024,15,0
4800,경상남도,4817,함양군,,지곡면투표소,901,519,137,361,8,0,6,0,0,0,0,2,0,1,515,4,382
4800,경상남도,4817,함양군,안의면,소계,3934,3057,767,2113,60,5,33,2,2,4,11,4,5,1,3007,50,877
4800,경상남도,4817,함양군,,관내사전투표,1915,1915,496,1329,29,4,14,2,2,2,4,0,4,0,1886,29,0
4800,경상남도,4817,함양군,,안의면제1투,1081,632,155,424,19,0,11,0,0,2,4,2,1,1,619,13,449
4800,경상남도,4817,함양군,,안의면제2투,938,510,116,360,12,1,8,0,0,0,3,2,0,0,502,8,428
4800,경상남도,4817,함양군,서하면,소계,1139,890,233,618,8,1,11,0,0,0,0,4,4,0,879,11,249
4800,경상남도,4817,함양군,,관내사전투표,527,527,138,362,5,1,7,0,0,0,0,2,4,0,519,8,0
4800,경상남도,4817,함양군,,서하면투표소,612,363,95,256,3,0,4,0,0,0,0,2,0,0,360,3,249
4800,경상남도,4817,함양군,서상면,소계,1566,1232,386,765,28,0,21,0,0,1,7,2,5,2,1217,15,334
4800,경상남도,4817,함양군,,관내사전투표,661,661,231,395,14,0,10,0,0,1,1,1,1,0,654,7,0
4800,경상남도,4817,함양군,,서상면투표소,905,571,155,370,14,0,11,0,0,0,6,1,4,2,563,8,334
4800,경상남도,4817,함양군,백전면,소계,1278,983,306,633,14,2,9,1,0,0,1,5,5,0,976,7,295
4800,경상남도,4817,함양군,,관내사전투표,560,560,213,328,9,0,2,1,0,0,0,3,1,0,557,3,0
4800,경상남도,4817,함양군,,백전면투표소,718,423,93,305,5,2,7,0,0,0,1,2,4,0,419,4,295
4800,경상남도,4817,함양군,병곡면,소계,1147,937,268,609,15,2,15,1,1,1,7,1,3,2,925,12,210
4800,경상남도,4817,함양군,,관내사전투표,587,587,188,369,10,1,8,1,1,0,2,1,1,1,583,4,0
4800,경상남도,4817,함양군,,병곡면투표소,560,350,80,240,5,1,7,0,0,1,5,0,2,1,342,8,210
4800,경상남도,4817,함양군,잘못 투입·구분된 투표지,,0,0,0,0,0,0,0,0,0,0,0,0,0,0,0,0,0
4800,경상남도,4818,산청군,합계,,31645,24913,7125,16607,464,24,218,9,4,9,34,82,42,28,24646,267,6732
4800,경상남도,4818,산청군,거소·선상투표,,156,142,52,67,1,0,2,0,0,1,0,3,0,1,127,15,14
4800,경상남도,4818,산청군,관외사전투표,,3667,3667,1262,2238,79,3,36,1,0,0,7,7,3,5,3641,26,0
4800,경상남도,4818,산청군,재외투표,,179,84,46,33,3,0,1,0,0,0,0,0,0,0,83,1,95
4800,경상남도,4818,산청군,산청읍,소계,5143,3809,1119,2506,82,5,43,1,0,1,4,10,4,3,3778,31,1334
4800,경상남도,4818,산청군,,관내사전투표,2037,2037,661,1278,52,2,20,1,0,1,1,7,3,0,2026,11,0
4800,경상남도,4818,산청군,,산청읍제1투,2377,1347,344,937,24,2,21,0,0,0,2,2,0,2,1334,13,1030
4800,경상남도,4818,산청군,,산청읍제2투,729,425,114,291,6,1,2,0,0,0,1,1,1,1,418,7,304
4800,경상남도,4818,산청군,차황면,소계,1178,916,243,634,10,1,5,0,0,2,0,3,4,3,905,11,262
4800,경상남도,4818,산청군,,관내사전투표,535,535,160,356,6,1,2,0,0,0,0,1,2,2,530,5,0
4800,경상남도,4818,산청군,,차황면투표소,643,381,83,278,4,0,3,0,0,2,0,2,2,1,375,6,262
4800,경상남도,4818,산청군,오부면,소계,849,649,157,445,12,2,8,0,0,0,2,6,4,3,639,10,200
4800,경상남도,4818,산청군,,관내사전투표,346,346,94,232,4,2,3,0,0,0,2,4,2,2,345,1,0
4800,경상남도,4818,산청군,,오부면투표소,503,303,63,213,8,0,5,0,0,0,0,2,2,1,294,9,200
4800,경상남도,4818,산청군,생초면,소계,1720,1283,274,953,17,0,5,0,0,1,3,3,4,1,1261,22,437
4800,경상남도,4818,산청군,,관내사전투표,680,680,150,502,8,0,3,0,0,0,2,3,2,0,670,10,0
4800,경상남도,4818,산청군,,생초면투표소,1040,603,124,451,9,0,2,0,0,1,1,0,2,1,591,12,437
4800,경상남도,4818,산청군,금서면,소계,2439,1803,506,1201,40,2,12,0,0,0,3,2,5,2,1773,30,636
4800,경상남도,4818,산청군,,관내사전투표,900,900,293,557,24,2,8,0,0,0,1,1,1,0,887,13,0
4800,경상남도,4818,산청군,,금서면제1투,1032,557,140,390,11,0,3,0,0,0,0,0,2,2,548,9,475
4800,경상남도,4818,산청군,,금서면제2투,507,346,73,254,5,0,1,0,0,0,2,1,2,0,338,8,161
4800,경상남도,4818,산청군,삼장면,소계,1488,1224,332,854,15,0,8,0,0,1,1,7,0,2,1220,4,264
4800,경상남도,4818,산청군,,관내사전투표,667,667,211,440,7,0,1,0,0,1,0,4,0,0,664,3,0
4800,경상남도,4818,산청군,,삼장면투표소,821,557,121,414,8,0,7,0,0,0,1,3,0,2,556,1,264
4800,경상남도,4818,산청군,시천면,소계,3324,2588,753,1727,44,1,27,0,1,0,4,8,0,2,2567,21,736
4800,경상남도,4818,산청군,,관내사전투표,1300,1300,467,784,24,1,9,0,0,0,2,7,0,0,1294,6,0
4800,경상남도,4818,산청군,,시천면제1투,1085,698,146,520,12,0,8,0,0,0,2,1,0,1,690,8,387
4800,경상남도,4818,산청군,,시천면제2투,939,590,140,423,8,0,10,0,1,0,0,0,0,1,583,7,349
4800,경상남도,4818,산청군,단성면,소계,4461,3293,866,2276,58,2,25,1,1,1,7,10,8,2,3257,36,1168
4800,경상남도,4818,산청군,,관내사전투표,1664,1664,509,1089,34,2,7,0,0,1,0,6,4,0,1652,12,0
4800,경상남도,4818,산청군,,단성면제1투,2169,1213,263,883,18,0,17,1,1,0,7,4,1,1,1196,17,956
4800,경상남도,4818,산청군,,단성면제2투,628,416,94,304,6,0,1,0,0,0,0,0,3,1,409,7,212
4800,경상남도,4818,산청군,신안면,소계,4276,3283,1001,2131,66,2,31,1,1,2,3,11,4,1,3254,29,993
4800,경상남도,4818,산청군,,관내사전투표,1654,1654,615,973,29,1,18,0,0,0,0,4,1,1,1642,12,0
4800,경상남도,4818,산청군,,신안면제1투,1782,1109,281,769,27,1,8,1,1,0,2,6,1,0,1097,12,673
4800,경상남도,4818,산청군,,신안면제2투,840,520,105,389,10,0,5,0,0,2,1,1,2,0,515,5,320
4800,경상남도,4818,산청군,생비량면,소계,957,756,157,555,20,3,3,2,1,0,0,6,1,1,749,7,201
4800,경상남도,4818,산청군,,관내사전투표,393,393,90,277,10,3,1,2,1,0,0,3,1,1,389,4,0
4800,경상남도,4818,산청군,,생비량면투표소,564,363,67,278,10,0,2,0,0,0,0,3,0,0,360,3,201
4800,경상남도,4818,산청군,신등면,소계,1808,1416,357,987,17,3,12,3,0,0,0,6,5,2,1392,24,392
4800,경상남도,4818,산청군,,관내사전투표,821,821,244,535,11,2,2,2,0,0,0,5,3,2,806,15,0
4800,경상남도,4818,산청군,,신등면투표소,987,595,113,452,6,1,10,1,0,0,0,1,2,0,586,9,392
4800,경상남도,4818,산청군,잘못 투입·구분된 투표지,,0,0,0,0,0,0,0,0,0,0,0,0,0,0,0,0,0
4800,경상남도,4819,거창군,합계,,53049,41399,11963,27254,895,46,490,19,18,12,42,92,62,52,40945,454,11650
4800,경상남도,4819,거창군,거소·선상투표,,135,126,30,83,1,1,2,0,0,0,0,0,0,0,117,9,9
4800,경상남도,4819,거창군,관외사전투표,,3904,3902,1401,2255,120,6,56,0,5,1,1,5,2,6,3858,44,2
4800,경상남도,4819,거창군,재외투표,,323,169,92,60,4,0,1,0,0,0,0,0,0,0,157,12,154
4800,경상남도,4819,거창군,거창읍,소계,28943,21108,6477,13625,463,13,231,6,4,4,15,42,15,13,20908,200,7835
4800,경상남도,4819,거창군,,관내사전투표,8057,8057,2836,4878,189,6,54,3,0,3,6,22,6,6,8009,48,0
4800,경상남도,4819,거창군,,거창읍제1투,2178,1331,467,795,35,0,12,2,0,0,1,1,2,2,1317,14,847
4800,경상남도,4819,거창군,,거창읍제2투,2131,1349,343,939,23,1,18,0,1,1,0,3,2,1,1332,17,782
4800,경상남도,4819,거창군,,거창읍제3투,2260,1476,386,1018,25,1,16,0,0,0,0,5,2,1,1454,22,784
4800,경상남도,4819,거창군,,거창읍제4투,2968,1824,550,1193,26,1,22,0,0,0,4,5,2,0,1803,21,1144
4800,경상남도,4819,거창군,,거창읍제5투,2711,1703,419,1207,35,1,13,0,0,0,3,0,1,0,1679,24,1008
4800,경상남도,4819,거창군,,거창읍제6투,1935,1200,302,834,20,0,29,0,0,0,0,3,0,1,1189,11,735
4800,경상남도,4819,거창군,,거창읍제7투,2082,1213,363,782,34,0,18,0,1,0,1,0,0,0,1199,14,869
4800,경상남도,4819,거창군,,거창읍제8투,1142,790,150,600,18,0,7,1,0,0,0,1,0,2,779,11,352
4800,경상남도,4819,거창군,,거창읍제9투,1369,887,296,548,20,2,13,0,0,0,0,2,0,0,881,6,482
4800,경상남도,4819,거창군,,거창읍제10투,2110,1278,365,831,38,1,29,0,2,0,0,0,0,0,1266,12,832
4800,경상남도,4819,거창군,주상면,소계,1573,1312,295,958,16,1,11,2,1,2,2,1,1,2,1292,20,261
4800,경상남도,4819,거창군,,관내사전투표,880,880,218,622,12,1,8,2,1,1,1,1,1,0,868,12,0
4800,경상남도,4819,거창군,,주상면투표소,693,432,77,336,4,0,3,0,0,1,1,0,0,2,424,8,261
4800,경상남도,4819,거창군,웅양면,소계,1702,1387,396,890,33,3,18,0,0,0,3,6,5,2,1356,31,315
4800,경상남도,4819,거창군,,관내사전투표,911,911,259,592,20,3,9,0,0,0,1,3,3,1,891,20,0
4800,경상남도,4819,거창군,,웅양면투표소,791,476,137,298,13,0,9,0,0,0,2,3,2,1,465,11,315
4800,경상남도,4819,거창군,고제면,소계,1296,1061,295,696,20,2,14,2,0,1,2,9,7,2,1050,11,235
4800,경상남도,4819,거창군,,관내사전투표,680,680,191,443,18,1,7,2,0,1,0,7,5,1,676,4,0
4800,경상남도,4819,거창군,,고제면투표소,616,381,104,253,2,1,7,0,0,0,2,2,2,1,374,7,235
4800,경상남도,4819,거창군,북상면,소계,1314,1037,273,712,19,3,4,2,1,0,0,4,2,2,1022,15,277
4800,경상남도,4819,거창군,,관내사전투표,695,695,189,473,12,2,2,0,1,0,0,3,1,1,684,11,0
4800,경상남도,4819,거창군,,북상면투표소,619,342,84,239,7,1,2,2,0,0,0,1,1,1,338,4,277
4800,경상남도,4819,거창군,위천면,소계,1698,1368,333,952,35,3,23,1,1,0,1,2,1,1,1353,15,330
4800,경상남도,4819,거창군,,관내사전투표,908,908,231,627,23,2,9,1,0,0,1,2,1,1,898,10,0
4800,경상남도,4819,거창군,,위천면투표소,790,460,102,325,12,1,14,0,1,0,0,0,0,0,455,5,330
4800,경상남도,4819,거창군,마리면,소계,2124,1719,435,1187,33,1,31,1,1,1,3,6,1,1,1701,18,405
4800,경상남도,4819,거창군,,관내사전투표,1155,1155,311,792,22,0,11,1,1,0,0,5,0,1,1144,11,0
4800,경상남도,4819,거창군,,마리면투표소,969,564,124,395,11,1,20,0,0,1,3,1,1,0,557,7,405
4800,경상남도,4819,거창군,남상면,소계,2314,1866,453,1301,31,3,19,2,2,1,7,3,6,8,1836,30,448
4800,경상남도,4819,거창군,,관내사전투표,1258,1258,323,858,27,2,11,2,2,0,4,2,3,7,1241,17,0
4800,경상남도,4819,거창군,,남상면투표소,1056,608,130,443,4,1,8,0,0,1,3,1,3,1,595,13,448
4800,경상남도,4819,거창군,남하면,소계,1831,1574,415,1076,36,4,20,0,0,1,2,5,4,3,1566,8,257
4800,경상남도,4819,거창군,,관내사전투표,1153,1153,333,765,25,3,12,0,0,1,1,4,4,2,1150,3,0
4800,경상남도,4819,거창군,,남하면투표소,678,421,82,311,11,1,8,0,0,0,1,1,0,1,416,5,257
4800,경상남도,4819,거창군,신원면,소계,1327,1045,234,741,25,3,13,1,1,1,0,0,9,5,1033,12,282
4800,경상남도,4819,거창군,,관내사전투표,664,664,171,447,17,1,7,1,1,1,0,0,8,3,657,7,0
4800,경상남도,4819,거창군,,신원면투표소,663,381,63,294,8,2,6,0,0,0,0,0,1,2,376,5,282
4800,경상남도,4819,거창군,가조면,소계,3444,2825,638,2056,53,3,32,2,1,0,5,5,3,7,2805,20,619
4800,경상남도,4819,거창군,,관내사전투표,1822,1822,428,1318,37,1,17,0,0,0,2,3,1,3,1810,12,0
4800,경상남도,4819,거창군,,가조면투표소,1622,1003,210,738,16,2,15,2,1,0,3,2,2,4,995,8,619
4800,경상남도,4819,거창군,가북면,소계,1121,898,196,661,6,0,15,0,1,0,1,4,6,0,890,8,223
4800,경상남도,4819,거창군,,관내사전투표,505,505,125,361,4,0,4,0,0,0,1,4,3,0,502,3,0
4800,경상남도,4819,거창군,,가북면투표소,616,393,71,300,2,0,11,0,1,0,0,0,3,0,388,5,223
4800,경상남도,4819,거창군,잘못 투입·구분된 투표지,,0,2,0,1,0,0,0,0,0,0,0,0,0,0,1,1,-2
4800,경상남도,4820,합천군,합계,,39768,31270,6911,22742,511,30,311,24,9,16,62,96,68,52,30832,438,8498
4800,경상남도,4820,합천군,거소·선상투표,,323,300,45,185,2,1,7,5,1,2,5,1,2,2,258,42,23
4800,경상남도,4820,합천군,관외사전투표,,3969,3968,1170,2626,83,3,35,2,1,1,2,9,3,0,3935,33,1
4800,경상남도,4820,합천군,재외투표,,287,127,47,68,1,1,0,0,0,0,0,0,0,0,117,10,160
4800,경상남도,4820,합천군,합천읍,소계,8732,6656,1630,4692,141,3,92,0,1,3,5,19,3,5,6594,62,2076
4800,경상남도,4820,합천군,,관내사전투표,3484,3484,949,2369,88,1,34,0,0,0,2,9,2,1,3455,29,0
4800,경상남도,4820,합천군,,합천읍제1투,1425,883,184,653,17,2,14,0,0,0,0,2,1,0,873,10,542
4800,경상남도,4820,합천군,,합천읍제2투,2113,1223,273,887,20,0,17,0,1,1,2,5,0,2,1208,15,890
4800,경상남도,4820,합천군,,합천읍제3투,1710,1066,224,783,16,0,27,0,0,2,1,3,0,2,1058,8,644
4800,경상남도,4820,합천군,봉산면,소계,1162,897,187,677,7,0,3,1,0,0,1,4,4,3,887,10,265
4800,경상남도,4820,합천군,,관내사전투표,523,523,109,399,4,0,2,0,0,0,1,1,1,2,519,4,0
4800,경상남도,4820,합천군,,봉산면투표소,639,374,78,278,3,0,1,1,0,0,0,3,3,1,368,6,265
4800,경상남도,4820,합천군,묘산면,소계,1333,1040,156,834,13,2,11,0,0,3,4,2,1,2,1028,12,293
4800,경상남도,4820,합천군,,관내사전투표,531,531,92,416,8,1,3,0,0,1,2,1,0,0,524,7,0
4800,경상남도,4820,합천군,,묘산면투표소,802,509,64,418,5,1,8,0,0,2,2,1,1,2,504,5,293
4800,경상남도,4820,합천군,가야면,소계,3420,2661,622,1932,30,0,19,2,2,2,5,7,5,2,2628,33,759
4800,경상남도,4820,합천군,,관내사전투표,1187,1187,319,819,17,0,13,1,0,1,1,3,2,1,1177,10,0
4800,경상남도,4820,합천군,,가야면제1투,908,561,105,427,5,0,4,0,2,0,3,1,0,1,548,13,347
4800,경상남도,4820,합천군,,가야면제2투,904,643,119,502,5,0,1,1,0,1,1,3,3,0,636,7,261
4800,경상남도,4820,합천군,,가야면제3투,421,270,79,184,3,0,1,0,0,0,0,0,0,0,267,3,151
4800,경상남도,4820,합천군,야로면,소계,1935,1504,268,1163,27,0,9,0,2,0,0,2,4,3,1478,26,431
4800,경상남도,4820,합천군,,관내사전투표,843,843,156,650,17,0,0,0,2,0,0,2,3,0,830,13,0
4800,경상남도,4820,합천군,,야로면투표소,1092,661,112,513,10,0,9,0,0,0,0,0,1,3,648,13,431
4800,경상남도,4820,합천군,율곡면,소계,1907,1423,245,1104,21,3,11,2,0,1,5,6,4,1,1403,20,484
4800,경상남도,4820,합천군,,관내사전투표,744,744,141,575,12,2,1,1,0,0,0,2,3,0,737,7,0
4800,경상남도,4820,합천군,,율곡면투표소,1163,679,104,529,9,1,10,1,0,1,5,4,1,1,666,13,484
4800,경상남도,4820,합천군,초계면,소계,2051,1551,320,1172,17,3,15,1,0,1,1,3,1,2,1536,15,500
4800,경상남도,4820,합천군,,관내사전투표,881,881,185,660,11,2,8,1,0,1,0,2,0,1,871,10,0
4800,경상남도,4820,합천군,,초계면투표소,1170,670,135,512,6,1,7,0,0,0,1,1,1,1,665,5,500
4800,경상남도,4820,합천군,쌍책면,소계,1062,878,128,697,12,1,8,0,0,0,5,8,3,5,867,11,184
4800,경상남도,4820,합천군,,관내사전투표,394,394,62,317,4,0,3,0,0,0,1,2,2,1,392,2,0
4800,경상남도,4820,합천군,,쌍책면투표소,668,484,66,380,8,1,5,0,0,0,4,6,1,4,475,9,184
4800,경상남도,4820,합천군,덕곡면,소계,726,583,85,472,7,0,4,1,0,0,0,1,2,0,572,11,143
4800,경상남도,4820,합천군,,관내사전투표,317,317,51,252,3,0,1,1,0,0,0,1,1,0,310,7,0
4800,경상남도,4820,합천군,,덕곡면투표소,409,266,34,220,4,0,3,0,0,0,0,0,1,0,262,4,143
4800,경상남도,4820,합천군,청덕면,소계,1286,939,138,743,15,2,8,1,1,2,6,1,5,1,923,16,347
4800,경상남도,4820,합천군,,관내사전투표,405,405,72,311,4,1,3,0,1,2,4,0,2,0,400,5,0
4800,경상남도,4820,합천군,,청덕면투표소,881,534,66,432,11,1,5,1,0,0,2,1,3,1,523,11,347
4800,경상남도,4820,합천군,적중면,소계,1171,905,161,683,12,1,15,1,0,0,4,3,4,4,888,17,266
4800,경상남도,4820,합천군,,관내사전투표,450,450,86,341,9,0,3,1,0,0,2,1,1,1,445,5,0
4800,경상남도,4820,합천군,,적중면투표소,721,455,75,342,3,1,12,0,0,0,2,2,3,3,443,12,266
4800,경상남도,4820,합천군,대양면,소계,1357,977,228,697,27,0,10,0,0,0,2,3,1,0,968,9,380
4800,경상남도,4820,합천군,,관내사전투표,518,518,125,368,14,0,2,0,0,0,0,3,1,0,513,5,0
4800,경상남도,4820,합천군,,대양면투표소,839,459,103,329,13,0,8,0,0,0,2,0,0,0,455,4,380
4800,경상남도,4820,합천군,쌍백면,소계,1470,1107,213,830,14,1,11,3,1,0,2,3,7,5,1090,17,363
4800,경상남도,4820,합천군,,관내사전투표,630,630,132,462,10,0,6,3,1,0,1,1,5,1,622,8,0
4800,경상남도,4820,합천군,,쌍백면투표소,840,477,81,368,4,1,5,0,0,0,1,2,2,4,468,9,363
4800,경상남도,4820,합천군,삼가면,소계,2724,2046,453,1480,34,4,20,0,0,1,3,6,0,5,2006,40,678
4800,경상남도,4820,합천군,,관내사전투표,1029,1029,249,726,20,4,5,0,0,1,2,3,0,1,1011,18,0
4800,경상남도,4820,합천군,,삼가면제1투,825,482,98,358,7,0,8,0,0,0,0,0,0,1,472,10,343
4800,경상남도,4820,합천군,,삼가면제2투,870,535,106,396,7,0,7,0,0,0,1,3,0,3,523,12,335
4800,경상남도,4820,합천군,가회면,소계,1375,1062,246,760,16,0,6,2,0,0,2,7,3,2,1044,18,313
4800,경상남도,4820,합천군,,관내사전투표,631,631,156,442,11,0,0,2,0,0,0,5,3,0,619,12,0
4800,경상남도,4820,합천군,,가회면투표소,744,431,90,318,5,0,6,0,0,0,2,2,0,2,425,6,313
4800,경상남도,4820,합천군,대병면,소계,1643,1233,268,895,11,4,17,2,0,0,3,4,5,5,1214,19,410
4800,경상남도,4820,합천군,,관내사전투표,715,715,166,509,4,4,8,0,0,0,3,3,4,2,703,12,0
4800,경상남도,4820,합천군,,대병면투표소,928,518,102,386,7,0,9,2,0,0,0,1,1,3,511,7,410
4800,경상남도,4820,합천군,용주면,소계,1835,1413,301,1032,21,1,10,1,0,0,7,7,11,5,1396,17,422
4800,경상남도,4820,합천군,,관내사전투표,796,796,188,569,10,0,2,0,0,0,2,4,8,2,785,11,0
4800,경상남도,4820,합천군,,용주면투표소,1039,617,113,463,11,1,8,1,0,0,5,3,3,3,611,6,422
4800,경상남도,4820,합천군,잘못 투입·구분된 투표지,,0,0,0,0,0,0,0,0,0,0,0,0,0,0,0,0,04900,제주특별자치도,4901,제주시,합계,,408552,296826,157695,122084,10007,189,2496,108,46,80,193,395,159,197,293649,3177,111726
4900,제주특별자치도,4901,제주시,거소·선상투표,,1201,1107,474,401,37,4,20,3,1,6,1,6,4,7,964,143,94
4900,제주특별자치도,4901,제주시,관외사전투표,,23035,23028,11333,10016,883,20,321,17,3,5,6,27,14,23,22668,360,7
4900,제주특별자치도,4901,제주시,재외투표,,2652,1606,803,610,52,0,2,1,0,1,2,6,1,1,1479,127,1046
4900,제주특별자치도,4901,제주시,한림읍,소계,17056,11666,5958,5105,331,12,95,4,2,2,6,14,12,13,11554,112,5390
4900,제주특별자치도,4901,제주시,,관내사전투표,4650,4651,2528,1924,117,6,33,0,1,1,2,7,3,2,4624,27,-1
4900,제주특별자치도,4901,제주시,,한림읍제1투,1188,730,333,352,29,1,3,0,0,0,0,2,1,0,721,9,458
4900,제주특별자치도,4901,제주시,,한림읍제2투,959,579,280,277,9,0,3,0,0,0,1,0,0,0,570,9,380
4900,제주특별자치도,4901,제주시,,한림읍제3투,1720,891,444,401,25,0,11,1,0,0,0,1,0,0,883,8,829
4900,제주특별자치도,4901,제주시,,한림읍제4투,614,402,235,144,8,0,3,0,0,0,0,0,2,2,394,8,212
4900,제주특별자치도,4901,제주시,,한림읍제5투,1032,593,240,311,25,1,5,1,0,0,2,0,1,0,586,7,439
4900,제주특별자치도,4901,제주시,,한림읍제6투,979,596,288,268,25,0,9,0,0,0,0,0,0,1,591,5,383
4900,제주특별자치도,4901,제주시,,한림읍제7투,1266,663,338,286,19,1,8,1,0,1,0,2,1,0,657,6,603
4900,제주특별자치도,4901,제주시,,한림읍제8투,900,580,299,254,15,0,3,0,0,0,0,1,1,3,576,4,320
4900,제주특별자치도,4901,제주시,,한림읍제9투,1409,691,374,279,22,0,5,0,0,0,1,1,2,0,684,7,718
4900,제주특별자치도,4901,제주시,,한림읍제10투,1272,637,319,271,23,1,6,0,0,0,0,0,0,2,622,15,635
4900,제주특별자치도,4901,제주시,,한림읍제11투,102,62,9,52,1,0,0,0,0,0,0,0,0,0,62,0,40
4900,제주특별자치도,4901,제주시,,한림읍제12투,457,260,124,123,3,1,5,0,0,0,0,0,0,1,257,3,197
4900,제주특별자치도,4901,제주시,,한림읍제13투,508,331,147,163,10,1,1,1,1,0,0,0,1,2,327,4,177
4900,제주특별자치도,4901,제주시,애월읍,소계,25993,17885,9530,7301,601,9,189,11,2,10,13,25,12,16,17719,166,8108
4900,제주특별자치도,4901,제주시,,관내사전투표,4736,4736,2826,1710,131,3,30,2,0,2,2,3,0,2,4711,25,0
4900,제주특별자치도,4901,제주시,,애월읍제1투,1991,1042,501,473,36,1,18,1,0,1,1,1,1,1,1035,7,949
4900,제주특별자치도,4901,제주시,,애월읍제2투,994,641,334,269,19,0,10,0,0,0,0,1,0,1,634,7,353
4900,제주특별자치도,4901,제주시,,애월읍제3투,2206,1310,642,572,41,2,18,1,0,3,3,0,1,3,1286,24,896
4900,제주특별자치도,4901,제주시,,애월읍제4투,2814,1683,880,709,46,0,26,0,0,0,1,2,1,1,1666,17,1131
4900,제주특별자치도,4901,제주시,,애월읍제5투,1015,715,363,311,23,1,6,0,0,0,1,2,0,0,707,8,300
4900,제주특별자치도,4901,제주시,,애월읍제6투,2923,1864,961,768,79,1,23,2,0,2,1,6,1,1,1845,19,1059
4900,제주특별자치도,4901,제주시,,애월읍제7투,883,576,268,265,19,0,3,2,1,0,0,3,2,0,563,13,307
4900,제주특별자치도,4901,제주시,,애월읍제8투,1038,687,363,283,22,1,6,0,1,0,0,3,1,2,682,5,351
4900,제주특별자치도,4901,제주시,,애월읍제9투,899,567,250,274,20,0,8,1,0,0,1,1,2,0,557,10,332
4900,제주특별자치도,4901,제주시,,애월읍제10투,812,544,274,239,19,0,6,0,0,0,0,0,1,1,540,4,268
4900,제주특별자치도,4901,제주시,,애월읍제11투,3393,2075,1102,836,90,0,25,1,0,1,1,3,1,0,2060,15,1318
4900,제주특별자치도,4901,제주시,,애월읍제12투,1159,760,377,339,24,0,9,1,0,1,2,0,0,1,754,6,399
4900,제주특별자치도,4901,제주시,,애월읍제13투,1130,685,389,253,32,0,1,0,0,0,0,0,1,3,679,6,445
4900,제주특별자치도,4901,제주시,구좌읍,소계,12024,8379,4026,3904,232,2,55,5,2,3,8,11,13,15,8276,103,3645
4900,제주특별자치도,4901,제주시,,관내사전투표,2858,2858,1568,1166,76,1,16,3,1,1,2,2,2,3,2841,17,0
4900,제주특별자치도,4901,제주시,,구좌읍제1투,1848,1208,545,583,36,0,10,1,0,2,2,1,3,2,1185,23,640
4900,제주특별자치도,4901,제주시,,구좌읍제2투,1140,688,293,352,14,0,5,0,1,0,0,2,4,1,672,16,452
4900,제주특별자치도,4901,제주시,,구좌읍제3투,772,430,190,211,19,0,2,0,0,0,0,0,0,1,423,7,342
4900,제주특별자치도,4901,제주시,,구좌읍제4투,840,523,282,210,17,0,3,0,0,0,0,0,0,1,513,10,317
4900,제주특별자치도,4901,제주시,,구좌읍제5투,1416,706,298,365,23,1,5,0,0,0,2,1,0,2,697,9,710
4900,제주특별자치도,4901,제주시,,구좌읍제6투,1081,640,260,350,18,0,4,0,0,0,1,2,1,1,637,3,441
4900,제주특별자치도,4901,제주시,,구좌읍제7투,826,539,257,254,9,0,2,1,0,0,0,2,1,3,529,10,287
4900,제주특별자치도,4901,제주시,,구좌읍제8투,505,341,157,166,10,0,3,0,0,0,1,0,1,1,339,2,164
4900,제주특별자치도,4901,제주시,,구좌읍제9투,738,446,176,247,10,0,5,0,0,0,0,1,1,0,440,6,292
4900,제주특별자치도,4901,제주시,조천읍,소계,19414,13832,7116,5891,478,11,104,5,5,6,10,23,15,12,13676,156,5582
4900,제주특별자치도,4901,제주시,,관내사전투표,5194,5194,3036,1915,163,4,28,3,1,1,2,6,2,7,5168,26,0
4900,제주특별자치도,4901,제주시,,조천읍제1투,2858,1740,855,767,74,3,10,0,0,0,3,4,1,0,1717,23,1118
4900,제주특별자치도,4901,제주시,,조천읍제2투,1419,746,333,364,28,0,9,0,0,0,0,0,2,0,736,10,673
4900,제주특별자치도,4901,제주시,,조천읍제3투,1596,991,477,443,29,1,16,1,0,0,0,1,1,0,969,22,605
4900,제주특별자치도,4901,제주시,,조천읍제4투,984,690,326,325,18,0,4,0,0,1,2,2,3,0,681,9,294
4900,제주특별자치도,4901,제주시,,조천읍제5투,932,611,290,278,16,0,8,0,1,1,0,1,2,1,598,13,321
4900,제주특별자치도,4901,제주시,,조천읍제6투,2122,1322,583,646,48,3,10,1,3,3,3,4,1,2,1307,15,800
4900,제주특별자치도,4901,제주시,,조천읍제7투,1725,1008,488,451,36,0,10,0,0,0,0,3,1,2,991,17,717
4900,제주특별자치도,4901,제주시,,조천읍제8투,2584,1530,728,702,66,0,9,0,0,0,0,2,2,0,1509,21,1054
4900,제주특별자치도,4901,제주시,한경면,소계,7409,5282,2749,2276,136,3,32,2,1,0,4,6,9,9,5227,55,2127
4900,제주특별자치도,4901,제주시,,관내사전투표,2122,2122,1191,841,46,3,7,2,0,0,0,3,2,2,2097,25,0
4900,제주특별자치도,4901,제주시,,한경면제1투,580,391,206,165,14,0,3,0,0,0,0,0,2,1,391,0,189
4900,제주특별자치도,4901,제주시,,한경면제2투,782,515,253,240,10,0,6,0,0,0,0,0,3,1,513,2,267
4900,제주특별자치도,4901,제주시,,한경면제3투,1334,686,351,289,22,0,6,0,1,0,2,1,2,3,677,9,648
4900,제주특별자치도,4901,제주시,,한경면제4투,1145,662,324,304,16,0,2,0,0,0,2,2,0,0,650,12,483
4900,제주특별자치도,4901,제주시,,한경면제5투,1446,906,424,437,28,0,8,0,0,0,0,0,0,2,899,7,540
4900,제주특별자치도,4901,제주시,추자면,소계,1257,877,452,373,18,0,8,1,0,1,2,0,5,1,861,16,380
4900,제주특별자치도,4901,제주시,,관내사전투표,389,389,207,157,8,0,4,0,0,0,1,0,1,0,378,11,0
4900,제주특별자치도,4901,제주시,,추자면제1투,467,249,114,121,5,0,3,1,0,0,1,0,3,0,248,1,218
4900,제주특별자치도,4901,제주시,,추자면제2투,401,239,131,95,5,0,1,0,0,1,0,0,1,1,235,4,162
4900,제주특별자치도,4901,제주시,우도면,소계,1347,940,453,447,19,0,9,0,0,0,1,0,1,3,933,7,407
4900,제주특별자치도,4901,제주시,,관내사전투표,624,624,306,301,9,0,4,0,0,0,0,0,1,1,622,2,0
4900,제주특별자치도,4901,제주시,,우도면투표소,723,316,147,146,10,0,5,0,0,0,1,0,0,2,311,5,407
4900,제주특별자치도,4901,제주시,일도1동,소계,2822,2066,1060,898,55,3,16,2,0,0,3,4,0,2,2043,23,756
4900,제주특별자치도,4901,제주시,,관내사전투표,1431,1431,784,579,34,3,11,2,0,0,1,2,0,1,1417,14,0
4900,제주특별자치도,4901,제주시,,일도1동투표소,1391,635,276,319,21,0,5,0,0,0,2,2,0,1,626,9,756
4900,제주특별자치도,4901,제주시,일도2동,소계,24471,17564,9088,7538,602,8,110,5,3,4,19,26,4,5,17412,152,6907
4900,제주특별자치도,4901,제주시,,관내사전투표,6236,6236,3379,2589,193,1,27,2,1,0,2,6,1,1,6202,34,0
4900,제주특별자치도,4901,제주시,,일도2동제1투,1739,1070,542,458,36,3,9,1,0,1,1,4,0,0,1055,15,669
4900,제주특별자치도,4901,제주시,,일도2동제2투,2046,1017,509,456,28,1,12,0,1,0,0,1,0,1,1009,8,1029
4900,제주특별자치도,4901,제주시,,일도2동제3투,1751,1083,505,509,34,2,12,0,0,0,2,5,2,0,1071,12,668
4900,제주특별자치도,4901,제주시,,일도2동제4투,2036,1094,533,483,49,0,8,1,0,0,2,1,0,0,1077,17,942
4900,제주특별자치도,4901,제주시,,일도2동제5투,1521,947,459,428,31,0,4,0,0,0,5,0,0,2,929,18,574
4900,제주특별자치도,4901,제주시,,일도2동제6투,2107,1272,601,594,51,0,10,0,1,0,0,2,0,0,1259,13,835
4900,제주특별자치도,4901,제주시,,일도2동제7투,2501,1713,934,692,60,0,10,1,0,0,1,2,1,1,1702,11,788
4900,제주특별자치도,4901,제주시,,일도2동제8투,2567,1735,911,713,83,0,7,0,0,1,3,2,0,0,1720,15,832
4900,제주특별자치도,4901,제주시,,일도2동제9투,1967,1397,715,616,37,1,11,0,0,2,3,3,0,0,1388,9,570
4900,제주특별자치도,4901,제주시,이도1동,소계,6405,4539,2290,2023,146,0,25,0,0,0,6,3,2,3,4498,41,1866
4900,제주특별자치도,4901,제주시,,관내사전투표,2164,2164,1180,897,60,0,11,0,0,0,3,2,0,1,2154,10,0
4900,제주특별자치도,4901,제주시,,이도1동제1투,1282,638,303,297,24,0,1,0,0,0,0,0,2,2,629,9,644
4900,제주특별자치도,4901,제주시,,이도1동제2투,1558,888,431,413,25,0,4,0,0,0,2,0,0,0,875,13,670
4900,제주특별자치도,4901,제주시,,이도1동제3투,1401,849,376,416,37,0,9,0,0,0,1,1,0,0,840,9,552
4900,제주특별자치도,4901,제주시,이도2동,소계,36374,25730,13508,10679,1007,17,190,5,1,5,13,35,9,11,25480,250,10644
4900,제주특별자치도,4901,제주시,,관내사전투표,8704,8704,4743,3435,366,5,63,2,0,2,1,11,3,3,8634,70,0
4900,제주특별자치도,4901,제주시,,이도2동제1투,2407,1418,682,641,54,2,9,1,0,1,3,1,0,0,1394,24,989
4900,제주특별자치도,4901,제주시,,이도2동제2투,4306,2835,1554,1124,102,1,21,0,0,1,4,3,0,1,2811,24,1471
4900,제주특별자치도,4901,제주시,,이도2동제3투,2797,1539,796,656,61,1,7,0,0,0,0,3,1,1,1526,13,1258
4900,제주특별자치도,4901,제주시,,이도2동제4투,3432,2129,1082,919,84,1,16,1,0,0,0,2,0,0,2105,24,1303
4900,제주특별자치도,4901,제주시,,이도2동제5투,2277,1438,826,519,62,1,10,1,0,0,0,3,0,0,1422,16,839
4900,제주특별자치도,4901,제주시,,이도2동제6투,2102,1212,558,578,42,1,13,0,0,0,0,4,1,1,1198,14,890
4900,제주특별자치도,4901,제주시,,이도2동제7투,3155,1878,944,806,79,2,20,0,0,0,2,0,1,1,1855,23,1277
4900,제주특별자치도,4901,제주시,,이도2동제8투,2312,1588,728,786,48,1,6,0,1,0,0,1,1,1,1573,15,724
4900,제주특별자치도,4901,제주시,,이도2동제9투,1719,1026,548,417,33,1,11,0,0,0,0,3,2,1,1016,10,693
4900,제주특별자치도,4901,제주시,,이도2동제10투,3163,1963,1047,798,76,1,14,0,0,1,3,4,0,2,1946,17,1200
4900,제주특별자치도,4901,제주시,삼도1동,소계,11001,7840,3971,3475,226,5,61,1,1,0,2,5,5,7,7759,81,3161
4900,제주특별자치도,4901,제주시,,관내사전투표,3627,3627,1911,1576,93,1,15,0,0,0,0,3,1,0,3600,27,0
4900,제주특별자치도,4901,제주시,,삼도1동제1투,1963,1133,576,492,36,1,8,0,0,0,1,0,2,4,1120,13,830
4900,제주특별자치도,4901,제주시,,삼도1동제2투,1615,953,443,461,23,1,11,0,0,0,0,1,2,2,944,9,662
4900,제주특별자치도,4901,제주시,,삼도1동제3투,1979,1057,543,445,31,1,17,1,1,0,1,1,0,0,1041,16,922
4900,제주특별자치도,4901,제주시,,삼도1동제4투,1817,1070,498,501,43,1,10,0,0,0,0,0,0,1,1054,16,747
4900,제주특별자치도,4901,제주시,삼도2동,소계,6665,4630,2344,2024,154,3,44,2,1,2,3,2,0,3,4582,48,2035
4900,제주특별자치도,4901,제주시,,관내사전투표,1897,1897,1058,739,72,1,12,0,0,1,1,0,0,2,1886,11,0
4900,제주특별자치도,4901,제주시,,삼도2동제1투,1584,850,419,377,27,1,11,0,0,0,0,0,0,0,835,15,734
4900,제주특별자치도,4901,제주시,,삼도2동제2투,1261,702,322,344,20,0,10,0,0,0,1,2,0,0,699,3,559
4900,제주특별자치도,4901,제주시,,삼도2동제3투,1923,1181,545,564,35,1,11,2,1,1,1,0,0,1,1162,19,742
4900,제주특별자치도,4901,제주시,용담1동,소계,5482,3628,1861,1554,123,4,32,4,0,0,2,5,3,2,3590,38,1854
4900,제주특별자치도,4901,제주시,,관내사전투표,1611,1611,860,665,48,1,15,1,0,0,1,3,0,2,1596,15,0
4900,제주특별자치도,4901,제주시,,용담1동제1투,1440,733,350,337,27,2,11,0,0,0,1,0,1,0,729,4,707
4900,제주특별자치도,4901,제주시,,용담1동제2투,1166,584,301,243,25,0,1,1,0,0,0,1,2,0,574,10,582
4900,제주특별자치도,4901,제주시,,용담1동제3투,1265,700,350,309,23,1,5,2,0,0,0,1,0,0,691,9,565
4900,제주특별자치도,4901,제주시,용담2동,소계,11187,7671,3893,3335,233,3,88,0,2,1,10,7,4,5,7581,90,3516
4900,제주특별자치도,4901,제주시,,관내사전투표,3327,3327,1727,1443,86,3,22,0,0,0,5,5,2,0,3293,34,0
4900,제주특별자치도,4901,제주시,,용담2동제1투,1476,768,341,370,31,0,11,0,1,1,2,0,0,3,760,8,708
4900,제주특별자치도,4901,제주시,,용담2동제2투,1756,918,456,398,32,0,17,0,0,0,0,1,0,0,904,14,838
4900,제주특별자치도,4901,제주시,,용담2동제3투,1474,868,464,350,26,0,9,0,1,0,1,0,1,0,852,16,606
4900,제주특별자치도,4901,제주시,,용담2동제4투,1534,844,416,372,31,0,11,0,0,0,1,0,1,2,834,10,690
4900,제주특별자치도,4901,제주시,,용담2동제5투,1620,946,489,402,27,0,18,0,0,0,1,1,0,0,938,8,674
4900,제주특별자치도,4901,제주시,건입동,소계,7832,5735,3075,2371,157,8,56,1,2,1,3,6,4,2,5686,49,2097
4900,제주특별자치도,4901,제주시,,관내사전투표,2974,2974,1710,1138,67,6,24,1,1,1,1,3,0,2,2954,20,0
4900,제주특별자치도,4901,제주시,,건입동제1투,416,190,93,87,3,0,5,0,1,0,1,0,0,0,190,0,226
4900,제주특별자치도,4901,제주시,,건입동제2투,1334,698,341,310,24,1,8,0,0,0,0,1,2,0,687,11,636
4900,제주특별자치도,4901,제주시,,건입동제3투,1747,1096,526,508,38,1,11,0,0,0,1,2,2,0,1089,7,651
4900,제주특별자치도,4901,제주시,,건입동제4투,1361,777,405,328,25,0,8,0,0,0,0,0,0,0,766,11,584
4900,제주특별자치도,4901,제주시,화북동,소계,17638,12688,7077,4838,463,11,111,7,5,5,16,19,6,8,12566,122,4950
4900,제주특별자치도,4901,제주시,,관내사전투표,5014,5014,2922,1857,158,5,27,6,1,0,4,5,3,1,4989,25,0
4900,제주특별자치도,4901,제주시,,화북동제1투,1509,906,489,339,31,0,18,0,0,1,4,3,0,2,887,19,603
4900,제주특별자치도,4901,제주시,,화북동제2투,2241,1249,643,520,50,1,15,0,1,0,1,3,0,1,1235,14,992
4900,제주특별자치도,4901,제주시,,화북동제3투,974,551,273,229,18,1,11,0,0,1,1,1,0,1,536,15,423
4900,제주특별자치도,4901,제주시,,화북동제4투,1618,869,454,352,40,0,12,0,0,1,1,0,0,0,860,9,749
4900,제주특별자치도,4901,제주시,,화북동제5투,1669,1160,615,473,47,0,8,0,0,1,0,1,1,0,1146,14,509
4900,제주특별자치도,4901,제주시,,화북동제6투,1836,1156,662,414,47,2,12,1,2,1,2,2,1,2,1148,8,680
4900,제주특별자치도,4901,제주시,,화북동제7투,2777,1783,1019,654,72,2,8,0,1,0,3,4,1,1,1765,18,994
4900,제주특별자치도,4901,제주시,삼양동,소계,18585,13544,8050,4785,450,10,91,5,2,1,6,13,10,5,13428,116,5041
4900,제주특별자치도,4901,제주시,,관내사전투표,5889,5889,3612,2043,163,1,28,1,0,0,0,5,4,2,5859,30,0
4900,제주특별자치도,4901,제주시,,삼양동제1투,1808,1037,535,430,45,2,9,0,0,0,1,1,0,0,1023,14,771
4900,제주특별자치도,4901,제주시,,삼양동제2투,3250,1836,1048,680,58,1,18,0,0,0,2,1,1,0,1809,27,1414
4900,제주특별자치도,4901,제주시,,삼양동제3투,2185,1266,723,476,34,2,13,2,0,0,0,3,1,3,1257,9,919
4900,제주특별자치도,4901,제주시,,삼양동제4투,510,323,169,127,12,0,4,0,1,0,0,0,2,0,315,8,187
4900,제주특별자치도,4901,제주시,,삼양동제5투,1924,1276,794,409,52,2,4,0,1,1,1,2,1,0,1267,9,648
4900,제주특별자치도,4901,제주시,,삼양동제6투,3019,1917,1169,620,86,2,15,2,0,0,2,1,1,0,1898,19,1102
4900,제주특별자치도,4901,제주시,봉개동,소계,5786,4609,2546,1803,152,6,48,4,1,2,0,5,2,3,4572,37,1177
4900,제주특별자치도,4901,제주시,,관내사전투표,3019,3019,1721,1156,84,5,24,3,1,2,0,3,1,1,3001,18,0
4900,제주특별자치도,4901,제주시,,봉개동제1투,2089,1166,605,463,62,1,19,0,0,0,0,0,0,1,1151,15,923
4900,제주특별자치도,4901,제주시,,봉개동제2투,443,268,142,112,3,0,5,1,0,0,0,1,0,0,264,4,175
4900,제주특별자치도,4901,제주시,,봉개동제3투,235,156,78,72,3,0,0,0,0,0,0,1,1,1,156,0,79
4900,제주특별자치도,4901,제주시,아라동,소계,27158,19399,11027,7251,734,7,116,5,1,3,11,49,6,6,19216,183,7759
4900,제주특별자치도,4901,제주시,,관내사전투표,8097,8096,4823,2912,269,2,18,3,1,1,3,20,0,2,8054,42,1
4900,제주특별자치도,4901,제주시,,아라동제1투,4304,2390,1270,928,115,3,29,0,0,0,0,7,1,2,2355,35,1914
4900,제주특별자치도,4901,제주시,,아라동제2투,3400,2113,1214,785,75,0,14,1,0,0,2,3,0,0,2094,19,1287
4900,제주특별자치도,4901,제주시,,아라동제3투,4515,2679,1516,988,107,1,20,1,0,0,3,6,2,1,2645,34,1836
4900,제주특별자치도,4901,제주시,,아라동제4투,1707,1112,601,430,48,1,15,0,0,1,0,4,0,1,1101,11,595
4900,제주특별자치도,4901,제주시,,아라동제5투,5135,3009,1603,1208,120,0,20,0,0,1,3,9,3,0,2967,42,2126
4900,제주특별자치도,4901,제주시,오라동,소계,14847,11583,6443,4558,378,4,100,5,3,0,4,12,3,5,11515,68,3264
4900,제주특별자치도,4901,제주시,,관내사전투표,7188,7187,4118,2757,201,2,58,3,1,0,3,8,3,2,7156,31,1
4900,제주특별자치도,4901,제주시,,오라동제1투,2677,1551,740,712,60,1,16,0,1,0,1,3,0,1,1535,16,1126
4900,제주특별자치도,4901,제주시,,오라동제2투,4982,2845,1585,1089,117,1,26,2,1,0,0,1,0,2,2824,21,2137
4900,제주특별자치도,4901,제주시,연동,소계,35269,23867,12234,10356,770,11,194,11,4,9,16,23,2,7,23637,230,11402
4900,제주특별자치도,4901,제주시,,관내사전투표,10548,10548,5731,4345,331,5,57,7,0,6,3,11,1,2,10499,49,0
4900,제주특별자치도,4901,제주시,,연동제1투,2382,1131,483,572,40,0,17,0,0,0,0,2,0,0,1114,17,1251
4900,제주특별자치도,4901,제주시,,연동제2투,3732,2049,948,984,59,3,22,0,1,0,4,2,0,1,2024,25,1683
4900,제주특별자치도,4901,제주시,,연동제3투,3321,1714,844,767,65,1,17,0,1,0,4,2,0,0,1701,13,1607
4900,제주특별자치도,4901,제주시,,연동제4투,2938,1276,621,585,27,0,16,0,1,1,2,1,0,0,1254,22,1662
4900,제주특별자치도,4901,제주시,,연동제5투,3341,2045,1075,831,83,1,18,3,0,0,1,0,0,3,2015,30,1296
4900,제주특별자치도,4901,제주시,,연동제6투,3347,1850,973,743,76,0,16,1,1,0,0,4,1,0,1815,35,1497
4900,제주특별자치도,4901,제주시,,연동제7투,1940,1020,472,500,23,0,9,0,0,2,1,1,0,0,1008,12,920
4900,제주특별자치도,4901,제주시,,연동제8투,3720,2234,1087,1029,66,1,22,0,0,0,1,0,0,1,2207,27,1486
4900,제주특별자치도,4901,제주시,노형동,소계,39969,28076,14986,11598,934,20,211,2,2,6,9,33,3,15,27819,257,11893
4900,제주특별자치도,4901,제주시,,관내사전투표,9370,9368,5294,3681,262,13,46,1,0,2,2,8,1,2,9312,56,2
4900,제주특별자치도,4901,제주시,,노형동제1투,2027,1317,732,509,53,0,8,0,1,0,1,1,0,1,1306,11,710
4900,제주특별자치도,4901,제주시,,노형동제2투,2586,1656,849,704,59,0,21,0,0,0,0,1,0,1,1635,21,930
4900,제주특별자치도,4901,제주시,,노형동제3투,4316,2269,1129,968,89,4,39,0,0,0,1,6,1,3,2240,29,2047
4900,제주특별자치도,4901,제주시,,노형동제4투,3301,2311,1121,1077,75,0,12,0,0,0,0,4,0,0,2289,22,990
4900,제주특별자치도,4901,제주시,,노형동제5투,2680,1535,787,655,57,0,14,0,0,1,0,2,0,3,1519,16,1145
4900,제주특별자치도,4901,제주시,,노형동제6투,4560,2534,1343,1031,102,1,21,0,0,2,1,3,0,3,2507,27,2026
4900,제주특별자치도,4901,제주시,,노형동제7투,1279,856,479,343,20,1,9,1,0,0,0,0,0,0,853,3,423
4900,제주특별자치도,4901,제주시,,노형동제8투,3584,2165,1126,895,92,1,19,0,0,1,1,3,0,2,2140,25,1419
4900,제주특별자치도,4901,제주시,,노형동제9투,2675,1650,918,641,50,0,12,0,1,0,2,1,1,0,1626,24,1025
4900,제주특별자치도,4901,제주시,,노형동제10투,3591,2415,1208,1094,75,0,10,0,0,0,1,4,0,0,2392,23,1176
4900,제주특별자치도,4901,제주시,외도동,소계,17787,12929,7883,4318,456,6,114,0,2,6,11,21,4,5,12826,103,4858
4900,제주특별자치도,4901,제주시,,관내사전투표,6564,6564,4219,2048,205,1,29,0,2,3,4,9,1,4,6525,39,0
4900,제주특별자치도,4901,제주시,,외도동제1투,3433,1761,980,661,68,0,29,0,0,2,1,2,1,1,1745,16,1672
4900,제주특별자치도,4901,제주시,,외도동제2투,1548,926,533,321,44,2,12,0,0,0,1,4,1,0,918,8,622
4900,제주특별자치도,4901,제주시,,외도동제3투,3833,2104,1208,741,84,3,36,0,0,1,5,3,0,0,2081,23,1729
4900,제주특별자치도,4901,제주시,,외도동제4투,2409,1574,943,547,55,0,8,0,0,0,0,3,1,0,1557,17,835
4900,제주특별자치도,4901,제주시,이호동,소계,4332,3322,1863,1297,91,0,35,0,0,0,4,5,3,1,3299,23,1010
4900,제주특별자치도,4901,제주시,,관내사전투표,1892,1892,1101,710,51,0,17,0,0,0,0,2,2,0,1883,9,0
4900,제주특별자치도,4901,제주시,,이호동제1투,782,419,202,188,13,0,6,0,0,0,1,2,1,0,413,6,363
4900,제주특별자치도,4901,제주시,,이호동제2투,1658,1011,560,399,27,0,12,0,0,0,3,1,0,1,1003,8,647
4900,제주특별자치도,4901,제주시,도두동,소계,3554,2803,1602,1058,89,2,19,0,0,1,2,4,3,2,2782,21,751
4900,제주특별자치도,4901,제주시,,관내사전투표,1761,1761,1037,645,48,2,11,0,0,0,1,3,2,0,1749,12,0
4900,제주특별자치도,4901,제주시,,도두동제1투,1163,617,323,253,25,0,4,0,0,1,1,1,1,1,610,7,546
4900,제주특별자치도,4901,제주시,,도두동제2투,630,425,242,160,16,0,4,0,0,0,0,0,0,1,423,2,205
4900,제주특별자치도,4901,제주시,잘못 투입·구분된 투표지,,0,1,0,1,0,0,0,0,0,0,0,0,0,0,1,0,-1
4900,제주특별자치도,4902,서귀포시,합계,,155802,112823,55435,50930,3591,78,1043,38,17,21,78,176,69,113,111589,1234,42979
4900,제주특별자치도,4902,서귀포시,거소·선상투표,,503,467,175,190,16,2,13,1,0,1,1,3,0,0,402,65,36
4900,제주특별자치도,4902,서귀포시,관외사전투표,,12858,12848,6022,6008,450,12,146,9,2,5,9,19,1,5,12688,160,10
4900,제주특별자치도,4902,서귀포시,재외투표,,1080,681,358,229,35,1,1,0,0,0,2,3,0,0,629,52,399
4900,제주특별자치도,4902,서귀포시,대정읍,소계,15947,10911,4903,5399,346,3,94,4,0,2,9,17,9,13,10799,112,5036
4900,제주특별자치도,4902,서귀포시,,관내사전투표,4070,4070,2016,1868,111,2,39,1,0,1,1,3,4,4,4050,20,0
4900,제주특별자치도,4902,서귀포시,,대정읍제1투,2256,1206,527,584,51,0,13,0,0,0,3,3,1,1,1183,23,1050
4900,제주특별자치도,4902,서귀포시,,대정읍제2투,1580,840,351,443,24,0,8,0,0,0,3,1,0,0,830,10,740
4900,제주특별자치도,4902,서귀포시,,대정읍제3투,938,557,260,253,20,0,10,0,0,0,0,3,0,1,547,10,381
4900,제주특별자치도,4902,서귀포시,,대정읍제4투,412,291,128,144,9,0,0,1,0,0,1,1,1,1,286,5,121
4900,제주특별자치도,4902,서귀포시,,대정읍제5투,2571,1472,514,892,43,0,9,0,0,0,0,1,0,0,1459,13,1099
4900,제주특별자치도,4902,서귀포시,,대정읍제6투,162,112,51,53,4,0,0,0,0,0,0,1,0,0,109,3,50
4900,제주특별자치도,4902,서귀포시,,대정읍제7투,560,379,165,200,8,0,0,1,0,0,0,2,1,0,377,2,181
4900,제주특별자치도,4902,서귀포시,,대정읍제8투,1677,799,369,380,28,0,7,0,0,0,1,1,1,3,790,9,878
4900,제주특별자치도,4902,서귀포시,,대정읍제9투,365,247,90,143,8,1,0,1,0,0,0,0,0,1,244,3,118
4900,제주특별자치도,4902,서귀포시,,대정읍제10투,410,293,147,117,13,0,3,0,0,0,0,1,0,1,282,11,117
4900,제주특별자치도,4902,서귀포시,,대정읍제11투,320,229,124,88,13,0,0,0,0,0,0,0,1,1,227,2,91
4900,제주특별자치도,4902,서귀포시,,대정읍제12투,626,416,161,234,14,0,5,0,0,1,0,0,0,0,415,1,210
4900,제주특별자치도,4902,서귀포시,남원읍,소계,14261,9868,4877,4435,284,9,82,4,1,1,4,26,10,15,9748,120,4393
4900,제주특별자치도,4902,서귀포시,,관내사전투표,3232,3232,1788,1308,84,3,14,2,0,0,1,4,0,2,3206,26,0
4900,제주특별자치도,4902,서귀포시,,남원읍제1투,514,315,137,149,18,1,3,0,0,0,0,2,1,0,311,4,199
4900,제주특별자치도,4902,서귀포시,,남원읍제2투,897,568,285,250,9,0,10,0,0,0,0,4,2,2,562,6,329
4900,제주특별자치도,4902,서귀포시,,남원읍제3투,681,439,201,217,9,0,3,0,0,0,1,0,0,0,431,8,242
4900,제주특별자치도,4902,서귀포시,,남원읍제4투,2288,1215,585,530,40,1,20,0,1,0,0,5,0,4,1186,29,1073
4900,제주특별자치도,4902,서귀포시,,남원읍제5투,1119,700,308,340,30,1,9,0,0,0,0,1,0,1,690,10,419
4900,제주특별자치도,4902,서귀포시,,남원읍제6투,1171,733,303,398,16,0,4,0,0,0,0,2,1,2,726,7,438
4900,제주특별자치도,4902,서귀포시,,남원읍제7투,623,377,146,203,14,0,2,1,0,0,0,1,0,0,367,10,246
4900,제주특별자치도,4902,서귀포시,,남원읍제8투,1638,938,458,435,29,2,5,0,0,0,1,1,2,1,934,4,700
4900,제주특별자치도,4902,서귀포시,,남원읍제9투,352,228,105,112,5,0,0,0,0,0,0,1,0,1,224,4,124
4900,제주특별자치도,4902,서귀포시,,남원읍제10투,466,293,140,128,10,0,4,0,0,0,0,0,3,0,285,8,173
4900,제주특별자치도,4902,서귀포시,,남원읍제11투,242,174,81,83,3,0,3,0,0,1,0,2,0,0,173,1,68
4900,제주특별자치도,4902,서귀포시,,남원읍제12투,375,227,106,111,5,1,1,0,0,0,0,1,0,0,225,2,148
4900,제주특별자치도,4902,서귀포시,,남원읍제13투,383,233,132,91,6,0,1,1,0,0,0,0,0,1,232,1,150
4900,제주특별자치도,4902,서귀포시,,남원읍제14투,280,196,102,80,6,0,3,0,0,0,1,2,1,1,196,0,84
4900,제주특별자치도,4902,서귀포시,성산읍,소계,11857,8152,3407,4363,208,2,58,2,1,1,3,13,8,12,8078,74,3705
4900,제주특별자치도,4902,서귀포시,,관내사전투표,2988,2988,1349,1520,73,1,17,0,0,0,0,4,0,2,2966,22,0
4900,제주특별자치도,4902,서귀포시,,성산읍제1투,1007,590,243,328,14,0,0,0,1,0,1,0,0,1,588,2,417
4900,제주특별자치도,4902,서귀포시,,성산읍제2투,618,362,129,212,11,0,2,0,0,0,0,1,0,0,355,7,256
4900,제주특별자치도,4902,서귀포시,,성산읍제3투,2215,1095,481,568,21,0,6,1,0,0,1,2,1,1,1082,13,1120
4900,제주특별자치도,4902,서귀포시,,성산읍제4투,771,455,169,256,13,0,5,0,0,1,0,0,0,3,447,8,316
4900,제주특별자치도,4902,서귀포시,,성산읍제5투,784,433,173,235,16,0,6,0,0,0,0,0,0,0,430,3,351
4900,제주특별자치도,4902,서귀포시,,성산읍제6투,708,436,209,201,17,0,3,0,0,0,0,5,0,0,435,1,272
4900,제주특별자치도,4902,서귀포시,,성산읍제7투,428,294,91,182,10,0,7,0,0,0,0,0,1,0,291,3,134
4900,제주특별자치도,4902,서귀포시,,성산읍제8투,318,200,73,120,2,0,1,1,0,0,0,0,1,0,198,2,118
4900,제주특별자치도,4902,서귀포시,,성산읍제9투,519,323,110,194,8,0,4,0,0,0,0,0,3,2,321,2,196
4900,제주특별자치도,4902,서귀포시,,성산읍제10투,421,287,117,155,6,0,1,0,0,0,0,0,0,2,281,6,134
4900,제주특별자치도,4902,서귀포시,,성산읍제11투,665,403,156,231,8,0,3,0,0,0,1,0,1,0,400,3,262
4900,제주특별자치도,4902,서귀포시,,성산읍제12투,415,286,107,161,9,1,3,0,0,0,0,1,1,1,284,2,129
4900,제주특별자치도,4902,서귀포시,안덕면,소계,9361,6662,3320,2949,220,6,71,2,0,1,6,7,6,14,6602,60,2699
4900,제주특별자치도,4902,서귀포시,,관내사전투표,2474,2474,1335,1011,78,3,24,1,0,0,3,1,0,4,2460,14,0
4900,제주특별자치도,4902,서귀포시,,안덕면제1투,1554,907,447,405,30,0,8,0,0,1,1,1,3,0,896,11,647
4900,제주특별자치도,4902,서귀포시,,안덕면제2투,1475,877,380,443,22,1,12,1,0,0,1,3,0,3,866,11,598
4900,제주특별자치도,4902,서귀포시,,안덕면제3투,731,503,215,260,16,0,3,0,0,0,0,0,1,1,496,7,228
4900,제주특별자치도,4902,서귀포시,,안덕면제4투,788,479,264,192,12,1,4,0,0,0,0,0,1,2,476,3,309
4900,제주특별자치도,4902,서귀포시,,안덕면제5투,768,438,216,198,12,1,7,0,0,0,1,1,0,0,436,2,330
4900,제주특별자치도,4902,서귀포시,,안덕면제6투,385,254,112,133,4,0,3,0,0,0,0,0,0,0,252,2,131
4900,제주특별자치도,4902,서귀포시,,안덕면제7투,508,320,160,128,18,0,5,0,0,0,0,1,0,1,313,7,188
4900,제주특별자치도,4902,서귀포시,,안덕면제8투,678,410,191,179,28,0,5,0,0,0,0,0,1,3,407,3,268
4900,제주특별자치도,4902,서귀포시,표선면,소계,9843,6966,3225,3358,209,6,56,4,1,0,6,15,7,12,6899,67,2877
4900,제주특별자치도,4902,서귀포시,,관내사전투표,3054,3054,1511,1418,79,3,13,1,0,0,1,4,1,4,3035,19,0
4900,제주특별자치도,4902,서귀포시,,표선면제1투,2693,1266,538,640,43,0,19,2,0,0,3,1,0,2,1248,18,1427
4900,제주특별자치도,4902,서귀포시,,표선면제2투,684,420,170,216,15,1,7,0,1,0,0,2,1,1,414,6,264
4900,제주특별자치도,4902,서귀포시,,표선면제3투,844,542,198,309,17,0,5,0,0,0,1,3,2,0,535,7,302
4900,제주특별자치도,4902,서귀포시,,표선면제4투,498,317,130,172,8,1,1,1,0,0,0,1,0,0,314,3,181
4900,제주특별자치도,4902,서귀포시,,표선면제5투,827,547,281,227,15,1,3,0,0,0,1,2,1,5,536,11,280
4900,제주특별자치도,4902,서귀포시,,표선면제6투,284,194,117,66,7,0,1,0,0,0,0,2,1,0,194,0,90
4900,제주특별자치도,4902,서귀포시,,표선면제7투,432,260,97,147,10,0,5,0,0,0,0,0,1,0,260,0,172
4900,제주특별자치도,4902,서귀포시,,표선면제8투,363,239,124,103,9,0,2,0,0,0,0,0,0,0,238,1,124
4900,제주특별자치도,4902,서귀포시,,표선면제9투,164,127,59,60,6,0,0,0,0,0,0,0,0,0,125,2,37
4900,제주특별자치도,4902,서귀포시,송산동,소계,3479,2431,1169,1129,80,0,24,1,0,0,1,3,0,1,2408,23,1048
4900,제주특별자치도,4902,서귀포시,,관내사전투표,1101,1101,616,439,32,0,6,0,0,0,0,2,0,0,1095,6,0
4900,제주특별자치도,4902,서귀포시,,송산동제1투,1062,560,263,256,17,0,10,1,0,0,0,1,0,1,549,11,502
4900,제주특별자치도,4902,서귀포시,,송산동제2투,1316,770,290,434,31,0,8,0,0,0,1,0,0,0,764,6,546
4900,제주특별자치도,4902,서귀포시,정방동,소계,1814,1126,562,506,34,0,13,1,1,0,2,1,0,0,1120,6,688
4900,제주특별자치도,4902,서귀포시,,관내사전투표,556,556,312,216,19,0,5,1,0,0,0,1,0,0,554,2,0
4900,제주특별자치도,4902,서귀포시,,정방동투표소,1258,570,250,290,15,0,8,0,1,0,2,0,0,0,566,4,688
4900,제주특별자치도,4902,서귀포시,중앙동,소계,3293,2292,1130,1032,64,3,26,0,1,0,3,6,3,1,2269,23,1001
4900,제주특별자치도,4902,서귀포시,,관내사전투표,1394,1394,705,623,33,2,11,0,1,0,1,4,2,1,1383,11,0
4900,제주특별자치도,4902,서귀포시,,중앙동투표소,1899,898,425,409,31,1,15,0,0,0,2,2,1,0,886,12,1001
4900,제주특별자치도,4902,서귀포시,천지동,소계,3545,2554,1273,1148,77,2,27,3,1,1,0,4,1,0,2537,17,991
4900,제주특별자치도,4902,서귀포시,,관내사전투표,1519,1519,794,642,51,2,15,1,1,0,0,3,1,0,1510,9,0
4900,제주특별자치도,4902,서귀포시,,천지동제1투,1821,910,408,454,25,0,12,1,0,1,0,1,0,0,902,8,911
4900,제주특별자치도,4902,서귀포시,,천지동제2투,205,125,71,52,1,0,0,1,0,0,0,0,0,0,125,0,80
4900,제주특별자치도,4902,서귀포시,효돈동,소계,4733,3551,1729,1626,111,3,39,0,0,0,2,5,4,1,3520,31,1182
4900,제주특별자치도,4902,서귀포시,,관내사전투표,1910,1910,1006,806,61,2,17,0,0,0,0,2,0,0,1894,16,0
4900,제주특별자치도,4902,서귀포시,,효돈동제1투,1242,743,347,357,23,0,7,0,0,0,0,2,2,1,739,4,499
4900,제주특별자치도,4902,서귀포시,,효돈동제2투,1581,898,376,463,27,1,15,0,0,0,2,1,2,0,887,11,683
4900,제주특별자치도,4902,서귀포시,영천동,소계,4525,3265,1658,1431,100,2,23,3,0,1,4,9,1,8,3240,25,1260
4900,제주특별자치도,4902,서귀포시,,관내사전투표,1787,1787,957,753,47,1,10,2,0,1,1,5,1,2,1780,7,0
4900,제주특별자치도,4902,서귀포시,,영천동제1투,1942,1001,504,419,44,0,10,1,0,0,3,3,0,5,989,12,941
4900,제주특별자치도,4902,서귀포시,,영천동제2투,452,269,116,141,6,0,1,0,0,0,0,0,0,0,264,5,183
4900,제주특별자치도,4902,서귀포시,,영천동제3투,344,208,81,118,3,1,2,0,0,0,0,1,0,1,207,1,136
4900,제주특별자치도,4902,서귀포시,동홍동,소계,16428,10861,5879,4401,338,9,93,0,1,1,6,17,7,10,10762,99,5567
4900,제주특별자치도,4902,서귀포시,,관내사전투표,4690,4690,2724,1763,127,5,30,0,0,1,0,10,0,2,4662,28,0
4900,제주특별자치도,4902,서귀포시,,동홍동제1투,2700,1365,727,578,27,1,9,0,0,0,4,3,1,4,1354,11,1335
4900,제주특별자치도,4902,서귀포시,,동홍동제2투,3500,1723,880,721,72,0,26,0,0,0,0,0,1,1,1701,22,1777
4900,제주특별자치도,4902,서귀포시,,동홍동제3투,3015,1628,839,684,66,0,18,0,0,0,0,2,3,0,1612,16,1387
4900,제주특별자치도,4902,서귀포시,,동홍동제4투,2523,1455,709,655,46,3,10,0,1,0,2,2,2,3,1433,22,1068
4900,제주특별자치도,4902,서귀포시,서홍동,소계,8418,5926,3181,2371,226,3,71,0,4,2,4,3,1,4,5870,56,2492
4900,제주특별자치도,4902,서귀포시,,관내사전투표,3140,3140,1786,1188,110,1,30,0,3,1,1,2,0,2,3124,16,0
4900,제주특별자치도,4902,서귀포시,,서홍동제1투,3312,1741,908,700,72,1,29,0,1,1,2,0,0,2,1716,25,1571
4900,제주특별자치도,4902,서귀포시,,서홍동제2투,1966,1045,487,483,44,1,12,0,0,0,1,1,1,0,1030,15,921
4900,제주특별자치도,4902,서귀포시,대륜동,소계,12920,9807,5162,4152,313,4,73,1,2,3,8,5,5,6,9734,73,3113
4900,제주특별자치도,4902,서귀포시,,관내사전투표,5315,5315,2999,2056,184,3,28,1,1,3,2,2,2,2,5283,32,0
4900,제주특별자치도,4902,서귀포시,,대륜동제1투,1651,947,396,503,31,0,7,0,0,0,1,0,0,0,938,9,704
4900,제주특별자치도,4902,서귀포시,,대륜동제2투,2785,1643,845,714,57,0,11,0,1,0,1,2,1,1,1633,10,1142
4900,제주특별자치도,4902,서귀포시,,대륜동제3투,1483,900,421,434,14,1,10,0,0,0,2,1,2,2,887,13,583
4900,제주특별자치도,4902,서귀포시,,대륜동제4투,1686,1002,501,445,27,0,17,0,0,0,2,0,0,1,993,9,684
4900,제주특별자치도,4902,서귀포시,대천동,소계,8437,5680,2882,2468,196,3,52,2,1,0,5,9,2,2,5622,58,2757
4900,제주특별자치도,4902,서귀포시,,관내사전투표,1695,1695,957,649,61,2,10,0,0,0,1,2,1,0,1683,12,0
4900,제주특별자치도,4902,서귀포시,,대천동제1투,1259,771,381,345,17,0,8,2,0,0,0,2,0,1,756,15,488
4900,제주특별자치도,4902,서귀포시,,대천동제2투,952,526,252,240,17,0,7,0,0,0,1,1,0,0,518,8,426
4900,제주특별자치도,4902,서귀포시,,대천동제3투,509,310,144,147,10,0,7,0,0,0,0,0,0,0,308,2,199
4900,제주특별자치도,4902,서귀포시,,대천동제4투,367,229,130,87,4,0,2,0,1,0,0,1,0,1,226,3,138
4900,제주특별자치도,4902,서귀포시,,대천동제5투,3655,2149,1018,1000,87,1,18,0,0,0,3,3,1,0,2131,18,1506
4900,제주특별자치도,4902,서귀포시,중문동,소계,9476,6677,3512,2766,228,6,57,0,1,0,2,7,3,7,6589,88,2799
4900,제주특별자치도,4902,서귀포시,,관내사전투표,3041,3041,1742,1172,79,2,21,0,0,0,0,4,1,1,3022,19,0
4900,제주특별자치도,4902,서귀포시,,중문동제1투,3887,2054,1042,859,86,3,26,0,0,0,2,3,1,3,2025,29,1833
4900,제주특별자치도,4902,서귀포시,,중문동제2투,1298,753,332,351,35,1,5,0,1,0,0,0,1,2,728,25,545
4900,제주특별자치도,4902,서귀포시,,중문동제3투,847,557,295,233,15,0,3,0,0,0,0,0,0,0,546,11,290
4900,제주특별자치도,4902,서귀포시,,중문동제4투,403,272,101,151,13,0,2,0,0,0,0,0,0,1,268,4,131
4900,제주특별자치도,4902,서귀포시,예래동,소계,3024,2096,1010,968,56,2,24,1,0,2,1,4,1,2,2071,25,928
4900,제주특별자치도,4902,서귀포시,,관내사전투표,881,881,435,406,20,2,10,0,0,0,0,3,1,1,878,3,0
4900,제주특별자치도,4902,서귀포시,,예래동제1투,701,421,180,204,13,0,9,1,0,2,0,0,0,1,410,11,280
4900,제주특별자치도,4902,서귀포시,,예래동제2투,1113,569,269,267,16,0,4,0,0,0,1,1,0,0,558,11,544
4900,제주특별자치도,4902,서귀포시,,예래동제3투,329,225,126,91,7,0,1,0,0,0,0,0,0,0,225,0,104
4900,제주특별자치도,4902,서귀포시,잘못 투입·구분된 투표지,,0,2,1,1,0,0,0,0,0,0,0,0,0,0,2,0,-2